Poker Hand #RC1441358286: Hold'em No Limit  ($0.05/$0.1) - 2023/03/31 09:01:05
Table 'RushAndCash29753546' 6-max Seat #1 is the button
Seat 1: f246f92c ($10 in chips)
Seat 2: f4e006f6 ($19.61 in chips)
Seat 3: Hero ($9.85 in chips)
Seat 4: 3e988a8a ($11.11 in chips)
Seat 5: ff36c4d7 ($34.73 in chips)
Seat 6: edfb37b7 ($10 in chips)
f4e006f6: posts small blind $0.05
Hero: posts big blind $0.1
*** HOLE CARDS ***
Dealt to f246f92c 
Dealt to f4e006f6 
Dealt to Hero [7c 2s]
Dealt to 3e988a8a 
Dealt to ff36c4d7 
Dealt to edfb37b7 
3e988a8a: folds
ff36c4d7: folds
edfb37b7: folds
f246f92c: folds
f4e006f6: folds
Uncalled bet ($0.05) returned to Hero
*** SHOWDOWN ***
Hero collected $0.1 from pot
*** SUMMARY ***
Total pot $0.1 | Rake $0 | Jackpot $0 | Bingo $0 | Fortune $0
Seat 1: f246f92c (button) folded before Flop (didn't bet)
Seat 2: f4e006f6 (small blind) folded before Flop
Seat 3: Hero (big blind) collected ($0.1)
Seat 4: 3e988a8a folded before Flop (didn't bet)
Seat 5: ff36c4d7 folded before Flop (didn't bet)
Seat 6: edfb37b7 folded before Flop (didn't bet)


Poker Hand #RC1441358280: Hold'em No Limit  ($0.05/$0.1) - 2023/03/31 09:01:00
Table 'RushAndCash29753540' 6-max Seat #1 is the button
Seat 1: b4b87234 ($10 in chips)
Seat 2: 745782b6 ($9.46 in chips)
Seat 3: f246f92c ($10 in chips)
Seat 4: Hero ($9.85 in chips)
Seat 5: 2d9d575 ($8.04 in chips)
Seat 6: db402987 ($6.02 in chips)
745782b6: posts small blind $0.05
f246f92c: posts big blind $0.1
*** HOLE CARDS ***
Dealt to b4b87234 
Dealt to 745782b6 
Dealt to f246f92c 
Dealt to Hero [2d Qc]
Dealt to 2d9d575 
Dealt to db402987 
Hero: folds
2d9d575: folds
db402987: folds
b4b87234: folds
745782b6: folds
Uncalled bet ($0.05) returned to f246f92c
*** SHOWDOWN ***
f246f92c collected $0.1 from pot
*** SUMMARY ***
Total pot $0.1 | Rake $0 | Jackpot $0 | Bingo $0 | Fortune $0
Seat 1: b4b87234 (button) folded before Flop (didn't bet)
Seat 2: 745782b6 (small blind) folded before Flop
Seat 3: f246f92c (big blind) collected ($0.1)
Seat 4: Hero folded before Flop (didn't bet)
Seat 5: 2d9d575 folded before Flop (didn't bet)
Seat 6: db402987 folded before Flop (didn't bet)


Poker Hand #RC1441358272: Hold'em No Limit  ($0.05/$0.1) - 2023/03/31 09:00:55
Table 'RushAndCash29753532' 6-max Seat #1 is the button
Seat 1: 5fdd5540 ($19.89 in chips)
Seat 2: 6314ef2d ($14.07 in chips)
Seat 3: 376c9a37 ($10.64 in chips)
Seat 4: Hero ($9.85 in chips)
Seat 5: e78bf364 ($11.79 in chips)
Seat 6: fc4d5bf ($10.31 in chips)
6314ef2d: posts small blind $0.05
376c9a37: posts big blind $0.1
*** HOLE CARDS ***
Dealt to 5fdd5540 
Dealt to 6314ef2d 
Dealt to 376c9a37 
Dealt to Hero [2c Ts]
Dealt to e78bf364 
Dealt to fc4d5bf 
Hero: folds
e78bf364: folds
fc4d5bf: raises $0.15 to $0.25
5fdd5540: folds
6314ef2d: folds
376c9a37: folds
Uncalled bet ($0.15) returned to fc4d5bf
*** SHOWDOWN ***
fc4d5bf collected $0.25 from pot
*** SUMMARY ***
Total pot $0.25 | Rake $0 | Jackpot $0 | Bingo $0 | Fortune $0
Seat 1: 5fdd5540 (button) folded before Flop (didn't bet)
Seat 2: 6314ef2d (small blind) folded before Flop
Seat 3: 376c9a37 (big blind) folded before Flop
Seat 4: Hero folded before Flop (didn't bet)
Seat 5: e78bf364 folded before Flop (didn't bet)
Seat 6: fc4d5bf collected ($0.25)


Poker Hand #RC1441358265: Hold'em No Limit  ($0.05/$0.1) - 2023/03/31 09:00:51
Table 'RushAndCash29753525' 6-max Seat #1 is the button
Seat 1: b882173 ($10 in chips)
Seat 2: b8657847 ($14.08 in chips)
Seat 3: 60f45786 ($13.34 in chips)
Seat 4: 848af279 ($8.39 in chips)
Seat 5: Hero ($9.85 in chips)
Seat 6: 61363db1 ($10.78 in chips)
b8657847: posts small blind $0.05
60f45786: posts big blind $0.1
*** HOLE CARDS ***
Dealt to b882173 
Dealt to b8657847 
Dealt to 60f45786 
Dealt to 848af279 
Dealt to Hero [4c 5d]
Dealt to 61363db1 
848af279: folds
Hero: folds
61363db1: folds
b882173: folds
b8657847: folds
Uncalled bet ($0.05) returned to 60f45786
*** SHOWDOWN ***
60f45786 collected $0.1 from pot
*** SUMMARY ***
Total pot $0.1 | Rake $0 | Jackpot $0 | Bingo $0 | Fortune $0
Seat 1: b882173 (button) folded before Flop (didn't bet)
Seat 2: b8657847 (small blind) folded before Flop
Seat 3: 60f45786 (big blind) collected ($0.1)
Seat 4: 848af279 folded before Flop (didn't bet)
Seat 5: Hero folded before Flop (didn't bet)
Seat 6: 61363db1 folded before Flop (didn't bet)


Poker Hand #RC1441358247: Hold'em No Limit  ($0.05/$0.1) - 2023/03/31 09:00:40
Table 'RushAndCash29753507' 6-max Seat #1 is the button
Seat 1: 88f21cb1 ($15.2 in chips)
Seat 2: f2a14101 ($10.07 in chips)
Seat 3: b4b87234 ($10 in chips)
Seat 4: 3f5569b ($10 in chips)
Seat 5: d6e0d525 ($10.15 in chips)
Seat 6: Hero ($9.85 in chips)
f2a14101: posts small blind $0.05
b4b87234: posts big blind $0.1
*** HOLE CARDS ***
Dealt to 88f21cb1 
Dealt to f2a14101 
Dealt to b4b87234 
Dealt to 3f5569b 
Dealt to d6e0d525 
Dealt to Hero [9s 6d]
3f5569b: folds
d6e0d525: folds
Hero: folds
88f21cb1: raises $0.1 to $0.2
f2a14101: calls $0.15
b4b87234: folds
*** FLOP *** [4h Jd Kd]
f2a14101: checks
88f21cb1: bets $0.25
f2a14101: calls $0.25
*** TURN *** [4h Jd Kd] [Ac]
f2a14101: checks
88f21cb1: checks
*** RIVER *** [4h Jd Kd Ac] [Ah]
f2a14101: checks
88f21cb1: checks
f2a14101: shows [Tc Jh] (Pair of Aces and Pair of Jacks)
88f21cb1: shows [Qc Kh] (Pair of Aces and Pair of Kings)
*** SHOWDOWN ***
88f21cb1 collected $0.95 from pot
*** SUMMARY ***
Total pot $1 | Rake $0.05 | Jackpot $0 | Bingo $0 | Fortune $0
Board [4h Jd Kd Ac Ah]
Seat 1: 88f21cb1 (button) showed [Qc Kh] and won ($0.95) with Pair of Aces and Pair of Kings
Seat 2: f2a14101 (small blind) showed [Tc Jh] and lost with Pair of Aces and Pair of Jacks
Seat 3: b4b87234 (big blind) folded before Flop
Seat 4: 3f5569b folded before Flop (didn't bet)
Seat 5: d6e0d525 folded before Flop (didn't bet)
Seat 6: Hero folded before Flop (didn't bet)


Poker Hand #RC1441358234: Hold'em No Limit  ($0.05/$0.1) - 2023/03/31 09:00:32
Table 'RushAndCash29753494' 6-max Seat #1 is the button
Seat 1: Hero ($9.85 in chips)
Seat 2: 6d4cb3f7 ($5.66 in chips)
Seat 3: 31c33419 ($10.98 in chips)
Seat 4: 7fae2130 ($10.3 in chips)
Seat 5: bccc5428 ($10.53 in chips)
Seat 6: 8eb86a3c ($11.77 in chips)
6d4cb3f7: posts small blind $0.05
31c33419: posts big blind $0.1
*** HOLE CARDS ***
Dealt to Hero [Jd 5c]
Dealt to 6d4cb3f7 
Dealt to 31c33419 
Dealt to 7fae2130 
Dealt to bccc5428 
Dealt to 8eb86a3c 
7fae2130: folds
bccc5428: folds
8eb86a3c: folds
Hero: folds
6d4cb3f7: raises $0.15 to $0.25
31c33419: raises $0.5 to $0.75
6d4cb3f7: calls $0.5
*** FLOP *** [3d Ah 3s]
6d4cb3f7: checks
31c33419: bets $0.75
6d4cb3f7: raises $0.75 to $1.5
31c33419: raises $8.73 to $10.23 and is all-in
6d4cb3f7: calls $3.41 and is all-in
Uncalled bet ($5.32) returned to 31c33419
31c33419: shows [2d Qh] (Pair of Treys)
6d4cb3f7: shows [Ac Tc] (Pair of Aces and Pair of Treys)
*** FIRST TURN *** [3d Ah 3s] [Kh]
*** FIRST RIVER *** [3d Ah 3s Kh] [Ks]
*** SECOND TURN *** [3d Ah 3s] [6d]
*** SECOND RIVER *** [3d Ah 3s 6d] [5d]
*** FIRST SHOWDOWN ***
6d4cb3f7 collected $5.44 from pot
*** SECOND SHOWDOWN ***
6d4cb3f7 collected $5.43 from pot
*** SUMMARY ***
Total pot $11.32 | Rake $0.3 | Jackpot $0.15 | Bingo $0 | Fortune $0
Hand was run two times
FIRST Board [3d Ah 3s Kh Ks]
SECOND Board [6d 5d]
Seat 1: Hero (button) folded before Flop (didn't bet)
Seat 2: 6d4cb3f7 (small blind) showed [Ac Tc] and won ($5.44) with Pair of Aces and Pair of Kings, and won ($5.43)
Seat 3: 31c33419 (big blind) showed [2d Qh] and lost with Pair of Kings and Pair of Treys, and lost
Seat 4: 7fae2130 folded before Flop (didn't bet)
Seat 5: bccc5428 folded before Flop (didn't bet)
Seat 6: 8eb86a3c folded before Flop (didn't bet)


Poker Hand #RC1441358203: Hold'em No Limit  ($0.05/$0.1) - 2023/03/31 09:00:14
Table 'RushAndCash29753463' 6-max Seat #1 is the button
Seat 1: 7908deea ($10 in chips)
Seat 2: Hero ($9.9 in chips)
Seat 3: 2a9ebb01 ($6.45 in chips)
Seat 4: 236aabbc ($2.88 in chips)
Seat 5: 74f2660d ($10 in chips)
Seat 6: 656b805a ($16.7 in chips)
Hero: posts small blind $0.05
2a9ebb01: posts big blind $0.1
*** HOLE CARDS ***
Dealt to 7908deea 
Dealt to Hero [Ac 4d]
Dealt to 2a9ebb01 
Dealt to 236aabbc 
Dealt to 74f2660d 
Dealt to 656b805a 
236aabbc: folds
74f2660d: raises $0.12 to $0.22
656b805a: folds
7908deea: folds
Hero: folds
2a9ebb01: folds
Uncalled bet ($0.12) returned to 74f2660d
*** SHOWDOWN ***
74f2660d collected $0.25 from pot
*** SUMMARY ***
Total pot $0.25 | Rake $0 | Jackpot $0 | Bingo $0 | Fortune $0
Seat 1: 7908deea (button) folded before Flop (didn't bet)
Seat 2: Hero (small blind) folded before Flop
Seat 3: 2a9ebb01 (big blind) folded before Flop
Seat 4: 236aabbc folded before Flop (didn't bet)
Seat 5: 74f2660d collected ($0.25)
Seat 6: 656b805a folded before Flop (didn't bet)


Poker Hand #RC1441358188: Hold'em No Limit  ($0.05/$0.1) - 2023/03/31 09:00:04
Table 'RushAndCash29753448' 6-max Seat #1 is the button
Seat 1: 8831f441 ($18.54 in chips)
Seat 2: 5fdd5540 ($19.99 in chips)
Seat 3: Hero ($10 in chips)
Seat 4: 66fc7d9d ($27.08 in chips)
Seat 5: 55aff11d ($26.03 in chips)
Seat 6: 3cba5816 ($13.89 in chips)
5fdd5540: posts small blind $0.05
Hero: posts big blind $0.1
*** HOLE CARDS ***
Dealt to 8831f441 
Dealt to 5fdd5540 
Dealt to Hero [4c Jc]
Dealt to 66fc7d9d 
Dealt to 55aff11d 
Dealt to 3cba5816 
66fc7d9d: raises $0.1 to $0.2
55aff11d: folds
3cba5816: folds
8831f441: folds
5fdd5540: folds
Hero: folds
Uncalled bet ($0.1) returned to 66fc7d9d
*** SHOWDOWN ***
66fc7d9d collected $0.25 from pot
*** SUMMARY ***
Total pot $0.25 | Rake $0 | Jackpot $0 | Bingo $0 | Fortune $0
Seat 1: 8831f441 (button) folded before Flop (didn't bet)
Seat 2: 5fdd5540 (small blind) folded before Flop
Seat 3: Hero (big blind) folded before Flop
Seat 4: 66fc7d9d collected ($0.25)
Seat 5: 55aff11d folded before Flop (didn't bet)
Seat 6: 3cba5816 folded before Flop (didn't bet)


