Poker Hand #RC1468036817: Hold'em No Limit  ($0.05/$0.1) - 2023/04/12 16:12:54
Table 'RushAndCash5532077' 6-max Seat #1 is the button
Seat 1: adc5743e ($20.86 in chips)
Seat 2: dd61112d ($12.92 in chips)
Seat 3: 48b72a6a ($16.04 in chips)
Seat 4: Hero ($4.27 in chips)
Seat 5: 4545890 ($15.47 in chips)
Seat 6: fc3c863d ($8.88 in chips)
dd61112d: posts small blind $0.05
48b72a6a: posts big blind $0.1
*** HOLE CARDS ***
Dealt to adc5743e 
Dealt to dd61112d 
Dealt to 48b72a6a 
Dealt to Hero [Ac Td]
Dealt to 4545890 
Dealt to fc3c863d 
Hero: raises $0.15 to $0.25
4545890: folds
fc3c863d: raises $0.65 to $0.9
adc5743e: folds
dd61112d: folds
48b72a6a: folds
Hero: raises $3.37 to $4.27 and is all-in
fc3c863d: calls $3.37
Hero: shows [Ac Td]
fc3c863d: shows [Ks Qs]
*** FLOP *** [Qh 6h 3c]
*** TURN *** [Qh 6h 3c] [Kc]
*** RIVER *** [Qh 6h 3c Kc] [9s]
*** SHOWDOWN ***
fc3c863d collected $8.24 from pot
*** SUMMARY ***
Total pot $8.69 | Rake $0.3 | Jackpot $0.15 | Bingo $0 | Fortune $0
Board [Qh 6h 3c Kc 9s]
Seat 1: adc5743e (button) folded before Flop (didn't bet)
Seat 2: dd61112d (small blind) folded before Flop
Seat 3: 48b72a6a (big blind) folded before Flop
Seat 4: Hero showed [Ac Td] and lost with Ace-High
Seat 5: 4545890 folded before Flop (didn't bet)
Seat 6: fc3c863d showed [Ks Qs] and won ($8.24) with Pair of Kings and Pair of Queens


Poker Hand #RC1468036738: Hold'em No Limit  ($0.05/$0.1) - 2023/04/12 16:12:44
Table 'RushAndCash5531998' 6-max Seat #1 is the button
Seat 1: 9fd526ef ($8.23 in chips)
Seat 2: 4075c164 ($23.81 in chips)
Seat 3: Hero ($4.22 in chips)
Seat 4: c2d58e42 ($10 in chips)
Seat 5: 814b7278 ($19.84 in chips)
Seat 6: 1b214f81 ($9.47 in chips)
4075c164: posts small blind $0.05
Hero: posts big blind $0.1
*** HOLE CARDS ***
Dealt to 9fd526ef 
Dealt to 4075c164 
Dealt to Hero [8d Qh]
Dealt to c2d58e42 
Dealt to 814b7278 
Dealt to 1b214f81 
c2d58e42: folds
814b7278: folds
1b214f81: folds
9fd526ef: folds
4075c164: folds
Uncalled bet ($0.05) returned to Hero
*** SHOWDOWN ***
Hero collected $0.1 from pot
*** SUMMARY ***
Total pot $0.1 | Rake $0 | Jackpot $0 | Bingo $0 | Fortune $0
Seat 1: 9fd526ef (button) folded before Flop (didn't bet)
Seat 2: 4075c164 (small blind) folded before Flop
Seat 3: Hero (big blind) collected ($0.1)
Seat 4: c2d58e42 folded before Flop (didn't bet)
Seat 5: 814b7278 folded before Flop (didn't bet)
Seat 6: 1b214f81 folded before Flop (didn't bet)


Poker Hand #RC1468036652: Hold'em No Limit  ($0.05/$0.1) - 2023/04/12 16:12:32
Table 'RushAndCash5531912' 6-max Seat #1 is the button
Seat 1: b09da851 ($11.83 in chips)
Seat 2: ea184f04 ($84.2 in chips)
Seat 3: 2ddc6ed ($9.28 in chips)
Seat 4: 6017fc33 ($10 in chips)
Seat 5: 7d88e034 ($9.54 in chips)
Seat 6: Hero ($4.22 in chips)
ea184f04: posts small blind $0.05
2ddc6ed: posts big blind $0.1
*** HOLE CARDS ***
Dealt to b09da851 
Dealt to ea184f04 
Dealt to 2ddc6ed 
Dealt to 6017fc33 
Dealt to 7d88e034 
Dealt to Hero [5h 4s]
6017fc33: folds
7d88e034: raises $0.12 to $0.22
Hero: folds
b09da851: folds
ea184f04: folds
2ddc6ed: folds
Uncalled bet ($0.12) returned to 7d88e034
*** SHOWDOWN ***
7d88e034 collected $0.25 from pot
*** SUMMARY ***
Total pot $0.25 | Rake $0 | Jackpot $0 | Bingo $0 | Fortune $0
Seat 1: b09da851 (button) folded before Flop (didn't bet)
Seat 2: ea184f04 (small blind) folded before Flop
Seat 3: 2ddc6ed (big blind) folded before Flop
Seat 4: 6017fc33 folded before Flop (didn't bet)
Seat 5: 7d88e034 collected ($0.25)
Seat 6: Hero folded before Flop (didn't bet)


Poker Hand #RC1468036182: Hold'em No Limit  ($0.05/$0.1) - 2023/04/12 16:11:32
Table 'RushAndCash5531442' 6-max Seat #1 is the button
Seat 1: Hero ($3.78 in chips)
Seat 2: 2ddc6ed ($9.95 in chips)
Seat 3: 7c825389 ($10 in chips)
Seat 4: d4fe74b7 ($12.26 in chips)
Seat 5: 8851a132 ($13.91 in chips)
Seat 6: 7d88e034 ($9.09 in chips)
2ddc6ed: posts small blind $0.05
7c825389: posts big blind $0.1
*** HOLE CARDS ***
Dealt to Hero [Kc Ad]
Dealt to 2ddc6ed 
Dealt to 7c825389 
Dealt to d4fe74b7 
Dealt to 8851a132 
Dealt to 7d88e034 
d4fe74b7: folds
8851a132: folds
7d88e034: raises $0.12 to $0.22
Hero: raises $0.45 to $0.67
2ddc6ed: calls $0.62
7c825389: calls $0.57
7d88e034: raises $2.83 to $3.5
Hero: raises $0.28 to $3.78 and is all-in
2ddc6ed: folds
7c825389: folds
7d88e034: calls $0.28
Hero: shows [Kc Ad]
7d88e034: shows [Kh Ac]
*** FLOP *** [6h Qs 3h]
*** TURN *** [6h Qs 3h] [7c]
*** RIVER *** [6h Qs 3h 7c] [2h]
*** SHOWDOWN ***
7d88e034 collected $4.23 from pot
Hero collected $4.22 from pot
*** SUMMARY ***
Total pot $8.9 | Rake $0.3 | Jackpot $0.15 | Bingo $0 | Fortune $0
Board [6h Qs 3h 7c 2h]
Seat 1: Hero (button) showed [Kc Ad] and won ($4.22) with Ace-High
Seat 2: 2ddc6ed (small blind) folded before Flop
Seat 3: 7c825389 (big blind) folded before Flop
Seat 4: d4fe74b7 folded before Flop (didn't bet)
Seat 5: 8851a132 folded before Flop (didn't bet)
Seat 6: 7d88e034 showed [Kh Ac] and won ($4.23) with Ace-High


Poker Hand #RC1468036086: Hold'em No Limit  ($0.05/$0.1) - 2023/04/12 16:11:20
Table 'RushAndCash5531346' 6-max Seat #1 is the button
Seat 1: b5b6d211 ($11.97 in chips)
Seat 2: Hero ($3.68 in chips)
Seat 3: d697ab49 ($11.34 in chips)
Seat 4: 5703b505 ($11.62 in chips)
Seat 5: 98181d0 ($10.45 in chips)
Seat 6: 8023e516 ($9.25 in chips)
Hero: posts small blind $0.05
d697ab49: posts big blind $0.1
*** HOLE CARDS ***
Dealt to b5b6d211 
Dealt to Hero [Jc Td]
Dealt to d697ab49 
Dealt to 5703b505 
Dealt to 98181d0 
Dealt to 8023e516 
5703b505: folds
98181d0: folds
8023e516: folds
b5b6d211: folds
Hero: raises $0.2 to $0.3
d697ab49: folds
Uncalled bet ($0.2) returned to Hero
*** SHOWDOWN ***
Hero collected $0.2 from pot
*** SUMMARY ***
Total pot $0.2 | Rake $0 | Jackpot $0 | Bingo $0 | Fortune $0
Seat 1: b5b6d211 (button) folded before Flop (didn't bet)
Seat 2: Hero (small blind) collected ($0.2)
Seat 3: d697ab49 (big blind) folded before Flop
Seat 4: 5703b505 folded before Flop (didn't bet)
Seat 5: 98181d0 folded before Flop (didn't bet)
Seat 6: 8023e516 folded before Flop (didn't bet)


Poker Hand #RC1468036052: Hold'em No Limit  ($0.05/$0.1) - 2023/04/12 16:11:15
Table 'RushAndCash5531312' 6-max Seat #1 is the button
Seat 1: 8851a132 ($13.76 in chips)
Seat 2: be601030 ($4.86 in chips)
Seat 3: beecdd3a ($10.05 in chips)
Seat 4: ae7ba048 ($10.15 in chips)
Seat 5: Hero ($3.68 in chips)
Seat 6: f5267f59 ($10 in chips)
be601030: posts small blind $0.05
beecdd3a: posts big blind $0.1
*** HOLE CARDS ***
Dealt to 8851a132 
Dealt to be601030 
Dealt to beecdd3a 
Dealt to ae7ba048 
Dealt to Hero [Qd Th]
Dealt to f5267f59 
ae7ba048: folds
Hero: folds
f5267f59: folds
8851a132: raises $0.15 to $0.25
be601030: folds
beecdd3a: folds
Uncalled bet ($0.15) returned to 8851a132
*** SHOWDOWN ***
8851a132 collected $0.25 from pot
*** SUMMARY ***
Total pot $0.25 | Rake $0 | Jackpot $0 | Bingo $0 | Fortune $0
Seat 1: 8851a132 (button) collected ($0.25)
Seat 2: be601030 (small blind) folded before Flop
Seat 3: beecdd3a (big blind) folded before Flop
Seat 4: ae7ba048 folded before Flop (didn't bet)
Seat 5: Hero folded before Flop (didn't bet)
Seat 6: f5267f59 folded before Flop (didn't bet)


Poker Hand #RC1468036015: Hold'em No Limit  ($0.05/$0.1) - 2023/04/12 16:11:09
Table 'RushAndCash5531275' 6-max Seat #1 is the button
Seat 1: Hero ($3.68 in chips)
Seat 2: 47ec94f9 ($10.2 in chips)
Seat 3: 3d1e056a ($12.22 in chips)
Seat 4: af29373e ($9.13 in chips)
Seat 5: 8af9dc9c ($10 in chips)
Seat 6: ee72a1b5 ($12.49 in chips)
47ec94f9: posts small blind $0.05
3d1e056a: posts big blind $0.1
*** HOLE CARDS ***
Dealt to Hero [8h 2s]
Dealt to 47ec94f9 
Dealt to 3d1e056a 
Dealt to af29373e 
Dealt to 8af9dc9c 
Dealt to ee72a1b5 
af29373e: raises $0.2 to $0.3
8af9dc9c: folds
ee72a1b5: folds
Hero: folds
47ec94f9: folds
3d1e056a: folds
Uncalled bet ($0.2) returned to af29373e
*** SHOWDOWN ***
af29373e collected $0.25 from pot
*** SUMMARY ***
Total pot $0.25 | Rake $0 | Jackpot $0 | Bingo $0 | Fortune $0
Seat 1: Hero (button) folded before Flop (didn't bet)
Seat 2: 47ec94f9 (small blind) folded before Flop
Seat 3: 3d1e056a (big blind) folded before Flop
Seat 4: af29373e collected ($0.25)
Seat 5: 8af9dc9c folded before Flop (didn't bet)
Seat 6: ee72a1b5 folded before Flop (didn't bet)


Poker Hand #RC1468035961: Hold'em No Limit  ($0.05/$0.1) - 2023/04/12 16:11:02
Table 'RushAndCash5531221' 6-max Seat #1 is the button
Seat 1: cfc88e88 ($6.76 in chips)
Seat 2: Hero ($3.73 in chips)
Seat 3: 2f597316 ($25.44 in chips)
Seat 4: e32dfde9 ($10.33 in chips)
Seat 5: f64c42ee ($10.98 in chips)
Seat 6: 7aa75295 ($11.43 in chips)
Hero: posts small blind $0.05
2f597316: posts big blind $0.1
*** HOLE CARDS ***
Dealt to cfc88e88 
Dealt to Hero [Ts 8h]
Dealt to 2f597316 
Dealt to e32dfde9 
Dealt to f64c42ee 
Dealt to 7aa75295 
e32dfde9: folds
f64c42ee: raises $0.15 to $0.25
7aa75295: folds
cfc88e88: raises $0.65 to $0.9
Hero: folds
2f597316: folds
f64c42ee: folds
Uncalled bet ($0.65) returned to cfc88e88
*** SHOWDOWN ***
cfc88e88 collected $0.62 from pot
*** SUMMARY ***
Total pot $0.65 | Rake $0.03 | Jackpot $0 | Bingo $0 | Fortune $0
Seat 1: cfc88e88 (button) collected ($0.62)
Seat 2: Hero (small blind) folded before Flop
Seat 3: 2f597316 (big blind) folded before Flop
Seat 4: e32dfde9 folded before Flop (didn't bet)
Seat 5: f64c42ee folded before Flop
Seat 6: 7aa75295 folded before Flop (didn't bet)


Poker Hand #RC1468035913: Hold'em No Limit  ($0.05/$0.1) - 2023/04/12 16:10:57
Table 'RushAndCash5531173' 6-max Seat #1 is the button
Seat 1: 2046d905 ($10.53 in chips)
Seat 2: 11ac4b22 ($13.32 in chips)
Seat 3: Hero ($3.83 in chips)
Seat 4: 49600bcc ($18.38 in chips)
Seat 5: 1f09d788 ($19.73 in chips)
Seat 6: 1c4c8b98 ($11.31 in chips)
11ac4b22: posts small blind $0.05
Hero: posts big blind $0.1
*** HOLE CARDS ***
Dealt to 2046d905 
Dealt to 11ac4b22 
Dealt to Hero [2s 5d]
Dealt to 49600bcc 
Dealt to 1f09d788 
Dealt to 1c4c8b98 
49600bcc: folds
1f09d788: folds
1c4c8b98: folds
2046d905: folds
11ac4b22: raises $0.15 to $0.25
Hero: folds
Uncalled bet ($0.15) returned to 11ac4b22
*** SHOWDOWN ***
11ac4b22 collected $0.2 from pot
*** SUMMARY ***
Total pot $0.2 | Rake $0 | Jackpot $0 | Bingo $0 | Fortune $0
Seat 1: 2046d905 (button) folded before Flop (didn't bet)
Seat 2: 11ac4b22 (small blind) collected ($0.2)
Seat 3: Hero (big blind) folded before Flop
Seat 4: 49600bcc folded before Flop (didn't bet)
Seat 5: 1f09d788 folded before Flop (didn't bet)
Seat 6: 1c4c8b98 folded before Flop (didn't bet)


Poker Hand #RC1468035873: Hold'em No Limit  ($0.05/$0.1) - 2023/04/12 16:10:52
Table 'RushAndCash5531133' 6-max Seat #1 is the button
Seat 1: ce8f526f ($24.62 in chips)
Seat 2: 61dcc7f0 ($12.23 in chips)
Seat 3: e32dfde9 ($10.43 in chips)
Seat 4: Hero ($3.83 in chips)
Seat 5: 98181d0 ($10.6 in chips)
Seat 6: 1c4c8b98 ($11.31 in chips)
61dcc7f0: posts small blind $0.05
e32dfde9: posts big blind $0.1
*** HOLE CARDS ***
Dealt to ce8f526f 
Dealt to 61dcc7f0 
Dealt to e32dfde9 
Dealt to Hero [Qc Js]
Dealt to 98181d0 
Dealt to 1c4c8b98 
Hero: folds
98181d0: folds
1c4c8b98: folds
ce8f526f: raises $0.15 to $0.25
61dcc7f0: folds
e32dfde9: folds
Uncalled bet ($0.15) returned to ce8f526f
*** SHOWDOWN ***
ce8f526f collected $0.25 from pot
*** SUMMARY ***
Total pot $0.25 | Rake $0 | Jackpot $0 | Bingo $0 | Fortune $0
Seat 1: ce8f526f (button) collected ($0.25)
Seat 2: 61dcc7f0 (small blind) folded before Flop
Seat 3: e32dfde9 (big blind) folded before Flop
Seat 4: Hero folded before Flop (didn't bet)
Seat 5: 98181d0 folded before Flop (didn't bet)
Seat 6: 1c4c8b98 folded before Flop (didn't bet)


Poker Hand #RC1468035793: Hold'em No Limit  ($0.05/$0.1) - 2023/04/12 16:10:41
Table 'RushAndCash5531053' 6-max Seat #1 is the button
Seat 1: 88a51a98 ($13.24 in chips)
Seat 2: cb45f23a ($11.8 in chips)
Seat 3: d711d5fe ($10.51 in chips)
Seat 4: 4e7ce881 ($10.32 in chips)
Seat 5: Hero ($3.68 in chips)
Seat 6: f06f21ca ($12.44 in chips)
cb45f23a: posts small blind $0.05
d711d5fe: posts big blind $0.1
*** HOLE CARDS ***
Dealt to 88a51a98 
Dealt to cb45f23a 
Dealt to d711d5fe 
Dealt to 4e7ce881 
Dealt to Hero [Qs Ah]
Dealt to f06f21ca 
4e7ce881: folds
Hero: raises $0.15 to $0.25
f06f21ca: folds
88a51a98: folds
cb45f23a: folds
d711d5fe: folds
Uncalled bet ($0.15) returned to Hero
*** SHOWDOWN ***
Hero collected $0.25 from pot
*** SUMMARY ***
Total pot $0.25 | Rake $0 | Jackpot $0 | Bingo $0 | Fortune $0
Seat 1: 88a51a98 (button) folded before Flop (didn't bet)
Seat 2: cb45f23a (small blind) folded before Flop
Seat 3: d711d5fe (big blind) folded before Flop
Seat 4: 4e7ce881 folded before Flop (didn't bet)
Seat 5: Hero collected ($0.25)
Seat 6: f06f21ca folded before Flop (didn't bet)


Poker Hand #RC1468035442: Hold'em No Limit  ($0.05/$0.1) - 2023/04/12 16:09:55
Table 'RushAndCash5530702' 6-max Seat #1 is the button
Seat 1: fc3c863d ($5.94 in chips)
Seat 2: Hero ($3.73 in chips)
Seat 3: 37a05025 ($12.46 in chips)
Seat 4: cf1e2de9 ($12.26 in chips)
Seat 5: 6d19d550 ($7.63 in chips)
Seat 6: b65022ac ($11.32 in chips)
Hero: posts small blind $0.05
37a05025: posts big blind $0.1
*** HOLE CARDS ***
Dealt to fc3c863d 
Dealt to Hero [7h 7c]
Dealt to 37a05025 
Dealt to cf1e2de9 
Dealt to 6d19d550 
Dealt to b65022ac 
cf1e2de9: raises $0.1 to $0.2
6d19d550: calls $0.2
b65022ac: folds
fc3c863d: calls $0.2
Hero: calls $0.15
37a05025: calls $0.1
*** FLOP *** [8d 9h Ah]
Hero: checks
37a05025: checks
cf1e2de9: bets $0.33
6d19d550: calls $0.33
fc3c863d: folds
Hero: folds
37a05025: calls $0.33
*** TURN *** [8d 9h Ah] [5c]
37a05025: checks
cf1e2de9: checks
6d19d550: checks
*** RIVER *** [8d 9h Ah 5c] [9s]
37a05025: checks
cf1e2de9: bets $0.66
6d19d550: folds
37a05025: folds
Uncalled bet ($0.66) returned to cf1e2de9
*** SHOWDOWN ***
cf1e2de9 collected $1.89 from pot
*** SUMMARY ***
Total pot $1.99 | Rake $0.1 | Jackpot $0 | Bingo $0 | Fortune $0
Board [8d 9h Ah 5c 9s]
Seat 1: fc3c863d (button) folded on the Flop
Seat 2: Hero (small blind) folded on the Flop
Seat 3: 37a05025 (big blind) folded on the River
Seat 4: cf1e2de9 won ($1.89)
Seat 5: 6d19d550 folded on the River
Seat 6: b65022ac folded before Flop (didn't bet)


Poker Hand #RC1468035407: Hold'em No Limit  ($0.05/$0.1) - 2023/04/12 16:09:50
Table 'RushAndCash5530667' 6-max Seat #1 is the button
Seat 1: 59bc51f2 ($24.27 in chips)
Seat 2: 26ab2bbd ($10.95 in chips)
Seat 3: 9966b88a ($16.35 in chips)
Seat 4: 470d64c2 ($20.1 in chips)
Seat 5: Hero ($3.73 in chips)
Seat 6: 6ded44d4 ($10.15 in chips)
26ab2bbd: posts small blind $0.05
9966b88a: posts big blind $0.1
*** HOLE CARDS ***
Dealt to 59bc51f2 
Dealt to 26ab2bbd 
Dealt to 9966b88a 
Dealt to 470d64c2 
Dealt to Hero [Ac 5s]
Dealt to 6ded44d4 
470d64c2: folds
Hero: folds
6ded44d4: folds
59bc51f2: folds
26ab2bbd: raises $0.2 to $0.3
9966b88a: folds
Uncalled bet ($0.2) returned to 26ab2bbd
*** SHOWDOWN ***
26ab2bbd collected $0.2 from pot
*** SUMMARY ***
Total pot $0.2 | Rake $0 | Jackpot $0 | Bingo $0 | Fortune $0
Seat 1: 59bc51f2 (button) folded before Flop (didn't bet)
Seat 2: 26ab2bbd (small blind) collected ($0.2)
Seat 3: 9966b88a (big blind) folded before Flop
Seat 4: 470d64c2 folded before Flop (didn't bet)
Seat 5: Hero folded before Flop (didn't bet)
Seat 6: 6ded44d4 folded before Flop (didn't bet)


Poker Hand #RC1468035374: Hold'em No Limit  ($0.05/$0.1) - 2023/04/12 16:09:46
Table 'RushAndCash5530634' 6-max Seat #1 is the button
Seat 1: cd8e30d1 ($11.24 in chips)
Seat 2: 4e188444 ($20.23 in chips)
Seat 3: Hero ($3.83 in chips)
Seat 4: 17f77488 ($9.85 in chips)
Seat 5: eb32aed2 ($13.76 in chips)
Seat 6: 59bc51f2 ($24.27 in chips)
4e188444: posts small blind $0.05
Hero: posts big blind $0.1
*** HOLE CARDS ***
Dealt to cd8e30d1 
Dealt to 4e188444 
Dealt to Hero [3s 8s]
Dealt to 17f77488 
Dealt to eb32aed2 
Dealt to 59bc51f2 
17f77488: folds
eb32aed2: folds
59bc51f2: folds
cd8e30d1: folds
4e188444: folds
Uncalled bet ($0.05) returned to Hero
*** SHOWDOWN ***
Hero collected $0.1 from pot
*** SUMMARY ***
Total pot $0.1 | Rake $0 | Jackpot $0 | Bingo $0 | Fortune $0
Seat 1: cd8e30d1 (button) folded before Flop (didn't bet)
Seat 2: 4e188444 (small blind) folded before Flop
Seat 3: Hero (big blind) collected ($0.1)
Seat 4: 17f77488 folded before Flop (didn't bet)
Seat 5: eb32aed2 folded before Flop (didn't bet)
Seat 6: 59bc51f2 folded before Flop (didn't bet)


Poker Hand #RC1468035334: Hold'em No Limit  ($0.05/$0.1) - 2023/04/12 16:09:41
Table 'RushAndCash5530594' 6-max Seat #1 is the button
Seat 1: fe7a3864 ($11.53 in chips)
Seat 2: 49c811a ($10.05 in chips)
Seat 3: beae81ac ($10.1 in chips)
Seat 4: 585e4380 ($10.33 in chips)
Seat 5: Hero ($3.83 in chips)
Seat 6: d419cc9a ($26.17 in chips)
49c811a: posts small blind $0.05
beae81ac: posts big blind $0.1
*** HOLE CARDS ***
Dealt to fe7a3864 
Dealt to 49c811a 
Dealt to beae81ac 
Dealt to 585e4380 
Dealt to Hero [7d 2h]
Dealt to d419cc9a 
585e4380: folds
Hero: folds
d419cc9a: folds
fe7a3864: raises $0.15 to $0.25
49c811a: folds
beae81ac: calls $0.15
*** FLOP *** [Jd 6s 4h]
beae81ac: checks
fe7a3864: bets $0.19
beae81ac: calls $0.19
*** TURN *** [Jd 6s 4h] [9c]
beae81ac: checks
fe7a3864: bets $0.62
beae81ac: raises $1.48 to $2.1
fe7a3864: calls $1.48
*** RIVER *** [Jd 6s 4h 9c] [4s]
beae81ac: bets $3.9
fe7a3864: raises $5.09 to $8.99 and is all-in
beae81ac: folds
Uncalled bet ($5.09) returned to fe7a3864
*** SHOWDOWN ***
fe7a3864 collected $12.48 from pot
*** SUMMARY ***
Total pot $12.93 | Rake $0.3 | Jackpot $0.15 | Bingo $0 | Fortune $0
Board [Jd 6s 4h 9c 4s]
Seat 1: fe7a3864 (button) won ($12.48)
Seat 2: 49c811a (small blind) folded before Flop
Seat 3: beae81ac (big blind) folded on the River
Seat 4: 585e4380 folded before Flop (didn't bet)
Seat 5: Hero folded before Flop (didn't bet)
Seat 6: d419cc9a folded before Flop (didn't bet)


Poker Hand #RC1468035277: Hold'em No Limit  ($0.05/$0.1) - 2023/04/12 16:09:33
Table 'RushAndCash5530537' 6-max Seat #1 is the button
Seat 1: Hero ($3.83 in chips)
Seat 2: c4f6ed66 ($16.48 in chips)
Seat 3: 42a3827c ($10.05 in chips)
Seat 4: 36623a12 ($13.68 in chips)
Seat 5: 650ba5f ($12.08 in chips)
Seat 6: 7f6bcad ($13.56 in chips)
c4f6ed66: posts small blind $0.05
42a3827c: posts big blind $0.1
*** HOLE CARDS ***
Dealt to Hero [4s 4d]
Dealt to c4f6ed66 
Dealt to 42a3827c 
Dealt to 36623a12 
Dealt to 650ba5f 
Dealt to 7f6bcad 
36623a12: raises $0.12 to $0.22
650ba5f: folds
7f6bcad: folds
Hero: folds
c4f6ed66: folds
42a3827c: folds
Uncalled bet ($0.12) returned to 36623a12
*** SHOWDOWN ***
36623a12 collected $0.25 from pot
*** SUMMARY ***
Total pot $0.25 | Rake $0 | Jackpot $0 | Bingo $0 | Fortune $0
Seat 1: Hero (button) folded before Flop (didn't bet)
Seat 2: c4f6ed66 (small blind) folded before Flop
Seat 3: 42a3827c (big blind) folded before Flop
Seat 4: 36623a12 collected ($0.25)
Seat 5: 650ba5f folded before Flop (didn't bet)
Seat 6: 7f6bcad folded before Flop (didn't bet)


Poker Hand #RC1468035219: Hold'em No Limit  ($0.05/$0.1) - 2023/04/12 16:09:26
Table 'RushAndCash5530479' 6-max Seat #1 is the button
Seat 1: 7e61096b ($10.1 in chips)
Seat 2: 98b7fb14 ($12.01 in chips)
Seat 3: ea9bb1c2 ($4.63 in chips)
Seat 4: e78fe0fc ($10 in chips)
Seat 5: 9d9c8154 ($13.26 in chips)
Seat 6: Hero ($3.83 in chips)
98b7fb14: posts small blind $0.05
ea9bb1c2: posts big blind $0.1
*** HOLE CARDS ***
Dealt to 7e61096b 
Dealt to 98b7fb14 
Dealt to ea9bb1c2 
Dealt to e78fe0fc 
Dealt to 9d9c8154 
Dealt to Hero [7h 2s]
e78fe0fc: raises $0.15 to $0.25
9d9c8154: folds
Hero: folds
7e61096b: folds
98b7fb14: folds
ea9bb1c2: folds
Uncalled bet ($0.15) returned to e78fe0fc
*** SHOWDOWN ***
e78fe0fc collected $0.25 from pot
*** SUMMARY ***
Total pot $0.25 | Rake $0 | Jackpot $0 | Bingo $0 | Fortune $0
Seat 1: 7e61096b (button) folded before Flop (didn't bet)
Seat 2: 98b7fb14 (small blind) folded before Flop
Seat 3: ea9bb1c2 (big blind) folded before Flop
Seat 4: e78fe0fc collected ($0.25)
Seat 5: 9d9c8154 folded before Flop (didn't bet)
Seat 6: Hero folded before Flop (didn't bet)


Poker Hand #RC1468035131: Hold'em No Limit  ($0.05/$0.1) - 2023/04/12 16:09:15
Table 'RushAndCash5530391' 6-max Seat #1 is the button
Seat 1: 18264f07 ($10 in chips)
Seat 2: 8061b980 ($44.92 in chips)
Seat 3: a9e2f5d5 ($10.18 in chips)
Seat 4: 601eadc7 ($12.8 in chips)
Seat 5: 2cbf83ab ($16.22 in chips)
Seat 6: Hero ($3.83 in chips)
8061b980: posts small blind $0.05
a9e2f5d5: posts big blind $0.1
*** HOLE CARDS ***
Dealt to 18264f07 
Dealt to 8061b980 
Dealt to a9e2f5d5 
Dealt to 601eadc7 
Dealt to 2cbf83ab 
Dealt to Hero [7d 6c]
601eadc7: folds
2cbf83ab: folds
Hero: folds
18264f07: folds
8061b980: raises $0.2 to $0.3
a9e2f5d5: raises $0.6 to $0.9
8061b980: calls $0.6
*** FLOP *** [2s 7c 2d]
8061b980: checks
a9e2f5d5: bets $0.9
8061b980: calls $0.9
*** TURN *** [2s 7c 2d] [6s]
8061b980: checks
a9e2f5d5: checks
*** RIVER *** [2s 7c 2d 6s] [6d]
8061b980: bets $1.19
a9e2f5d5: calls $1.19
8061b980: shows [As Qc] (Pair of Sixes and Pair of Twos)
a9e2f5d5: shows [9c Ad] (Pair of Sixes and Pair of Twos)
*** SHOWDOWN ***
8061b980 collected $2.78 from pot
a9e2f5d5 collected $2.77 from pot
*** SUMMARY ***
Total pot $5.98 | Rake $0.28 | Jackpot $0.15 | Bingo $0 | Fortune $0
Board [2s 7c 2d 6s 6d]
Seat 1: 18264f07 (button) folded before Flop (didn't bet)
Seat 2: 8061b980 (small blind) showed [As Qc] and won ($2.78) with Pair of Sixes and Pair of Twos
Seat 3: a9e2f5d5 (big blind) showed [9c Ad] and won ($2.77) with Pair of Sixes and Pair of Twos
Seat 4: 601eadc7 folded before Flop (didn't bet)
Seat 5: 2cbf83ab folded before Flop (didn't bet)
Seat 6: Hero folded before Flop (didn't bet)


Poker Hand #RC1468035098: Hold'em No Limit  ($0.05/$0.1) - 2023/04/12 16:09:11
Table 'RushAndCash5530358' 6-max Seat #1 is the button
Seat 1: 1a1ee5c6 ($4.99 in chips)
Seat 2: Hero ($3.88 in chips)
Seat 3: 21a28361 ($26.86 in chips)
Seat 4: 3c2eb6cf ($16.64 in chips)
Seat 5: 51df5cf1 ($10.28 in chips)
Seat 6: d988015a ($7.28 in chips)
Hero: posts small blind $0.05
21a28361: posts big blind $0.1
*** HOLE CARDS ***
Dealt to 1a1ee5c6 
Dealt to Hero [2c 4h]
Dealt to 21a28361 
Dealt to 3c2eb6cf 
Dealt to 51df5cf1 
Dealt to d988015a 
3c2eb6cf: folds
51df5cf1: folds
d988015a: folds
1a1ee5c6: folds
Hero: folds
Uncalled bet ($0.05) returned to 21a28361
*** SHOWDOWN ***
21a28361 collected $0.1 from pot
*** SUMMARY ***
Total pot $0.1 | Rake $0 | Jackpot $0 | Bingo $0 | Fortune $0
Seat 1: 1a1ee5c6 (button) folded before Flop (didn't bet)
Seat 2: Hero (small blind) folded before Flop
Seat 3: 21a28361 (big blind) collected ($0.1)
Seat 4: 3c2eb6cf folded before Flop (didn't bet)
Seat 5: 51df5cf1 folded before Flop (didn't bet)
Seat 6: d988015a folded before Flop (didn't bet)


Poker Hand #RC1468035061: Hold'em No Limit  ($0.05/$0.1) - 2023/04/12 16:09:06
Table 'RushAndCash5530321' 6-max Seat #1 is the button
Seat 1: Hero ($3.88 in chips)
Seat 2: 1c28e75d ($11.28 in chips)
Seat 3: c4f6ed66 ($16.48 in chips)
Seat 4: d07c11e7 ($10.43 in chips)
Seat 5: 3bb7e352 ($10 in chips)
Seat 6: d4f16d55 ($18.35 in chips)
1c28e75d: posts small blind $0.05
c4f6ed66: posts big blind $0.1
*** HOLE CARDS ***
Dealt to Hero [2d 3s]
Dealt to 1c28e75d 
Dealt to c4f6ed66 
Dealt to d07c11e7 
Dealt to 3bb7e352 
Dealt to d4f16d55 
d07c11e7: folds
3bb7e352: folds
d4f16d55: folds
Hero: folds
1c28e75d: folds
Uncalled bet ($0.05) returned to c4f6ed66
*** SHOWDOWN ***
c4f6ed66 collected $0.1 from pot
*** SUMMARY ***
Total pot $0.1 | Rake $0 | Jackpot $0 | Bingo $0 | Fortune $0
Seat 1: Hero (button) folded before Flop (didn't bet)
Seat 2: 1c28e75d (small blind) folded before Flop
Seat 3: c4f6ed66 (big blind) collected ($0.1)
Seat 4: d07c11e7 folded before Flop (didn't bet)
Seat 5: 3bb7e352 folded before Flop (didn't bet)
Seat 6: d4f16d55 folded before Flop (didn't bet)


Poker Hand #RC1468034981: Hold'em No Limit  ($0.05/$0.1) - 2023/04/12 16:08:56
Table 'RushAndCash5530241' 6-max Seat #1 is the button
Seat 1: 4075c164 ($24.06 in chips)
Seat 2: 5d312d40 ($10 in chips)
Seat 3: Hero ($3.98 in chips)
Seat 4: abe05f0c ($13 in chips)
Seat 5: 26ab2bbd ($10.75 in chips)
Seat 6: 599a61a1 ($10.38 in chips)
5d312d40: posts small blind $0.05
Hero: posts big blind $0.1
*** HOLE CARDS ***
Dealt to 4075c164 
Dealt to 5d312d40 
Dealt to Hero [4d Jh]
Dealt to abe05f0c 
Dealt to 26ab2bbd 
Dealt to 599a61a1 
abe05f0c: folds
26ab2bbd: raises $0.1 to $0.2
599a61a1: folds
4075c164: folds
5d312d40: folds
Hero: folds
Uncalled bet ($0.1) returned to 26ab2bbd
*** SHOWDOWN ***
26ab2bbd collected $0.25 from pot
*** SUMMARY ***
Total pot $0.25 | Rake $0 | Jackpot $0 | Bingo $0 | Fortune $0
Seat 1: 4075c164 (button) folded before Flop (didn't bet)
Seat 2: 5d312d40 (small blind) folded before Flop
Seat 3: Hero (big blind) folded before Flop
Seat 4: abe05f0c folded before Flop (didn't bet)
Seat 5: 26ab2bbd collected ($0.25)
Seat 6: 599a61a1 folded before Flop (didn't bet)


Poker Hand #RC1468034824: Hold'em No Limit  ($0.05/$0.1) - 2023/04/12 16:08:36
Table 'RushAndCash5530084' 6-max Seat #1 is the button
Seat 1: 7730fd6d ($10 in chips)
Seat 2: abe05f0c ($12.68 in chips)
Seat 3: cd8e30d1 ($11.39 in chips)
Seat 4: 254b9316 ($17.65 in chips)
Seat 5: 2cbf83ab ($16.37 in chips)
Seat 6: Hero ($4.23 in chips)
abe05f0c: posts small blind $0.05
cd8e30d1: posts big blind $0.1
*** HOLE CARDS ***
Dealt to 7730fd6d 
Dealt to abe05f0c 
Dealt to cd8e30d1 
Dealt to 254b9316 
Dealt to 2cbf83ab 
Dealt to Hero [5h Ac]
254b9316: folds
2cbf83ab: folds
Hero: raises $0.15 to $0.25
7730fd6d: folds
abe05f0c: raises $0.65 to $0.9
cd8e30d1: folds
Hero: folds
Uncalled bet ($0.65) returned to abe05f0c
*** SHOWDOWN ***
abe05f0c collected $0.57 from pot
*** SUMMARY ***
Total pot $0.6 | Rake $0.03 | Jackpot $0 | Bingo $0 | Fortune $0
Seat 1: 7730fd6d (button) folded before Flop (didn't bet)
Seat 2: abe05f0c (small blind) collected ($0.57)
Seat 3: cd8e30d1 (big blind) folded before Flop
Seat 4: 254b9316 folded before Flop (didn't bet)
Seat 5: 2cbf83ab folded before Flop (didn't bet)
Seat 6: Hero folded before Flop


Poker Hand #RC1468034781: Hold'em No Limit  ($0.05/$0.1) - 2023/04/12 16:08:30
Table 'RushAndCash5530041' 6-max Seat #1 is the button
Seat 1: c1515a2c ($7.27 in chips)
Seat 2: 9effed17 ($13.03 in chips)
Seat 3: bc20e67f ($11.65 in chips)
Seat 4: 677369de ($11.19 in chips)
Seat 5: 11ac4b22 ($13.62 in chips)
Seat 6: Hero ($4.23 in chips)
9effed17: posts small blind $0.05
bc20e67f: posts big blind $0.1
*** HOLE CARDS ***
Dealt to c1515a2c 
Dealt to 9effed17 
Dealt to bc20e67f 
Dealt to 677369de 
Dealt to 11ac4b22 
Dealt to Hero [Ks 7h]
677369de: folds
11ac4b22: folds
Hero: folds
c1515a2c: folds
9effed17: folds
Uncalled bet ($0.05) returned to bc20e67f
*** SHOWDOWN ***
bc20e67f collected $0.1 from pot
*** SUMMARY ***
Total pot $0.1 | Rake $0 | Jackpot $0 | Bingo $0 | Fortune $0
Seat 1: c1515a2c (button) folded before Flop (didn't bet)
Seat 2: 9effed17 (small blind) folded before Flop
Seat 3: bc20e67f (big blind) collected ($0.1)
Seat 4: 677369de folded before Flop (didn't bet)
Seat 5: 11ac4b22 folded before Flop (didn't bet)
Seat 6: Hero folded before Flop (didn't bet)


Poker Hand #RC1468034741: Hold'em No Limit  ($0.05/$0.1) - 2023/04/12 16:08:25
Table 'RushAndCash5530001' 6-max Seat #1 is the button
Seat 1: 9bd2df41 ($10.59 in chips)
Seat 2: f70dfc31 ($11.38 in chips)
Seat 3: 2cfddf3d ($10 in chips)
Seat 4: Hero ($4.23 in chips)
Seat 5: 5703b505 ($9.9 in chips)
Seat 6: 73f9955f ($11.22 in chips)
f70dfc31: posts small blind $0.05
2cfddf3d: posts big blind $0.1
*** HOLE CARDS ***
Dealt to 9bd2df41 
Dealt to f70dfc31 
Dealt to 2cfddf3d 
Dealt to Hero [9s 4h]
Dealt to 5703b505 
Dealt to 73f9955f 
Hero: folds
5703b505: raises $0.2 to $0.3
73f9955f: folds
9bd2df41: folds
f70dfc31: folds
2cfddf3d: folds
Uncalled bet ($0.2) returned to 5703b505
*** SHOWDOWN ***
5703b505 collected $0.25 from pot
*** SUMMARY ***
Total pot $0.25 | Rake $0 | Jackpot $0 | Bingo $0 | Fortune $0
Seat 1: 9bd2df41 (button) folded before Flop (didn't bet)
Seat 2: f70dfc31 (small blind) folded before Flop
Seat 3: 2cfddf3d (big blind) folded before Flop
Seat 4: Hero folded before Flop (didn't bet)
Seat 5: 5703b505 collected ($0.25)
Seat 6: 73f9955f folded before Flop (didn't bet)


Poker Hand #RC1468014693: Hold'em No Limit  ($0.05/$0.1) - 2023/04/12 16:08:18
Table 'RushAndCash5529953' 6-max Seat #1 is the button
Seat 1: 74ec0dc8 ($10.29 in chips)
Seat 2: 3e9ad104 ($11.94 in chips)
Seat 3: Hero ($4.33 in chips)
Seat 4: 79059c86 ($10.33 in chips)
Seat 5: d4950190 ($9.38 in chips)
Seat 6: 6fa2ab79 ($16.18 in chips)
3e9ad104: posts small blind $0.05
Hero: posts big blind $0.1
*** HOLE CARDS ***
Dealt to 74ec0dc8 
Dealt to 3e9ad104 
Dealt to Hero [4c Jc]
Dealt to 79059c86 
Dealt to d4950190 
Dealt to 6fa2ab79 
79059c86: folds
d4950190: raises $0.1 to $0.2
6fa2ab79: calls $0.2
74ec0dc8: folds
3e9ad104: folds
Hero: folds
*** FLOP *** [9c 8s 4d]
d4950190: checks
6fa2ab79: bets $0.42
d4950190: calls $0.42
*** TURN *** [9c 8s 4d] [Ad]
d4950190: checks
6fa2ab79: bets $4.65
d4950190: folds
Uncalled bet ($4.65) returned to 6fa2ab79
*** SHOWDOWN ***
6fa2ab79 collected $1.32 from pot
*** SUMMARY ***
Total pot $1.39 | Rake $0.07 | Jackpot $0 | Bingo $0 | Fortune $0
Board [9c 8s 4d Ad]
Seat 1: 74ec0dc8 (button) folded before Flop (didn't bet)
Seat 2: 3e9ad104 (small blind) folded before Flop
Seat 3: Hero (big blind) folded before Flop
Seat 4: 79059c86 folded before Flop (didn't bet)
Seat 5: d4950190 folded on the Turn
Seat 6: 6fa2ab79 won ($1.32)


Poker Hand #RC1468014646: Hold'em No Limit  ($0.05/$0.1) - 2023/04/12 16:08:12
Table 'RushAndCash5529906' 6-max Seat #1 is the button
Seat 1: c13536e9 ($8.71 in chips)
Seat 2: Hero ($4.38 in chips)
Seat 3: fdfeec0a ($9.44 in chips)
Seat 4: b7ff5f84 ($21.39 in chips)
Seat 5: 9effed17 ($13.13 in chips)
Seat 6: 6f217f91 ($5.71 in chips)
Hero: posts small blind $0.05
fdfeec0a: posts big blind $0.1
*** HOLE CARDS ***
Dealt to c13536e9 
Dealt to Hero [Tc 6s]
Dealt to fdfeec0a 
Dealt to b7ff5f84 
Dealt to 9effed17 
Dealt to 6f217f91 
b7ff5f84: folds
9effed17: folds
6f217f91: folds
c13536e9: raises $0.12 to $0.22
Hero: folds
fdfeec0a: calls $0.12
*** FLOP *** [5h Jh 6h]
fdfeec0a: checks
c13536e9: checks
*** TURN *** [5h Jh 6h] [Th]
fdfeec0a: bets $0.25
c13536e9: calls $0.25
*** RIVER *** [5h Jh 6h Th] [Qh]
fdfeec0a: checks
c13536e9: checks
fdfeec0a: shows [Js 8h] (Queen High Flush)
c13536e9: shows [Qd Jc] (Queen High Flush)
*** SHOWDOWN ***
fdfeec0a collected $0.94 from pot
*** SUMMARY ***
Total pot $0.99 | Rake $0.05 | Jackpot $0 | Bingo $0 | Fortune $0
Board [5h Jh 6h Th Qh]
Seat 1: c13536e9 (button) showed [Qd Jc] and lost with Queen High Flush
Seat 2: Hero (small blind) folded before Flop
Seat 3: fdfeec0a (big blind) showed [Js 8h] and won ($0.94) with Queen High Flush
Seat 4: b7ff5f84 folded before Flop (didn't bet)
Seat 5: 9effed17 folded before Flop (didn't bet)
Seat 6: 6f217f91 folded before Flop (didn't bet)


Poker Hand #RC1468014602: Hold'em No Limit  ($0.05/$0.1) - 2023/04/12 16:08:06
Table 'RushAndCash5529862' 6-max Seat #1 is the button
Seat 1: 6ded44d4 ($10 in chips)
Seat 2: 470d64c2 ($18.17 in chips)
Seat 3: 2870a38f ($10.38 in chips)
Seat 4: Hero ($4.38 in chips)
Seat 5: d82e07a8 ($11.19 in chips)
Seat 6: 677369de ($11.34 in chips)
470d64c2: posts small blind $0.05
2870a38f: posts big blind $0.1
*** HOLE CARDS ***
Dealt to 6ded44d4 
Dealt to 470d64c2 
Dealt to 2870a38f 
Dealt to Hero [Kd 3s]
Dealt to d82e07a8 
Dealt to 677369de 
Hero: folds
d82e07a8: raises $0.2 to $0.3
677369de: folds
6ded44d4: folds
470d64c2: folds
2870a38f: calls $0.2
*** FLOP *** [2c Qs 6c]
2870a38f: checks
d82e07a8: bets $0.3
2870a38f: folds
Uncalled bet ($0.3) returned to d82e07a8
*** SHOWDOWN ***
d82e07a8 collected $0.62 from pot
*** SUMMARY ***
Total pot $0.65 | Rake $0.03 | Jackpot $0 | Bingo $0 | Fortune $0
Board [2c Qs 6c]
Seat 1: 6ded44d4 (button) folded before Flop (didn't bet)
Seat 2: 470d64c2 (small blind) folded before Flop
Seat 3: 2870a38f (big blind) folded on the Flop
Seat 4: Hero folded before Flop (didn't bet)
Seat 5: d82e07a8 won ($0.62)
Seat 6: 677369de folded before Flop (didn't bet)


Poker Hand #RC1468014559: Hold'em No Limit  ($0.05/$0.1) - 2023/04/12 16:08:00
Table 'RushAndCash5529819' 6-max Seat #1 is the button
Seat 1: Hero ($4.38 in chips)
Seat 2: 849499bc ($17.04 in chips)
Seat 3: adc5743e ($20.22 in chips)
Seat 4: 1a1ee5c6 ($5.44 in chips)
Seat 5: e000bde4 ($10 in chips)
Seat 6: 98b7fb14 ($10.6 in chips)
849499bc: posts small blind $0.05
adc5743e: posts big blind $0.1
*** HOLE CARDS ***
Dealt to Hero [2s 8s]
Dealt to 849499bc 
Dealt to adc5743e 
Dealt to 1a1ee5c6 
Dealt to e000bde4 
Dealt to 98b7fb14 
1a1ee5c6: raises $0.1 to $0.2
e000bde4: calls $0.2
98b7fb14: calls $0.2
Hero: folds
849499bc: calls $0.15
adc5743e: calls $0.1
*** FLOP *** [Kc As Jd]
849499bc: checks
adc5743e: checks
1a1ee5c6: checks
e000bde4: checks
98b7fb14: bets $0.33
849499bc: calls $0.33
adc5743e: folds
1a1ee5c6: folds
e000bde4: calls $0.33
*** TURN *** [Kc As Jd] [9c]
849499bc: checks
e000bde4: checks
98b7fb14: bets $0.7
849499bc: folds
e000bde4: folds
Uncalled bet ($0.7) returned to 98b7fb14
*** SHOWDOWN ***
98b7fb14 collected $1.89 from pot
*** SUMMARY ***
Total pot $1.99 | Rake $0.1 | Jackpot $0 | Bingo $0 | Fortune $0
Board [Kc As Jd 9c]
Seat 1: Hero (button) folded before Flop (didn't bet)
Seat 2: 849499bc (small blind) folded on the Turn
Seat 3: adc5743e (big blind) folded on the Flop
Seat 4: 1a1ee5c6 folded on the Flop
Seat 5: e000bde4 folded on the Turn
Seat 6: 98b7fb14 won ($1.89)


Poker Hand #RC1468014516: Hold'em No Limit  ($0.05/$0.1) - 2023/04/12 16:07:54
Table 'RushAndCash5529776' 6-max Seat #1 is the button
Seat 1: 6f217f91 ($5.76 in chips)
Seat 2: 7aa75295 ($10.87 in chips)
Seat 3: 1bd3bc3d ($20.15 in chips)
Seat 4: c1515a2c ($8.07 in chips)
Seat 5: Hero ($4.38 in chips)
Seat 6: 11ac4b22 ($12.75 in chips)
7aa75295: posts small blind $0.05
1bd3bc3d: posts big blind $0.1
*** HOLE CARDS ***
Dealt to 6f217f91 
Dealt to 7aa75295 
Dealt to 1bd3bc3d 
Dealt to c1515a2c 
Dealt to Hero [7c 2h]
Dealt to 11ac4b22 
c1515a2c: raises $0.15 to $0.25
Hero: folds
11ac4b22: raises $0.55 to $0.8
6f217f91: folds
7aa75295: folds
1bd3bc3d: folds
c1515a2c: calls $0.55
*** FLOP *** [3c 6c 9s]
c1515a2c: checks
11ac4b22: checks
*** TURN *** [3c 6c 9s] [Jh]
c1515a2c: checks
11ac4b22: bets $0.58
c1515a2c: folds
Uncalled bet ($0.58) returned to 11ac4b22
*** SHOWDOWN ***
11ac4b22 collected $1.67 from pot
*** SUMMARY ***
Total pot $1.75 | Rake $0.08 | Jackpot $0 | Bingo $0 | Fortune $0
Board [3c 6c 9s Jh]
Seat 1: 6f217f91 (button) folded before Flop (didn't bet)
Seat 2: 7aa75295 (small blind) folded before Flop
Seat 3: 1bd3bc3d (big blind) folded before Flop
Seat 4: c1515a2c folded on the Turn
Seat 5: Hero folded before Flop (didn't bet)
Seat 6: 11ac4b22 won ($1.67)


Poker Hand #RC1468014435: Hold'em No Limit  ($0.05/$0.1) - 2023/04/12 16:07:44
Table 'RushAndCash5529695' 6-max Seat #1 is the button
Seat 1: 408150e0 ($10.39 in chips)
Seat 2: 36623a12 ($14.03 in chips)
Seat 3: 96070601 ($10.05 in chips)
Seat 4: 59bc51f2 ($20.97 in chips)
Seat 5: Hero ($4.38 in chips)
Seat 6: 1fac3333 ($19.25 in chips)
36623a12: posts small blind $0.05
96070601: posts big blind $0.1
*** HOLE CARDS ***
Dealt to 408150e0 
Dealt to 36623a12 
Dealt to 96070601 
Dealt to 59bc51f2 
Dealt to Hero [Js 8h]
Dealt to 1fac3333 
59bc51f2: folds
Hero: folds
1fac3333: folds
408150e0: raises $0.2 to $0.3
36623a12: folds
96070601: raises $0.65 to $0.95
408150e0: calls $0.65
*** FLOP *** [Ah 9s 7s]
96070601: bets $0.98
408150e0: folds
Uncalled bet ($0.98) returned to 96070601
*** SHOWDOWN ***
96070601 collected $1.86 from pot
*** SUMMARY ***
Total pot $1.95 | Rake $0.09 | Jackpot $0 | Bingo $0 | Fortune $0
Board [Ah 9s 7s]
Seat 1: 408150e0 (button) folded on the Flop
Seat 2: 36623a12 (small blind) folded before Flop
Seat 3: 96070601 (big blind) won ($1.86)
Seat 4: 59bc51f2 folded before Flop (didn't bet)
Seat 5: Hero folded before Flop (didn't bet)
Seat 6: 1fac3333 folded before Flop (didn't bet)


Poker Hand #RC1468014374: Hold'em No Limit  ($0.05/$0.1) - 2023/04/12 16:07:36
Table 'RushAndCash5529634' 6-max Seat #1 is the button
Seat 1: 1d9dc806 ($19.14 in chips)
Seat 2: b775f0b6 ($21.28 in chips)
Seat 3: 4dde0cbc ($10.3 in chips)
Seat 4: 518a2b78 ($7.94 in chips)
Seat 5: Hero ($4.38 in chips)
Seat 6: fc3c863d ($7.07 in chips)
b775f0b6: posts small blind $0.05
4dde0cbc: posts big blind $0.1
*** HOLE CARDS ***
Dealt to 1d9dc806 
Dealt to b775f0b6 
Dealt to 4dde0cbc 
Dealt to 518a2b78 
Dealt to Hero [Ks 4s]
Dealt to fc3c863d 
518a2b78: raises $0.2 to $0.3
Hero: folds
fc3c863d: folds
1d9dc806: folds
b775f0b6: folds
4dde0cbc: folds
Uncalled bet ($0.2) returned to 518a2b78
*** SHOWDOWN ***
518a2b78 collected $0.25 from pot
*** SUMMARY ***
Total pot $0.25 | Rake $0 | Jackpot $0 | Bingo $0 | Fortune $0
Seat 1: 1d9dc806 (button) folded before Flop (didn't bet)
Seat 2: b775f0b6 (small blind) folded before Flop
Seat 3: 4dde0cbc (big blind) folded before Flop
Seat 4: 518a2b78 collected ($0.25)
Seat 5: Hero folded before Flop (didn't bet)
Seat 6: fc3c863d folded before Flop (didn't bet)


Poker Hand #RC1468014337: Hold'em No Limit  ($0.05/$0.1) - 2023/04/12 16:07:30
Table 'RushAndCash5529597' 6-max Seat #1 is the button
Seat 1: b29d650 ($12.77 in chips)
Seat 2: Hero ($4.43 in chips)
Seat 3: 75dcbe6d ($11.6 in chips)
Seat 4: 85b7299e ($34.77 in chips)
Seat 5: d4950190 ($9.38 in chips)
Seat 6: 51df5cf1 ($10.38 in chips)
Hero: posts small blind $0.05
75dcbe6d: posts big blind $0.1
*** HOLE CARDS ***
Dealt to b29d650 
Dealt to Hero [4h Js]
Dealt to 75dcbe6d 
Dealt to 85b7299e 
Dealt to d4950190 
Dealt to 51df5cf1 
85b7299e: folds
d4950190: folds
51df5cf1: raises $0.15 to $0.25
b29d650: raises $0.5 to $0.75
Hero: folds
75dcbe6d: folds
51df5cf1: folds
Uncalled bet ($0.5) returned to b29d650
*** SHOWDOWN ***
b29d650 collected $0.62 from pot
*** SUMMARY ***
Total pot $0.65 | Rake $0.03 | Jackpot $0 | Bingo $0 | Fortune $0
Seat 1: b29d650 (button) collected ($0.62)
Seat 2: Hero (small blind) folded before Flop
Seat 3: 75dcbe6d (big blind) folded before Flop
Seat 4: 85b7299e folded before Flop (didn't bet)
Seat 5: d4950190 folded before Flop (didn't bet)
Seat 6: 51df5cf1 folded before Flop


Poker Hand #RC1468014219: Hold'em No Limit  ($0.05/$0.1) - 2023/04/12 16:07:14
Table 'RushAndCash5529479' 6-max Seat #1 is the button
Seat 1: Hero ($4.28 in chips)
Seat 2: b7f06c48 ($12.73 in chips)
Seat 3: 73536806 ($12.17 in chips)
Seat 4: 5a53f0bb ($13.27 in chips)
Seat 5: 184223c2 ($11.33 in chips)
Seat 6: 7f6bcad ($12.43 in chips)
b7f06c48: posts small blind $0.05
73536806: posts big blind $0.1
*** HOLE CARDS ***
Dealt to Hero [Ad 9d]
Dealt to b7f06c48 
Dealt to 73536806 
Dealt to 5a53f0bb 
Dealt to 184223c2 
Dealt to 7f6bcad 
5a53f0bb: folds
184223c2: folds
7f6bcad: folds
Hero: raises $0.15 to $0.25
b7f06c48: folds
73536806: folds
Uncalled bet ($0.15) returned to Hero
*** SHOWDOWN ***
Hero collected $0.25 from pot
*** SUMMARY ***
Total pot $0.25 | Rake $0 | Jackpot $0 | Bingo $0 | Fortune $0
Seat 1: Hero (button) collected ($0.25)
Seat 2: b7f06c48 (small blind) folded before Flop
Seat 3: 73536806 (big blind) folded before Flop
Seat 4: 5a53f0bb folded before Flop (didn't bet)
Seat 5: 184223c2 folded before Flop (didn't bet)
Seat 6: 7f6bcad folded before Flop (didn't bet)


Poker Hand #RC1468013775: Hold'em No Limit  ($0.05/$0.1) - 2023/04/12 16:06:15
Table 'RushAndCash5529035' 6-max Seat #1 is the button
Seat 1: 18ac5c ($10.33 in chips)
Seat 2: 285693dc ($12.15 in chips)
Seat 3: Hero ($4.93 in chips)
Seat 4: bfa27a07 ($10.87 in chips)
Seat 5: 81c8a690 ($12.63 in chips)
Seat 6: c13536e9 ($10.66 in chips)
285693dc: posts small blind $0.05
Hero: posts big blind $0.1
*** HOLE CARDS ***
Dealt to 18ac5c 
Dealt to 285693dc 
Dealt to Hero [9c 8c]
Dealt to bfa27a07 
Dealt to 81c8a690 
Dealt to c13536e9 
bfa27a07: folds
81c8a690: raises $0.15 to $0.25
c13536e9: folds
18ac5c: calls $0.25
285693dc: folds
Hero: calls $0.15
*** FLOP *** [4c 5d 4s]
Hero: bets $0.4
81c8a690: calls $0.4
18ac5c: calls $0.4
*** TURN *** [4c 5d 4s] [Ah]
Hero: checks
81c8a690: bets $0.74
18ac5c: calls $0.74
Hero: folds
*** RIVER *** [4c 5d 4s Ah] [Jh]
81c8a690: bets $1.99
18ac5c: raises $3.73 to $5.72
81c8a690: folds
Uncalled bet ($3.73) returned to 18ac5c
*** SHOWDOWN ***
18ac5c collected $7.01 from pot
*** SUMMARY ***
Total pot $7.46 | Rake $0.3 | Jackpot $0.15 | Bingo $0 | Fortune $0
Board [4c 5d 4s Ah Jh]
Seat 1: 18ac5c (button) won ($7.01)
Seat 2: 285693dc (small blind) folded before Flop
Seat 3: Hero (big blind) folded on the Turn
Seat 4: bfa27a07 folded before Flop (didn't bet)
Seat 5: 81c8a690 folded on the River
Seat 6: c13536e9 folded before Flop (didn't bet)


Poker Hand #RC1468013461: Hold'em No Limit  ($0.05/$0.1) - 2023/04/12 16:05:36
Table 'RushAndCash5528721' 6-max Seat #1 is the button
Seat 1: 3bc9f7ca ($27.08 in chips)
Seat 2: d755c17e ($10.15 in chips)
Seat 3: 84ae99a4 ($10.8 in chips)
Seat 4: Hero ($4.65 in chips)
Seat 5: 56a5b3f7 ($17.24 in chips)
Seat 6: 8061b980 ($45.15 in chips)
d755c17e: posts small blind $0.05
84ae99a4: posts big blind $0.1
*** HOLE CARDS ***
Dealt to 3bc9f7ca 
Dealt to d755c17e 
Dealt to 84ae99a4 
Dealt to Hero [Td As]
Dealt to 56a5b3f7 
Dealt to 8061b980 
Hero: raises $0.15 to $0.25
56a5b3f7: folds
8061b980: folds
3bc9f7ca: folds
d755c17e: folds
84ae99a4: calls $0.15
*** FLOP *** [Ad 2s 5h]
84ae99a4: checks
Hero: bets $0.28
84ae99a4: folds
Uncalled bet ($0.28) returned to Hero
*** SHOWDOWN ***
Hero collected $0.53 from pot
*** SUMMARY ***
Total pot $0.55 | Rake $0.02 | Jackpot $0 | Bingo $0 | Fortune $0
Board [Ad 2s 5h]
Seat 1: 3bc9f7ca (button) folded before Flop (didn't bet)
Seat 2: d755c17e (small blind) folded before Flop
Seat 3: 84ae99a4 (big blind) folded on the Flop
Seat 4: Hero won ($0.53)
Seat 5: 56a5b3f7 folded before Flop (didn't bet)
Seat 6: 8061b980 folded before Flop (didn't bet)


Poker Hand #RC1468013414: Hold'em No Limit  ($0.05/$0.1) - 2023/04/12 16:05:31
Table 'RushAndCash5528674' 6-max Seat #1 is the button
Seat 1: aa9e0f1 ($10 in chips)
Seat 2: 4dde0cbc ($6.37 in chips)
Seat 3: 4df7250d ($11.5 in chips)
Seat 4: Hero ($4.65 in chips)
Seat 5: 814b7278 ($10.15 in chips)
Seat 6: f26bc305 ($15.66 in chips)
4dde0cbc: posts small blind $0.05
4df7250d: posts big blind $0.1
*** HOLE CARDS ***
Dealt to aa9e0f1 
Dealt to 4dde0cbc 
Dealt to 4df7250d 
Dealt to Hero [9s 7c]
Dealt to 814b7278 
Dealt to f26bc305 
Hero: folds
814b7278: folds
f26bc305: folds
aa9e0f1: folds
4dde0cbc: folds
Uncalled bet ($0.05) returned to 4df7250d
*** SHOWDOWN ***
4df7250d collected $0.1 from pot
*** SUMMARY ***
Total pot $0.1 | Rake $0 | Jackpot $0 | Bingo $0 | Fortune $0
Seat 1: aa9e0f1 (button) folded before Flop (didn't bet)
Seat 2: 4dde0cbc (small blind) folded before Flop
Seat 3: 4df7250d (big blind) collected ($0.1)
Seat 4: Hero folded before Flop (didn't bet)
Seat 5: 814b7278 folded before Flop (didn't bet)
Seat 6: f26bc305 folded before Flop (didn't bet)


Poker Hand #RC1468013311: Hold'em No Limit  ($0.05/$0.1) - 2023/04/12 16:05:20
Table 'RushAndCash5528571' 6-max Seat #1 is the button
Seat 1: ff1471 ($14.26 in chips)
Seat 2: e8dd0f9b ($11.92 in chips)
Seat 3: Hero ($4.75 in chips)
Seat 4: 36094f35 ($33.41 in chips)
Seat 5: 4c1c668b ($12.45 in chips)
Seat 6: 50cdddb1 ($10.07 in chips)
e8dd0f9b: posts small blind $0.05
Hero: posts big blind $0.1
*** HOLE CARDS ***
Dealt to ff1471 
Dealt to e8dd0f9b 
Dealt to Hero [Jh 6h]
Dealt to 36094f35 
Dealt to 4c1c668b 
Dealt to 50cdddb1 
36094f35: folds
4c1c668b: folds
50cdddb1: raises $0.15 to $0.25
ff1471: folds
e8dd0f9b: folds
Hero: folds
Uncalled bet ($0.15) returned to 50cdddb1
*** SHOWDOWN ***
50cdddb1 collected $0.25 from pot
*** SUMMARY ***
Total pot $0.25 | Rake $0 | Jackpot $0 | Bingo $0 | Fortune $0
Seat 1: ff1471 (button) folded before Flop (didn't bet)
Seat 2: e8dd0f9b (small blind) folded before Flop
Seat 3: Hero (big blind) folded before Flop
Seat 4: 36094f35 folded before Flop (didn't bet)
Seat 5: 4c1c668b folded before Flop (didn't bet)
Seat 6: 50cdddb1 collected ($0.25)


Poker Hand #RC1468013170: Hold'em No Limit  ($0.05/$0.1) - 2023/04/12 16:05:01
Table 'RushAndCash5528430' 6-max Seat #1 is the button
Seat 1: Hero ($4.75 in chips)
Seat 2: 8626b661 ($12.51 in chips)
Seat 3: d1da1715 ($17.7 in chips)
Seat 4: 47ec94f9 ($10 in chips)
Seat 5: c2d58e42 ($13 in chips)
Seat 6: 75daf67b ($10 in chips)
8626b661: posts small blind $0.05
d1da1715: posts big blind $0.1
*** HOLE CARDS ***
Dealt to Hero [6h Ks]
Dealt to 8626b661 
Dealt to d1da1715 
Dealt to 47ec94f9 
Dealt to c2d58e42 
Dealt to 75daf67b 
47ec94f9: raises $0.1 to $0.2
c2d58e42: folds
75daf67b: folds
Hero: folds
8626b661: folds
d1da1715: folds
Uncalled bet ($0.1) returned to 47ec94f9
*** SHOWDOWN ***
47ec94f9 collected $0.25 from pot
*** SUMMARY ***
Total pot $0.25 | Rake $0 | Jackpot $0 | Bingo $0 | Fortune $0
Seat 1: Hero (button) folded before Flop (didn't bet)
Seat 2: 8626b661 (small blind) folded before Flop
Seat 3: d1da1715 (big blind) folded before Flop
Seat 4: 47ec94f9 collected ($0.25)
Seat 5: c2d58e42 folded before Flop (didn't bet)
Seat 6: 75daf67b folded before Flop (didn't bet)


Poker Hand #RC1468013081: Hold'em No Limit  ($0.05/$0.1) - 2023/04/12 16:04:50
Table 'RushAndCash5528341' 6-max Seat #1 is the button
Seat 1: bb4b6a70 ($9.85 in chips)
Seat 2: 8c5f0968 ($23.59 in chips)
Seat 3: b15fc266 ($10.64 in chips)
Seat 4: 1beaaae ($13.11 in chips)
Seat 5: Hero ($4.75 in chips)
Seat 6: 22a3e1df ($41.01 in chips)
8c5f0968: posts small blind $0.05
b15fc266: posts big blind $0.1
*** HOLE CARDS ***
Dealt to bb4b6a70 
Dealt to 8c5f0968 
Dealt to b15fc266 
Dealt to 1beaaae 
Dealt to Hero [5s 4d]
Dealt to 22a3e1df 
1beaaae: folds
Hero: folds
22a3e1df: folds
bb4b6a70: raises $0.1 to $0.2
8c5f0968: calls $0.15
b15fc266: folds
*** FLOP *** [5h 4c 2h]
8c5f0968: checks
bb4b6a70: checks
*** TURN *** [5h 4c 2h] [Jc]
8c5f0968: bets $0.38
bb4b6a70: folds
Uncalled bet ($0.38) returned to 8c5f0968
*** SHOWDOWN ***
8c5f0968 collected $0.48 from pot
*** SUMMARY ***
Total pot $0.5 | Rake $0.02 | Jackpot $0 | Bingo $0 | Fortune $0
Board [5h 4c 2h Jc]
Seat 1: bb4b6a70 (button) folded on the Turn
Seat 2: 8c5f0968 (small blind) won ($0.48)
Seat 3: b15fc266 (big blind) folded before Flop
Seat 4: 1beaaae folded before Flop (didn't bet)
Seat 5: Hero folded before Flop (didn't bet)
Seat 6: 22a3e1df folded before Flop (didn't bet)


Poker Hand #RC1468012983: Hold'em No Limit  ($0.05/$0.1) - 2023/04/12 16:04:38
Table 'RushAndCash5528243' 6-max Seat #1 is the button
Seat 1: 6f217f91 ($5.48 in chips)
Seat 2: Hero ($4.8 in chips)
Seat 3: 2509cf80 ($10.99 in chips)
Seat 4: 91a45384 ($10.15 in chips)
Seat 5: 79059c86 ($10 in chips)
Seat 6: 5767d9c0 ($11.03 in chips)
Hero: posts small blind $0.05
2509cf80: posts big blind $0.1
*** HOLE CARDS ***
Dealt to 6f217f91 
Dealt to Hero [Qc 8d]
Dealt to 2509cf80 
Dealt to 91a45384 
Dealt to 79059c86 
Dealt to 5767d9c0 
91a45384: folds
79059c86: folds
5767d9c0: folds
6f217f91: raises $0.15 to $0.25
Hero: folds
2509cf80: folds
Uncalled bet ($0.15) returned to 6f217f91
*** SHOWDOWN ***
6f217f91 collected $0.25 from pot
*** SUMMARY ***
Total pot $0.25 | Rake $0 | Jackpot $0 | Bingo $0 | Fortune $0
Seat 1: 6f217f91 (button) collected ($0.25)
Seat 2: Hero (small blind) folded before Flop
Seat 3: 2509cf80 (big blind) folded before Flop
Seat 4: 91a45384 folded before Flop (didn't bet)
Seat 5: 79059c86 folded before Flop (didn't bet)
Seat 6: 5767d9c0 folded before Flop (didn't bet)


Poker Hand #RC1468012904: Hold'em No Limit  ($0.05/$0.1) - 2023/04/12 16:04:28
Table 'RushAndCash5528164' 6-max Seat #1 is the button
Seat 1: bfa27a07 ($11.13 in chips)
Seat 2: 680ee71e ($11 in chips)
Seat 3: d4950190 ($9.7 in chips)
Seat 4: 23c20d6b ($8.19 in chips)
Seat 5: bf4adbc8 ($11.78 in chips)
Seat 6: Hero ($4.8 in chips)
680ee71e: posts small blind $0.05
d4950190: posts big blind $0.1
*** HOLE CARDS ***
Dealt to bfa27a07 
Dealt to 680ee71e 
Dealt to d4950190 
Dealt to 23c20d6b 
Dealt to bf4adbc8 
Dealt to Hero [As 5c]
23c20d6b: folds
bf4adbc8: raises $0.15 to $0.25
Hero: folds
bfa27a07: folds
680ee71e: folds
d4950190: calls $0.15
*** FLOP *** [5h 7h Qs]
d4950190: checks
bf4adbc8: checks
*** TURN *** [5h 7h Qs] [Jd]
d4950190: checks
bf4adbc8: checks
*** RIVER *** [5h 7h Qs Jd] [3s]
d4950190: bets $0.3
bf4adbc8: folds
Uncalled bet ($0.3) returned to d4950190
*** SHOWDOWN ***
d4950190 collected $0.53 from pot
*** SUMMARY ***
Total pot $0.55 | Rake $0.02 | Jackpot $0 | Bingo $0 | Fortune $0
Board [5h 7h Qs Jd 3s]
Seat 1: bfa27a07 (button) folded before Flop (didn't bet)
Seat 2: 680ee71e (small blind) folded before Flop
Seat 3: d4950190 (big blind) won ($0.53)
Seat 4: 23c20d6b folded before Flop (didn't bet)
Seat 5: bf4adbc8 folded on the River
Seat 6: Hero folded before Flop (didn't bet)


Poker Hand #RC1468012865: Hold'em No Limit  ($0.05/$0.1) - 2023/04/12 16:04:23
Table 'RushAndCash5528125' 6-max Seat #1 is the button
Seat 1: Hero ($4.8 in chips)
Seat 2: 1d575b2c ($6.9 in chips)
Seat 3: 1f4b8b1e ($10 in chips)
Seat 4: 23e43d38 ($29.03 in chips)
Seat 5: 8b3bb6ab ($10 in chips)
Seat 6: a49b99da ($16.54 in chips)
1d575b2c: posts small blind $0.05
1f4b8b1e: posts big blind $0.1
*** HOLE CARDS ***
Dealt to Hero [Ts 4c]
Dealt to 1d575b2c 
Dealt to 1f4b8b1e 
Dealt to 23e43d38 
Dealt to 8b3bb6ab 
Dealt to a49b99da 
23e43d38: folds
8b3bb6ab: folds
a49b99da: raises $0.12 to $0.22
Hero: folds
1d575b2c: calls $0.17
1f4b8b1e: folds
*** FLOP *** [9h Ah 5d]
1d575b2c: bets $0.18
a49b99da: folds
Uncalled bet ($0.18) returned to 1d575b2c
*** SHOWDOWN ***
1d575b2c collected $0.52 from pot
*** SUMMARY ***
Total pot $0.54 | Rake $0.02 | Jackpot $0 | Bingo $0 | Fortune $0
Board [9h Ah 5d]
Seat 1: Hero (button) folded before Flop (didn't bet)
Seat 2: 1d575b2c (small blind) won ($0.52)
Seat 3: 1f4b8b1e (big blind) folded before Flop
Seat 4: 23e43d38 folded before Flop (didn't bet)
Seat 5: 8b3bb6ab folded before Flop (didn't bet)
Seat 6: a49b99da folded on the Flop


Poker Hand #RC1468012814: Hold'em No Limit  ($0.05/$0.1) - 2023/04/12 16:04:17
Table 'RushAndCash5528074' 6-max Seat #1 is the button
Seat 1: ba890047 ($10.15 in chips)
Seat 2: 7dec8cf1 ($11.33 in chips)
Seat 3: e83ab7b6 ($9.67 in chips)
Seat 4: 4dde0cbc ($8.22 in chips)
Seat 5: Hero ($4.8 in chips)
Seat 6: a9dcf77b ($46.19 in chips)
7dec8cf1: posts small blind $0.05
e83ab7b6: posts big blind $0.1
*** HOLE CARDS ***
Dealt to ba890047 
Dealt to 7dec8cf1 
Dealt to e83ab7b6 
Dealt to 4dde0cbc 
Dealt to Hero [Ad 6c]
Dealt to a9dcf77b 
4dde0cbc: raises $0.15 to $0.25
Hero: folds
a9dcf77b: folds
ba890047: folds
7dec8cf1: raises $0.75 to $1
e83ab7b6: folds
4dde0cbc: calls $0.75
*** FLOP *** [4d 8h Kc]
7dec8cf1: bets $0.7
4dde0cbc: calls $0.7
*** TURN *** [4d 8h Kc] [2c]
7dec8cf1: bets $2.63
4dde0cbc: folds
Uncalled bet ($2.63) returned to 7dec8cf1
*** SHOWDOWN ***
7dec8cf1 collected $3.19 from pot
*** SUMMARY ***
Total pot $3.5 | Rake $0.16 | Jackpot $0.15 | Bingo $0 | Fortune $0
Board [4d 8h Kc 2c]
Seat 1: ba890047 (button) folded before Flop (didn't bet)
Seat 2: 7dec8cf1 (small blind) won ($3.19)
Seat 3: e83ab7b6 (big blind) folded before Flop
Seat 4: 4dde0cbc folded on the Turn
Seat 5: Hero folded before Flop (didn't bet)
Seat 6: a9dcf77b folded before Flop (didn't bet)


Poker Hand #RC1468012397: Hold'em No Limit  ($0.05/$0.1) - 2023/04/12 16:03:24
Table 'RushAndCash5527657' 6-max Seat #1 is the button
Seat 1: cd8e30d1 ($9.85 in chips)
Seat 2: ee7db857 ($16.78 in chips)
Seat 3: 7dec8cf1 ($10.72 in chips)
Seat 4: a052f1e8 ($14.17 in chips)
Seat 5: 9d9c8154 ($14.68 in chips)
Seat 6: Hero ($5.42 in chips)
ee7db857: posts small blind $0.05
7dec8cf1: posts big blind $0.1
*** HOLE CARDS ***
Dealt to cd8e30d1 
Dealt to ee7db857 
Dealt to 7dec8cf1 
Dealt to a052f1e8 
Dealt to 9d9c8154 
Dealt to Hero [Ah Kd]
a052f1e8: folds
9d9c8154: folds
Hero: raises $0.15 to $0.25
cd8e30d1: folds
ee7db857: folds
7dec8cf1: calls $0.15
*** FLOP *** [8c 8h 5s]
7dec8cf1: checks
Hero: checks
*** TURN *** [8c 8h 5s] [3d]
7dec8cf1: bets $0.37
Hero: calls $0.37
*** RIVER *** [8c 8h 5s 3d] [9s]
7dec8cf1: bets $0.86
Hero: folds
Uncalled bet ($0.86) returned to 7dec8cf1
*** SHOWDOWN ***
7dec8cf1 collected $1.23 from pot
*** SUMMARY ***
Total pot $1.29 | Rake $0.06 | Jackpot $0 | Bingo $0 | Fortune $0
Board [8c 8h 5s 3d 9s]
Seat 1: cd8e30d1 (button) folded before Flop (didn't bet)
Seat 2: ee7db857 (small blind) folded before Flop
Seat 3: 7dec8cf1 (big blind) won ($1.23)
Seat 4: a052f1e8 folded before Flop (didn't bet)
Seat 5: 9d9c8154 folded before Flop (didn't bet)
Seat 6: Hero folded on the River


Poker Hand #RC1468012357: Hold'em No Limit  ($0.05/$0.1) - 2023/04/12 16:03:19
Table 'RushAndCash5527617' 6-max Seat #1 is the button
Seat 1: a8c83e2d ($10.27 in chips)
Seat 2: 8089184f ($10 in chips)
Seat 3: Hero ($5.52 in chips)
Seat 4: 89d7f5ab ($10 in chips)
Seat 5: e1c8ef1d ($13.59 in chips)
Seat 6: a39d28e4 ($12.8 in chips)
8089184f: posts small blind $0.05
Hero: posts big blind $0.1
*** HOLE CARDS ***
Dealt to a8c83e2d 
Dealt to 8089184f 
Dealt to Hero [2c 6h]
Dealt to 89d7f5ab 
Dealt to e1c8ef1d 
Dealt to a39d28e4 
89d7f5ab: folds
e1c8ef1d: folds
a39d28e4: folds
a8c83e2d: raises $0.2 to $0.3
8089184f: folds
Hero: folds
Uncalled bet ($0.2) returned to a8c83e2d
*** SHOWDOWN ***
a8c83e2d collected $0.25 from pot
*** SUMMARY ***
Total pot $0.25 | Rake $0 | Jackpot $0 | Bingo $0 | Fortune $0
Seat 1: a8c83e2d (button) collected ($0.25)
Seat 2: 8089184f (small blind) folded before Flop
Seat 3: Hero (big blind) folded before Flop
Seat 4: 89d7f5ab folded before Flop (didn't bet)
Seat 5: e1c8ef1d folded before Flop (didn't bet)
Seat 6: a39d28e4 folded before Flop (didn't bet)


Poker Hand #RC1468012320: Hold'em No Limit  ($0.05/$0.1) - 2023/04/12 16:03:15
Table 'RushAndCash5527580' 6-max Seat #1 is the button
Seat 1: 43ba1868 ($8.95 in chips)
Seat 2: Hero ($5.57 in chips)
Seat 3: 4fbe82b6 ($10 in chips)
Seat 4: a39d28e4 ($12.8 in chips)
Seat 5: c0f75cde ($17.76 in chips)
Seat 6: 74189c4c ($10 in chips)
Hero: posts small blind $0.05
4fbe82b6: posts big blind $0.1
*** HOLE CARDS ***
Dealt to 43ba1868 
Dealt to Hero [Ks 6c]
Dealt to 4fbe82b6 
Dealt to a39d28e4 
Dealt to c0f75cde 
Dealt to 74189c4c 
a39d28e4: folds
c0f75cde: folds
74189c4c: folds
43ba1868: folds
Hero: folds
Uncalled bet ($0.05) returned to 4fbe82b6
*** SHOWDOWN ***
4fbe82b6 collected $0.1 from pot
*** SUMMARY ***
Total pot $0.1 | Rake $0 | Jackpot $0 | Bingo $0 | Fortune $0
Seat 1: 43ba1868 (button) folded before Flop (didn't bet)
Seat 2: Hero (small blind) folded before Flop
Seat 3: 4fbe82b6 (big blind) collected ($0.1)
Seat 4: a39d28e4 folded before Flop (didn't bet)
Seat 5: c0f75cde folded before Flop (didn't bet)
Seat 6: 74189c4c folded before Flop (didn't bet)


Poker Hand #RC1468012285: Hold'em No Limit  ($0.05/$0.1) - 2023/04/12 16:03:11
Table 'RushAndCash5527545' 6-max Seat #1 is the button
Seat 1: 5e304ffe ($13.32 in chips)
Seat 2: d755c17e ($10.05 in chips)
Seat 3: abe05f0c ($12.04 in chips)
Seat 4: f4e25d78 ($10.28 in chips)
Seat 5: Hero ($5.57 in chips)
Seat 6: 987c9c6 ($13.02 in chips)
d755c17e: posts small blind $0.05
abe05f0c: posts big blind $0.1
*** HOLE CARDS ***
Dealt to 5e304ffe 
Dealt to d755c17e 
Dealt to abe05f0c 
Dealt to f4e25d78 
Dealt to Hero [Qd 7s]
Dealt to 987c9c6 
f4e25d78: folds
Hero: folds
987c9c6: folds
5e304ffe: folds
d755c17e: raises $0.18 to $0.28
abe05f0c: folds
Uncalled bet ($0.18) returned to d755c17e
*** SHOWDOWN ***
d755c17e collected $0.2 from pot
*** SUMMARY ***
Total pot $0.2 | Rake $0 | Jackpot $0 | Bingo $0 | Fortune $0
Seat 1: 5e304ffe (button) folded before Flop (didn't bet)
Seat 2: d755c17e (small blind) collected ($0.2)
Seat 3: abe05f0c (big blind) folded before Flop
Seat 4: f4e25d78 folded before Flop (didn't bet)
Seat 5: Hero folded before Flop (didn't bet)
Seat 6: 987c9c6 folded before Flop (didn't bet)


Poker Hand #RC1468012236: Hold'em No Limit  ($0.05/$0.1) - 2023/04/12 16:03:03
Table 'RushAndCash5527496' 6-max Seat #1 is the button
Seat 1: 7d88e034 ($12.59 in chips)
Seat 2: fc68e31 ($15.35 in chips)
Seat 3: cd8e30d1 ($9.85 in chips)
Seat 4: e0a92987 ($14.19 in chips)
Seat 5: 96070601 ($10.3 in chips)
Seat 6: Hero ($5.57 in chips)
fc68e31: posts small blind $0.05
cd8e30d1: posts big blind $0.1
*** HOLE CARDS ***
Dealt to 7d88e034 
Dealt to fc68e31 
Dealt to cd8e30d1 
Dealt to e0a92987 
Dealt to 96070601 
Dealt to Hero [Ac 3s]
e0a92987: folds
96070601: folds
Hero: folds
7d88e034: folds
fc68e31: folds
Uncalled bet ($0.05) returned to cd8e30d1
*** SHOWDOWN ***
cd8e30d1 collected $0.1 from pot
*** SUMMARY ***
Total pot $0.1 | Rake $0 | Jackpot $0 | Bingo $0 | Fortune $0
Seat 1: 7d88e034 (button) folded before Flop (didn't bet)
Seat 2: fc68e31 (small blind) folded before Flop
Seat 3: cd8e30d1 (big blind) collected ($0.1)
Seat 4: e0a92987 folded before Flop (didn't bet)
Seat 5: 96070601 folded before Flop (didn't bet)
Seat 6: Hero folded before Flop (didn't bet)


Poker Hand #RC1468012204: Hold'em No Limit  ($0.05/$0.1) - 2023/04/12 16:02:59
Table 'RushAndCash5527464' 6-max Seat #1 is the button
Seat 1: 9e73201d ($14.01 in chips)
Seat 2: Hero ($5.62 in chips)
Seat 3: 3b1b561d ($13.13 in chips)
Seat 4: e66c0d5 ($15.46 in chips)
Seat 5: aed826cb ($10.77 in chips)
Seat 6: 58580b96 ($5.38 in chips)
Hero: posts small blind $0.05
3b1b561d: posts big blind $0.1
*** HOLE CARDS ***
Dealt to 9e73201d 
Dealt to Hero [6c 8h]
Dealt to 3b1b561d 
Dealt to e66c0d5 
Dealt to aed826cb 
Dealt to 58580b96 
e66c0d5: folds
aed826cb: folds
58580b96: raises $0.1 to $0.2
9e73201d: folds
Hero: folds
3b1b561d: calls $0.1
*** FLOP *** [2c 3h 8c]
3b1b561d: checks
58580b96: checks
*** TURN *** [2c 3h 8c] [Td]
3b1b561d: checks
58580b96: bets $0.25
3b1b561d: folds
Uncalled bet ($0.25) returned to 58580b96
*** SHOWDOWN ***
58580b96 collected $0.43 from pot
*** SUMMARY ***
Total pot $0.45 | Rake $0.02 | Jackpot $0 | Bingo $0 | Fortune $0
Board [2c 3h 8c Td]
Seat 1: 9e73201d (button) folded before Flop (didn't bet)
Seat 2: Hero (small blind) folded before Flop
Seat 3: 3b1b561d (big blind) folded on the Turn
Seat 4: e66c0d5 folded before Flop (didn't bet)
Seat 5: aed826cb folded before Flop (didn't bet)
Seat 6: 58580b96 won ($0.43)


Poker Hand #RC1468011735: Hold'em No Limit  ($0.05/$0.1) - 2023/04/12 16:02:01
Table 'RushAndCash5526995' 6-max Seat #1 is the button
Seat 1: 75dcbe6d ($11.98 in chips)
Seat 2: aa024d7e ($12.65 in chips)
Seat 3: 932365a3 ($10.65 in chips)
Seat 4: 3bad9b0f ($5.72 in chips)
Seat 5: 3b1b561d ($10.34 in chips)
Seat 6: Hero ($7.66 in chips)
aa024d7e: posts small blind $0.05
932365a3: posts big blind $0.1
*** HOLE CARDS ***
Dealt to 75dcbe6d 
Dealt to aa024d7e 
Dealt to 932365a3 
Dealt to 3bad9b0f 
Dealt to 3b1b561d 
Dealt to Hero [Tc As]
3bad9b0f: raises $0.15 to $0.25
3b1b561d: calls $0.25
Hero: raises $0.75 to $1
75dcbe6d: folds
aa024d7e: folds
932365a3: folds
3bad9b0f: calls $0.75
3b1b561d: calls $0.75
*** FLOP *** [5h 4h 8c]
3bad9b0f: checks
3b1b561d: checks
Hero: bets $1.04
3bad9b0f: folds
3b1b561d: raises $1.76 to $2.8
Hero: folds
Uncalled bet ($1.76) returned to 3b1b561d
*** SHOWDOWN ***
3b1b561d collected $4.83 from pot
*** SUMMARY ***
Total pot $5.23 | Rake $0.25 | Jackpot $0.15 | Bingo $0 | Fortune $0
Board [5h 4h 8c]
Seat 1: 75dcbe6d (button) folded before Flop (didn't bet)
Seat 2: aa024d7e (small blind) folded before Flop
Seat 3: 932365a3 (big blind) folded before Flop
Seat 4: 3bad9b0f folded on the Flop
Seat 5: 3b1b561d won ($4.83)
Seat 6: Hero folded on the Flop


Poker Hand #RC1468011646: Hold'em No Limit  ($0.05/$0.1) - 2023/04/12 16:01:51
Table 'RushAndCash5526906' 6-max Seat #1 is the button
Seat 1: 40cc1594 ($10.15 in chips)
Seat 2: 3b3d664e ($10.2 in chips)
Seat 3: Hero ($7.61 in chips)
Seat 4: cc434304 ($10.15 in chips)
Seat 5: 45e87636 ($10.39 in chips)
Seat 6: a8209fe2 ($11.15 in chips)
3b3d664e: posts small blind $0.05
Hero: posts big blind $0.1
*** HOLE CARDS ***
Dealt to 40cc1594 
Dealt to 3b3d664e 
Dealt to Hero [Qs Qd]
Dealt to cc434304 
Dealt to 45e87636 
Dealt to a8209fe2 
cc434304: folds
45e87636: folds
a8209fe2: folds
40cc1594: folds
3b3d664e: folds
Uncalled bet ($0.05) returned to Hero
*** SHOWDOWN ***
Hero collected $0.1 from pot
*** SUMMARY ***
Total pot $0.1 | Rake $0 | Jackpot $0 | Bingo $0 | Fortune $0
Seat 1: 40cc1594 (button) folded before Flop (didn't bet)
Seat 2: 3b3d664e (small blind) folded before Flop
Seat 3: Hero (big blind) collected ($0.1)
Seat 4: cc434304 folded before Flop (didn't bet)
Seat 5: 45e87636 folded before Flop (didn't bet)
Seat 6: a8209fe2 folded before Flop (didn't bet)


Poker Hand #RC1468011505: Hold'em No Limit  ($0.05/$0.1) - 2023/04/12 16:01:34
Table 'RushAndCash5526765' 6-max Seat #1 is the button
Seat 1: Hero ($7.61 in chips)
Seat 2: 5cc65e8d ($13.45 in chips)
Seat 3: 3b3d664e ($10.3 in chips)
Seat 4: 285693dc ($10.05 in chips)
Seat 5: 7d6041fb ($10 in chips)
Seat 6: a53d9f28 ($10 in chips)
5cc65e8d: posts small blind $0.05
3b3d664e: posts big blind $0.1
*** HOLE CARDS ***
Dealt to Hero [2c Jd]
Dealt to 5cc65e8d 
Dealt to 3b3d664e 
Dealt to 285693dc 
Dealt to 7d6041fb 
Dealt to a53d9f28 
285693dc: folds
7d6041fb: folds
a53d9f28: folds
Hero: folds
5cc65e8d: raises $0.13 to $0.23
3b3d664e: folds
Uncalled bet ($0.13) returned to 5cc65e8d
*** SHOWDOWN ***
5cc65e8d collected $0.2 from pot
*** SUMMARY ***
Total pot $0.2 | Rake $0 | Jackpot $0 | Bingo $0 | Fortune $0
Seat 1: Hero (button) folded before Flop (didn't bet)
Seat 2: 5cc65e8d (small blind) collected ($0.2)
Seat 3: 3b3d664e (big blind) folded before Flop
Seat 4: 285693dc folded before Flop (didn't bet)
Seat 5: 7d6041fb folded before Flop (didn't bet)
Seat 6: a53d9f28 folded before Flop (didn't bet)


Poker Hand #RC1468011425: Hold'em No Limit  ($0.05/$0.1) - 2023/04/12 16:01:23
Table 'RushAndCash5526685' 6-max Seat #1 is the button
Seat 1: Hero ($7.61 in chips)
Seat 2: a857da8e ($25.11 in chips)
Seat 3: d3fe8d9f ($7.55 in chips)
Seat 4: c5b84a5b ($11.03 in chips)
Seat 5: aa9e0f1 ($10.15 in chips)
Seat 6: 7aa75295 ($10.11 in chips)
a857da8e: posts small blind $0.05
d3fe8d9f: posts big blind $0.1
*** HOLE CARDS ***
Dealt to Hero [Jh 3h]
Dealt to a857da8e 
Dealt to d3fe8d9f 
Dealt to c5b84a5b 
Dealt to aa9e0f1 
Dealt to 7aa75295 
c5b84a5b: folds
aa9e0f1: folds
7aa75295: folds
Hero: folds
a857da8e: raises $0.12 to $0.22
d3fe8d9f: folds
Uncalled bet ($0.12) returned to a857da8e
*** SHOWDOWN ***
a857da8e collected $0.2 from pot
*** SUMMARY ***
Total pot $0.2 | Rake $0 | Jackpot $0 | Bingo $0 | Fortune $0
Seat 1: Hero (button) folded before Flop (didn't bet)
Seat 2: a857da8e (small blind) collected ($0.2)
Seat 3: d3fe8d9f (big blind) folded before Flop
Seat 4: c5b84a5b folded before Flop (didn't bet)
Seat 5: aa9e0f1 folded before Flop (didn't bet)
Seat 6: 7aa75295 folded before Flop (didn't bet)


Poker Hand #RC1468011383: Hold'em No Limit  ($0.05/$0.1) - 2023/04/12 16:01:18
Table 'RushAndCash5526643' 6-max Seat #1 is the button
Seat 1: f12186f7 ($11.7 in chips)
Seat 2: c9683944 ($10.15 in chips)
Seat 3: f372733f ($18.82 in chips)
Seat 4: Hero ($7.61 in chips)
Seat 5: 56cec6d0 ($10.9 in chips)
Seat 6: e5e63f02 ($10.35 in chips)
c9683944: posts small blind $0.05
f372733f: posts big blind $0.1
*** HOLE CARDS ***
Dealt to f12186f7 
Dealt to c9683944 
Dealt to f372733f 
Dealt to Hero [8s 6d]
Dealt to 56cec6d0 
Dealt to e5e63f02 
Hero: folds
56cec6d0: folds
e5e63f02: folds
f12186f7: raises $0.15 to $0.25
c9683944: folds
f372733f: calls $0.15
*** FLOP *** [Th 6s Tc]
f372733f: checks
f12186f7: bets $0.19
f372733f: raises $0.47 to $0.66
f12186f7: folds
Uncalled bet ($0.47) returned to f372733f
*** SHOWDOWN ***
f372733f collected $0.89 from pot
*** SUMMARY ***
Total pot $0.93 | Rake $0.04 | Jackpot $0 | Bingo $0 | Fortune $0
Board [Th 6s Tc]
Seat 1: f12186f7 (button) folded on the Flop
Seat 2: c9683944 (small blind) folded before Flop
Seat 3: f372733f (big blind) won ($0.89)
Seat 4: Hero folded before Flop (didn't bet)
Seat 5: 56cec6d0 folded before Flop (didn't bet)
Seat 6: e5e63f02 folded before Flop (didn't bet)


Poker Hand #RC1468011343: Hold'em No Limit  ($0.05/$0.1) - 2023/04/12 16:01:13
Table 'RushAndCash5526603' 6-max Seat #1 is the button
Seat 1: 771f9cca ($10.57 in chips)
Seat 2: Hero ($7.66 in chips)
Seat 3: 5005043b ($26.3 in chips)
Seat 4: 1a46c10d ($10 in chips)
Seat 5: dade74e3 ($10.1 in chips)
Seat 6: d3740883 ($19.54 in chips)
Hero: posts small blind $0.05
5005043b: posts big blind $0.1
*** HOLE CARDS ***
Dealt to 771f9cca 
Dealt to Hero [Jd 4c]
Dealt to 5005043b 
Dealt to 1a46c10d 
Dealt to dade74e3 
Dealt to d3740883 
1a46c10d: folds
dade74e3: folds
d3740883: folds
771f9cca: folds
Hero: folds
Uncalled bet ($0.05) returned to 5005043b
*** SHOWDOWN ***
5005043b collected $0.1 from pot
*** SUMMARY ***
Total pot $0.1 | Rake $0 | Jackpot $0 | Bingo $0 | Fortune $0
Seat 1: 771f9cca (button) folded before Flop (didn't bet)
Seat 2: Hero (small blind) folded before Flop
Seat 3: 5005043b (big blind) collected ($0.1)
Seat 4: 1a46c10d folded before Flop (didn't bet)
Seat 5: dade74e3 folded before Flop (didn't bet)
Seat 6: d3740883 folded before Flop (didn't bet)


Poker Hand #RC1468011308: Hold'em No Limit  ($0.05/$0.1) - 2023/04/12 16:01:09
Table 'RushAndCash5526568' 6-max Seat #1 is the button
Seat 1: c71f0439 ($10.75 in chips)
Seat 2: 6d03ad0d ($10 in chips)
Seat 3: ce8f526f ($22.36 in chips)
Seat 4: 8c84d365 ($21.23 in chips)
Seat 5: Hero ($7.66 in chips)
Seat 6: 9f3d8720 ($9.85 in chips)
6d03ad0d: posts small blind $0.05
ce8f526f: posts big blind $0.1
*** HOLE CARDS ***
Dealt to c71f0439 
Dealt to 6d03ad0d 
Dealt to ce8f526f 
Dealt to 8c84d365 
Dealt to Hero [Qh 7h]
Dealt to 9f3d8720 
8c84d365: folds
Hero: folds
9f3d8720: raises $0.11 to $0.21
c71f0439: folds
6d03ad0d: folds
ce8f526f: calls $0.11
*** FLOP *** [7d 8h 2h]
ce8f526f: checks
9f3d8720: bets $0.24
ce8f526f: calls $0.24
*** TURN *** [7d 8h 2h] [Kc]
ce8f526f: checks
9f3d8720: checks
*** RIVER *** [7d 8h 2h Kc] [5s]
ce8f526f: checks
9f3d8720: checks
ce8f526f: shows [Jh Ah] (Ace-High)
9f3d8720: shows [Ts Td] (Pair of Tens)
*** SHOWDOWN ***
9f3d8720 collected $0.91 from pot
*** SUMMARY ***
Total pot $0.95 | Rake $0.04 | Jackpot $0 | Bingo $0 | Fortune $0
Board [7d 8h 2h Kc 5s]
Seat 1: c71f0439 (button) folded before Flop (didn't bet)
Seat 2: 6d03ad0d (small blind) folded before Flop
Seat 3: ce8f526f (big blind) showed [Jh Ah] and lost with Ace-High
Seat 4: 8c84d365 folded before Flop (didn't bet)
Seat 5: Hero folded before Flop (didn't bet)
Seat 6: 9f3d8720 showed [Ts Td] and won ($0.91) with Pair of Tens


Poker Hand #RC1468011243: Hold'em No Limit  ($0.05/$0.1) - 2023/04/12 16:01:02
Table 'RushAndCash5526503' 6-max Seat #1 is the button
Seat 1: ef331f6a ($10.32 in chips)
Seat 2: 9a10b576 ($14.95 in chips)
Seat 3: Hero ($7.76 in chips)
Seat 4: 3c328684 ($9.76 in chips)
Seat 5: 29b2c9b8 ($20.5 in chips)
Seat 6: c795ab0b ($15.63 in chips)
9a10b576: posts small blind $0.05
Hero: posts big blind $0.1
*** HOLE CARDS ***
Dealt to ef331f6a 
Dealt to 9a10b576 
Dealt to Hero [7h Ts]
Dealt to 3c328684 
Dealt to 29b2c9b8 
Dealt to c795ab0b 
3c328684: raises $0.2 to $0.3
29b2c9b8: folds
c795ab0b: folds
ef331f6a: folds
9a10b576: folds
Hero: folds
Uncalled bet ($0.2) returned to 3c328684
*** SHOWDOWN ***
3c328684 collected $0.25 from pot
*** SUMMARY ***
Total pot $0.25 | Rake $0 | Jackpot $0 | Bingo $0 | Fortune $0
Seat 1: ef331f6a (button) folded before Flop (didn't bet)
Seat 2: 9a10b576 (small blind) folded before Flop
Seat 3: Hero (big blind) folded before Flop
Seat 4: 3c328684 collected ($0.25)
Seat 5: 29b2c9b8 folded before Flop (didn't bet)
Seat 6: c795ab0b folded before Flop (didn't bet)


Poker Hand #RC1468011200: Hold'em No Limit  ($0.05/$0.1) - 2023/04/12 16:00:56
Table 'RushAndCash5526460' 6-max Seat #1 is the button
Seat 1: 4dde0cbc ($8.59 in chips)
Seat 2: d82e07a8 ($7.84 in chips)
Seat 3: b5a5fbb8 ($15.09 in chips)
Seat 4: 312f864e ($28.83 in chips)
Seat 5: Hero ($7.76 in chips)
Seat 6: 47268c3 ($9.85 in chips)
d82e07a8: posts small blind $0.05
b5a5fbb8: posts big blind $0.1
*** HOLE CARDS ***
Dealt to 4dde0cbc 
Dealt to d82e07a8 
Dealt to b5a5fbb8 
Dealt to 312f864e 
Dealt to Hero [2d 9h]
Dealt to 47268c3 
312f864e: folds
Hero: folds
47268c3: folds
4dde0cbc: folds
d82e07a8: folds
Uncalled bet ($0.05) returned to b5a5fbb8
*** SHOWDOWN ***
b5a5fbb8 collected $0.1 from pot
*** SUMMARY ***
Total pot $0.1 | Rake $0 | Jackpot $0 | Bingo $0 | Fortune $0
Seat 1: 4dde0cbc (button) folded before Flop (didn't bet)
Seat 2: d82e07a8 (small blind) folded before Flop
Seat 3: b5a5fbb8 (big blind) collected ($0.1)
Seat 4: 312f864e folded before Flop (didn't bet)
Seat 5: Hero folded before Flop (didn't bet)
Seat 6: 47268c3 folded before Flop (didn't bet)


Poker Hand #RC1468011148: Hold'em No Limit  ($0.05/$0.1) - 2023/04/12 16:00:48
Table 'RushAndCash5526408' 6-max Seat #1 is the button
Seat 1: 96cfdf8b ($16.29 in chips)
Seat 2: bdebddbc ($9.61 in chips)
Seat 3: 74ff2461 ($10 in chips)
Seat 4: Hero ($7.76 in chips)
Seat 5: 4545890 ($13.86 in chips)
Seat 6: 585e4380 ($8.6 in chips)
bdebddbc: posts small blind $0.05
74ff2461: posts big blind $0.1
*** HOLE CARDS ***
Dealt to 96cfdf8b 
Dealt to bdebddbc 
Dealt to 74ff2461 
Dealt to Hero [Js 4h]
Dealt to 4545890 
Dealt to 585e4380 
Hero: folds
4545890: folds
585e4380: folds
96cfdf8b: folds
bdebddbc: folds
Uncalled bet ($0.05) returned to 74ff2461
*** SHOWDOWN ***
74ff2461 collected $0.1 from pot
*** SUMMARY ***
Total pot $0.1 | Rake $0 | Jackpot $0 | Bingo $0 | Fortune $0
Seat 1: 96cfdf8b (button) folded before Flop (didn't bet)
Seat 2: bdebddbc (small blind) folded before Flop
Seat 3: 74ff2461 (big blind) collected ($0.1)
Seat 4: Hero folded before Flop (didn't bet)
Seat 5: 4545890 folded before Flop (didn't bet)
Seat 6: 585e4380 folded before Flop (didn't bet)


Poker Hand #RC1468011095: Hold'em No Limit  ($0.05/$0.1) - 2023/04/12 16:00:42
Table 'RushAndCash5526355' 6-max Seat #1 is the button
Seat 1: d4f16d55 ($17.05 in chips)
Seat 2: f2b01908 ($12.34 in chips)
Seat 3: a857da8e ($25.11 in chips)
Seat 4: 1beaaae ($10.47 in chips)
Seat 5: Hero ($7.76 in chips)
Seat 6: 6717051b ($4 in chips)
f2b01908: posts small blind $0.05
a857da8e: posts big blind $0.1
*** HOLE CARDS ***
Dealt to d4f16d55 
Dealt to f2b01908 
Dealt to a857da8e 
Dealt to 1beaaae 
Dealt to Hero [9h 2c]
Dealt to 6717051b 
1beaaae: folds
Hero: folds
6717051b: raises $0.2 to $0.3
d4f16d55: folds
f2b01908: folds
a857da8e: folds
Uncalled bet ($0.2) returned to 6717051b
*** SHOWDOWN ***
6717051b collected $0.25 from pot
*** SUMMARY ***
Total pot $0.25 | Rake $0 | Jackpot $0 | Bingo $0 | Fortune $0
Seat 1: d4f16d55 (button) folded before Flop (didn't bet)
Seat 2: f2b01908 (small blind) folded before Flop
Seat 3: a857da8e (big blind) folded before Flop
Seat 4: 1beaaae folded before Flop (didn't bet)
Seat 5: Hero folded before Flop (didn't bet)
Seat 6: 6717051b collected ($0.25)


Poker Hand #RC1468011050: Hold'em No Limit  ($0.05/$0.1) - 2023/04/12 16:00:37
Table 'RushAndCash5526310' 6-max Seat #1 is the button
Seat 1: aed826cb ($11.09 in chips)
Seat 2: 85b7299e ($32.53 in chips)
Seat 3: eef1755d ($16.18 in chips)
Seat 4: ce0ae4bf ($8.22 in chips)
Seat 5: Hero ($7.76 in chips)
Seat 6: b37d10fa ($11.83 in chips)
85b7299e: posts small blind $0.05
eef1755d: posts big blind $0.1
*** HOLE CARDS ***
Dealt to aed826cb 
Dealt to 85b7299e 
Dealt to eef1755d 
Dealt to ce0ae4bf 
Dealt to Hero [4h 8d]
Dealt to b37d10fa 
ce0ae4bf: raises $0.15 to $0.25
Hero: folds
b37d10fa: raises $0.49 to $0.74
aed826cb: folds
85b7299e: folds
eef1755d: folds
ce0ae4bf: raises $1.33 to $2.07
b37d10fa: folds
Uncalled bet ($1.33) returned to ce0ae4bf
*** SHOWDOWN ***
ce0ae4bf collected $1.55 from pot
*** SUMMARY ***
Total pot $1.63 | Rake $0.08 | Jackpot $0 | Bingo $0 | Fortune $0
Seat 1: aed826cb (button) folded before Flop (didn't bet)
Seat 2: 85b7299e (small blind) folded before Flop
Seat 3: eef1755d (big blind) folded before Flop
Seat 4: ce0ae4bf collected ($1.55)
Seat 5: Hero folded before Flop (didn't bet)
Seat 6: b37d10fa folded before Flop


Poker Hand #RC1468010945: Hold'em No Limit  ($0.05/$0.1) - 2023/04/12 16:00:24
Table 'RushAndCash5526205' 6-max Seat #1 is the button
Seat 1: ce0ae4bf ($8.22 in chips)
Seat 2: Hero ($7.81 in chips)
Seat 3: 6d19d550 ($7.33 in chips)
Seat 4: 53eced64 ($12.65 in chips)
Seat 5: e9f8dd81 ($10 in chips)
Seat 6: ee7db857 ($17.11 in chips)
Hero: posts small blind $0.05
6d19d550: posts big blind $0.1
*** HOLE CARDS ***
Dealt to ce0ae4bf 
Dealt to Hero [5s Ad]
Dealt to 6d19d550 
Dealt to 53eced64 
Dealt to e9f8dd81 
Dealt to ee7db857 
53eced64: folds
e9f8dd81: folds
ee7db857: raises $0.15 to $0.25
ce0ae4bf: folds
Hero: folds
6d19d550: calls $0.15
*** FLOP *** [9h Tc Qd]
6d19d550: checks
ee7db857: checks
*** TURN *** [9h Tc Qd] [6d]
6d19d550: checks
ee7db857: checks
*** RIVER *** [9h Tc Qd 6d] [Qh]
6d19d550: checks
ee7db857: checks
6d19d550: shows [Kh Td] (Pair of Queens and Pair of Tens)
ee7db857: shows [8c Kc] (Pair of Queens)
*** SHOWDOWN ***
6d19d550 collected $0.52 from pot
*** SUMMARY ***
Total pot $0.55 | Rake $0.03 | Jackpot $0 | Bingo $0 | Fortune $0
Board [9h Tc Qd 6d Qh]
Seat 1: ce0ae4bf (button) folded before Flop (didn't bet)
Seat 2: Hero (small blind) folded before Flop
Seat 3: 6d19d550 (big blind) showed [Kh Td] and won ($0.52) with Pair of Queens and Pair of Tens
Seat 4: 53eced64 folded before Flop (didn't bet)
Seat 5: e9f8dd81 folded before Flop (didn't bet)
Seat 6: ee7db857 showed [8c Kc] and lost with Pair of Queens


Poker Hand #RC1468010395: Hold'em No Limit  ($0.05/$0.1) - 2023/04/12 15:59:17
Table 'RushAndCash5525655' 6-max Seat #1 is the button
Seat 1: 38b9b220 ($21.42 in chips)
Seat 2: ffbe1a45 ($12.48 in chips)
Seat 3: ce0ae4bf ($8.66 in chips)
Seat 4: Hero ($7.36 in chips)
Seat 5: b2bf7acd ($5.43 in chips)
Seat 6: 38dddee5 ($8.55 in chips)
ffbe1a45: posts small blind $0.05
ce0ae4bf: posts big blind $0.1
*** HOLE CARDS ***
Dealt to 38b9b220 
Dealt to ffbe1a45 
Dealt to ce0ae4bf 
Dealt to Hero [8c 9c]
Dealt to b2bf7acd 
Dealt to 38dddee5 
Hero: raises $0.15 to $0.25
b2bf7acd: folds
38dddee5: folds
38b9b220: folds
ffbe1a45: folds
ce0ae4bf: calls $0.15
*** FLOP *** [3s As Th]
ce0ae4bf: checks
Hero: bets $0.19
ce0ae4bf: calls $0.19
*** TURN *** [3s As Th] [5h]
ce0ae4bf: checks
Hero: bets $0.47
ce0ae4bf: folds
Uncalled bet ($0.47) returned to Hero
*** SHOWDOWN ***
Hero collected $0.89 from pot
*** SUMMARY ***
Total pot $0.93 | Rake $0.04 | Jackpot $0 | Bingo $0 | Fortune $0
Board [3s As Th 5h]
Seat 1: 38b9b220 (button) folded before Flop (didn't bet)
Seat 2: ffbe1a45 (small blind) folded before Flop
Seat 3: ce0ae4bf (big blind) folded on the Turn
Seat 4: Hero won ($0.89)
Seat 5: b2bf7acd folded before Flop (didn't bet)
Seat 6: 38dddee5 folded before Flop (didn't bet)


Poker Hand #RC1468010340: Hold'em No Limit  ($0.05/$0.1) - 2023/04/12 15:59:11
Table 'RushAndCash5525600' 6-max Seat #1 is the button
Seat 1: Hero ($7.36 in chips)
Seat 2: 77f824e7 ($10 in chips)
Seat 3: e789a8ea ($19.31 in chips)
Seat 4: 73f9955f ($10.83 in chips)
Seat 5: 601eadc7 ($10 in chips)
Seat 6: 74945146 ($10 in chips)
77f824e7: posts small blind $0.05
e789a8ea: posts big blind $0.1
*** HOLE CARDS ***
Dealt to Hero [3d 8h]
Dealt to 77f824e7 
Dealt to e789a8ea 
Dealt to 73f9955f 
Dealt to 601eadc7 
Dealt to 74945146 
73f9955f: raises $0.15 to $0.25
601eadc7: folds
74945146: folds
Hero: folds
77f824e7: folds
e789a8ea: folds
Uncalled bet ($0.15) returned to 73f9955f
*** SHOWDOWN ***
73f9955f collected $0.25 from pot
*** SUMMARY ***
Total pot $0.25 | Rake $0 | Jackpot $0 | Bingo $0 | Fortune $0
Seat 1: Hero (button) folded before Flop (didn't bet)
Seat 2: 77f824e7 (small blind) folded before Flop
Seat 3: e789a8ea (big blind) folded before Flop
Seat 4: 73f9955f collected ($0.25)
Seat 5: 601eadc7 folded before Flop (didn't bet)
Seat 6: 74945146 folded before Flop (didn't bet)


Poker Hand #RC1468010223: Hold'em No Limit  ($0.05/$0.1) - 2023/04/12 15:58:57
Table 'RushAndCash5525483' 6-max Seat #1 is the button
Seat 1: 7c2ee6c6 ($11.91 in chips)
Seat 2: e1c8ef1d ($11.13 in chips)
Seat 3: Hero ($7.31 in chips)
Seat 4: d697ab49 ($10 in chips)
Seat 5: 45e87636 ($10 in chips)
Seat 6: 45ce4665 ($14.01 in chips)
e1c8ef1d: posts small blind $0.05
Hero: posts big blind $0.1
*** HOLE CARDS ***
Dealt to 7c2ee6c6 
Dealt to e1c8ef1d 
Dealt to Hero [8h 9c]
Dealt to d697ab49 
Dealt to 45e87636 
Dealt to 45ce4665 
d697ab49: folds
45e87636: raises $0.15 to $0.25
45ce4665: folds
7c2ee6c6: folds
e1c8ef1d: folds
Hero: folds
Uncalled bet ($0.15) returned to 45e87636
*** SHOWDOWN ***
45e87636 collected $0.25 from pot
*** SUMMARY ***
Total pot $0.25 | Rake $0 | Jackpot $0 | Bingo $0 | Fortune $0
Seat 1: 7c2ee6c6 (button) folded before Flop (didn't bet)
Seat 2: e1c8ef1d (small blind) folded before Flop
Seat 3: Hero (big blind) folded before Flop
Seat 4: d697ab49 folded before Flop (didn't bet)
Seat 5: 45e87636 collected ($0.25)
Seat 6: 45ce4665 folded before Flop (didn't bet)


Poker Hand #RC1468010182: Hold'em No Limit  ($0.05/$0.1) - 2023/04/12 15:58:53
Table 'RushAndCash5525442' 6-max Seat #1 is the button
Seat 1: 9df7f473 ($13.47 in chips)
Seat 2: 8bfa3ed5 ($19.78 in chips)
Seat 3: Hero ($7.41 in chips)
Seat 4: 2ed01443 ($10 in chips)
Seat 5: 779c4822 ($11.33 in chips)
Seat 6: 1e6e5904 ($13.02 in chips)
8bfa3ed5: posts small blind $0.05
Hero: posts big blind $0.1
*** HOLE CARDS ***
Dealt to 9df7f473 
Dealt to 8bfa3ed5 
Dealt to Hero [2h Ks]
Dealt to 2ed01443 
Dealt to 779c4822 
Dealt to 1e6e5904 
2ed01443: folds
779c4822: folds
1e6e5904: folds
9df7f473: folds
8bfa3ed5: folds
Uncalled bet ($0.05) returned to Hero
*** SHOWDOWN ***
Hero collected $0.1 from pot
*** SUMMARY ***
Total pot $0.1 | Rake $0 | Jackpot $0 | Bingo $0 | Fortune $0
Seat 1: 9df7f473 (button) folded before Flop (didn't bet)
Seat 2: 8bfa3ed5 (small blind) folded before Flop
Seat 3: Hero (big blind) collected ($0.1)
Seat 4: 2ed01443 folded before Flop (didn't bet)
Seat 5: 779c4822 folded before Flop (didn't bet)
Seat 6: 1e6e5904 folded before Flop (didn't bet)


Poker Hand #RC1468010099: Hold'em No Limit  ($0.05/$0.1) - 2023/04/12 15:58:42
Table 'RushAndCash5525359' 6-max Seat #1 is the button
Seat 1: Hero ($7.41 in chips)
Seat 2: a6b652a4 ($27.49 in chips)
Seat 3: acc98f95 ($23.36 in chips)
Seat 4: 7774e9ed ($11.25 in chips)
Seat 5: 49ac90c ($11.98 in chips)
Seat 6: 6b2fd7cb ($9.49 in chips)
a6b652a4: posts small blind $0.05
acc98f95: posts big blind $0.1
*** HOLE CARDS ***
Dealt to Hero [Ts 5h]
Dealt to a6b652a4 
Dealt to acc98f95 
Dealt to 7774e9ed 
Dealt to 49ac90c 
Dealt to 6b2fd7cb 
7774e9ed: folds
49ac90c: folds
6b2fd7cb: folds
Hero: folds
a6b652a4: raises $0.25 to $0.35
acc98f95: calls $0.25
*** FLOP *** [Ad 6s Kd]
a6b652a4: bets $0.35
acc98f95: calls $0.35
*** TURN *** [Ad 6s Kd] [Tc]
a6b652a4: bets $0.47
acc98f95: calls $0.47
*** RIVER *** [Ad 6s Kd Tc] [9d]
a6b652a4: checks
acc98f95: bets $1.76
a6b652a4: folds
Uncalled bet ($1.76) returned to acc98f95
acc98f95: shows [Td] (Pair of Tens)
*** SHOWDOWN ***
acc98f95 collected $2.23 from pot
*** SUMMARY ***
Total pot $2.34 | Rake $0.11 | Jackpot $0 | Bingo $0 | Fortune $0
Board [Ad 6s Kd Tc 9d]
Seat 1: Hero (button) folded before Flop (didn't bet)
Seat 2: a6b652a4 (small blind) folded on the River
Seat 3: acc98f95 (big blind) showed [Td Qs] and won ($2.23) with Pair of Tens
Seat 4: 7774e9ed folded before Flop (didn't bet)
Seat 5: 49ac90c folded before Flop (didn't bet)
Seat 6: 6b2fd7cb folded before Flop (didn't bet)


Poker Hand #RC1468009776: Hold'em No Limit  ($0.05/$0.1) - 2023/04/12 15:58:03
Table 'RushAndCash5525036' 6-max Seat #1 is the button
Seat 1: e8dd0f9b ($10.64 in chips)
Seat 2: c9683944 ($10 in chips)
Seat 3: a6b652a4 ($27.74 in chips)
Seat 4: bc42c2ac ($23.21 in chips)
Seat 5: Hero ($7.13 in chips)
Seat 6: ee16cd70 ($9.72 in chips)
c9683944: posts small blind $0.05
a6b652a4: posts big blind $0.1
*** HOLE CARDS ***
Dealt to e8dd0f9b 
Dealt to c9683944 
Dealt to a6b652a4 
Dealt to bc42c2ac 
Dealt to Hero [Kc Jd]
Dealt to ee16cd70 
bc42c2ac: folds
Hero: raises $0.15 to $0.25
ee16cd70: folds
e8dd0f9b: folds
c9683944: folds
a6b652a4: calls $0.15
*** FLOP *** [5c Jh Th]
a6b652a4: checks
Hero: bets $0.28
a6b652a4: folds
Uncalled bet ($0.28) returned to Hero
*** SHOWDOWN ***
Hero collected $0.53 from pot
*** SUMMARY ***
Total pot $0.55 | Rake $0.02 | Jackpot $0 | Bingo $0 | Fortune $0
Board [5c Jh Th]
Seat 1: e8dd0f9b (button) folded before Flop (didn't bet)
Seat 2: c9683944 (small blind) folded before Flop
Seat 3: a6b652a4 (big blind) folded on the Flop
Seat 4: bc42c2ac folded before Flop (didn't bet)
Seat 5: Hero won ($0.53)
Seat 6: ee16cd70 folded before Flop (didn't bet)


Poker Hand #RC1468009225: Hold'em No Limit  ($0.05/$0.1) - 2023/04/12 15:56:56
Table 'RushAndCash5524485' 6-max Seat #1 is the button
Seat 1: dca37b1a ($8.63 in chips)
Seat 2: c71f0439 ($10 in chips)
Seat 3: ee16cd70 ($10.14 in chips)
Seat 4: a6b652a4 ($26.91 in chips)
Seat 5: 697a403b ($11.03 in chips)
Seat 6: Hero ($7.55 in chips)
c71f0439: posts small blind $0.05
ee16cd70: posts big blind $0.1
*** HOLE CARDS ***
Dealt to dca37b1a 
Dealt to c71f0439 
Dealt to ee16cd70 
Dealt to a6b652a4 
Dealt to 697a403b 
Dealt to Hero [6c 6d]
a6b652a4: raises $0.1 to $0.2
697a403b: folds
Hero: calls $0.2
dca37b1a: folds
c71f0439: folds
ee16cd70: calls $0.1
*** FLOP *** [2d Qd 5h]
ee16cd70: checks
a6b652a4: bets $0.22
Hero: calls $0.22
ee16cd70: calls $0.22
*** TURN *** [2d Qd 5h] [3s]
ee16cd70: checks
a6b652a4: checks
Hero: checks
*** RIVER *** [2d Qd 5h 3s] [5d]
ee16cd70: checks
a6b652a4: bets $0.99
Hero: folds
ee16cd70: folds
Uncalled bet ($0.99) returned to a6b652a4
*** SHOWDOWN ***
a6b652a4 collected $1.25 from pot
*** SUMMARY ***
Total pot $1.31 | Rake $0.06 | Jackpot $0 | Bingo $0 | Fortune $0
Board [2d Qd 5h 3s 5d]
Seat 1: dca37b1a (button) folded before Flop (didn't bet)
Seat 2: c71f0439 (small blind) folded before Flop
Seat 3: ee16cd70 (big blind) folded on the River
Seat 4: a6b652a4 won ($1.25)
Seat 5: 697a403b folded before Flop (didn't bet)
Seat 6: Hero folded on the River


Poker Hand #RC1468009078: Hold'em No Limit  ($0.05/$0.1) - 2023/04/12 15:56:38
Table 'RushAndCash5524338' 6-max Seat #1 is the button
Seat 1: 4ad7a460 ($15.25 in chips)
Seat 2: Hero ($7.45 in chips)
Seat 3: 6e60c14e ($12.01 in chips)
Seat 4: 7234e68a ($15.49 in chips)
Seat 5: 285693dc ($10.09 in chips)
Seat 6: fc29cdac ($20.82 in chips)
Hero: posts small blind $0.05
6e60c14e: posts big blind $0.1
*** HOLE CARDS ***
Dealt to 4ad7a460 
Dealt to Hero [7d 8s]
Dealt to 6e60c14e 
Dealt to 7234e68a 
Dealt to 285693dc 
Dealt to fc29cdac 
7234e68a: folds
285693dc: folds
fc29cdac: folds
4ad7a460: folds
Hero: raises $0.2 to $0.3
6e60c14e: folds
Uncalled bet ($0.2) returned to Hero
*** SHOWDOWN ***
Hero collected $0.2 from pot
*** SUMMARY ***
Total pot $0.2 | Rake $0 | Jackpot $0 | Bingo $0 | Fortune $0
Seat 1: 4ad7a460 (button) folded before Flop (didn't bet)
Seat 2: Hero (small blind) collected ($0.2)
Seat 3: 6e60c14e (big blind) folded before Flop
Seat 4: 7234e68a folded before Flop (didn't bet)
Seat 5: 285693dc folded before Flop (didn't bet)
Seat 6: fc29cdac folded before Flop (didn't bet)


Poker Hand #RC1468009041: Hold'em No Limit  ($0.05/$0.1) - 2023/04/12 15:56:34
Table 'RushAndCash5524301' 6-max Seat #1 is the button
Seat 1: aa8e8074 ($12.14 in chips)
Seat 2: cfc7976a ($18.01 in chips)
Seat 3: f6cf9606 ($14.27 in chips)
Seat 4: de214bb ($16.41 in chips)
Seat 5: Hero ($7.45 in chips)
Seat 6: e18d44d ($9.34 in chips)
cfc7976a: posts small blind $0.05
f6cf9606: posts big blind $0.1
*** HOLE CARDS ***
Dealt to aa8e8074 
Dealt to cfc7976a 
Dealt to f6cf9606 
Dealt to de214bb 
Dealt to Hero [Qd 7c]
Dealt to e18d44d 
de214bb: folds
Hero: folds
e18d44d: folds
aa8e8074: raises $0.15 to $0.25
cfc7976a: folds
f6cf9606: calls $0.15
*** FLOP *** [2h Ad Jc]
f6cf9606: checks
aa8e8074: bets $0.2
f6cf9606: calls $0.2
*** TURN *** [2h Ad Jc] [Jh]
f6cf9606: checks
aa8e8074: checks
*** RIVER *** [2h Ad Jc Jh] [Td]
f6cf9606: checks
aa8e8074: checks
f6cf9606: shows [5s Ah] (Pair of Aces and Pair of Jacks)
aa8e8074: shows [8s Ac] (Pair of Aces and Pair of Jacks)
*** SHOWDOWN ***
f6cf9606 collected $0.46 from pot
aa8e8074 collected $0.45 from pot
*** SUMMARY ***
Total pot $0.95 | Rake $0.04 | Jackpot $0 | Bingo $0 | Fortune $0
Board [2h Ad Jc Jh Td]
Seat 1: aa8e8074 (button) showed [8s Ac] and won ($0.45) with Pair of Aces and Pair of Jacks
Seat 2: cfc7976a (small blind) folded before Flop
Seat 3: f6cf9606 (big blind) showed [5s Ah] and won ($0.46) with Pair of Aces and Pair of Jacks
Seat 4: de214bb folded before Flop (didn't bet)
Seat 5: Hero folded before Flop (didn't bet)
Seat 6: e18d44d folded before Flop (didn't bet)


Poker Hand #RC1468008979: Hold'em No Limit  ($0.05/$0.1) - 2023/04/12 15:56:27
Table 'RushAndCash5524239' 6-max Seat #1 is the button
Seat 1: 6a7b2285 ($18.92 in chips)
Seat 2: 34ea15d7 ($13.56 in chips)
Seat 3: bd80a89b ($17.08 in chips)
Seat 4: 97ae1911 ($10.99 in chips)
Seat 5: Hero ($7.45 in chips)
Seat 6: b29d650 ($10 in chips)
34ea15d7: posts small blind $0.05
bd80a89b: posts big blind $0.1
*** HOLE CARDS ***
Dealt to 6a7b2285 
Dealt to 34ea15d7 
Dealt to bd80a89b 
Dealt to 97ae1911 
Dealt to Hero [Tc 2s]
Dealt to b29d650 
97ae1911: folds
Hero: folds
b29d650: folds
6a7b2285: raises $0.15 to $0.25
34ea15d7: folds
bd80a89b: calls $0.15
*** FLOP *** [2h Qc 2d]
bd80a89b: checks
6a7b2285: bets $0.28
bd80a89b: folds
Uncalled bet ($0.28) returned to 6a7b2285
*** SHOWDOWN ***
6a7b2285 collected $0.53 from pot
*** SUMMARY ***
Total pot $0.55 | Rake $0.02 | Jackpot $0 | Bingo $0 | Fortune $0
Board [2h Qc 2d]
Seat 1: 6a7b2285 (button) won ($0.53)
Seat 2: 34ea15d7 (small blind) folded before Flop
Seat 3: bd80a89b (big blind) folded on the Flop
Seat 4: 97ae1911 folded before Flop (didn't bet)
Seat 5: Hero folded before Flop (didn't bet)
Seat 6: b29d650 folded before Flop (didn't bet)


Poker Hand #RC1468008581: Hold'em No Limit  ($0.05/$0.1) - 2023/04/12 15:55:40
Table 'RushAndCash5523841' 6-max Seat #1 is the button
Seat 1: d5330762 ($11.78 in chips)
Seat 2: 538ec9b7 ($11.73 in chips)
Seat 3: Hero ($8.45 in chips)
Seat 4: 5381d055 ($10.59 in chips)
Seat 5: 83a73178 ($11.9 in chips)
Seat 6: 8c84d365 ($21.78 in chips)
538ec9b7: posts small blind $0.05
Hero: posts big blind $0.1
*** HOLE CARDS ***
Dealt to d5330762 
Dealt to 538ec9b7 
Dealt to Hero [9c Kd]
Dealt to 5381d055 
Dealt to 83a73178 
Dealt to 8c84d365 
5381d055: folds
83a73178: folds
8c84d365: folds
d5330762: folds
538ec9b7: raises $0.2 to $0.3
Hero: calls $0.2
*** FLOP *** [5s Kc 5d]
538ec9b7: bets $0.2
Hero: calls $0.2
*** TURN *** [5s Kc 5d] [As]
538ec9b7: checks
Hero: checks
*** RIVER *** [5s Kc 5d As] [7s]
538ec9b7: bets $0.5
Hero: calls $0.5
538ec9b7: shows [6d Ad] (Pair of Aces and Pair of Fives)
Hero: shows [9c Kd] (Pair of Kings and Pair of Fives)
*** SHOWDOWN ***
538ec9b7 collected $1.9 from pot
*** SUMMARY ***
Total pot $2 | Rake $0.1 | Jackpot $0 | Bingo $0 | Fortune $0
Board [5s Kc 5d As 7s]
Seat 1: d5330762 (button) folded before Flop (didn't bet)
Seat 2: 538ec9b7 (small blind) showed [6d Ad] and won ($1.9) with Pair of Aces and Pair of Fives
Seat 3: Hero (big blind) showed [9c Kd] and lost with Pair of Kings and Pair of Fives
Seat 4: 5381d055 folded before Flop (didn't bet)
Seat 5: 83a73178 folded before Flop (didn't bet)
Seat 6: 8c84d365 folded before Flop (didn't bet)


Poker Hand #RC1468008539: Hold'em No Limit  ($0.05/$0.1) - 2023/04/12 15:55:35
Table 'RushAndCash5523799' 6-max Seat #1 is the button
Seat 1: Hero ($8.45 in chips)
Seat 2: d5330762 ($11.83 in chips)
Seat 3: d6d3bfc9 ($10 in chips)
Seat 4: 37bc01f ($8.45 in chips)
Seat 5: a41754d0 ($16 in chips)
Seat 6: 12da46de ($20.63 in chips)
d5330762: posts small blind $0.05
d6d3bfc9: posts big blind $0.1
*** HOLE CARDS ***
Dealt to Hero [Ac 6h]
Dealt to d5330762 
Dealt to d6d3bfc9 
Dealt to 37bc01f 
Dealt to a41754d0 
Dealt to 12da46de 
37bc01f: folds
a41754d0: folds
12da46de: raises $0.15 to $0.25
Hero: folds
d5330762: folds
d6d3bfc9: folds
Uncalled bet ($0.15) returned to 12da46de
*** SHOWDOWN ***
12da46de collected $0.25 from pot
*** SUMMARY ***
Total pot $0.25 | Rake $0 | Jackpot $0 | Bingo $0 | Fortune $0
Seat 1: Hero (button) folded before Flop (didn't bet)
Seat 2: d5330762 (small blind) folded before Flop
Seat 3: d6d3bfc9 (big blind) folded before Flop
Seat 4: 37bc01f folded before Flop (didn't bet)
Seat 5: a41754d0 folded before Flop (didn't bet)
Seat 6: 12da46de collected ($0.25)


Poker Hand #RC1468008436: Hold'em No Limit  ($0.05/$0.1) - 2023/04/12 15:55:23
Table 'RushAndCash5523696' 6-max Seat #1 is the button
Seat 1: 96cfdf8b ($15.09 in chips)
Seat 2: Hero ($8.5 in chips)
Seat 3: 6372d866 ($12.52 in chips)
Seat 4: 59fe0d64 ($12.28 in chips)
Seat 5: 15793975 ($16.71 in chips)
Seat 6: 49f98d57 ($10.79 in chips)
Hero: posts small blind $0.05
6372d866: posts big blind $0.1
*** HOLE CARDS ***
Dealt to 96cfdf8b 
Dealt to Hero [6s 8s]
Dealt to 6372d866 
Dealt to 59fe0d64 
Dealt to 15793975 
Dealt to 49f98d57 
59fe0d64: folds
15793975: folds
49f98d57: folds
96cfdf8b: raises $0.12 to $0.22
Hero: folds
6372d866: folds
Uncalled bet ($0.12) returned to 96cfdf8b
*** SHOWDOWN ***
96cfdf8b collected $0.25 from pot
*** SUMMARY ***
Total pot $0.25 | Rake $0 | Jackpot $0 | Bingo $0 | Fortune $0
Seat 1: 96cfdf8b (button) collected ($0.25)
Seat 2: Hero (small blind) folded before Flop
Seat 3: 6372d866 (big blind) folded before Flop
Seat 4: 59fe0d64 folded before Flop (didn't bet)
Seat 5: 15793975 folded before Flop (didn't bet)
Seat 6: 49f98d57 folded before Flop (didn't bet)


Poker Hand #RC1468008389: Hold'em No Limit  ($0.05/$0.1) - 2023/04/12 15:55:18
Table 'RushAndCash5523649' 6-max Seat #1 is the button
Seat 1: 4a95f8f6 ($11.63 in chips)
Seat 2: 51ac1b2b ($10 in chips)
Seat 3: 464a920b ($10.91 in chips)
Seat 4: 36206684 ($9.48 in chips)
Seat 5: Hero ($8.5 in chips)
Seat 6: 3b3d664e ($10.86 in chips)
51ac1b2b: posts small blind $0.05
464a920b: posts big blind $0.1
*** HOLE CARDS ***
Dealt to 4a95f8f6 
Dealt to 51ac1b2b 
Dealt to 464a920b 
Dealt to 36206684 
Dealt to Hero [9s 4d]
Dealt to 3b3d664e 
36206684: raises $0.2 to $0.3
Hero: folds
3b3d664e: folds
4a95f8f6: folds
51ac1b2b: folds
464a920b: folds
Uncalled bet ($0.2) returned to 36206684
*** SHOWDOWN ***
36206684 collected $0.25 from pot
*** SUMMARY ***
Total pot $0.25 | Rake $0 | Jackpot $0 | Bingo $0 | Fortune $0
Seat 1: 4a95f8f6 (button) folded before Flop (didn't bet)
Seat 2: 51ac1b2b (small blind) folded before Flop
Seat 3: 464a920b (big blind) folded before Flop
Seat 4: 36206684 collected ($0.25)
Seat 5: Hero folded before Flop (didn't bet)
Seat 6: 3b3d664e folded before Flop (didn't bet)


Poker Hand #RC1468008353: Hold'em No Limit  ($0.05/$0.1) - 2023/04/12 15:55:14
Table 'RushAndCash5523613' 6-max Seat #1 is the button
Seat 1: 3b5f429d ($12.46 in chips)
Seat 2: f0603828 ($7.45 in chips)
Seat 3: 936e20d7 ($26 in chips)
Seat 4: Hero ($8.5 in chips)
Seat 5: 935420cf ($25.14 in chips)
Seat 6: 67313548 ($10 in chips)
f0603828: posts small blind $0.05
936e20d7: posts big blind $0.1
*** HOLE CARDS ***
Dealt to 3b5f429d 
Dealt to f0603828 
Dealt to 936e20d7 
Dealt to Hero [8d Ks]
Dealt to 935420cf 
Dealt to 67313548 
Hero: folds
935420cf: folds
67313548: folds
3b5f429d: folds
f0603828: raises $0.2 to $0.3
936e20d7: raises $0.6 to $0.9
f0603828: raises $6.55 to $7.45 and is all-in
936e20d7: folds
Uncalled bet ($6.55) returned to f0603828
*** SHOWDOWN ***
f0603828 collected $1.71 from pot
*** SUMMARY ***
Total pot $1.8 | Rake $0.09 | Jackpot $0 | Bingo $0 | Fortune $0
Seat 1: 3b5f429d (button) folded before Flop (didn't bet)
Seat 2: f0603828 (small blind) collected ($1.71)
Seat 3: 936e20d7 (big blind) folded before Flop
Seat 4: Hero folded before Flop (didn't bet)
Seat 5: 935420cf folded before Flop (didn't bet)
Seat 6: 67313548 folded before Flop (didn't bet)


Poker Hand #RC1468008084: Hold'em No Limit  ($0.05/$0.1) - 2023/04/12 15:54:43
Table 'RushAndCash5523344' 6-max Seat #1 is the button
Seat 1: c5cf0f37 ($16 in chips)
Seat 2: 9264936a ($14.13 in chips)
Seat 3: 3bc9f7ca ($16.3 in chips)
Seat 4: 2200675c ($3.41 in chips)
Seat 5: 550757ca ($10.15 in chips)
Seat 6: Hero ($8.75 in chips)
9264936a: posts small blind $0.05
3bc9f7ca: posts big blind $0.1
*** HOLE CARDS ***
Dealt to c5cf0f37 
Dealt to 9264936a 
Dealt to 3bc9f7ca 
Dealt to 2200675c 
Dealt to 550757ca 
Dealt to Hero [Th Jh]
2200675c: folds
550757ca: raises $0.15 to $0.25
Hero: calls $0.25
c5cf0f37: raises $0.95 to $1.2
9264936a: folds
3bc9f7ca: folds
550757ca: raises $1.15 to $2.35
Hero: folds
c5cf0f37: raises $13.65 to $16 and is all-in
550757ca: calls $7.8 and is all-in
Uncalled bet ($5.85) returned to c5cf0f37
c5cf0f37: shows [Qc Qs]
550757ca: shows [Kh Ks]
*** FLOP *** [Ts 8d 2h]
*** TURN *** [Ts 8d 2h] [Qd]
c5cf0f37: Chooses to EV Cashout 
*** RIVER *** [Ts 8d 2h Qd] [7h]
c5cf0f37: Pays Cashout Risk ($1.13)
*** SHOWDOWN ***
c5cf0f37 collected $20.25 from pot
*** SUMMARY ***
Total pot $20.7 | Rake $0.3 | Jackpot $0.15 | Bingo $0 | Fortune $0
Board [Ts 8d 2h Qd 7h]
Seat 1: c5cf0f37 (button) showed [Qc Qs] and won ($20.25) with Three Queens, Cashout Risk ($1.13)
Seat 2: 9264936a (small blind) folded before Flop
Seat 3: 3bc9f7ca (big blind) folded before Flop
Seat 4: 2200675c folded before Flop (didn't bet)
Seat 5: 550757ca showed [Kh Ks] and lost with Pair of Kings
Seat 6: Hero folded before Flop


Poker Hand #RC1468007660: Hold'em No Limit  ($0.05/$0.1) - 2023/04/12 15:53:53
Table 'RushAndCash5522920' 6-max Seat #1 is the button
Seat 1: 1b1b34c ($11.82 in chips)
Seat 2: Hero ($10.2 in chips)
Seat 3: 847543a9 ($57.05 in chips)
Seat 4: 6717051b ($5.86 in chips)
Seat 5: 149d493f ($3.02 in chips)
Seat 6: 3bc9f7ca ($15.04 in chips)
Hero: posts small blind $0.05
847543a9: posts big blind $0.1
*** HOLE CARDS ***
Dealt to 1b1b34c 
Dealt to Hero [Ah 4h]
Dealt to 847543a9 
Dealt to 6717051b 
Dealt to 149d493f 
Dealt to 3bc9f7ca 
6717051b: folds
149d493f: folds
3bc9f7ca: raises $0.15 to $0.25
1b1b34c: folds
Hero: calls $0.2
847543a9: folds
*** FLOP *** [Ac Ts Jh]
Hero: bets $0.45
3bc9f7ca: calls $0.45
*** TURN *** [Ac Ts Jh] [As]
Hero: checks
3bc9f7ca: checks
*** RIVER *** [Ac Ts Jh As] [Kd]
Hero: checks
3bc9f7ca: bets $0.75
Hero: calls $0.75
3bc9f7ca: shows [Qc Tc] (Aces-High Straight)
Hero: shows [Ah 4h] (Three Aces)
*** SHOWDOWN ***
3bc9f7ca collected $2.71 from pot
*** SUMMARY ***
Total pot $3 | Rake $0.14 | Jackpot $0.15 | Bingo $0 | Fortune $0
Board [Ac Ts Jh As Kd]
Seat 1: 1b1b34c (button) folded before Flop (didn't bet)
Seat 2: Hero (small blind) showed [Ah 4h] and lost with Three Aces
Seat 3: 847543a9 (big blind) folded before Flop
Seat 4: 6717051b folded before Flop (didn't bet)
Seat 5: 149d493f folded before Flop (didn't bet)
Seat 6: 3bc9f7ca showed [Qc Tc] and won ($2.71) with Aces-High Straight


Poker Hand #RC1468007546: Hold'em No Limit  ($0.05/$0.1) - 2023/04/12 15:53:40
Table 'RushAndCash5522806' 6-max Seat #1 is the button
Seat 1: 910eaedd ($10.83 in chips)
Seat 2: cf1e2de9 ($13.03 in chips)
Seat 3: Hero ($10.3 in chips)
Seat 4: c2a2cb2e ($33.8 in chips)
Seat 5: 1fac3333 ($12.84 in chips)
Seat 6: 550757ca ($10.33 in chips)
cf1e2de9: posts small blind $0.05
Hero: posts big blind $0.1
*** HOLE CARDS ***
Dealt to 910eaedd 
Dealt to cf1e2de9 
Dealt to Hero [Ks 8d]
Dealt to c2a2cb2e 
Dealt to 1fac3333 
Dealt to 550757ca 
c2a2cb2e: folds
1fac3333: raises $0.15 to $0.25
550757ca: folds
910eaedd: folds
cf1e2de9: folds
Hero: folds
Uncalled bet ($0.15) returned to 1fac3333
*** SHOWDOWN ***
1fac3333 collected $0.25 from pot
*** SUMMARY ***
Total pot $0.25 | Rake $0 | Jackpot $0 | Bingo $0 | Fortune $0
Seat 1: 910eaedd (button) folded before Flop (didn't bet)
Seat 2: cf1e2de9 (small blind) folded before Flop
Seat 3: Hero (big blind) folded before Flop
Seat 4: c2a2cb2e folded before Flop (didn't bet)
Seat 5: 1fac3333 collected ($0.25)
Seat 6: 550757ca folded before Flop (didn't bet)


Poker Hand #RC1468007499: Hold'em No Limit  ($0.05/$0.1) - 2023/04/12 15:53:35
Table 'RushAndCash5522759' 6-max Seat #1 is the button
Seat 1: 82c9ee00 ($9.92 in chips)
Seat 2: e22e1fa0 ($11.67 in chips)
Seat 3: a39d28e4 ($15.01 in chips)
Seat 4: b5d2bed4 ($10.15 in chips)
Seat 5: 9966b88a ($10.97 in chips)
Seat 6: Hero ($10.3 in chips)
e22e1fa0: posts small blind $0.05
a39d28e4: posts big blind $0.1
*** HOLE CARDS ***
Dealt to 82c9ee00 
Dealt to e22e1fa0 
Dealt to a39d28e4 
Dealt to b5d2bed4 
Dealt to 9966b88a 
Dealt to Hero [2d 5h]
b5d2bed4: folds
9966b88a: folds
Hero: folds
82c9ee00: folds
e22e1fa0: raises $0.2 to $0.3
a39d28e4: folds
Uncalled bet ($0.2) returned to e22e1fa0
*** SHOWDOWN ***
e22e1fa0 collected $0.2 from pot
*** SUMMARY ***
Total pot $0.2 | Rake $0 | Jackpot $0 | Bingo $0 | Fortune $0
Seat 1: 82c9ee00 (button) folded before Flop (didn't bet)
Seat 2: e22e1fa0 (small blind) collected ($0.2)
Seat 3: a39d28e4 (big blind) folded before Flop
Seat 4: b5d2bed4 folded before Flop (didn't bet)
Seat 5: 9966b88a folded before Flop (didn't bet)
Seat 6: Hero folded before Flop (didn't bet)


Poker Hand #RC1468007416: Hold'em No Limit  ($0.05/$0.1) - 2023/04/12 15:53:25
Table 'RushAndCash5522676' 6-max Seat #1 is the button
Seat 1: Hero ($10.3 in chips)
Seat 2: 6372d866 ($12.49 in chips)
Seat 3: 314da29d ($10 in chips)
Seat 4: 9df7f473 ($12.5 in chips)
Seat 5: dc57ea9e ($27.26 in chips)
Seat 6: 67691183 ($12.19 in chips)
6372d866: posts small blind $0.05
314da29d: posts big blind $0.1
*** HOLE CARDS ***
Dealt to Hero [7s 5d]
Dealt to 6372d866 
Dealt to 314da29d 
Dealt to 9df7f473 
Dealt to dc57ea9e 
Dealt to 67691183 
9df7f473: folds
dc57ea9e: raises $0.1 to $0.2
67691183: folds
Hero: folds
6372d866: folds
314da29d: folds
Uncalled bet ($0.1) returned to dc57ea9e
*** SHOWDOWN ***
dc57ea9e collected $0.25 from pot
*** SUMMARY ***
Total pot $0.25 | Rake $0 | Jackpot $0 | Bingo $0 | Fortune $0
Seat 1: Hero (button) folded before Flop (didn't bet)
Seat 2: 6372d866 (small blind) folded before Flop
Seat 3: 314da29d (big blind) folded before Flop
Seat 4: 9df7f473 folded before Flop (didn't bet)
Seat 5: dc57ea9e collected ($0.25)
Seat 6: 67691183 folded before Flop (didn't bet)


Poker Hand #RC1468007363: Hold'em No Limit  ($0.05/$0.1) - 2023/04/12 15:53:19
Table 'RushAndCash5522623' 6-max Seat #1 is the button
Seat 1: 1475e8f0 ($14.64 in chips)
Seat 2: 2fb79acf ($9.85 in chips)
Seat 3: cacb386 ($11.81 in chips)
Seat 4: 4c1c668b ($10.35 in chips)
Seat 5: Hero ($10.3 in chips)
Seat 6: ffbe1a45 ($10.57 in chips)
2fb79acf: posts small blind $0.05
cacb386: posts big blind $0.1
*** HOLE CARDS ***
Dealt to 1475e8f0 
Dealt to 2fb79acf 
Dealt to cacb386 
Dealt to 4c1c668b 
Dealt to Hero [4h Ts]
Dealt to ffbe1a45 
4c1c668b: folds
Hero: folds
ffbe1a45: folds
1475e8f0: folds
2fb79acf: folds
Uncalled bet ($0.05) returned to cacb386
*** SHOWDOWN ***
cacb386 collected $0.1 from pot
*** SUMMARY ***
Total pot $0.1 | Rake $0 | Jackpot $0 | Bingo $0 | Fortune $0
Seat 1: 1475e8f0 (button) folded before Flop (didn't bet)
Seat 2: 2fb79acf (small blind) folded before Flop
Seat 3: cacb386 (big blind) collected ($0.1)
Seat 4: 4c1c668b folded before Flop (didn't bet)
Seat 5: Hero folded before Flop (didn't bet)
Seat 6: ffbe1a45 folded before Flop (didn't bet)


Poker Hand #RC1468007282: Hold'em No Limit  ($0.05/$0.1) - 2023/04/12 15:53:10
Table 'RushAndCash5522542' 6-max Seat #1 is the button
Seat 1: 6b2fd7cb ($9.84 in chips)
Seat 2: 299bca27 ($41.7 in chips)
Seat 3: 4ba30345 ($20.61 in chips)
Seat 4: Hero ($10.3 in chips)
Seat 5: 8317b47c ($14.6 in chips)
Seat 6: 3d9dd182 ($14.02 in chips)
299bca27: posts small blind $0.05
4ba30345: posts big blind $0.1
*** HOLE CARDS ***
Dealt to 6b2fd7cb 
Dealt to 299bca27 
Dealt to 4ba30345 
Dealt to Hero [Js 4d]
Dealt to 8317b47c 
Dealt to 3d9dd182 
Hero: folds
8317b47c: folds
3d9dd182: folds
6b2fd7cb: folds
299bca27: folds
Uncalled bet ($0.05) returned to 4ba30345
*** SHOWDOWN ***
4ba30345 collected $0.1 from pot
*** SUMMARY ***
Total pot $0.1 | Rake $0 | Jackpot $0 | Bingo $0 | Fortune $0
Seat 1: 6b2fd7cb (button) folded before Flop (didn't bet)
Seat 2: 299bca27 (small blind) folded before Flop
Seat 3: 4ba30345 (big blind) collected ($0.1)
Seat 4: Hero folded before Flop (didn't bet)
Seat 5: 8317b47c folded before Flop (didn't bet)
Seat 6: 3d9dd182 folded before Flop (didn't bet)


Poker Hand #RC1468007210: Hold'em No Limit  ($0.05/$0.1) - 2023/04/12 15:53:02
Table 'RushAndCash5522470' 6-max Seat #1 is the button
Seat 1: Hero ($10.3 in chips)
Seat 2: 5481297d ($8.05 in chips)
Seat 3: 40e53c25 ($13.6 in chips)
Seat 4: 4df83cef ($10 in chips)
Seat 5: aa024d7e ($12.33 in chips)
Seat 6: 7d88e034 ($12.66 in chips)
5481297d: posts small blind $0.05
40e53c25: posts big blind $0.1
*** HOLE CARDS ***
Dealt to Hero [Jc 7h]
Dealt to 5481297d 
Dealt to 40e53c25 
Dealt to 4df83cef 
Dealt to aa024d7e 
Dealt to 7d88e034 
4df83cef: folds
aa024d7e: raises $0.1 to $0.2
7d88e034: folds
Hero: folds
5481297d: folds
40e53c25: folds
Uncalled bet ($0.1) returned to aa024d7e
*** SHOWDOWN ***
aa024d7e collected $0.25 from pot
*** SUMMARY ***
Total pot $0.25 | Rake $0 | Jackpot $0 | Bingo $0 | Fortune $0
Seat 1: Hero (button) folded before Flop (didn't bet)
Seat 2: 5481297d (small blind) folded before Flop
Seat 3: 40e53c25 (big blind) folded before Flop
Seat 4: 4df83cef folded before Flop (didn't bet)
Seat 5: aa024d7e collected ($0.25)
Seat 6: 7d88e034 folded before Flop (didn't bet)


Poker Hand #RC1468006505: Hold'em No Limit  ($0.05/$0.1) - 2023/04/12 15:51:41
Table 'RushAndCash5521765' 6-max Seat #1 is the button
Seat 1: 6493d175 ($10.38 in chips)
Seat 2: baf82713 ($20.12 in chips)
Seat 3: Hero ($10.02 in chips)
Seat 4: 7dec8cf1 ($10 in chips)
Seat 5: c41e4ca9 ($4.4 in chips)
Seat 6: de214bb ($15.13 in chips)
baf82713: posts small blind $0.05
Hero: posts big blind $0.1
*** HOLE CARDS ***
Dealt to 6493d175 
Dealt to baf82713 
Dealt to Hero [Js Kh]
Dealt to 7dec8cf1 
Dealt to c41e4ca9 
Dealt to de214bb 
7dec8cf1: folds
c41e4ca9: folds
de214bb: raises $0.15 to $0.25
6493d175: folds
baf82713: folds
Hero: calls $0.15
*** FLOP *** [4c Ts 8c]
Hero: checks
de214bb: checks
*** TURN *** [4c Ts 8c] [8s]
Hero: checks
de214bb: checks
*** RIVER *** [4c Ts 8c 8s] [Ks]
Hero: checks
de214bb: checks
Hero: shows [Js Kh] (Pair of Kings and Pair of Eights)
de214bb: shows [4h As] (Pair of Eights and Pair of Fours)
*** SHOWDOWN ***
Hero collected $0.53 from pot
*** SUMMARY ***
Total pot $0.55 | Rake $0.02 | Jackpot $0 | Bingo $0 | Fortune $0
Board [4c Ts 8c 8s Ks]
Seat 1: 6493d175 (button) folded before Flop (didn't bet)
Seat 2: baf82713 (small blind) folded before Flop
Seat 3: Hero (big blind) showed [Js Kh] and won ($0.53) with Pair of Kings and Pair of Eights
Seat 4: 7dec8cf1 folded before Flop (didn't bet)
Seat 5: c41e4ca9 folded before Flop (didn't bet)
Seat 6: de214bb showed [4h As] and lost with Pair of Eights and Pair of Fours


Poker Hand #RC1468006445: Hold'em No Limit  ($0.05/$0.1) - 2023/04/12 15:51:35
Table 'RushAndCash5521705' 6-max Seat #1 is the button
Seat 1: 910eaedd ($11.23 in chips)
Seat 2: Hero ($10.07 in chips)
Seat 3: 53e5bc90 ($11.27 in chips)
Seat 4: 55216799 ($10.05 in chips)
Seat 5: 6372d866 ($12.18 in chips)
Seat 6: 3bc9f7ca ($13.97 in chips)
Hero: posts small blind $0.05
53e5bc90: posts big blind $0.1
*** HOLE CARDS ***
Dealt to 910eaedd 
Dealt to Hero [9c 4c]
Dealt to 53e5bc90 
Dealt to 55216799 
Dealt to 6372d866 
Dealt to 3bc9f7ca 
55216799: folds
6372d866: folds
3bc9f7ca: folds
910eaedd: raises $0.1 to $0.2
Hero: folds
53e5bc90: folds
Uncalled bet ($0.1) returned to 910eaedd
*** SHOWDOWN ***
910eaedd collected $0.25 from pot
*** SUMMARY ***
Total pot $0.25 | Rake $0 | Jackpot $0 | Bingo $0 | Fortune $0
Seat 1: 910eaedd (button) collected ($0.25)
Seat 2: Hero (small blind) folded before Flop
Seat 3: 53e5bc90 (big blind) folded before Flop
Seat 4: 55216799 folded before Flop (didn't bet)
Seat 5: 6372d866 folded before Flop (didn't bet)
Seat 6: 3bc9f7ca folded before Flop (didn't bet)


Poker Hand #RC1468006376: Hold'em No Limit  ($0.05/$0.1) - 2023/04/12 15:51:27
Table 'RushAndCash5521636' 6-max Seat #1 is the button
Seat 1: d0f0dced ($11.13 in chips)
Seat 2: 72910231 ($10.57 in chips)
Seat 3: 93e2eddd ($4 in chips)
Seat 4: 9fd526ef ($16.2 in chips)
Seat 5: f7c00497 ($33.51 in chips)
Seat 6: Hero ($10.07 in chips)
72910231: posts small blind $0.05
93e2eddd: posts big blind $0.1
*** HOLE CARDS ***
Dealt to d0f0dced 
Dealt to 72910231 
Dealt to 93e2eddd 
Dealt to 9fd526ef 
Dealt to f7c00497 
Dealt to Hero [8c Th]
9fd526ef: folds
f7c00497: folds
Hero: folds
d0f0dced: raises $0.15 to $0.25
72910231: folds
93e2eddd: calls $0.15
*** FLOP *** [2h Kd Kh]
93e2eddd: checks
d0f0dced: bets $0.19
93e2eddd: folds
Uncalled bet ($0.19) returned to d0f0dced
*** SHOWDOWN ***
d0f0dced collected $0.53 from pot
*** SUMMARY ***
Total pot $0.55 | Rake $0.02 | Jackpot $0 | Bingo $0 | Fortune $0
Board [2h Kd Kh]
Seat 1: d0f0dced (button) won ($0.53)
Seat 2: 72910231 (small blind) folded before Flop
Seat 3: 93e2eddd (big blind) folded on the Flop
Seat 4: 9fd526ef folded before Flop (didn't bet)
Seat 5: f7c00497 folded before Flop (didn't bet)
Seat 6: Hero folded before Flop (didn't bet)


Poker Hand #RC1468006295: Hold'em No Limit  ($0.05/$0.1) - 2023/04/12 15:51:18
Table 'RushAndCash5521555' 6-max Seat #1 is the button
Seat 1: 1f4b8b1e ($10.2 in chips)
Seat 2: b78e78d0 ($14.36 in chips)
Seat 3: aed826cb ($11.35 in chips)
Seat 4: Hero ($10.07 in chips)
Seat 5: 6aedbdfc ($10.38 in chips)
Seat 6: bc29b78b ($10.37 in chips)
b78e78d0: posts small blind $0.05
aed826cb: posts big blind $0.1
*** HOLE CARDS ***
Dealt to 1f4b8b1e 
Dealt to b78e78d0 
Dealt to aed826cb 
Dealt to Hero [Ks 6c]
Dealt to 6aedbdfc 
Dealt to bc29b78b 
Hero: folds
6aedbdfc: folds
bc29b78b: folds
1f4b8b1e: folds
b78e78d0: folds
Uncalled bet ($0.05) returned to aed826cb
*** SHOWDOWN ***
aed826cb collected $0.1 from pot
*** SUMMARY ***
Total pot $0.1 | Rake $0 | Jackpot $0 | Bingo $0 | Fortune $0
Seat 1: 1f4b8b1e (button) folded before Flop (didn't bet)
Seat 2: b78e78d0 (small blind) folded before Flop
Seat 3: aed826cb (big blind) collected ($0.1)
Seat 4: Hero folded before Flop (didn't bet)
Seat 5: 6aedbdfc folded before Flop (didn't bet)
Seat 6: bc29b78b folded before Flop (didn't bet)


Poker Hand #RC1468006250: Hold'em No Limit  ($0.05/$0.1) - 2023/04/12 15:51:13
Table 'RushAndCash5521510' 6-max Seat #1 is the button
Seat 1: 4f324fbc ($10.69 in chips)
Seat 2: 51a302c9 ($12.19 in chips)
Seat 3: 3fd47639 ($5.01 in chips)
Seat 4: Hero ($10.07 in chips)
Seat 5: 2fb79acf ($9.95 in chips)
Seat 6: b969b8ec ($14.14 in chips)
51a302c9: posts small blind $0.05
3fd47639: posts big blind $0.1
*** HOLE CARDS ***
Dealt to 4f324fbc 
Dealt to 51a302c9 
Dealt to 3fd47639 
Dealt to Hero [4c 6h]
Dealt to 2fb79acf 
Dealt to b969b8ec 
Hero: folds
2fb79acf: folds
b969b8ec: folds
4f324fbc: folds
51a302c9: folds
Uncalled bet ($0.05) returned to 3fd47639
*** SHOWDOWN ***
3fd47639 collected $0.1 from pot
*** SUMMARY ***
Total pot $0.1 | Rake $0 | Jackpot $0 | Bingo $0 | Fortune $0
Seat 1: 4f324fbc (button) folded before Flop (didn't bet)
Seat 2: 51a302c9 (small blind) folded before Flop
Seat 3: 3fd47639 (big blind) collected ($0.1)
Seat 4: Hero folded before Flop (didn't bet)
Seat 5: 2fb79acf folded before Flop (didn't bet)
Seat 6: b969b8ec folded before Flop (didn't bet)


Poker Hand #RC1468006117: Hold'em No Limit  ($0.05/$0.1) - 2023/04/12 15:50:58
Table 'RushAndCash5521377' 6-max Seat #1 is the button
Seat 1: ecd5efd7 ($11.32 in chips)
Seat 2: e57f93b7 ($10.83 in chips)
Seat 3: 274f71d9 ($12.36 in chips)
Seat 4: d8c6a667 ($9.57 in chips)
Seat 5: fc64a2f6 ($11.84 in chips)
Seat 6: Hero ($9.92 in chips)
e57f93b7: posts small blind $0.05
274f71d9: posts big blind $0.1
*** HOLE CARDS ***
Dealt to ecd5efd7 
Dealt to e57f93b7 
Dealt to 274f71d9 
Dealt to d8c6a667 
Dealt to fc64a2f6 
Dealt to Hero [3c 4c]
d8c6a667: folds
fc64a2f6: folds
Hero: raises $0.1 to $0.2
ecd5efd7: folds
e57f93b7: folds
274f71d9: folds
Uncalled bet ($0.1) returned to Hero
*** SHOWDOWN ***
Hero collected $0.25 from pot
*** SUMMARY ***
Total pot $0.25 | Rake $0 | Jackpot $0 | Bingo $0 | Fortune $0
Seat 1: ecd5efd7 (button) folded before Flop (didn't bet)
Seat 2: e57f93b7 (small blind) folded before Flop
Seat 3: 274f71d9 (big blind) folded before Flop
Seat 4: d8c6a667 folded before Flop (didn't bet)
Seat 5: fc64a2f6 folded before Flop (didn't bet)
Seat 6: Hero collected ($0.25)


Poker Hand #RC1468006072: Hold'em No Limit  ($0.05/$0.1) - 2023/04/12 15:50:53
Table 'RushAndCash5521332' 6-max Seat #1 is the button
Seat 1: 85c60eca ($10.28 in chips)
Seat 2: 6b2fd7cb ($9 in chips)
Seat 3: 82abcad3 ($3.32 in chips)
Seat 4: Hero ($9.92 in chips)
Seat 5: 238619eb ($15.23 in chips)
Seat 6: cea019e6 ($11.85 in chips)
6b2fd7cb: posts small blind $0.05
82abcad3: posts big blind $0.1
*** HOLE CARDS ***
Dealt to 85c60eca 
Dealt to 6b2fd7cb 
Dealt to 82abcad3 
Dealt to Hero [9s 4s]
Dealt to 238619eb 
Dealt to cea019e6 
Hero: folds
238619eb: folds
cea019e6: folds
85c60eca: folds
6b2fd7cb: folds
Uncalled bet ($0.05) returned to 82abcad3
*** SHOWDOWN ***
82abcad3 collected $0.1 from pot
*** SUMMARY ***
Total pot $0.1 | Rake $0 | Jackpot $0 | Bingo $0 | Fortune $0
Seat 1: 85c60eca (button) folded before Flop (didn't bet)
Seat 2: 6b2fd7cb (small blind) folded before Flop
Seat 3: 82abcad3 (big blind) collected ($0.1)
Seat 4: Hero folded before Flop (didn't bet)
Seat 5: 238619eb folded before Flop (didn't bet)
Seat 6: cea019e6 folded before Flop (didn't bet)


Poker Hand #RC1468005538: Hold'em No Limit  ($0.05/$0.1) - 2023/04/12 15:49:53
Table 'RushAndCash5520798' 6-max Seat #1 is the button
Seat 1: 6b2fd7cb ($9.85 in chips)
Seat 2: cc283623 ($10.24 in chips)
Seat 3: Hero ($9.1 in chips)
Seat 4: 6372d866 ($13.08 in chips)
Seat 5: a41754d0 ($12.06 in chips)
Seat 6: b011655b ($10.37 in chips)
cc283623: posts small blind $0.05
Hero: posts big blind $0.1
*** HOLE CARDS ***
Dealt to 6b2fd7cb 
Dealt to cc283623 
Dealt to Hero [Qc Qd]
Dealt to 6372d866 
Dealt to a41754d0 
Dealt to b011655b 
6372d866: folds
a41754d0: folds
b011655b: folds
6b2fd7cb: raises $0.11 to $0.21
cc283623: folds
Hero: raises $0.64 to $0.85
6b2fd7cb: calls $0.64
*** FLOP *** [Kd Jc 2h]
Hero: checks
6b2fd7cb: checks
*** TURN *** [Kd Jc 2h] [6c]
Hero: bets $0.88
6b2fd7cb: folds
Uncalled bet ($0.88) returned to Hero
*** SHOWDOWN ***
Hero collected $1.67 from pot
*** SUMMARY ***
Total pot $1.75 | Rake $0.08 | Jackpot $0 | Bingo $0 | Fortune $0
Board [Kd Jc 2h 6c]
Seat 1: 6b2fd7cb (button) folded on the Turn
Seat 2: cc283623 (small blind) folded before Flop
Seat 3: Hero (big blind) won ($1.67)
Seat 4: 6372d866 folded before Flop (didn't bet)
Seat 5: a41754d0 folded before Flop (didn't bet)
Seat 6: b011655b folded before Flop (didn't bet)


Poker Hand #RC1468005498: Hold'em No Limit  ($0.05/$0.1) - 2023/04/12 15:49:48
Table 'RushAndCash5520758' 6-max Seat #1 is the button
Seat 1: a052f1e8 ($10 in chips)
Seat 2: Hero ($9.15 in chips)
Seat 3: be047cf5 ($6.8 in chips)
Seat 4: b9a72970 ($10.45 in chips)
Seat 5: 37e7d5 ($10.23 in chips)
Seat 6: 48d346af ($8.7 in chips)
Hero: posts small blind $0.05
be047cf5: posts big blind $0.1
*** HOLE CARDS ***
Dealt to a052f1e8 
Dealt to Hero [6h 9c]
Dealt to be047cf5 
Dealt to b9a72970 
Dealt to 37e7d5 
Dealt to 48d346af 
b9a72970: folds
37e7d5: raises $0.1 to $0.2
48d346af: calls $0.2
a052f1e8: folds
Hero: folds
be047cf5: raises $0.6 to $0.8
37e7d5: calls $0.6
48d346af: calls $0.6
*** FLOP *** [8s 7h 4c]
be047cf5: bets $1.23
37e7d5: folds
48d346af: calls $1.23
*** TURN *** [8s 7h 4c] [Ac]
be047cf5: bets $4.77 and is all-in
48d346af: folds
Uncalled bet ($4.77) returned to be047cf5
*** SHOWDOWN ***
be047cf5 collected $4.53 from pot
*** SUMMARY ***
Total pot $4.91 | Rake $0.23 | Jackpot $0.15 | Bingo $0 | Fortune $0
Board [8s 7h 4c Ac]
Seat 1: a052f1e8 (button) folded before Flop (didn't bet)
Seat 2: Hero (small blind) folded before Flop
Seat 3: be047cf5 (big blind) won ($4.53)
Seat 4: b9a72970 folded before Flop (didn't bet)
Seat 5: 37e7d5 folded on the Flop
Seat 6: 48d346af folded on the Turn


Poker Hand #RC1468005260: Hold'em No Limit  ($0.05/$0.1) - 2023/04/12 15:49:19
Table 'RushAndCash5520520' 6-max Seat #1 is the button
Seat 1: Hero ($9.4 in chips)
Seat 2: e70565e0 ($11.06 in chips)
Seat 3: f3e4ec46 ($10.05 in chips)
Seat 4: 6493d175 ($10.83 in chips)
Seat 5: c8c12654 ($10.34 in chips)
Seat 6: d6ed9b1 ($10 in chips)
e70565e0: posts small blind $0.05
f3e4ec46: posts big blind $0.1
*** HOLE CARDS ***
Dealt to Hero [Tc 9s]
Dealt to e70565e0 
Dealt to f3e4ec46 
Dealt to 6493d175 
Dealt to c8c12654 
Dealt to d6ed9b1 
6493d175: folds
c8c12654: folds
d6ed9b1: folds
Hero: raises $0.15 to $0.25
e70565e0: raises $0.6 to $0.85
f3e4ec46: folds
Hero: folds
Uncalled bet ($0.6) returned to e70565e0
*** SHOWDOWN ***
e70565e0 collected $0.57 from pot
*** SUMMARY ***
Total pot $0.6 | Rake $0.03 | Jackpot $0 | Bingo $0 | Fortune $0
Seat 1: Hero (button) folded before Flop
Seat 2: e70565e0 (small blind) collected ($0.57)
Seat 3: f3e4ec46 (big blind) folded before Flop
Seat 4: 6493d175 folded before Flop (didn't bet)
Seat 5: c8c12654 folded before Flop (didn't bet)
Seat 6: d6ed9b1 folded before Flop (didn't bet)


Poker Hand #RC1468005154: Hold'em No Limit  ($0.05/$0.1) - 2023/04/12 15:49:07
Table 'RushAndCash5520414' 6-max Seat #1 is the button
Seat 1: ae7ba048 ($10.95 in chips)
Seat 2: 7bab8310 ($15.3 in chips)
Seat 3: 7774e9ed ($10.37 in chips)
Seat 4: Hero ($9.25 in chips)
Seat 5: 35a4b2ea ($10.23 in chips)
Seat 6: 7aa75295 ($10 in chips)
7bab8310: posts small blind $0.05
7774e9ed: posts big blind $0.1
*** HOLE CARDS ***
Dealt to ae7ba048 
Dealt to 7bab8310 
Dealt to 7774e9ed 
Dealt to Hero [Qh Ah]
Dealt to 35a4b2ea 
Dealt to 7aa75295 
Hero: raises $0.15 to $0.25
35a4b2ea: folds
7aa75295: folds
ae7ba048: folds
7bab8310: folds
7774e9ed: folds
Uncalled bet ($0.15) returned to Hero
*** SHOWDOWN ***
Hero collected $0.25 from pot
*** SUMMARY ***
Total pot $0.25 | Rake $0 | Jackpot $0 | Bingo $0 | Fortune $0
Seat 1: ae7ba048 (button) folded before Flop (didn't bet)
Seat 2: 7bab8310 (small blind) folded before Flop
Seat 3: 7774e9ed (big blind) folded before Flop
Seat 4: Hero collected ($0.25)
Seat 5: 35a4b2ea folded before Flop (didn't bet)
Seat 6: 7aa75295 folded before Flop (didn't bet)


Poker Hand #RC1468005029: Hold'em No Limit  ($0.05/$0.1) - 2023/04/12 15:48:52
Table 'RushAndCash5520289' 6-max Seat #1 is the button
Seat 1: 8a9db059 ($16.82 in chips)
Seat 2: Hero ($9.15 in chips)
Seat 3: 52d50f35 ($10.02 in chips)
Seat 4: 935420cf ($31.9 in chips)
Seat 5: de690849 ($24.91 in chips)
Seat 6: bde28c48 ($12.48 in chips)
Hero: posts small blind $0.05
52d50f35: posts big blind $0.1
*** HOLE CARDS ***
Dealt to 8a9db059 
Dealt to Hero [Ac Th]
Dealt to 52d50f35 
Dealt to 935420cf 
Dealt to de690849 
Dealt to bde28c48 
935420cf: folds
de690849: folds
bde28c48: folds
8a9db059: folds
Hero: raises $0.2 to $0.3
52d50f35: folds
Uncalled bet ($0.2) returned to Hero
*** SHOWDOWN ***
Hero collected $0.2 from pot
*** SUMMARY ***
Total pot $0.2 | Rake $0 | Jackpot $0 | Bingo $0 | Fortune $0
Seat 1: 8a9db059 (button) folded before Flop (didn't bet)
Seat 2: Hero (small blind) collected ($0.2)
Seat 3: 52d50f35 (big blind) folded before Flop
Seat 4: 935420cf folded before Flop (didn't bet)
Seat 5: de690849 folded before Flop (didn't bet)
Seat 6: bde28c48 folded before Flop (didn't bet)


Poker Hand #RC1468004929: Hold'em No Limit  ($0.05/$0.1) - 2023/04/12 15:48:41
Table 'RushAndCash5520189' 6-max Seat #1 is the button
Seat 1: Hero ($9.15 in chips)
Seat 2: de81a986 ($10.78 in chips)
Seat 3: 96cfdf8b ($12.47 in chips)
Seat 4: c1d4ecfc ($55.75 in chips)
Seat 5: 8466402e ($10.25 in chips)
Seat 6: f4e25d78 ($10.15 in chips)
de81a986: posts small blind $0.05
96cfdf8b: posts big blind $0.1
*** HOLE CARDS ***
Dealt to Hero [6h 2c]
Dealt to de81a986 
Dealt to 96cfdf8b 
Dealt to c1d4ecfc 
Dealt to 8466402e 
Dealt to f4e25d78 
c1d4ecfc: folds
8466402e: folds
f4e25d78: raises $0.15 to $0.25
Hero: folds
de81a986: folds
96cfdf8b: folds
Uncalled bet ($0.15) returned to f4e25d78
*** SHOWDOWN ***
f4e25d78 collected $0.25 from pot
*** SUMMARY ***
Total pot $0.25 | Rake $0 | Jackpot $0 | Bingo $0 | Fortune $0
Seat 1: Hero (button) folded before Flop (didn't bet)
Seat 2: de81a986 (small blind) folded before Flop
Seat 3: 96cfdf8b (big blind) folded before Flop
Seat 4: c1d4ecfc folded before Flop (didn't bet)
Seat 5: 8466402e folded before Flop (didn't bet)
Seat 6: f4e25d78 collected ($0.25)


Poker Hand #RC1468004839: Hold'em No Limit  ($0.05/$0.1) - 2023/04/12 15:48:30
Table 'RushAndCash5520099' 6-max Seat #1 is the button
Seat 1: 6bb948b2 ($22.87 in chips)
Seat 2: d7c7769f ($49.51 in chips)
Seat 3: Hero ($9.25 in chips)
Seat 4: 8aa5fae1 ($25.14 in chips)
Seat 5: aed826cb ($11.09 in chips)
Seat 6: 32c976f3 ($14.1 in chips)
d7c7769f: posts small blind $0.05
Hero: posts big blind $0.1
*** HOLE CARDS ***
Dealt to 6bb948b2 
Dealt to d7c7769f 
Dealt to Hero [2h 5d]
Dealt to 8aa5fae1 
Dealt to aed826cb 
Dealt to 32c976f3 
8aa5fae1: folds
aed826cb: raises $0.12 to $0.22
32c976f3: calls $0.22
6bb948b2: folds
d7c7769f: folds
Hero: folds
*** FLOP *** [Th 8s Qs]
aed826cb: bets $0.15
32c976f3: calls $0.15
*** TURN *** [Th 8s Qs] [8c]
aed826cb: bets $0.6
32c976f3: folds
Uncalled bet ($0.6) returned to aed826cb
*** SHOWDOWN ***
aed826cb collected $0.85 from pot
*** SUMMARY ***
Total pot $0.89 | Rake $0.04 | Jackpot $0 | Bingo $0 | Fortune $0
Board [Th 8s Qs 8c]
Seat 1: 6bb948b2 (button) folded before Flop (didn't bet)
Seat 2: d7c7769f (small blind) folded before Flop
Seat 3: Hero (big blind) folded before Flop
Seat 4: 8aa5fae1 folded before Flop (didn't bet)
Seat 5: aed826cb won ($0.85)
Seat 6: 32c976f3 folded on the Turn


Poker Hand #RC1468004773: Hold'em No Limit  ($0.05/$0.1) - 2023/04/12 15:48:23
Table 'RushAndCash5520033' 6-max Seat #1 is the button
Seat 1: dac244a8 ($11.14 in chips)
Seat 2: f4e25d78 ($10.2 in chips)
Seat 3: 27caed27 ($20.16 in chips)
Seat 4: 51c877ee ($10.27 in chips)
Seat 5: Hero ($9.25 in chips)
Seat 6: 46348693 ($18.97 in chips)
f4e25d78: posts small blind $0.05
27caed27: posts big blind $0.1
*** HOLE CARDS ***
Dealt to dac244a8 
Dealt to f4e25d78 
Dealt to 27caed27 
Dealt to 51c877ee 
Dealt to Hero [Jh 3h]
Dealt to 46348693 
51c877ee: raises $0.1 to $0.2
Hero: folds
46348693: folds
dac244a8: folds
f4e25d78: folds
27caed27: folds
Uncalled bet ($0.1) returned to 51c877ee
*** SHOWDOWN ***
51c877ee collected $0.25 from pot
*** SUMMARY ***
Total pot $0.25 | Rake $0 | Jackpot $0 | Bingo $0 | Fortune $0
Seat 1: dac244a8 (button) folded before Flop (didn't bet)
Seat 2: f4e25d78 (small blind) folded before Flop
Seat 3: 27caed27 (big blind) folded before Flop
Seat 4: 51c877ee collected ($0.25)
Seat 5: Hero folded before Flop (didn't bet)
Seat 6: 46348693 folded before Flop (didn't bet)


Poker Hand #RC1467974696: Hold'em No Limit  ($0.05/$0.1) - 2023/04/12 15:48:14
Table 'RushAndCash5519956' 6-max Seat #1 is the button
Seat 1: a5d53ee7 ($18.06 in chips)
Seat 2: d419cc9a ($20.55 in chips)
Seat 3: eaf0c4e5 ($12.45 in chips)
Seat 4: d82e07a8 ($10 in chips)
Seat 5: Hero ($9.25 in chips)
Seat 6: 1b1b34c ($10.21 in chips)
d419cc9a: posts small blind $0.05
eaf0c4e5: posts big blind $0.1
*** HOLE CARDS ***
Dealt to a5d53ee7 
Dealt to d419cc9a 
Dealt to eaf0c4e5 
Dealt to d82e07a8 
Dealt to Hero [Js Th]
Dealt to 1b1b34c 
d82e07a8: folds
Hero: folds
1b1b34c: raises $0.1 to $0.2
a5d53ee7: folds
d419cc9a: folds
eaf0c4e5: folds
Uncalled bet ($0.1) returned to 1b1b34c
*** SHOWDOWN ***
1b1b34c collected $0.25 from pot
*** SUMMARY ***
Total pot $0.25 | Rake $0 | Jackpot $0 | Bingo $0 | Fortune $0
Seat 1: a5d53ee7 (button) folded before Flop (didn't bet)
Seat 2: d419cc9a (small blind) folded before Flop
Seat 3: eaf0c4e5 (big blind) folded before Flop
Seat 4: d82e07a8 folded before Flop (didn't bet)
Seat 5: Hero folded before Flop (didn't bet)
Seat 6: 1b1b34c collected ($0.25)


Poker Hand #RC1467974639: Hold'em No Limit  ($0.05/$0.1) - 2023/04/12 15:48:08
Table 'RushAndCash5519899' 6-max Seat #1 is the button
Seat 1: 1475e8f0 ($15.46 in chips)
Seat 2: e44f2012 ($10 in chips)
Seat 3: 3d9dd182 ($14.12 in chips)
Seat 4: Hero ($9.25 in chips)
Seat 5: 38b9b220 ($10 in chips)
Seat 6: 1b2e5663 ($11.87 in chips)
e44f2012: posts small blind $0.05
3d9dd182: posts big blind $0.1
*** HOLE CARDS ***
Dealt to 1475e8f0 
Dealt to e44f2012 
Dealt to 3d9dd182 
Dealt to Hero [5h Qh]
Dealt to 38b9b220 
Dealt to 1b2e5663 
Hero: folds
38b9b220: folds
1b2e5663: folds
1475e8f0: folds
e44f2012: folds
Uncalled bet ($0.05) returned to 3d9dd182
*** SHOWDOWN ***
3d9dd182 collected $0.1 from pot
*** SUMMARY ***
Total pot $0.1 | Rake $0 | Jackpot $0 | Bingo $0 | Fortune $0
Seat 1: 1475e8f0 (button) folded before Flop (didn't bet)
Seat 2: e44f2012 (small blind) folded before Flop
Seat 3: 3d9dd182 (big blind) collected ($0.1)
Seat 4: Hero folded before Flop (didn't bet)
Seat 5: 38b9b220 folded before Flop (didn't bet)
Seat 6: 1b2e5663 folded before Flop (didn't bet)


Poker Hand #RC1467974450: Hold'em No Limit  ($0.05/$0.1) - 2023/04/12 15:47:45
Table 'RushAndCash5519710' 6-max Seat #1 is the button
Seat 1: 66d56f2c ($10.06 in chips)
Seat 2: 86aa7b6b ($10.05 in chips)
Seat 3: 56cec6d0 ($11.95 in chips)
Seat 4: 76aab391 ($11.47 in chips)
Seat 5: Hero ($9.25 in chips)
Seat 6: 1e6140e6 ($11.53 in chips)
86aa7b6b: posts small blind $0.05
56cec6d0: posts big blind $0.1
*** HOLE CARDS ***
Dealt to 66d56f2c 
Dealt to 86aa7b6b 
Dealt to 56cec6d0 
Dealt to 76aab391 
Dealt to Hero [4d 2c]
Dealt to 1e6140e6 
76aab391: folds
Hero: folds
1e6140e6: raises $0.15 to $0.25
66d56f2c: folds
86aa7b6b: folds
56cec6d0: folds
Uncalled bet ($0.15) returned to 1e6140e6
*** SHOWDOWN ***
1e6140e6 collected $0.25 from pot
*** SUMMARY ***
Total pot $0.25 | Rake $0 | Jackpot $0 | Bingo $0 | Fortune $0
Seat 1: 66d56f2c (button) folded before Flop (didn't bet)
Seat 2: 86aa7b6b (small blind) folded before Flop
Seat 3: 56cec6d0 (big blind) folded before Flop
Seat 4: 76aab391 folded before Flop (didn't bet)
Seat 5: Hero folded before Flop (didn't bet)
Seat 6: 1e6140e6 collected ($0.25)


Poker Hand #RC1467974329: Hold'em No Limit  ($0.05/$0.1) - 2023/04/12 15:47:30
Table 'RushAndCash5519589' 6-max Seat #1 is the button
Seat 1: 41650a84 ($6.21 in chips)
Seat 2: Hero ($9.3 in chips)
Seat 3: eb56c217 ($22.89 in chips)
Seat 4: 291834e1 ($11.78 in chips)
Seat 5: 9e73201d ($11.74 in chips)
Seat 6: fda2ca77 ($16.07 in chips)
Hero: posts small blind $0.05
eb56c217: posts big blind $0.1
*** HOLE CARDS ***
Dealt to 41650a84 
Dealt to Hero [7c Ts]
Dealt to eb56c217 
Dealt to 291834e1 
Dealt to 9e73201d 
Dealt to fda2ca77 
291834e1: folds
9e73201d: folds
fda2ca77: folds
41650a84: folds
Hero: folds
Uncalled bet ($0.05) returned to eb56c217
*** SHOWDOWN ***
eb56c217 collected $0.1 from pot
*** SUMMARY ***
Total pot $0.1 | Rake $0 | Jackpot $0 | Bingo $0 | Fortune $0
Seat 1: 41650a84 (button) folded before Flop (didn't bet)
Seat 2: Hero (small blind) folded before Flop
Seat 3: eb56c217 (big blind) collected ($0.1)
Seat 4: 291834e1 folded before Flop (didn't bet)
Seat 5: 9e73201d folded before Flop (didn't bet)
Seat 6: fda2ca77 folded before Flop (didn't bet)


Poker Hand #RC1467974090: Hold'em No Limit  ($0.05/$0.1) - 2023/04/12 15:47:01
Table 'RushAndCash5519350' 6-max Seat #1 is the button
Seat 1: 76641ec ($10 in chips)
Seat 2: 9e73201d ($11.94 in chips)
Seat 3: Hero ($9.12 in chips)
Seat 4: 5e304ffe ($16.93 in chips)
Seat 5: 3df0ecb3 ($27.65 in chips)
Seat 6: 6a7b2285 ($28.61 in chips)
9e73201d: posts small blind $0.05
Hero: posts big blind $0.1
*** HOLE CARDS ***
Dealt to 76641ec 
Dealt to 9e73201d 
Dealt to Hero [Th Tc]
Dealt to 5e304ffe 
Dealt to 3df0ecb3 
Dealt to 6a7b2285 
5e304ffe: folds
3df0ecb3: folds
6a7b2285: folds
76641ec: folds
9e73201d: raises $0.1 to $0.2
Hero: raises $0.35 to $0.55
9e73201d: folds
Uncalled bet ($0.35) returned to Hero
*** SHOWDOWN ***
Hero collected $0.38 from pot
*** SUMMARY ***
Total pot $0.4 | Rake $0.02 | Jackpot $0 | Bingo $0 | Fortune $0
Seat 1: 76641ec (button) folded before Flop (didn't bet)
Seat 2: 9e73201d (small blind) folded before Flop
Seat 3: Hero (big blind) collected ($0.38)
Seat 4: 5e304ffe folded before Flop (didn't bet)
Seat 5: 3df0ecb3 folded before Flop (didn't bet)
Seat 6: 6a7b2285 folded before Flop (didn't bet)


Poker Hand #RC1467973983: Hold'em No Limit  ($0.05/$0.1) - 2023/04/12 15:46:49
Table 'RushAndCash5519243' 6-max Seat #1 is the button
Seat 1: e44f2012 ($10 in chips)
Seat 2: 5f51a34a ($10.15 in chips)
Seat 3: 61da8fe6 ($10.1 in chips)
Seat 4: Hero ($8.97 in chips)
Seat 5: aed826cb ($11.09 in chips)
Seat 6: 54e30dae ($10.86 in chips)
5f51a34a: posts small blind $0.05
61da8fe6: posts big blind $0.1
*** HOLE CARDS ***
Dealt to e44f2012 
Dealt to 5f51a34a 
Dealt to 61da8fe6 
Dealt to Hero [2s 2h]
Dealt to aed826cb 
Dealt to 54e30dae 
Hero: raises $0.1 to $0.2
aed826cb: folds
54e30dae: folds
e44f2012: folds
5f51a34a: folds
61da8fe6: folds
Uncalled bet ($0.1) returned to Hero
*** SHOWDOWN ***
Hero collected $0.25 from pot
*** SUMMARY ***
Total pot $0.25 | Rake $0 | Jackpot $0 | Bingo $0 | Fortune $0
Seat 1: e44f2012 (button) folded before Flop (didn't bet)
Seat 2: 5f51a34a (small blind) folded before Flop
Seat 3: 61da8fe6 (big blind) folded before Flop
Seat 4: Hero collected ($0.25)
Seat 5: aed826cb folded before Flop (didn't bet)
Seat 6: 54e30dae folded before Flop (didn't bet)


Poker Hand #RC1467973890: Hold'em No Limit  ($0.05/$0.1) - 2023/04/12 15:46:38
Table 'RushAndCash5519150' 6-max Seat #1 is the button
Seat 1: 650ba5f ($9.85 in chips)
Seat 2: 3df0ecb3 ($27.7 in chips)
Seat 3: 33a288a7 ($32.27 in chips)
Seat 4: ee7db857 ($10.01 in chips)
Seat 5: Hero ($8.97 in chips)
Seat 6: 66d56f2c ($9.85 in chips)
3df0ecb3: posts small blind $0.05
33a288a7: posts big blind $0.1
*** HOLE CARDS ***
Dealt to 650ba5f 
Dealt to 3df0ecb3 
Dealt to 33a288a7 
Dealt to ee7db857 
Dealt to Hero [6h 8c]
Dealt to 66d56f2c 
ee7db857: raises $0.15 to $0.25
Hero: folds
66d56f2c: folds
650ba5f: folds
3df0ecb3: folds
33a288a7: folds
Uncalled bet ($0.15) returned to ee7db857
*** SHOWDOWN ***
ee7db857 collected $0.25 from pot
*** SUMMARY ***
Total pot $0.25 | Rake $0 | Jackpot $0 | Bingo $0 | Fortune $0
Seat 1: 650ba5f (button) folded before Flop (didn't bet)
Seat 2: 3df0ecb3 (small blind) folded before Flop
Seat 3: 33a288a7 (big blind) folded before Flop
Seat 4: ee7db857 collected ($0.25)
Seat 5: Hero folded before Flop (didn't bet)
Seat 6: 66d56f2c folded before Flop (didn't bet)


Poker Hand #RC1467973685: Hold'em No Limit  ($0.05/$0.1) - 2023/04/12 15:46:13
Table 'RushAndCash5518945' 6-max Seat #1 is the button
Seat 1: Hero ($9.22 in chips)
Seat 2: 1c3bcef4 ($10 in chips)
Seat 3: 37e7d5 ($10.05 in chips)
Seat 4: 9a952988 ($10.3 in chips)
Seat 5: 3fd47639 ($5.49 in chips)
Seat 6: 6aedbdfc ($9.85 in chips)
1c3bcef4: posts small blind $0.05
37e7d5: posts big blind $0.1
*** HOLE CARDS ***
Dealt to Hero [Kd Td]
Dealt to 1c3bcef4 
Dealt to 37e7d5 
Dealt to 9a952988 
Dealt to 3fd47639 
Dealt to 6aedbdfc 
9a952988: folds
3fd47639: folds
6aedbdfc: raises $0.15 to $0.25
Hero: calls $0.25
1c3bcef4: calls $0.2
37e7d5: folds
*** FLOP *** [Qh 9c 4h]
1c3bcef4: checks
6aedbdfc: bets $0.64
Hero: folds
1c3bcef4: calls $0.64
*** TURN *** [Qh 9c 4h] [Jc]
1c3bcef4: checks
6aedbdfc: bets $1.6
1c3bcef4: raises $7.51 to $9.11 and is all-in
6aedbdfc: folds
Uncalled bet ($7.51) returned to 1c3bcef4
6aedbdfc: shows [Qd 9h] (Pair of Queens and Pair of Nines)
*** SHOWDOWN ***
1c3bcef4 collected $4.93 from pot
*** SUMMARY ***
Total pot $5.33 | Rake $0.25 | Jackpot $0.15 | Bingo $0 | Fortune $0
Board [Qh 9c 4h Jc]
Seat 1: Hero (button) folded on the Flop
Seat 2: 1c3bcef4 (small blind) won ($4.93)
Seat 3: 37e7d5 (big blind) folded before Flop
Seat 4: 9a952988 folded before Flop (didn't bet)
Seat 5: 3fd47639 folded before Flop (didn't bet)
Seat 6: 6aedbdfc folded on the Turn


Poker Hand #RC1467973644: Hold'em No Limit  ($0.05/$0.1) - 2023/04/12 15:46:08
Table 'RushAndCash5518904' 6-max Seat #1 is the button
Seat 1: 8061b980 ($31.43 in chips)
Seat 2: ce4ef03f ($11.43 in chips)
Seat 3: 38a180dd ($14.59 in chips)
Seat 4: ed92191e ($5.4 in chips)
Seat 5: df21e762 ($9.75 in chips)
Seat 6: Hero ($9.22 in chips)
ce4ef03f: posts small blind $0.05
38a180dd: posts big blind $0.1
*** HOLE CARDS ***
Dealt to 8061b980 
Dealt to ce4ef03f 
Dealt to 38a180dd 
Dealt to ed92191e 
Dealt to df21e762 
Dealt to Hero [9h 8d]
ed92191e: raises $0.2 to $0.3
df21e762: folds
Hero: folds
8061b980: raises $0.57 to $0.87
ce4ef03f: folds
38a180dd: folds
ed92191e: folds
Uncalled bet ($0.57) returned to 8061b980
*** SHOWDOWN ***
8061b980 collected $0.72 from pot
*** SUMMARY ***
Total pot $0.75 | Rake $0.03 | Jackpot $0 | Bingo $0 | Fortune $0
Seat 1: 8061b980 (button) collected ($0.72)
Seat 2: ce4ef03f (small blind) folded before Flop
Seat 3: 38a180dd (big blind) folded before Flop
Seat 4: ed92191e folded before Flop
Seat 5: df21e762 folded before Flop (didn't bet)
Seat 6: Hero folded before Flop (didn't bet)


Poker Hand #RC1467973584: Hold'em No Limit  ($0.05/$0.1) - 2023/04/12 15:46:01
Table 'RushAndCash5518844' 6-max Seat #1 is the button
Seat 1: a3f65dc3 ($9.85 in chips)
Seat 2: 49600bcc ($12.01 in chips)
Seat 3: 6787f85a ($9.95 in chips)
Seat 4: 9df7f473 ($11.45 in chips)
Seat 5: Hero ($9.22 in chips)
Seat 6: 4e7ce881 ($10.64 in chips)
49600bcc: posts small blind $0.05
6787f85a: posts big blind $0.1
*** HOLE CARDS ***
Dealt to a3f65dc3 
Dealt to 49600bcc 
Dealt to 6787f85a 
Dealt to 9df7f473 
Dealt to Hero [4c Qs]
Dealt to 4e7ce881 
9df7f473: folds
Hero: folds
4e7ce881: raises $0.13 to $0.23
a3f65dc3: folds
49600bcc: folds
6787f85a: raises $0.69 to $0.92
4e7ce881: folds
Uncalled bet ($0.69) returned to 6787f85a
*** SHOWDOWN ***
6787f85a collected $0.49 from pot
*** SUMMARY ***
Total pot $0.51 | Rake $0.02 | Jackpot $0 | Bingo $0 | Fortune $0
Seat 1: a3f65dc3 (button) folded before Flop (didn't bet)
Seat 2: 49600bcc (small blind) folded before Flop
Seat 3: 6787f85a (big blind) collected ($0.49)
Seat 4: 9df7f473 folded before Flop (didn't bet)
Seat 5: Hero folded before Flop (didn't bet)
Seat 6: 4e7ce881 folded before Flop


Poker Hand #RC1467973459: Hold'em No Limit  ($0.05/$0.1) - 2023/04/12 15:45:45
Table 'RushAndCash5518719' 6-max Seat #1 is the button
Seat 1: Hero ($9.22 in chips)
Seat 2: df21e762 ($9.9 in chips)
Seat 3: af29373e ($10.61 in chips)
Seat 4: 76aab391 ($10.86 in chips)
Seat 5: c5dc269e ($10.23 in chips)
Seat 6: 33ddbfa5 ($19.64 in chips)
df21e762: posts small blind $0.05
af29373e: posts big blind $0.1
*** HOLE CARDS ***
Dealt to Hero [Jc 7c]
Dealt to df21e762 
Dealt to af29373e 
Dealt to 76aab391 
Dealt to c5dc269e 
Dealt to 33ddbfa5 
76aab391: folds
c5dc269e: raises $0.2 to $0.3
33ddbfa5: raises $0.57 to $0.87
Hero: folds
df21e762: folds
af29373e: folds
c5dc269e: calls $0.57
*** FLOP *** [8c 8d Kc]
c5dc269e: bets $0.63
33ddbfa5: raises $1.58 to $2.21
c5dc269e: folds
Uncalled bet ($1.58) returned to 33ddbfa5
*** SHOWDOWN ***
33ddbfa5 collected $2.85 from pot
*** SUMMARY ***
Total pot $3.15 | Rake $0.15 | Jackpot $0.15 | Bingo $0 | Fortune $0
Board [8c 8d Kc]
Seat 1: Hero (button) folded before Flop (didn't bet)
Seat 2: df21e762 (small blind) folded before Flop
Seat 3: af29373e (big blind) folded before Flop
Seat 4: 76aab391 folded before Flop (didn't bet)
Seat 5: c5dc269e folded on the Flop
Seat 6: 33ddbfa5 won ($2.85)


Poker Hand #RC1467973391: Hold'em No Limit  ($0.05/$0.1) - 2023/04/12 15:45:38
Table 'RushAndCash5518651' 6-max Seat #1 is the button
Seat 1: 82c9ee00 ($7.01 in chips)
Seat 2: Hero ($9.27 in chips)
Seat 3: f6453934 ($28.73 in chips)
Seat 4: de214bb ($14.96 in chips)
Seat 5: 88a51a98 ($10.05 in chips)
Seat 6: ce6e887a ($10 in chips)
Hero: posts small blind $0.05
f6453934: posts big blind $0.1
*** HOLE CARDS ***
Dealt to 82c9ee00 
Dealt to Hero [9d 7s]
Dealt to f6453934 
Dealt to de214bb 
Dealt to 88a51a98 
Dealt to ce6e887a 
de214bb: folds
88a51a98: folds
ce6e887a: folds
82c9ee00: raises $0.15 to $0.25
Hero: folds
f6453934: folds
Uncalled bet ($0.15) returned to 82c9ee00
*** SHOWDOWN ***
82c9ee00 collected $0.25 from pot
*** SUMMARY ***
Total pot $0.25 | Rake $0 | Jackpot $0 | Bingo $0 | Fortune $0
Seat 1: 82c9ee00 (button) collected ($0.25)
Seat 2: Hero (small blind) folded before Flop
Seat 3: f6453934 (big blind) folded before Flop
Seat 4: de214bb folded before Flop (didn't bet)
Seat 5: 88a51a98 folded before Flop (didn't bet)
Seat 6: ce6e887a folded before Flop (didn't bet)


Poker Hand #RC1467973252: Hold'em No Limit  ($0.05/$0.1) - 2023/04/12 15:45:22
Table 'RushAndCash5518512' 6-max Seat #1 is the button
Seat 1: 69cc8d29 ($10.25 in chips)
Seat 2: a5d53ee7 ($18.61 in chips)
Seat 3: Hero ($9.22 in chips)
Seat 4: 4ccec75c ($10.99 in chips)
Seat 5: 44da8f33 ($7.81 in chips)
Seat 6: 17f13c9e ($9.6 in chips)
a5d53ee7: posts small blind $0.05
Hero: posts big blind $0.1
*** HOLE CARDS ***
Dealt to 69cc8d29 
Dealt to a5d53ee7 
Dealt to Hero [Jd 5c]
Dealt to 4ccec75c 
Dealt to 44da8f33 
Dealt to 17f13c9e 
4ccec75c: folds
44da8f33: folds
17f13c9e: folds
69cc8d29: folds
a5d53ee7: folds
Uncalled bet ($0.05) returned to Hero
*** SHOWDOWN ***
Hero collected $0.1 from pot
*** SUMMARY ***
Total pot $0.1 | Rake $0 | Jackpot $0 | Bingo $0 | Fortune $0
Seat 1: 69cc8d29 (button) folded before Flop (didn't bet)
Seat 2: a5d53ee7 (small blind) folded before Flop
Seat 3: Hero (big blind) collected ($0.1)
Seat 4: 4ccec75c folded before Flop (didn't bet)
Seat 5: 44da8f33 folded before Flop (didn't bet)
Seat 6: 17f13c9e folded before Flop (didn't bet)


Poker Hand #RC1467973212: Hold'em No Limit  ($0.05/$0.1) - 2023/04/12 15:45:18
Table 'RushAndCash5518472' 6-max Seat #1 is the button
Seat 1: 41275612 ($10 in chips)
Seat 2: 25d23fa3 ($12.5 in chips)
Seat 3: be047cf5 ($9.08 in chips)
Seat 4: Hero ($9.22 in chips)
Seat 5: 54ec144c ($10 in chips)
Seat 6: a31d9536 ($9.75 in chips)
25d23fa3: posts small blind $0.05
be047cf5: posts big blind $0.1
*** HOLE CARDS ***
Dealt to 41275612 
Dealt to 25d23fa3 
Dealt to be047cf5 
Dealt to Hero [9h 3h]
Dealt to 54ec144c 
Dealt to a31d9536 
Hero: folds
54ec144c: folds
a31d9536: raises $0.15 to $0.25
41275612: folds
25d23fa3: folds
be047cf5: folds
Uncalled bet ($0.15) returned to a31d9536
*** SHOWDOWN ***
a31d9536 collected $0.25 from pot
*** SUMMARY ***
Total pot $0.25 | Rake $0 | Jackpot $0 | Bingo $0 | Fortune $0
Seat 1: 41275612 (button) folded before Flop (didn't bet)
Seat 2: 25d23fa3 (small blind) folded before Flop
Seat 3: be047cf5 (big blind) folded before Flop
Seat 4: Hero folded before Flop (didn't bet)
Seat 5: 54ec144c folded before Flop (didn't bet)
Seat 6: a31d9536 collected ($0.25)


Poker Hand #RC1467973154: Hold'em No Limit  ($0.05/$0.1) - 2023/04/12 15:45:11
Table 'RushAndCash5518414' 6-max Seat #1 is the button
Seat 1: 3d9dd182 ($14.52 in chips)
Seat 2: e57f93b7 ($11.1 in chips)
Seat 3: ff1471 ($10.3 in chips)
Seat 4: 82abe0fd ($11.46 in chips)
Seat 5: Hero ($9.22 in chips)
Seat 6: 73536806 ($12.43 in chips)
e57f93b7: posts small blind $0.05
ff1471: posts big blind $0.1
*** HOLE CARDS ***
Dealt to 3d9dd182 
Dealt to e57f93b7 
Dealt to ff1471 
Dealt to 82abe0fd 
Dealt to Hero [7c 2d]
Dealt to 73536806 
82abe0fd: folds
Hero: folds
73536806: raises $0.12 to $0.22
3d9dd182: folds
e57f93b7: folds
ff1471: folds
Uncalled bet ($0.12) returned to 73536806
*** SHOWDOWN ***
73536806 collected $0.25 from pot
*** SUMMARY ***
Total pot $0.25 | Rake $0 | Jackpot $0 | Bingo $0 | Fortune $0
Seat 1: 3d9dd182 (button) folded before Flop (didn't bet)
Seat 2: e57f93b7 (small blind) folded before Flop
Seat 3: ff1471 (big blind) folded before Flop
Seat 4: 82abe0fd folded before Flop (didn't bet)
Seat 5: Hero folded before Flop (didn't bet)
Seat 6: 73536806 collected ($0.25)


Poker Hand #RC1467972970: Hold'em No Limit  ($0.05/$0.1) - 2023/04/12 15:44:47
Table 'RushAndCash5518230' 6-max Seat #1 is the button
Seat 1: 5227d6a7 ($20.54 in chips)
Seat 2: Hero ($9.12 in chips)
Seat 3: d8c6a667 ($10.6 in chips)
Seat 4: d3740883 ($16.93 in chips)
Seat 5: 90b04cc ($9.69 in chips)
Seat 6: c4f6ed66 ($15.45 in chips)
Hero: posts small blind $0.05
d8c6a667: posts big blind $0.1
*** HOLE CARDS ***
Dealt to 5227d6a7 
Dealt to Hero [Ts Js]
Dealt to d8c6a667 
Dealt to d3740883 
Dealt to 90b04cc 
Dealt to c4f6ed66 
d3740883: folds
90b04cc: folds
c4f6ed66: folds
5227d6a7: folds
Hero: raises $0.2 to $0.3
d8c6a667: folds
Uncalled bet ($0.2) returned to Hero
*** SHOWDOWN ***
Hero collected $0.2 from pot
*** SUMMARY ***
Total pot $0.2 | Rake $0 | Jackpot $0 | Bingo $0 | Fortune $0
Seat 1: 5227d6a7 (button) folded before Flop (didn't bet)
Seat 2: Hero (small blind) collected ($0.2)
Seat 3: d8c6a667 (big blind) folded before Flop
Seat 4: d3740883 folded before Flop (didn't bet)
Seat 5: 90b04cc folded before Flop (didn't bet)
Seat 6: c4f6ed66 folded before Flop (didn't bet)


Poker Hand #RC1467972864: Hold'em No Limit  ($0.05/$0.1) - 2023/04/12 15:44:34
Table 'RushAndCash5518124' 6-max Seat #1 is the button
Seat 1: 90b04cc ($9.69 in chips)
Seat 2: 4b35b612 ($4.81 in chips)
Seat 3: 49ac90c ($14.38 in chips)
Seat 4: 26d86c67 ($21.03 in chips)
Seat 5: 7095e0fe ($12.1 in chips)
Seat 6: Hero ($9.12 in chips)
4b35b612: posts small blind $0.05
49ac90c: posts big blind $0.1
*** HOLE CARDS ***
Dealt to 90b04cc 
Dealt to 4b35b612 
Dealt to 49ac90c 
Dealt to 26d86c67 
Dealt to 7095e0fe 
Dealt to Hero [7h As]
26d86c67: folds
7095e0fe: raises $0.1 to $0.2
Hero: folds
90b04cc: folds
4b35b612: folds
49ac90c: folds
Uncalled bet ($0.1) returned to 7095e0fe
*** SHOWDOWN ***
7095e0fe collected $0.25 from pot
*** SUMMARY ***
Total pot $0.25 | Rake $0 | Jackpot $0 | Bingo $0 | Fortune $0
Seat 1: 90b04cc (button) folded before Flop (didn't bet)
Seat 2: 4b35b612 (small blind) folded before Flop
Seat 3: 49ac90c (big blind) folded before Flop
Seat 4: 26d86c67 folded before Flop (didn't bet)
Seat 5: 7095e0fe collected ($0.25)
Seat 6: Hero folded before Flop (didn't bet)


Poker Hand #RC1467972777: Hold'em No Limit  ($0.05/$0.1) - 2023/04/12 15:44:25
Table 'RushAndCash5518037' 6-max Seat #1 is the button
Seat 1: aa8e8074 ($14.46 in chips)
Seat 2: d5330762 ($10 in chips)
Seat 3: Hero ($9.22 in chips)
Seat 4: 41275612 ($10 in chips)
Seat 5: d775b93b ($10 in chips)
Seat 6: c07b91d4 ($13.49 in chips)
d5330762: posts small blind $0.05
Hero: posts big blind $0.1
*** HOLE CARDS ***
Dealt to aa8e8074 
Dealt to d5330762 
Dealt to Hero [4d 2d]
Dealt to 41275612 
Dealt to d775b93b 
Dealt to c07b91d4 
41275612: folds
d775b93b: raises $0.13 to $0.23
c07b91d4: folds
aa8e8074: folds
d5330762: folds
Hero: folds
Uncalled bet ($0.13) returned to d775b93b
*** SHOWDOWN ***
d775b93b collected $0.25 from pot
*** SUMMARY ***
Total pot $0.25 | Rake $0 | Jackpot $0 | Bingo $0 | Fortune $0
Seat 1: aa8e8074 (button) folded before Flop (didn't bet)
Seat 2: d5330762 (small blind) folded before Flop
Seat 3: Hero (big blind) folded before Flop
Seat 4: 41275612 folded before Flop (didn't bet)
Seat 5: d775b93b collected ($0.25)
Seat 6: c07b91d4 folded before Flop (didn't bet)


Poker Hand #RC1467972682: Hold'em No Limit  ($0.05/$0.1) - 2023/04/12 15:44:13
Table 'RushAndCash5517942' 6-max Seat #1 is the button
Seat 1: Hero ($9.22 in chips)
Seat 2: 739df99a ($10.05 in chips)
Seat 3: 314da29d ($10.97 in chips)
Seat 4: 723bff68 ($19.85 in chips)
Seat 5: 8317b47c ($13.83 in chips)
Seat 6: a90305ee ($10.87 in chips)
739df99a: posts small blind $0.05
314da29d: posts big blind $0.1
*** HOLE CARDS ***
Dealt to Hero [Kh Jd]
Dealt to 739df99a 
Dealt to 314da29d 
Dealt to 723bff68 
Dealt to 8317b47c 
Dealt to a90305ee 
723bff68: folds
8317b47c: folds
a90305ee: raises $0.15 to $0.25
Hero: folds
739df99a: folds
314da29d: calls $0.15
*** FLOP *** [Qs 6d As]
314da29d: checks
a90305ee: bets $0.19
314da29d: folds
Uncalled bet ($0.19) returned to a90305ee
*** SHOWDOWN ***
a90305ee collected $0.53 from pot
*** SUMMARY ***
Total pot $0.55 | Rake $0.02 | Jackpot $0 | Bingo $0 | Fortune $0
Board [Qs 6d As]
Seat 1: Hero (button) folded before Flop (didn't bet)
Seat 2: 739df99a (small blind) folded before Flop
Seat 3: 314da29d (big blind) folded on the Flop
Seat 4: 723bff68 folded before Flop (didn't bet)
Seat 5: 8317b47c folded before Flop (didn't bet)
Seat 6: a90305ee won ($0.53)


Poker Hand #RC1467972302: Hold'em No Limit  ($0.05/$0.1) - 2023/04/12 15:43:28
Table 'RushAndCash5517562' 6-max Seat #1 is the button
Seat 1: a052f1e8 ($10.68 in chips)
Seat 2: 70272f5a ($21.23 in chips)
Seat 3: dc57ea9e ($29.05 in chips)
Seat 4: 36094f35 ($16.29 in chips)
Seat 5: 887eeabb ($10 in chips)
Seat 6: Hero ($10.37 in chips)
70272f5a: posts small blind $0.05
dc57ea9e: posts big blind $0.1
*** HOLE CARDS ***
Dealt to a052f1e8 
Dealt to 70272f5a 
Dealt to dc57ea9e 
Dealt to 36094f35 
Dealt to 887eeabb 
Dealt to Hero [9h Kh]
36094f35: folds
887eeabb: folds
Hero: raises $0.15 to $0.25
a052f1e8: folds
70272f5a: calls $0.2
dc57ea9e: folds
*** FLOP *** [Jd 6s Ts]
70272f5a: checks
Hero: checks
*** TURN *** [Jd 6s Ts] [Kd]
70272f5a: bets $0.3
Hero: calls $0.3
*** RIVER *** [Jd 6s Ts Kd] [Tc]
70272f5a: bets $0.6
Hero: calls $0.6
70272f5a: shows [Qd Ac] (Aces-High Straight)
Hero: shows [9h Kh] (Pair of Kings and Pair of Tens)
*** SHOWDOWN ***
70272f5a collected $2.28 from pot
*** SUMMARY ***
Total pot $2.4 | Rake $0.12 | Jackpot $0 | Bingo $0 | Fortune $0
Board [Jd 6s Ts Kd Tc]
Seat 1: a052f1e8 (button) folded before Flop (didn't bet)
Seat 2: 70272f5a (small blind) showed [Qd Ac] and won ($2.28) with Aces-High Straight
Seat 3: dc57ea9e (big blind) folded before Flop
Seat 4: 36094f35 folded before Flop (didn't bet)
Seat 5: 887eeabb folded before Flop (didn't bet)
Seat 6: Hero showed [9h Kh] and lost with Pair of Kings and Pair of Tens


Poker Hand #RC1467972227: Hold'em No Limit  ($0.05/$0.1) - 2023/04/12 15:43:18
Table 'RushAndCash5517487' 6-max Seat #1 is the button
Seat 1: Hero ($10.37 in chips)
Seat 2: 96213652 ($10.05 in chips)
Seat 3: d5330762 ($10.15 in chips)
Seat 4: f2b01908 ($12.99 in chips)
Seat 5: 55216799 ($10.15 in chips)
Seat 6: 312f864e ($10.1 in chips)
96213652: posts small blind $0.05
d5330762: posts big blind $0.1
*** HOLE CARDS ***
Dealt to Hero [Kd 3c]
Dealt to 96213652 
Dealt to d5330762 
Dealt to f2b01908 
Dealt to 55216799 
Dealt to 312f864e 
f2b01908: folds
55216799: folds
312f864e: folds
Hero: folds
96213652: folds
Uncalled bet ($0.05) returned to d5330762
*** SHOWDOWN ***
d5330762 collected $0.1 from pot
*** SUMMARY ***
Total pot $0.1 | Rake $0 | Jackpot $0 | Bingo $0 | Fortune $0
Seat 1: Hero (button) folded before Flop (didn't bet)
Seat 2: 96213652 (small blind) folded before Flop
Seat 3: d5330762 (big blind) collected ($0.1)
Seat 4: f2b01908 folded before Flop (didn't bet)
Seat 5: 55216799 folded before Flop (didn't bet)
Seat 6: 312f864e folded before Flop (didn't bet)


Poker Hand #RC1467972127: Hold'em No Limit  ($0.05/$0.1) - 2023/04/12 15:43:06
Table 'RushAndCash5517387' 6-max Seat #1 is the button
Seat 1: f26bc305 ($17.41 in chips)
Seat 2: Hero ($10.27 in chips)
Seat 3: be0b6517 ($9.84 in chips)
Seat 4: ee7db857 ($10.53 in chips)
Seat 5: 9a10b576 ($12.17 in chips)
Seat 6: 98342ffc ($10.15 in chips)
Hero: posts small blind $0.05
be0b6517: posts big blind $0.1
*** HOLE CARDS ***
Dealt to f26bc305 
Dealt to Hero [4c Ac]
Dealt to be0b6517 
Dealt to ee7db857 
Dealt to 9a10b576 
Dealt to 98342ffc 
ee7db857: folds
9a10b576: folds
98342ffc: folds
f26bc305: folds
Hero: raises $0.2 to $0.3
be0b6517: folds
Uncalled bet ($0.2) returned to Hero
*** SHOWDOWN ***
Hero collected $0.2 from pot
*** SUMMARY ***
Total pot $0.2 | Rake $0 | Jackpot $0 | Bingo $0 | Fortune $0
Seat 1: f26bc305 (button) folded before Flop (didn't bet)
Seat 2: Hero (small blind) collected ($0.2)
Seat 3: be0b6517 (big blind) folded before Flop
Seat 4: ee7db857 folded before Flop (didn't bet)
Seat 5: 9a10b576 folded before Flop (didn't bet)
Seat 6: 98342ffc folded before Flop (didn't bet)


Poker Hand #RC1467971990: Hold'em No Limit  ($0.05/$0.1) - 2023/04/12 15:42:50
Table 'RushAndCash5517250' 6-max Seat #1 is the button
Seat 1: f503b66 ($10 in chips)
Seat 2: 5d5a5867 ($17.09 in chips)
Seat 3: Hero ($10.37 in chips)
Seat 4: ccb19a96 ($7.67 in chips)
Seat 5: 1d9dc806 ($16.69 in chips)
Seat 6: a23437f4 ($10.7 in chips)
5d5a5867: posts small blind $0.05
Hero: posts big blind $0.1
*** HOLE CARDS ***
Dealt to f503b66 
Dealt to 5d5a5867 
Dealt to Hero [3d 7s]
Dealt to ccb19a96 
Dealt to 1d9dc806 
Dealt to a23437f4 
ccb19a96: folds
1d9dc806: folds
a23437f4: folds
f503b66: raises $0.15 to $0.25
5d5a5867: folds
Hero: folds
Uncalled bet ($0.15) returned to f503b66
*** SHOWDOWN ***
f503b66 collected $0.25 from pot
*** SUMMARY ***
Total pot $0.25 | Rake $0 | Jackpot $0 | Bingo $0 | Fortune $0
Seat 1: f503b66 (button) collected ($0.25)
Seat 2: 5d5a5867 (small blind) folded before Flop
Seat 3: Hero (big blind) folded before Flop
Seat 4: ccb19a96 folded before Flop (didn't bet)
Seat 5: 1d9dc806 folded before Flop (didn't bet)
Seat 6: a23437f4 folded before Flop (didn't bet)


Poker Hand #RC1467971770: Hold'em No Limit  ($0.05/$0.1) - 2023/04/12 15:42:24
Table 'RushAndCash5517030' 6-max Seat #1 is the button
Seat 1: 51a302c9 ($24.99 in chips)
Seat 2: 98342ffc ($10 in chips)
Seat 3: 48d346af ($8.96 in chips)
Seat 4: Hero ($10.05 in chips)
Seat 5: dd057de8 ($10.37 in chips)
Seat 6: 5e165583 ($10.98 in chips)
98342ffc: posts small blind $0.05
48d346af: posts big blind $0.1
*** HOLE CARDS ***
Dealt to 51a302c9 
Dealt to 98342ffc 
Dealt to 48d346af 
Dealt to Hero [9h 9s]
Dealt to dd057de8 
Dealt to 5e165583 
Hero: raises $0.15 to $0.25
dd057de8: folds
5e165583: folds
51a302c9: folds
98342ffc: calls $0.2
48d346af: folds
*** FLOP *** [7h 3s 4d]
98342ffc: checks
Hero: bets $0.4
98342ffc: folds
Uncalled bet ($0.4) returned to Hero
*** SHOWDOWN ***
Hero collected $0.57 from pot
*** SUMMARY ***
Total pot $0.6 | Rake $0.03 | Jackpot $0 | Bingo $0 | Fortune $0
Board [7h 3s 4d]
Seat 1: 51a302c9 (button) folded before Flop (didn't bet)
Seat 2: 98342ffc (small blind) folded on the Flop
Seat 3: 48d346af (big blind) folded before Flop
Seat 4: Hero won ($0.57)
Seat 5: dd057de8 folded before Flop (didn't bet)
Seat 6: 5e165583 folded before Flop (didn't bet)


Poker Hand #RC1467971718: Hold'em No Limit  ($0.05/$0.1) - 2023/04/12 15:42:17
Table 'RushAndCash5516978' 6-max Seat #1 is the button
Seat 1: a2b8fafe ($6.17 in chips)
Seat 2: 2ea35399 ($11.53 in chips)
Seat 3: 50cdddb1 ($10.67 in chips)
Seat 4: cb60ab53 ($26.45 in chips)
Seat 5: 12568bd4 ($11.79 in chips)
Seat 6: Hero ($10.05 in chips)
2ea35399: posts small blind $0.05
50cdddb1: posts big blind $0.1
*** HOLE CARDS ***
Dealt to a2b8fafe 
Dealt to 2ea35399 
Dealt to 50cdddb1 
Dealt to cb60ab53 
Dealt to 12568bd4 
Dealt to Hero [8h Qs]
cb60ab53: folds
12568bd4: raises $0.1 to $0.2
Hero: folds
a2b8fafe: calls $0.2
2ea35399: raises $0.9 to $1.1
50cdddb1: folds
12568bd4: folds
a2b8fafe: folds
Uncalled bet ($0.9) returned to 2ea35399
*** SHOWDOWN ***
2ea35399 collected $0.67 from pot
*** SUMMARY ***
Total pot $0.7 | Rake $0.03 | Jackpot $0 | Bingo $0 | Fortune $0
Seat 1: a2b8fafe (button) folded before Flop
Seat 2: 2ea35399 (small blind) collected ($0.67)
Seat 3: 50cdddb1 (big blind) folded before Flop
Seat 4: cb60ab53 folded before Flop (didn't bet)
Seat 5: 12568bd4 folded before Flop
Seat 6: Hero folded before Flop (didn't bet)


Poker Hand #RC1467971641: Hold'em No Limit  ($0.05/$0.1) - 2023/04/12 15:42:09
Table 'RushAndCash5516901' 6-max Seat #1 is the button
Seat 1: 1b4a3aa6 ($16.21 in chips)
Seat 2: bd2a55c2 ($12.33 in chips)
Seat 3: 9e9b81d2 ($10.28 in chips)
Seat 4: 9fbe53c8 ($10.19 in chips)
Seat 5: bde28c48 ($11.52 in chips)
Seat 6: Hero ($10.05 in chips)
bd2a55c2: posts small blind $0.05
9e9b81d2: posts big blind $0.1
*** HOLE CARDS ***
Dealt to 1b4a3aa6 
Dealt to bd2a55c2 
Dealt to 9e9b81d2 
Dealt to 9fbe53c8 
Dealt to bde28c48 
Dealt to Hero [4d Jc]
9fbe53c8: folds
bde28c48: calls $0.1
Hero: folds
1b4a3aa6: folds
bd2a55c2: folds
9e9b81d2: checks
*** FLOP *** [8d 3h Th]
9e9b81d2: checks
bde28c48: bets $0.15
9e9b81d2: calls $0.15
*** TURN *** [8d 3h Th] [Ad]
9e9b81d2: checks
bde28c48: checks
*** RIVER *** [8d 3h Th Ad] [2c]
9e9b81d2: checks
bde28c48: bets $0.42
9e9b81d2: calls $0.42
bde28c48: shows [Ts 6s] (Pair of Tens)
9e9b81d2: shows [7s 8s] (Pair of Eights)
*** SHOWDOWN ***
bde28c48 collected $1.32 from pot
*** SUMMARY ***
Total pot $1.39 | Rake $0.07 | Jackpot $0 | Bingo $0 | Fortune $0
Board [8d 3h Th Ad 2c]
Seat 1: 1b4a3aa6 (button) folded before Flop (didn't bet)
Seat 2: bd2a55c2 (small blind) folded before Flop
Seat 3: 9e9b81d2 (big blind) showed [7s 8s] and lost with Pair of Eights
Seat 4: 9fbe53c8 folded before Flop (didn't bet)
Seat 5: bde28c48 showed [Ts 6s] and won ($1.32) with Pair of Tens
Seat 6: Hero folded before Flop (didn't bet)


Poker Hand #RC1467971595: Hold'em No Limit  ($0.05/$0.1) - 2023/04/12 15:42:04
Table 'RushAndCash5516855' 6-max Seat #1 is the button
Seat 1: 1d7321df ($16.44 in chips)
Seat 2: 48b83388 ($13.02 in chips)
Seat 3: f2b01908 ($12.74 in chips)
Seat 4: Hero ($10.05 in chips)
Seat 5: ddeddc27 ($3.39 in chips)
Seat 6: c9e29676 ($13.48 in chips)
48b83388: posts small blind $0.05
f2b01908: posts big blind $0.1
*** HOLE CARDS ***
Dealt to 1d7321df 
Dealt to 48b83388 
Dealt to f2b01908 
Dealt to Hero [9c 5s]
Dealt to ddeddc27 
Dealt to c9e29676 
Hero: folds
ddeddc27: raises $0.15 to $0.25
c9e29676: folds
1d7321df: folds
48b83388: folds
f2b01908: folds
Uncalled bet ($0.15) returned to ddeddc27
*** SHOWDOWN ***
ddeddc27 collected $0.25 from pot
*** SUMMARY ***
Total pot $0.25 | Rake $0 | Jackpot $0 | Bingo $0 | Fortune $0
Seat 1: 1d7321df (button) folded before Flop (didn't bet)
Seat 2: 48b83388 (small blind) folded before Flop
Seat 3: f2b01908 (big blind) folded before Flop
Seat 4: Hero folded before Flop (didn't bet)
Seat 5: ddeddc27 collected ($0.25)
Seat 6: c9e29676 folded before Flop (didn't bet)


Poker Hand #RC1467971498: Hold'em No Limit  ($0.05/$0.1) - 2023/04/12 15:41:53
Table 'RushAndCash5516758' 6-max Seat #1 is the button
Seat 1: 5f1ce63e ($11.35 in chips)
Seat 2: cf8c9a08 ($10.21 in chips)
Seat 3: 2db8efb ($13.59 in chips)
Seat 4: 7095e0fe ($10.15 in chips)
Seat 5: Hero ($9.9 in chips)
Seat 6: 37cb2502 ($24.49 in chips)
cf8c9a08: posts small blind $0.05
2db8efb: posts big blind $0.1
*** HOLE CARDS ***
Dealt to 5f1ce63e 
Dealt to cf8c9a08 
Dealt to 2db8efb 
Dealt to 7095e0fe 
Dealt to Hero [5h 5s]
Dealt to 37cb2502 
7095e0fe: folds
Hero: raises $0.15 to $0.25
37cb2502: folds
5f1ce63e: folds
cf8c9a08: folds
2db8efb: folds
Uncalled bet ($0.15) returned to Hero
*** SHOWDOWN ***
Hero collected $0.25 from pot
*** SUMMARY ***
Total pot $0.25 | Rake $0 | Jackpot $0 | Bingo $0 | Fortune $0
Seat 1: 5f1ce63e (button) folded before Flop (didn't bet)
Seat 2: cf8c9a08 (small blind) folded before Flop
Seat 3: 2db8efb (big blind) folded before Flop
Seat 4: 7095e0fe folded before Flop (didn't bet)
Seat 5: Hero collected ($0.25)
Seat 6: 37cb2502 folded before Flop (didn't bet)


Poker Hand #RC1467971397: Hold'em No Limit  ($0.05/$0.1) - 2023/04/12 15:41:39
Table 'RushAndCash5516657' 6-max Seat #1 is the button
Seat 1: 36a5fa7a ($10 in chips)
Seat 2: f0878005 ($17.63 in chips)
Seat 3: Hero ($10 in chips)
Seat 4: afacabc0 ($13.42 in chips)
Seat 5: 4f324fbc ($10.03 in chips)
Seat 6: 11ac4b22 ($10.68 in chips)
f0878005: posts small blind $0.05
Hero: posts big blind $0.1
*** HOLE CARDS ***
Dealt to 36a5fa7a 
Dealt to f0878005 
Dealt to Hero [9c 6s]
Dealt to afacabc0 
Dealt to 4f324fbc 
Dealt to 11ac4b22 
afacabc0: raises $0.1 to $0.2
4f324fbc: folds
11ac4b22: folds
36a5fa7a: folds
f0878005: folds
Hero: folds
Uncalled bet ($0.1) returned to afacabc0
*** SHOWDOWN ***
afacabc0 collected $0.25 from pot
*** SUMMARY ***
Total pot $0.25 | Rake $0 | Jackpot $0 | Bingo $0 | Fortune $0
Seat 1: 36a5fa7a (button) folded before Flop (didn't bet)
Seat 2: f0878005 (small blind) folded before Flop
Seat 3: Hero (big blind) folded before Flop
Seat 4: afacabc0 collected ($0.25)
Seat 5: 4f324fbc folded before Flop (didn't bet)
Seat 6: 11ac4b22 folded before Flop (didn't bet)


Poker Hand #RC1467971362: Hold'em No Limit  ($0.05/$0.1) - 2023/04/12 15:41:35
Table 'RushAndCash5516622' 6-max Seat #1 is the button
Seat 1: Hero ($10 in chips)
Seat 2: c8c12654 ($10.15 in chips)
Seat 3: ccb19a96 ($7.8 in chips)
Seat 4: 26d86c67 ($23.26 in chips)
Seat 5: afacabc0 ($13.42 in chips)
Seat 6: a0fe44a7 ($10.26 in chips)
c8c12654: posts small blind $0.05
ccb19a96: posts big blind $0.1
*** HOLE CARDS ***
Dealt to Hero [Qs 3d]
Dealt to c8c12654 
Dealt to ccb19a96 
Dealt to 26d86c67 
Dealt to afacabc0 
Dealt to a0fe44a7 
26d86c67: raises $0.13 to $0.23
afacabc0: folds
a0fe44a7: folds
Hero: folds
c8c12654: folds
ccb19a96: calls $0.13
*** FLOP *** [Kc 8s 7h]
ccb19a96: checks
26d86c67: bets $0.24
ccb19a96: folds
Uncalled bet ($0.24) returned to 26d86c67
*** SHOWDOWN ***
26d86c67 collected $0.49 from pot
*** SUMMARY ***
Total pot $0.51 | Rake $0.02 | Jackpot $0 | Bingo $0 | Fortune $0
Board [Kc 8s 7h]
Seat 1: Hero (button) folded before Flop (didn't bet)
Seat 2: c8c12654 (small blind) folded before Flop
Seat 3: ccb19a96 (big blind) folded on the Flop
Seat 4: 26d86c67 won ($0.49)
Seat 5: afacabc0 folded before Flop (didn't bet)
Seat 6: a0fe44a7 folded before Flop (didn't bet)


Poker Hand #RC1467971288: Hold'em No Limit  ($0.05/$0.1) - 2023/04/12 15:41:25
Table 'RushAndCash5516548' 6-max Seat #1 is the button
Seat 1: d5330762 ($10 in chips)
Seat 2: c07b91d4 ($11.66 in chips)
Seat 3: 887eeabb ($10 in chips)
Seat 4: b4dba95 ($11.21 in chips)
Seat 5: cd812933 ($7.11 in chips)
Seat 6: Hero ($10 in chips)
c07b91d4: posts small blind $0.05
887eeabb: posts big blind $0.1
*** HOLE CARDS ***
Dealt to d5330762 
Dealt to c07b91d4 
Dealt to 887eeabb 
Dealt to b4dba95 
Dealt to cd812933 
Dealt to Hero [Ks Jh]
b4dba95: raises $0.15 to $0.25
cd812933: folds
Hero: folds
d5330762: folds
c07b91d4: folds
887eeabb: folds
Uncalled bet ($0.15) returned to b4dba95
*** SHOWDOWN ***
b4dba95 collected $0.25 from pot
*** SUMMARY ***
Total pot $0.25 | Rake $0 | Jackpot $0 | Bingo $0 | Fortune $0
Seat 1: d5330762 (button) folded before Flop (didn't bet)
Seat 2: c07b91d4 (small blind) folded before Flop
Seat 3: 887eeabb (big blind) folded before Flop
Seat 4: b4dba95 collected ($0.25)
Seat 5: cd812933 folded before Flop (didn't bet)
Seat 6: Hero folded before Flop (didn't bet)


Poker Hand #RC1467971247: Hold'em No Limit  ($0.05/$0.1) - 2023/04/12 15:41:21
Table 'RushAndCash5516507' 6-max Seat #1 is the button
Seat 1: 84ae99a4 ($10.61 in chips)
Seat 2: Hero ($10.05 in chips)
Seat 3: 6b3cfe62 ($37.89 in chips)
Seat 4: b4dba95 ($11.21 in chips)
Seat 5: c07b91d4 ($11.66 in chips)
Seat 6: 18264f07 ($10.63 in chips)
Hero: posts small blind $0.05
6b3cfe62: posts big blind $0.1
*** HOLE CARDS ***
Dealt to 84ae99a4 
Dealt to Hero [Ts 5c]
Dealt to 6b3cfe62 
Dealt to b4dba95 
Dealt to c07b91d4 
Dealt to 18264f07 
b4dba95: folds
c07b91d4: folds
18264f07: folds
84ae99a4: raises $0.2 to $0.3
Hero: folds
6b3cfe62: folds
Uncalled bet ($0.2) returned to 84ae99a4
*** SHOWDOWN ***
84ae99a4 collected $0.25 from pot
*** SUMMARY ***
Total pot $0.25 | Rake $0 | Jackpot $0 | Bingo $0 | Fortune $0
Seat 1: 84ae99a4 (button) collected ($0.25)
Seat 2: Hero (small blind) folded before Flop
Seat 3: 6b3cfe62 (big blind) folded before Flop
Seat 4: b4dba95 folded before Flop (didn't bet)
Seat 5: c07b91d4 folded before Flop (didn't bet)
Seat 6: 18264f07 folded before Flop (didn't bet)


Poker Hand #RC1467971191: Hold'em No Limit  ($0.05/$0.1) - 2023/04/12 15:41:14
Table 'RushAndCash5516451' 6-max Seat #1 is the button
Seat 1: fa1fe519 ($17.72 in chips)
Seat 2: aad4ee1f ($10.1 in chips)
Seat 3: ffbe1a45 ($9.95 in chips)
Seat 4: 697a403b ($15.69 in chips)
Seat 5: Hero ($10.05 in chips)
Seat 6: 49f98d57 ($10 in chips)
aad4ee1f: posts small blind $0.05
ffbe1a45: posts big blind $0.1
*** HOLE CARDS ***
Dealt to fa1fe519 
Dealt to aad4ee1f 
Dealt to ffbe1a45 
Dealt to 697a403b 
Dealt to Hero [4c 5h]
Dealt to 49f98d57 
697a403b: raises $0.2 to $0.3
Hero: folds
49f98d57: folds
fa1fe519: folds
aad4ee1f: folds
ffbe1a45: folds
Uncalled bet ($0.2) returned to 697a403b
*** SHOWDOWN ***
697a403b collected $0.25 from pot
*** SUMMARY ***
Total pot $0.25 | Rake $0 | Jackpot $0 | Bingo $0 | Fortune $0
Seat 1: fa1fe519 (button) folded before Flop (didn't bet)
Seat 2: aad4ee1f (small blind) folded before Flop
Seat 3: ffbe1a45 (big blind) folded before Flop
Seat 4: 697a403b collected ($0.25)
Seat 5: Hero folded before Flop (didn't bet)
Seat 6: 49f98d57 folded before Flop (didn't bet)


Poker Hand #RC1467971084: Hold'em No Limit  ($0.05/$0.1) - 2023/04/12 15:41:02
Table 'RushAndCash5516344' 6-max Seat #1 is the button
Seat 1: Hero ($9.9 in chips)
Seat 2: d41aa5a0 ($11.8 in chips)
Seat 3: 2226570f ($10 in chips)
Seat 4: f2b01908 ($12.43 in chips)
Seat 5: 8cdabfb8 ($12.01 in chips)
Seat 6: 35a4b2ea ($10 in chips)
d41aa5a0: posts small blind $0.05
2226570f: posts big blind $0.1
*** HOLE CARDS ***
Dealt to Hero [3d 8s]
Dealt to d41aa5a0 
Dealt to 2226570f 
Dealt to f2b01908 
Dealt to 8cdabfb8 
Dealt to 35a4b2ea 
f2b01908: folds
8cdabfb8: raises $0.13 to $0.23
35a4b2ea: folds
Hero: folds
d41aa5a0: folds
2226570f: calls $0.13
*** FLOP *** [6h 2c Jd]
2226570f: checks
8cdabfb8: checks
*** TURN *** [6h 2c Jd] [3h]
2226570f: bets $0.34
8cdabfb8: folds
Uncalled bet ($0.34) returned to 2226570f
*** SHOWDOWN ***
2226570f collected $0.49 from pot
*** SUMMARY ***
Total pot $0.51 | Rake $0.02 | Jackpot $0 | Bingo $0 | Fortune $0
Board [6h 2c Jd 3h]
Seat 1: Hero (button) folded before Flop (didn't bet)
Seat 2: d41aa5a0 (small blind) folded before Flop
Seat 3: 2226570f (big blind) won ($0.49)
Seat 4: f2b01908 folded before Flop (didn't bet)
Seat 5: 8cdabfb8 folded on the Turn
Seat 6: 35a4b2ea folded before Flop (didn't bet)


Poker Hand #RC1467971049: Hold'em No Limit  ($0.05/$0.1) - 2023/04/12 15:40:57
Table 'RushAndCash5516309' 6-max Seat #1 is the button
Seat 1: cc4a12f0 ($14.37 in chips)
Seat 2: 707258d3 ($10 in chips)
Seat 3: Hero ($10 in chips)
Seat 4: 2356722 ($10.02 in chips)
Seat 5: f5445b8a ($10.1 in chips)
Seat 6: b65022ac ($12.45 in chips)
707258d3: posts small blind $0.05
Hero: posts big blind $0.1
*** HOLE CARDS ***
Dealt to cc4a12f0 
Dealt to 707258d3 
Dealt to Hero [Th 8s]
Dealt to 2356722 
Dealt to f5445b8a 
Dealt to b65022ac 
2356722: folds
f5445b8a: folds
b65022ac: folds
cc4a12f0: folds
707258d3: folds
Uncalled bet ($0.05) returned to Hero
*** SHOWDOWN ***
Hero collected $0.1 from pot
*** SUMMARY ***
Total pot $0.1 | Rake $0 | Jackpot $0 | Bingo $0 | Fortune $0
Seat 1: cc4a12f0 (button) folded before Flop (didn't bet)
Seat 2: 707258d3 (small blind) folded before Flop
Seat 3: Hero (big blind) collected ($0.1)
Seat 4: 2356722 folded before Flop (didn't bet)
Seat 5: f5445b8a folded before Flop (didn't bet)
Seat 6: b65022ac folded before Flop (didn't bet)


Poker Hand #RC1467970889: Hold'em No Limit  ($0.05/$0.1) - 2023/04/12 15:40:41
Table 'RushAndCash5516149' 6-max Seat #1 is the button
Seat 1: 74ec0dc8 ($12 in chips)
Seat 2: Hero ($10.05 in chips)
Seat 3: 46348693 ($16.33 in chips)
Seat 4: 2510be7 ($11.05 in chips)
Seat 5: 73f9955f ($12.42 in chips)
Seat 6: 39f7151d ($10 in chips)
Hero: posts small blind $0.05
46348693: posts big blind $0.1
*** HOLE CARDS ***
Dealt to 74ec0dc8 
Dealt to Hero [Jc 7c]
Dealt to 46348693 
Dealt to 2510be7 
Dealt to 73f9955f 
Dealt to 39f7151d 
2510be7: folds
73f9955f: folds
39f7151d: raises $0.15 to $0.25
74ec0dc8: raises $0.65 to $0.9
Hero: folds
46348693: raises $1.2 to $2.1
39f7151d: folds
74ec0dc8: folds
Uncalled bet ($1.2) returned to 46348693
*** SHOWDOWN ***
46348693 collected $2 from pot
*** SUMMARY ***
Total pot $2.1 | Rake $0.1 | Jackpot $0 | Bingo $0 | Fortune $0
Seat 1: 74ec0dc8 (button) folded before Flop
Seat 2: Hero (small blind) folded before Flop
Seat 3: 46348693 (big blind) collected ($2)
Seat 4: 2510be7 folded before Flop (didn't bet)
Seat 5: 73f9955f folded before Flop (didn't bet)
Seat 6: 39f7151d folded before Flop


Poker Hand #RC1467969982: Hold'em No Limit  ($0.05/$0.1) - 2023/04/12 15:38:55
Table 'RushAndCash5515242' 6-max Seat #1 is the button
Seat 1: 43ed2541 ($10.76 in chips)
Seat 2: 497a59bf ($10.05 in chips)
Seat 3: 8c321e77 ($10 in chips)
Seat 4: 46348693 ($14.62 in chips)
Seat 5: Hero ($11.95 in chips)
Seat 6: d47da05f ($14.05 in chips)
497a59bf: posts small blind $0.05
8c321e77: posts big blind $0.1
*** HOLE CARDS ***
Dealt to 43ed2541 
Dealt to 497a59bf 
Dealt to 8c321e77 
Dealt to 46348693 
Dealt to Hero [Jd Jc]
Dealt to d47da05f 
46348693: raises $0.2 to $0.3
Hero: raises $0.62 to $0.92
d47da05f: folds
43ed2541: folds
497a59bf: folds
8c321e77: folds
46348693: raises $0.98 to $1.9
Hero: calls $0.98
*** FLOP *** [7s Th Kd]
46348693: checks
Hero: checks
*** TURN *** [7s Th Kd] [9s]
46348693: bets $2.97
Hero: folds
Uncalled bet ($2.97) returned to 46348693
*** SHOWDOWN ***
46348693 collected $3.61 from pot
*** SUMMARY ***
Total pot $3.95 | Rake $0.19 | Jackpot $0.15 | Bingo $0 | Fortune $0
Board [7s Th Kd 9s]
Seat 1: 43ed2541 (button) folded before Flop (didn't bet)
Seat 2: 497a59bf (small blind) folded before Flop
Seat 3: 8c321e77 (big blind) folded before Flop
Seat 4: 46348693 won ($3.61)
Seat 5: Hero folded on the Turn
Seat 6: d47da05f folded before Flop (didn't bet)


Poker Hand #RC1467969938: Hold'em No Limit  ($0.05/$0.1) - 2023/04/12 15:38:49
Table 'RushAndCash5515198' 6-max Seat #1 is the button
Seat 1: d2aa52ff ($14.25 in chips)
Seat 2: b65022ac ($11.62 in chips)
Seat 3: c6d43ffa ($10.3 in chips)
Seat 4: Hero ($11.95 in chips)
Seat 5: cea019e6 ($10.18 in chips)
Seat 6: 9cbf1b58 ($7.49 in chips)
b65022ac: posts small blind $0.05
c6d43ffa: posts big blind $0.1
*** HOLE CARDS ***
Dealt to d2aa52ff 
Dealt to b65022ac 
Dealt to c6d43ffa 
Dealt to Hero [8h 3d]
Dealt to cea019e6 
Dealt to 9cbf1b58 
Hero: folds
cea019e6: raises $0.15 to $0.25
9cbf1b58: calls $0.25
d2aa52ff: folds
b65022ac: folds
c6d43ffa: calls $0.15
*** FLOP *** [6s 2h 3c]
c6d43ffa: checks
cea019e6: checks
9cbf1b58: checks
*** TURN *** [6s 2h 3c] [5s]
c6d43ffa: checks
cea019e6: checks
9cbf1b58: bets $0.36
c6d43ffa: folds
cea019e6: folds
Uncalled bet ($0.36) returned to 9cbf1b58
*** SHOWDOWN ***
9cbf1b58 collected $0.76 from pot
*** SUMMARY ***
Total pot $0.8 | Rake $0.04 | Jackpot $0 | Bingo $0 | Fortune $0
Board [6s 2h 3c 5s]
Seat 1: d2aa52ff (button) folded before Flop (didn't bet)
Seat 2: b65022ac (small blind) folded before Flop
Seat 3: c6d43ffa (big blind) folded on the Turn
Seat 4: Hero folded before Flop (didn't bet)
Seat 5: cea019e6 folded on the Turn
Seat 6: 9cbf1b58 won ($0.76)


Poker Hand #RC1467969885: Hold'em No Limit  ($0.05/$0.1) - 2023/04/12 15:38:44
Table 'RushAndCash5515145' 6-max Seat #1 is the button
Seat 1: e99cb144 ($10 in chips)
Seat 2: 1d7c1213 ($51.43 in chips)
Seat 3: 70272f5a ($18.61 in chips)
Seat 4: Hero ($11.95 in chips)
Seat 5: eaf0c4e5 ($12.7 in chips)
Seat 6: fa1fe519 ($18.6 in chips)
1d7c1213: posts small blind $0.05
70272f5a: posts big blind $0.1
*** HOLE CARDS ***
Dealt to e99cb144 
Dealt to 1d7c1213 
Dealt to 70272f5a 
Dealt to Hero [Kh Jd]
Dealt to eaf0c4e5 
Dealt to fa1fe519 
Hero: folds
eaf0c4e5: folds
fa1fe519: folds
e99cb144: folds
1d7c1213: folds
Uncalled bet ($0.05) returned to 70272f5a
*** SHOWDOWN ***
70272f5a collected $0.1 from pot
*** SUMMARY ***
Total pot $0.1 | Rake $0 | Jackpot $0 | Bingo $0 | Fortune $0
Seat 1: e99cb144 (button) folded before Flop (didn't bet)
Seat 2: 1d7c1213 (small blind) folded before Flop
Seat 3: 70272f5a (big blind) collected ($0.1)
Seat 4: Hero folded before Flop (didn't bet)
Seat 5: eaf0c4e5 folded before Flop (didn't bet)
Seat 6: fa1fe519 folded before Flop (didn't bet)


Poker Hand #RC1467969848: Hold'em No Limit  ($0.05/$0.1) - 2023/04/12 15:38:39
Table 'RushAndCash5515108' 6-max Seat #1 is the button
Seat 1: 25c75e1c ($13.09 in chips)
Seat 2: 587e3bc5 ($10.06 in chips)
Seat 3: fa1fe519 ($18.7 in chips)
Seat 4: 2f597316 ($9.71 in chips)
Seat 5: e77b7178 ($17.41 in chips)
Seat 6: Hero ($11.95 in chips)
587e3bc5: posts small blind $0.05
fa1fe519: posts big blind $0.1
*** HOLE CARDS ***
Dealt to 25c75e1c 
Dealt to 587e3bc5 
Dealt to fa1fe519 
Dealt to 2f597316 
Dealt to e77b7178 
Dealt to Hero [6d Kc]
2f597316: raises $0.15 to $0.25
e77b7178: folds
Hero: folds
25c75e1c: folds
587e3bc5: folds
fa1fe519: folds
Uncalled bet ($0.15) returned to 2f597316
*** SHOWDOWN ***
2f597316 collected $0.25 from pot
*** SUMMARY ***
Total pot $0.25 | Rake $0 | Jackpot $0 | Bingo $0 | Fortune $0
Seat 1: 25c75e1c (button) folded before Flop (didn't bet)
Seat 2: 587e3bc5 (small blind) folded before Flop
Seat 3: fa1fe519 (big blind) folded before Flop
Seat 4: 2f597316 collected ($0.25)
Seat 5: e77b7178 folded before Flop (didn't bet)
Seat 6: Hero folded before Flop (didn't bet)


Poker Hand #RC1467969790: Hold'em No Limit  ($0.05/$0.1) - 2023/04/12 15:38:32
Table 'RushAndCash5515050' 6-max Seat #1 is the button
Seat 1: 8995a93d ($10.43 in chips)
Seat 2: 2a9ce08f ($10 in chips)
Seat 3: Hero ($12.05 in chips)
Seat 4: f503b66 ($11.73 in chips)
Seat 5: a2b8fafe ($10.45 in chips)
Seat 6: 1bd3bc3d ($18.68 in chips)
2a9ce08f: posts small blind $0.05
Hero: posts big blind $0.1
*** HOLE CARDS ***
Dealt to 8995a93d 
Dealt to 2a9ce08f 
Dealt to Hero [3h 2s]
Dealt to f503b66 
Dealt to a2b8fafe 
Dealt to 1bd3bc3d 
f503b66: folds
a2b8fafe: folds
1bd3bc3d: folds
8995a93d: raises $0.1 to $0.2
2a9ce08f: folds
Hero: folds
Uncalled bet ($0.1) returned to 8995a93d
*** SHOWDOWN ***
8995a93d collected $0.25 from pot
*** SUMMARY ***
Total pot $0.25 | Rake $0 | Jackpot $0 | Bingo $0 | Fortune $0
Seat 1: 8995a93d (button) collected ($0.25)
Seat 2: 2a9ce08f (small blind) folded before Flop
Seat 3: Hero (big blind) folded before Flop
Seat 4: f503b66 folded before Flop (didn't bet)
Seat 5: a2b8fafe folded before Flop (didn't bet)
Seat 6: 1bd3bc3d folded before Flop (didn't bet)


Poker Hand #RC1467969744: Hold'em No Limit  ($0.05/$0.1) - 2023/04/12 15:38:27
Table 'RushAndCash5515004' 6-max Seat #1 is the button
Seat 1: Hero ($12.05 in chips)
Seat 2: 29f6dd38 ($8.02 in chips)
Seat 3: bde28c48 ($11.17 in chips)
Seat 4: cf8c9a08 ($10.09 in chips)
Seat 5: a37a90c9 ($10 in chips)
Seat 6: 1a1ee5c6 ($8.72 in chips)
29f6dd38: posts small blind $0.05
bde28c48: posts big blind $0.1
*** HOLE CARDS ***
Dealt to Hero [2c Qh]
Dealt to 29f6dd38 
Dealt to bde28c48 
Dealt to cf8c9a08 
Dealt to a37a90c9 
Dealt to 1a1ee5c6 
cf8c9a08: folds
a37a90c9: folds
1a1ee5c6: folds
Hero: folds
29f6dd38: raises $0.1 to $0.2
bde28c48: folds
Uncalled bet ($0.1) returned to 29f6dd38
*** SHOWDOWN ***
29f6dd38 collected $0.2 from pot
*** SUMMARY ***
Total pot $0.2 | Rake $0 | Jackpot $0 | Bingo $0 | Fortune $0
Seat 1: Hero (button) folded before Flop (didn't bet)
Seat 2: 29f6dd38 (small blind) collected ($0.2)
Seat 3: bde28c48 (big blind) folded before Flop
Seat 4: cf8c9a08 folded before Flop (didn't bet)
Seat 5: a37a90c9 folded before Flop (didn't bet)
Seat 6: 1a1ee5c6 folded before Flop (didn't bet)


Poker Hand #RC1467969670: Hold'em No Limit  ($0.05/$0.1) - 2023/04/12 15:38:17
Table 'RushAndCash5514930' 6-max Seat #1 is the button
Seat 1: ba8619a5 ($10.45 in chips)
Seat 2: Hero ($12.1 in chips)
Seat 3: 27caed27 ($11.06 in chips)
Seat 4: 19039d1d ($5.08 in chips)
Seat 5: b8271fd1 ($16.85 in chips)
Seat 6: ce6e887a ($10 in chips)
Hero: posts small blind $0.05
27caed27: posts big blind $0.1
*** HOLE CARDS ***
Dealt to ba8619a5 
Dealt to Hero [3h 8s]
Dealt to 27caed27 
Dealt to 19039d1d 
Dealt to b8271fd1 
Dealt to ce6e887a 
19039d1d: folds
b8271fd1: folds
ce6e887a: folds
ba8619a5: folds
Hero: folds
Uncalled bet ($0.05) returned to 27caed27
*** SHOWDOWN ***
27caed27 collected $0.1 from pot
*** SUMMARY ***
Total pot $0.1 | Rake $0 | Jackpot $0 | Bingo $0 | Fortune $0
Seat 1: ba8619a5 (button) folded before Flop (didn't bet)
Seat 2: Hero (small blind) folded before Flop
Seat 3: 27caed27 (big blind) collected ($0.1)
Seat 4: 19039d1d folded before Flop (didn't bet)
Seat 5: b8271fd1 folded before Flop (didn't bet)
Seat 6: ce6e887a folded before Flop (didn't bet)


Poker Hand #RC1467969601: Hold'em No Limit  ($0.05/$0.1) - 2023/04/12 15:38:10
Table 'RushAndCash5514861' 6-max Seat #1 is the button
Seat 1: b8c0a7fc ($16.06 in chips)
Seat 2: cf8c9a08 ($10.14 in chips)
Seat 3: 587e3bc5 ($10.31 in chips)
Seat 4: 27caed27 ($11.06 in chips)
Seat 5: Hero ($12.1 in chips)
Seat 6: 41a2caec ($7.58 in chips)
cf8c9a08: posts small blind $0.05
587e3bc5: posts big blind $0.1
*** HOLE CARDS ***
Dealt to b8c0a7fc 
Dealt to cf8c9a08 
Dealt to 587e3bc5 
Dealt to 27caed27 
Dealt to Hero [9c 6s]
Dealt to 41a2caec 
27caed27: folds
Hero: folds
41a2caec: folds
b8c0a7fc: raises $0.15 to $0.25
cf8c9a08: folds
587e3bc5: folds
Uncalled bet ($0.15) returned to b8c0a7fc
*** SHOWDOWN ***
b8c0a7fc collected $0.25 from pot
*** SUMMARY ***
Total pot $0.25 | Rake $0 | Jackpot $0 | Bingo $0 | Fortune $0
Seat 1: b8c0a7fc (button) collected ($0.25)
Seat 2: cf8c9a08 (small blind) folded before Flop
Seat 3: 587e3bc5 (big blind) folded before Flop
Seat 4: 27caed27 folded before Flop (didn't bet)
Seat 5: Hero folded before Flop (didn't bet)
Seat 6: 41a2caec folded before Flop (didn't bet)


Poker Hand #RC1467969483: Hold'em No Limit  ($0.05/$0.1) - 2023/04/12 15:37:55
Table 'RushAndCash5514743' 6-max Seat #1 is the button
Seat 1: 7903d490 ($11.56 in chips)
Seat 2: c63ad623 ($9.21 in chips)
Seat 3: f1f32720 ($22.22 in chips)
Seat 4: 6787f85a ($10.62 in chips)
Seat 5: Hero ($11.95 in chips)
Seat 6: ae03fcc6 ($10.42 in chips)
c63ad623: posts small blind $0.05
f1f32720: posts big blind $0.1
*** HOLE CARDS ***
Dealt to 7903d490 
Dealt to c63ad623 
Dealt to f1f32720 
Dealt to 6787f85a 
Dealt to Hero [Ks Ts]
Dealt to ae03fcc6 
6787f85a: folds
Hero: raises $0.15 to $0.25
ae03fcc6: folds
7903d490: folds
c63ad623: folds
f1f32720: folds
Uncalled bet ($0.15) returned to Hero
*** SHOWDOWN ***
Hero collected $0.25 from pot
*** SUMMARY ***
Total pot $0.25 | Rake $0 | Jackpot $0 | Bingo $0 | Fortune $0
Seat 1: 7903d490 (button) folded before Flop (didn't bet)
Seat 2: c63ad623 (small blind) folded before Flop
Seat 3: f1f32720 (big blind) folded before Flop
Seat 4: 6787f85a folded before Flop (didn't bet)
Seat 5: Hero collected ($0.25)
Seat 6: ae03fcc6 folded before Flop (didn't bet)


Poker Hand #RC1467969138: Hold'em No Limit  ($0.05/$0.1) - 2023/04/12 15:37:14
Table 'RushAndCash5514398' 6-max Seat #1 is the button
Seat 1: 3e673b5a ($20.95 in chips)
Seat 2: Hero ($11.48 in chips)
Seat 3: 31c83e63 ($17.93 in chips)
Seat 4: e974108b ($11.84 in chips)
Seat 5: a18cab94 ($10.1 in chips)
Seat 6: 7903d490 ($11.81 in chips)
Hero: posts small blind $0.05
31c83e63: posts big blind $0.1
*** HOLE CARDS ***
Dealt to 3e673b5a 
Dealt to Hero [6s 6c]
Dealt to 31c83e63 
Dealt to e974108b 
Dealt to a18cab94 
Dealt to 7903d490 
e974108b: folds
a18cab94: folds
7903d490: raises $0.15 to $0.25
3e673b5a: folds
Hero: calls $0.2
31c83e63: folds
*** FLOP *** [Qc 4h 8c]
Hero: checks
7903d490: checks
*** TURN *** [Qc 4h 8c] [7c]
Hero: bets $0.2
7903d490: folds
Uncalled bet ($0.2) returned to Hero
*** SHOWDOWN ***
Hero collected $0.57 from pot
*** SUMMARY ***
Total pot $0.6 | Rake $0.03 | Jackpot $0 | Bingo $0 | Fortune $0
Board [Qc 4h 8c 7c]
Seat 1: 3e673b5a (button) folded before Flop (didn't bet)
Seat 2: Hero (small blind) won ($0.57)
Seat 3: 31c83e63 (big blind) folded before Flop
Seat 4: e974108b folded before Flop (didn't bet)
Seat 5: a18cab94 folded before Flop (didn't bet)
Seat 6: 7903d490 folded on the Turn


Poker Hand #RC1467969083: Hold'em No Limit  ($0.05/$0.1) - 2023/04/12 15:37:07
Table 'RushAndCash5514343' 6-max Seat #1 is the button
Seat 1: 9e73201d ($10 in chips)
Seat 2: baf82713 ($18.98 in chips)
Seat 3: Hero ($11.58 in chips)
Seat 4: 9b3c3698 ($8.42 in chips)
Seat 5: 74f03d83 ($12.5 in chips)
Seat 6: c2211fc6 ($10.64 in chips)
baf82713: posts small blind $0.05
Hero: posts big blind $0.1
*** HOLE CARDS ***
Dealt to 9e73201d 
Dealt to baf82713 
Dealt to Hero [2c 8h]
Dealt to 9b3c3698 
Dealt to 74f03d83 
Dealt to c2211fc6 
9b3c3698: folds
74f03d83: folds
c2211fc6: folds
9e73201d: folds
baf82713: folds
Uncalled bet ($0.05) returned to Hero
*** SHOWDOWN ***
Hero collected $0.1 from pot
*** SUMMARY ***
Total pot $0.1 | Rake $0 | Jackpot $0 | Bingo $0 | Fortune $0
Seat 1: 9e73201d (button) folded before Flop (didn't bet)
Seat 2: baf82713 (small blind) folded before Flop
Seat 3: Hero (big blind) collected ($0.1)
Seat 4: 9b3c3698 folded before Flop (didn't bet)
Seat 5: 74f03d83 folded before Flop (didn't bet)
Seat 6: c2211fc6 folded before Flop (didn't bet)


Poker Hand #RC1467968915: Hold'em No Limit  ($0.05/$0.1) - 2023/04/12 15:36:49
Table 'RushAndCash5514175' 6-max Seat #1 is the button
Seat 1: Hero ($11.58 in chips)
Seat 2: a39d28e4 ($20.61 in chips)
Seat 3: f3ebf5a4 ($10.2 in chips)
Seat 4: 43ed2541 ($10.59 in chips)
Seat 5: a41754d0 ($10 in chips)
Seat 6: 273567f7 ($10.58 in chips)
a39d28e4: posts small blind $0.05
f3ebf5a4: posts big blind $0.1
*** HOLE CARDS ***
Dealt to Hero [9s 5d]
Dealt to a39d28e4 
Dealt to f3ebf5a4 
Dealt to 43ed2541 
Dealt to a41754d0 
Dealt to 273567f7 
43ed2541: folds
a41754d0: raises $0.15 to $0.25
273567f7: folds
Hero: folds
a39d28e4: folds
f3ebf5a4: folds
Uncalled bet ($0.15) returned to a41754d0
*** SHOWDOWN ***
a41754d0 collected $0.25 from pot
*** SUMMARY ***
Total pot $0.25 | Rake $0 | Jackpot $0 | Bingo $0 | Fortune $0
Seat 1: Hero (button) folded before Flop (didn't bet)
Seat 2: a39d28e4 (small blind) folded before Flop
Seat 3: f3ebf5a4 (big blind) folded before Flop
Seat 4: 43ed2541 folded before Flop (didn't bet)
Seat 5: a41754d0 collected ($0.25)
Seat 6: 273567f7 folded before Flop (didn't bet)


Poker Hand #RC1467968744: Hold'em No Limit  ($0.05/$0.1) - 2023/04/12 15:36:29
Table 'RushAndCash5514004' 6-max Seat #1 is the button
Seat 1: 14f925fa ($10.31 in chips)
Seat 2: e249c43 ($9.75 in chips)
Seat 3: b00d5510 ($10.58 in chips)
Seat 4: Hero ($11.43 in chips)
Seat 5: eef1755d ($10.15 in chips)
Seat 6: a1201edb ($17.46 in chips)
e249c43: posts small blind $0.05
b00d5510: posts big blind $0.1
*** HOLE CARDS ***
Dealt to 14f925fa 
Dealt to e249c43 
Dealt to b00d5510 
Dealt to Hero [Qs Ad]
Dealt to eef1755d 
Dealt to a1201edb 
Hero: raises $0.15 to $0.25
eef1755d: folds
a1201edb: folds
14f925fa: folds
e249c43: folds
b00d5510: folds
Uncalled bet ($0.15) returned to Hero
*** SHOWDOWN ***
Hero collected $0.25 from pot
*** SUMMARY ***
Total pot $0.25 | Rake $0 | Jackpot $0 | Bingo $0 | Fortune $0
Seat 1: 14f925fa (button) folded before Flop (didn't bet)
Seat 2: e249c43 (small blind) folded before Flop
Seat 3: b00d5510 (big blind) folded before Flop
Seat 4: Hero collected ($0.25)
Seat 5: eef1755d folded before Flop (didn't bet)
Seat 6: a1201edb folded before Flop (didn't bet)


Poker Hand #RC1467968696: Hold'em No Limit  ($0.05/$0.1) - 2023/04/12 15:36:23
Table 'RushAndCash5513956' 6-max Seat #1 is the button
Seat 1: cd94488c ($10 in chips)
Seat 2: a1909bdf ($22.16 in chips)
Seat 3: 9e317c8b ($10 in chips)
Seat 4: Hero ($11.43 in chips)
Seat 5: e1c8ef1d ($10.25 in chips)
Seat 6: d697ab49 ($10.82 in chips)
a1909bdf: posts small blind $0.05
9e317c8b: posts big blind $0.1
*** HOLE CARDS ***
Dealt to cd94488c 
Dealt to a1909bdf 
Dealt to 9e317c8b 
Dealt to Hero [6d 2s]
Dealt to e1c8ef1d 
Dealt to d697ab49 
Hero: folds
e1c8ef1d: folds
d697ab49: raises $0.1 to $0.2
cd94488c: folds
a1909bdf: raises $0.4 to $0.6
9e317c8b: folds
d697ab49: calls $0.4
*** FLOP *** [3c 9h Td]
a1909bdf: bets $3.7
d697ab49: folds
Uncalled bet ($3.7) returned to a1909bdf
*** SHOWDOWN ***
a1909bdf collected $1.24 from pot
*** SUMMARY ***
Total pot $1.3 | Rake $0.06 | Jackpot $0 | Bingo $0 | Fortune $0
Board [3c 9h Td]
Seat 1: cd94488c (button) folded before Flop (didn't bet)
Seat 2: a1909bdf (small blind) won ($1.24)
Seat 3: 9e317c8b (big blind) folded before Flop
Seat 4: Hero folded before Flop (didn't bet)
Seat 5: e1c8ef1d folded before Flop (didn't bet)
Seat 6: d697ab49 folded on the Flop


Poker Hand #RC1467968607: Hold'em No Limit  ($0.05/$0.1) - 2023/04/12 15:36:11
Table 'RushAndCash5513867' 6-max Seat #1 is the button
Seat 1: Hero ($11.43 in chips)
Seat 2: 80c73401 ($42.66 in chips)
Seat 3: 41650a84 ($4.63 in chips)
Seat 4: bc1779f ($10 in chips)
Seat 5: ebb82bce ($8.96 in chips)
Seat 6: d43ffcc9 ($8.4 in chips)
80c73401: posts small blind $0.05
41650a84: posts big blind $0.1
*** HOLE CARDS ***
Dealt to Hero [2h 4c]
Dealt to 80c73401 
Dealt to 41650a84 
Dealt to bc1779f 
Dealt to ebb82bce 
Dealt to d43ffcc9 
bc1779f: folds
ebb82bce: folds
d43ffcc9: raises $0.1 to $0.2
Hero: folds
80c73401: folds
41650a84: folds
Uncalled bet ($0.1) returned to d43ffcc9
*** SHOWDOWN ***
d43ffcc9 collected $0.25 from pot
*** SUMMARY ***
Total pot $0.25 | Rake $0 | Jackpot $0 | Bingo $0 | Fortune $0
Seat 1: Hero (button) folded before Flop (didn't bet)
Seat 2: 80c73401 (small blind) folded before Flop
Seat 3: 41650a84 (big blind) folded before Flop
Seat 4: bc1779f folded before Flop (didn't bet)
Seat 5: ebb82bce folded before Flop (didn't bet)
Seat 6: d43ffcc9 collected ($0.25)


Poker Hand #RC1467968548: Hold'em No Limit  ($0.05/$0.1) - 2023/04/12 15:36:03
Table 'RushAndCash5513808' 6-max Seat #1 is the button
Seat 1: 830b8437 ($10.81 in chips)
Seat 2: Hero ($11.48 in chips)
Seat 3: d1b16232 ($9.68 in chips)
Seat 4: 3c2eb6cf ($9.47 in chips)
Seat 5: 4e64da7c ($11.7 in chips)
Seat 6: 33a288a7 ($32.2 in chips)
Hero: posts small blind $0.05
d1b16232: posts big blind $0.1
*** HOLE CARDS ***
Dealt to 830b8437 
Dealt to Hero [Tc 3c]
Dealt to d1b16232 
Dealt to 3c2eb6cf 
Dealt to 4e64da7c 
Dealt to 33a288a7 
3c2eb6cf: folds
4e64da7c: folds
33a288a7: folds
830b8437: folds
Hero: folds
Uncalled bet ($0.05) returned to d1b16232
*** SHOWDOWN ***
d1b16232 collected $0.1 from pot
*** SUMMARY ***
Total pot $0.1 | Rake $0 | Jackpot $0 | Bingo $0 | Fortune $0
Seat 1: 830b8437 (button) folded before Flop (didn't bet)
Seat 2: Hero (small blind) folded before Flop
Seat 3: d1b16232 (big blind) collected ($0.1)
Seat 4: 3c2eb6cf folded before Flop (didn't bet)
Seat 5: 4e64da7c folded before Flop (didn't bet)
Seat 6: 33a288a7 folded before Flop (didn't bet)


Poker Hand #RC1467967977: Hold'em No Limit  ($0.05/$0.1) - 2023/04/12 15:34:49
Table 'RushAndCash5513237' 6-max Seat #1 is the button
Seat 1: aaccdce2 ($11.58 in chips)
Seat 2: e481b18e ($10 in chips)
Seat 3: 76aab391 ($11.12 in chips)
Seat 4: d1b16232 ($11.37 in chips)
Seat 5: c095780d ($10.56 in chips)
Seat 6: Hero ($9.95 in chips)
e481b18e: posts small blind $0.05
76aab391: posts big blind $0.1
*** HOLE CARDS ***
Dealt to aaccdce2 
Dealt to e481b18e 
Dealt to 76aab391 
Dealt to d1b16232 
Dealt to c095780d 
Dealt to Hero [Jh Js]
d1b16232: raises $0.15 to $0.25
c095780d: folds
Hero: raises $0.54 to $0.79
aaccdce2: folds
e481b18e: folds
76aab391: folds
d1b16232: calls $0.54
*** FLOP *** [Kd 9h 4h]
d1b16232: checks
Hero: checks
*** TURN *** [Kd 9h 4h] [8d]
d1b16232: bets $0.9
Hero: calls $0.9
*** RIVER *** [Kd 9h 4h 8d] [5c]
d1b16232: checks
Hero: checks
d1b16232: shows [Tc Ts] (Pair of Tens)
Hero: shows [Jh Js] (Pair of Jacks)
*** SHOWDOWN ***
Hero collected $3.22 from pot
*** SUMMARY ***
Total pot $3.53 | Rake $0.16 | Jackpot $0.15 | Bingo $0 | Fortune $0
Board [Kd 9h 4h 8d 5c]
Seat 1: aaccdce2 (button) folded before Flop (didn't bet)
Seat 2: e481b18e (small blind) folded before Flop
Seat 3: 76aab391 (big blind) folded before Flop
Seat 4: d1b16232 showed [Tc Ts] and lost with Pair of Tens
Seat 5: c095780d folded before Flop (didn't bet)
Seat 6: Hero showed [Jh Js] and won ($3.22) with Pair of Jacks


Poker Hand #RC1467967906: Hold'em No Limit  ($0.05/$0.1) - 2023/04/12 15:34:40
Table 'RushAndCash5513166' 6-max Seat #1 is the button
Seat 1: d5e1a6b5 ($4.01 in chips)
Seat 2: b904aff3 ($11.09 in chips)
Seat 3: Hero ($10.05 in chips)
Seat 4: bbc7a77a ($12.87 in chips)
Seat 5: 50cdddb1 ($10 in chips)
Seat 6: b704fdcc ($12.21 in chips)
b904aff3: posts small blind $0.05
Hero: posts big blind $0.1
*** HOLE CARDS ***
Dealt to d5e1a6b5 
Dealt to b904aff3 
Dealt to Hero [5h 9d]
Dealt to bbc7a77a 
Dealt to 50cdddb1 
Dealt to b704fdcc 
bbc7a77a: folds
50cdddb1: folds
b704fdcc: folds
d5e1a6b5: raises $0.14 to $0.24
b904aff3: raises $0.76 to $1
Hero: folds
d5e1a6b5: raises $1.26 to $2.26
b904aff3: calls $1.26
*** FLOP *** [9s Ac As]
b904aff3: checks
d5e1a6b5: bets $1.75 and is all-in
b904aff3: calls $1.75
d5e1a6b5: shows [Qh Qc] (Pair of Aces and Pair of Queens)
b904aff3: shows [Kd Ah] (Three Aces)
*** FIRST TURN *** [9s Ac As] [8d]
*** FIRST RIVER *** [9s Ac As 8d] [6c]
*** SECOND TURN *** [9s Ac As] [Ks]
*** SECOND RIVER *** [9s Ac As Ks] [3h]
*** FIRST SHOWDOWN ***
b904aff3 collected $3.84 from pot
*** SECOND SHOWDOWN ***
b904aff3 collected $3.83 from pot
*** SUMMARY ***
Total pot $8.12 | Rake $0.3 | Jackpot $0.15 | Bingo $0 | Fortune $0
Hand was run two times
FIRST Board [9s Ac As 8d 6c]
SECOND Board [Ks 3h]
Seat 1: d5e1a6b5 (button) showed [Qh Qc] and lost with Pair of Aces and Pair of Queens, and lost
Seat 2: b904aff3 (small blind) showed [Kd Ah] and won ($3.84) with Three Aces, and won ($3.83)
Seat 3: Hero (big blind) folded before Flop
Seat 4: bbc7a77a folded before Flop (didn't bet)
Seat 5: 50cdddb1 folded before Flop (didn't bet)
Seat 6: b704fdcc folded before Flop (didn't bet)


Poker Hand #RC1467967855: Hold'em No Limit  ($0.05/$0.1) - 2023/04/12 15:34:34
Table 'RushAndCash5513115' 6-max Seat #1 is the button
Seat 1: 74f03d83 ($10.39 in chips)
Seat 2: 3c3bd770 ($10.68 in chips)
Seat 3: add94475 ($14.53 in chips)
Seat 4: 4df7250d ($10 in chips)
Seat 5: e563a3fc ($9.34 in chips)
Seat 6: Hero ($10.05 in chips)
3c3bd770: posts small blind $0.05
add94475: posts big blind $0.1
*** HOLE CARDS ***
Dealt to 74f03d83 
Dealt to 3c3bd770 
Dealt to add94475 
Dealt to 4df7250d 
Dealt to e563a3fc 
Dealt to Hero [7s Ts]
4df7250d: raises $0.15 to $0.25
e563a3fc: folds
Hero: folds
74f03d83: folds
3c3bd770: folds
add94475: folds
Uncalled bet ($0.15) returned to 4df7250d
*** SHOWDOWN ***
4df7250d collected $0.25 from pot
*** SUMMARY ***
Total pot $0.25 | Rake $0 | Jackpot $0 | Bingo $0 | Fortune $0
Seat 1: 74f03d83 (button) folded before Flop (didn't bet)
Seat 2: 3c3bd770 (small blind) folded before Flop
Seat 3: add94475 (big blind) folded before Flop
Seat 4: 4df7250d collected ($0.25)
Seat 5: e563a3fc folded before Flop (didn't bet)
Seat 6: Hero folded before Flop (didn't bet)


Poker Hand #RC1467967755: Hold'em No Limit  ($0.05/$0.1) - 2023/04/12 15:34:20
Table 'RushAndCash5513015' 6-max Seat #1 is the button
Seat 1: 4b35b612 ($7.13 in chips)
Seat 2: e13a368f ($10 in chips)
Seat 3: 33ddbfa5 ($12.07 in chips)
Seat 4: 587e3bc5 ($10.15 in chips)
Seat 5: 52d50f35 ($11.74 in chips)
Seat 6: Hero ($9.9 in chips)
e13a368f: posts small blind $0.05
33ddbfa5: posts big blind $0.1
*** HOLE CARDS ***
Dealt to 4b35b612 
Dealt to e13a368f 
Dealt to 33ddbfa5 
Dealt to 587e3bc5 
Dealt to 52d50f35 
Dealt to Hero [2s 2d]
587e3bc5: folds
52d50f35: folds
Hero: raises $0.15 to $0.25
4b35b612: folds
e13a368f: folds
33ddbfa5: folds
Uncalled bet ($0.15) returned to Hero
*** SHOWDOWN ***
Hero collected $0.25 from pot
*** SUMMARY ***
Total pot $0.25 | Rake $0 | Jackpot $0 | Bingo $0 | Fortune $0
Seat 1: 4b35b612 (button) folded before Flop (didn't bet)
Seat 2: e13a368f (small blind) folded before Flop
Seat 3: 33ddbfa5 (big blind) folded before Flop
Seat 4: 587e3bc5 folded before Flop (didn't bet)
Seat 5: 52d50f35 folded before Flop (didn't bet)
Seat 6: Hero collected ($0.25)


Poker Hand #RC1467967717: Hold'em No Limit  ($0.05/$0.1) - 2023/04/12 15:34:16
Table 'RushAndCash5512977' 6-max Seat #1 is the button
Seat 1: cacb386 ($10.86 in chips)
Seat 2: 9a860021 ($11.5 in chips)
Seat 3: 86aa7b6b ($10 in chips)
Seat 4: 29f6dd38 ($10.23 in chips)
Seat 5: 86f417b6 ($11.48 in chips)
Seat 6: Hero ($9.9 in chips)
9a860021: posts small blind $0.05
86aa7b6b: posts big blind $0.1
*** HOLE CARDS ***
Dealt to cacb386 
Dealt to 9a860021 
Dealt to 86aa7b6b 
Dealt to 29f6dd38 
Dealt to 86f417b6 
Dealt to Hero [9h 2c]
29f6dd38: raises $0.15 to $0.25
86f417b6: raises $0.49 to $0.74
Hero: folds
cacb386: folds
9a860021: folds
86aa7b6b: folds
29f6dd38: calls $0.49
*** FLOP *** [7h Ks 9s]
29f6dd38: checks
86f417b6: bets $1.23
29f6dd38: folds
Uncalled bet ($1.23) returned to 86f417b6
*** SHOWDOWN ***
86f417b6 collected $1.55 from pot
*** SUMMARY ***
Total pot $1.63 | Rake $0.08 | Jackpot $0 | Bingo $0 | Fortune $0
Board [7h Ks 9s]
Seat 1: cacb386 (button) folded before Flop (didn't bet)
Seat 2: 9a860021 (small blind) folded before Flop
Seat 3: 86aa7b6b (big blind) folded before Flop
Seat 4: 29f6dd38 folded on the Flop
Seat 5: 86f417b6 won ($1.55)
Seat 6: Hero folded before Flop (didn't bet)


Poker Hand #RC1467967627: Hold'em No Limit  ($0.05/$0.1) - 2023/04/12 15:34:07
Table 'RushAndCash5512887' 6-max Seat #1 is the button
Seat 1: Hero ($9.9 in chips)
Seat 2: d749f135 ($18.31 in chips)
Seat 3: adc5743e ($4.73 in chips)
Seat 4: d37b3b4f ($43.28 in chips)
Seat 5: c07b91d4 ($13.85 in chips)
Seat 6: d4fe74b7 ($10 in chips)
d749f135: posts small blind $0.05
adc5743e: posts big blind $0.1
*** HOLE CARDS ***
Dealt to Hero [8s 4c]
Dealt to d749f135 
Dealt to adc5743e 
Dealt to d37b3b4f 
Dealt to c07b91d4 
Dealt to d4fe74b7 
d37b3b4f: raises $0.15 to $0.25
c07b91d4: folds
d4fe74b7: folds
Hero: folds
d749f135: calls $0.2
adc5743e: calls $0.15
*** FLOP *** [Jh 7h 8c]
d749f135: checks
adc5743e: bets $0.57
d37b3b4f: calls $0.57
d749f135: calls $0.57
*** TURN *** [Jh 7h 8c] [9d]
d749f135: checks
adc5743e: checks
d37b3b4f: bets $1.23
d749f135: calls $1.23
adc5743e: folds
*** RIVER *** [Jh 7h 8c 9d] [2h]
d749f135: bets $1.2
d37b3b4f: calls $1.2
d749f135: shows [Ah Th] (Ace High Flush)
d37b3b4f: shows [Tc Td] (Jacks-High Straight)
*** SHOWDOWN ***
d749f135 collected $6.87 from pot
*** SUMMARY ***
Total pot $7.32 | Rake $0.3 | Jackpot $0.15 | Bingo $0 | Fortune $0
Board [Jh 7h 8c 9d 2h]
Seat 1: Hero (button) folded before Flop (didn't bet)
Seat 2: d749f135 (small blind) showed [Ah Th] and won ($6.87) with Ace High Flush
Seat 3: adc5743e (big blind) folded on the Turn
Seat 4: d37b3b4f showed [Tc Td] and lost with Jacks-High Straight
Seat 5: c07b91d4 folded before Flop (didn't bet)
Seat 6: d4fe74b7 folded before Flop (didn't bet)


Poker Hand #RC1467966216: Hold'em No Limit  ($0.05/$0.1) - 2023/04/12 15:31:02
Table 'RushAndCash5511476' 6-max Seat #1 is the button
Seat 1: 8f998190 ($10.57 in chips)
Seat 2: Hero ($7.33 in chips)
Seat 3: 36424257 ($10.15 in chips)
Seat 4: ae679003 ($10 in chips)
Seat 5: dc57ea9e ($24.81 in chips)
Seat 6: ea7a41f9 ($10.42 in chips)
Hero: posts small blind $0.05
36424257: posts big blind $0.1
*** HOLE CARDS ***
Dealt to 8f998190 
Dealt to Hero [Ah 8h]
Dealt to 36424257 
Dealt to ae679003 
Dealt to dc57ea9e 
Dealt to ea7a41f9 
ae679003: raises $0.1 to $0.2
dc57ea9e: folds
ea7a41f9: folds
8f998190: folds
Hero: raises $0.4 to $0.6
36424257: folds
ae679003: calls $0.4
*** FLOP *** [3d 9h Th]
Hero: bets $0.8
ae679003: calls $0.8
*** TURN *** [3d 9h Th] [Tc]
Hero: checks
ae679003: bets $1.5
Hero: calls $1.5
*** RIVER *** [3d 9h Th Tc] [5c]
Hero: checks
ae679003: checks
Hero: shows [Ah 8h] (Pair of Tens)
ae679003: shows [Qh Kc] (Pair of Tens)
*** SHOWDOWN ***
Hero collected $5.47 from pot
*** SUMMARY ***
Total pot $5.9 | Rake $0.28 | Jackpot $0.15 | Bingo $0 | Fortune $0
Board [3d 9h Th Tc 5c]
Seat 1: 8f998190 (button) folded before Flop (didn't bet)
Seat 2: Hero (small blind) showed [Ah 8h] and won ($5.47) with Pair of Tens
Seat 3: 36424257 (big blind) folded before Flop
Seat 4: ae679003 showed [Qh Kc] and lost with Pair of Tens
Seat 5: dc57ea9e folded before Flop (didn't bet)
Seat 6: ea7a41f9 folded before Flop (didn't bet)


Poker Hand #RC1467965754: Hold'em No Limit  ($0.05/$0.1) - 2023/04/12 15:30:02
Table 'RushAndCash5511014' 6-max Seat #1 is the button
Seat 1: 1475e8f0 ($10.17 in chips)
Seat 2: e6a52b04 ($10 in chips)
Seat 3: Hero ($7.05 in chips)
Seat 4: b5a5fbb8 ($13.87 in chips)
Seat 5: 2e119c3d ($10.02 in chips)
Seat 6: c1261f40 ($15.65 in chips)
e6a52b04: posts small blind $0.05
Hero: posts big blind $0.1
*** HOLE CARDS ***
Dealt to 1475e8f0 
Dealt to e6a52b04 
Dealt to Hero [5d 5s]
Dealt to b5a5fbb8 
Dealt to 2e119c3d 
Dealt to c1261f40 
b5a5fbb8: folds
2e119c3d: folds
c1261f40: folds
1475e8f0: raises $0.15 to $0.25
e6a52b04: folds
Hero: calls $0.15
*** FLOP *** [Jc Ah Jh]
Hero: checks
1475e8f0: checks
*** TURN *** [Jc Ah Jh] [2d]
Hero: checks
1475e8f0: checks
*** RIVER *** [Jc Ah Jh 2d] [7h]
Hero: checks
1475e8f0: checks
Hero: shows [5d 5s] (Pair of Jacks and Pair of Fives)
1475e8f0: shows [Qs 9s] (Pair of Jacks)
*** SHOWDOWN ***
Hero collected $0.53 from pot
*** SUMMARY ***
Total pot $0.55 | Rake $0.02 | Jackpot $0 | Bingo $0 | Fortune $0
Board [Jc Ah Jh 2d 7h]
Seat 1: 1475e8f0 (button) showed [Qs 9s] and lost with Pair of Jacks
Seat 2: e6a52b04 (small blind) folded before Flop
Seat 3: Hero (big blind) showed [5d 5s] and won ($0.53) with Pair of Jacks and Pair of Fives
Seat 4: b5a5fbb8 folded before Flop (didn't bet)
Seat 5: 2e119c3d folded before Flop (didn't bet)
Seat 6: c1261f40 folded before Flop (didn't bet)


Poker Hand #RC1467965680: Hold'em No Limit  ($0.05/$0.1) - 2023/04/12 15:29:52
Table 'RushAndCash5510940' 6-max Seat #1 is the button
Seat 1: d5e1a6b5 ($4.29 in chips)
Seat 2: ba61a188 ($11.35 in chips)
Seat 3: 2356722 ($10.28 in chips)
Seat 4: Hero ($7.05 in chips)
Seat 5: 3772f1f2 ($10.63 in chips)
Seat 6: a83ae7bf ($10 in chips)
ba61a188: posts small blind $0.05
2356722: posts big blind $0.1
*** HOLE CARDS ***
Dealt to d5e1a6b5 
Dealt to ba61a188 
Dealt to 2356722 
Dealt to Hero [6c Kh]
Dealt to 3772f1f2 
Dealt to a83ae7bf 
Hero: folds
3772f1f2: folds
a83ae7bf: raises $0.12 to $0.22
d5e1a6b5: folds
ba61a188: folds
2356722: folds
Uncalled bet ($0.12) returned to a83ae7bf
*** SHOWDOWN ***
a83ae7bf collected $0.25 from pot
*** SUMMARY ***
Total pot $0.25 | Rake $0 | Jackpot $0 | Bingo $0 | Fortune $0
Seat 1: d5e1a6b5 (button) folded before Flop (didn't bet)
Seat 2: ba61a188 (small blind) folded before Flop
Seat 3: 2356722 (big blind) folded before Flop
Seat 4: Hero folded before Flop (didn't bet)
Seat 5: 3772f1f2 folded before Flop (didn't bet)
Seat 6: a83ae7bf collected ($0.25)


Poker Hand #RC1467965283: Hold'em No Limit  ($0.05/$0.1) - 2023/04/12 15:29:03
Table 'RushAndCash5510543' 6-max Seat #1 is the button
Seat 1: 5b284e7c ($10.87 in chips)
Seat 2: 9c359e44 ($10.16 in chips)
Seat 3: ba61a188 ($10.71 in chips)
Seat 4: b9a72970 ($10.15 in chips)
Seat 5: 549d1936 ($15.09 in chips)
Seat 6: Hero ($7.7 in chips)
9c359e44: posts small blind $0.05
ba61a188: posts big blind $0.1
*** HOLE CARDS ***
Dealt to 5b284e7c 
Dealt to 9c359e44 
Dealt to ba61a188 
Dealt to b9a72970 
Dealt to 549d1936 
Dealt to Hero [Td Jc]
b9a72970: folds
549d1936: folds
Hero: raises $0.15 to $0.25
5b284e7c: folds
9c359e44: folds
ba61a188: calls $0.15
*** FLOP *** [6c Qc 9h]
ba61a188: bets $0.4
Hero: calls $0.4
*** TURN *** [6c Qc 9h] [4h]
ba61a188: bets $0.98
Hero: folds
Uncalled bet ($0.98) returned to ba61a188
*** SHOWDOWN ***
ba61a188 collected $1.29 from pot
*** SUMMARY ***
Total pot $1.35 | Rake $0.06 | Jackpot $0 | Bingo $0 | Fortune $0
Board [6c Qc 9h 4h]
Seat 1: 5b284e7c (button) folded before Flop (didn't bet)
Seat 2: 9c359e44 (small blind) folded before Flop
Seat 3: ba61a188 (big blind) won ($1.29)
Seat 4: b9a72970 folded before Flop (didn't bet)
Seat 5: 549d1936 folded before Flop (didn't bet)
Seat 6: Hero folded on the Turn


Poker Hand #RC1467965248: Hold'em No Limit  ($0.05/$0.1) - 2023/04/12 15:28:58
Table 'RushAndCash5510508' 6-max Seat #1 is the button
Seat 1: 8abdc81c ($9.7 in chips)
Seat 2: 8317b47c ($26.09 in chips)
Seat 3: d8ab9b56 ($4 in chips)
Seat 4: 79ed3d49 ($8.47 in chips)
Seat 5: Hero ($7.7 in chips)
Seat 6: bc1779f ($11.59 in chips)
8317b47c: posts small blind $0.05
d8ab9b56: posts big blind $0.1
*** HOLE CARDS ***
Dealt to 8abdc81c 
Dealt to 8317b47c 
Dealt to d8ab9b56 
Dealt to 79ed3d49 
Dealt to Hero [Qh 6h]
Dealt to bc1779f 
79ed3d49: folds
Hero: folds
bc1779f: folds
8abdc81c: raises $0.15 to $0.25
8317b47c: folds
d8ab9b56: calls $0.15
*** FLOP *** [9s 4s 8h]
d8ab9b56: bets $0.55
8abdc81c: folds
Uncalled bet ($0.55) returned to d8ab9b56
*** SHOWDOWN ***
d8ab9b56 collected $0.53 from pot
*** SUMMARY ***
Total pot $0.55 | Rake $0.02 | Jackpot $0 | Bingo $0 | Fortune $0
Board [9s 4s 8h]
Seat 1: 8abdc81c (button) folded on the Flop
Seat 2: 8317b47c (small blind) folded before Flop
Seat 3: d8ab9b56 (big blind) won ($0.53)
Seat 4: 79ed3d49 folded before Flop (didn't bet)
Seat 5: Hero folded before Flop (didn't bet)
Seat 6: bc1779f folded before Flop (didn't bet)


Poker Hand #RC1467965140: Hold'em No Limit  ($0.05/$0.1) - 2023/04/12 15:28:46
Table 'RushAndCash5510400' 6-max Seat #1 is the button
Seat 1: 5227d6a7 ($21.1 in chips)
Seat 2: a1201edb ($16.59 in chips)
Seat 3: 2a9ce08f ($14.25 in chips)
Seat 4: 62b0b251 ($10.56 in chips)
Seat 5: 8c84d365 ($12.98 in chips)
Seat 6: Hero ($7.55 in chips)
a1201edb: posts small blind $0.05
2a9ce08f: posts big blind $0.1
*** HOLE CARDS ***
Dealt to 5227d6a7 
Dealt to a1201edb 
Dealt to 2a9ce08f 
Dealt to 62b0b251 
Dealt to 8c84d365 
Dealt to Hero [Ah Qh]
62b0b251: folds
8c84d365: folds
Hero: raises $0.15 to $0.25
5227d6a7: folds
a1201edb: folds
2a9ce08f: folds
Uncalled bet ($0.15) returned to Hero
*** SHOWDOWN ***
Hero collected $0.25 from pot
*** SUMMARY ***
Total pot $0.25 | Rake $0 | Jackpot $0 | Bingo $0 | Fortune $0
Seat 1: 5227d6a7 (button) folded before Flop (didn't bet)
Seat 2: a1201edb (small blind) folded before Flop
Seat 3: 2a9ce08f (big blind) folded before Flop
Seat 4: 62b0b251 folded before Flop (didn't bet)
Seat 5: 8c84d365 folded before Flop (didn't bet)
Seat 6: Hero collected ($0.25)


Poker Hand #RC1467965094: Hold'em No Limit  ($0.05/$0.1) - 2023/04/12 15:28:39
Table 'RushAndCash5510354' 6-max Seat #1 is the button
Seat 1: Hero ($7.55 in chips)
Seat 2: a6d23e61 ($54.05 in chips)
Seat 3: f3593a00 ($11.73 in chips)
Seat 4: 707d4131 ($10.05 in chips)
Seat 5: 428aabcd ($15.02 in chips)
Seat 6: 1c3bcef4 ($10.53 in chips)
a6d23e61: posts small blind $0.05
f3593a00: posts big blind $0.1
*** HOLE CARDS ***
Dealt to Hero [Qs 2c]
Dealt to a6d23e61 
Dealt to f3593a00 
Dealt to 707d4131 
Dealt to 428aabcd 
Dealt to 1c3bcef4 
707d4131: folds
428aabcd: folds
1c3bcef4: folds
Hero: folds
a6d23e61: raises $0.2 to $0.3
f3593a00: folds
Uncalled bet ($0.2) returned to a6d23e61
*** SHOWDOWN ***
a6d23e61 collected $0.2 from pot
*** SUMMARY ***
Total pot $0.2 | Rake $0 | Jackpot $0 | Bingo $0 | Fortune $0
Seat 1: Hero (button) folded before Flop (didn't bet)
Seat 2: a6d23e61 (small blind) collected ($0.2)
Seat 3: f3593a00 (big blind) folded before Flop
Seat 4: 707d4131 folded before Flop (didn't bet)
Seat 5: 428aabcd folded before Flop (didn't bet)
Seat 6: 1c3bcef4 folded before Flop (didn't bet)


Poker Hand #RC1467965057: Hold'em No Limit  ($0.05/$0.1) - 2023/04/12 15:28:35
Table 'RushAndCash5510317' 6-max Seat #1 is the button
Seat 1: 27665868 ($10.39 in chips)
Seat 2: Hero ($7.6 in chips)
Seat 3: ba05cd4d ($12.85 in chips)
Seat 4: fcd427f2 ($10 in chips)
Seat 5: e8e611a ($11.62 in chips)
Seat 6: 2356722 ($10.71 in chips)
Hero: posts small blind $0.05
ba05cd4d: posts big blind $0.1
*** HOLE CARDS ***
Dealt to 27665868 
Dealt to Hero [2c 3d]
Dealt to ba05cd4d 
Dealt to fcd427f2 
Dealt to e8e611a 
Dealt to 2356722 
fcd427f2: folds
e8e611a: raises $0.1 to $0.2
2356722: raises $0.55 to $0.75
27665868: folds
Hero: folds
ba05cd4d: calls $0.65
e8e611a: calls $0.55
*** FLOP *** [2s 3h 7c]
ba05cd4d: checks
e8e611a: checks
2356722: bets $1.15
ba05cd4d: folds
e8e611a: calls $1.15
*** TURN *** [2s 3h 7c] [3c]
e8e611a: checks
2356722: checks
*** RIVER *** [2s 3h 7c 3c] [8d]
e8e611a: bets $1.2
2356722: folds
Uncalled bet ($1.2) returned to e8e611a
*** SHOWDOWN ***
e8e611a collected $4.23 from pot
*** SUMMARY ***
Total pot $4.6 | Rake $0.22 | Jackpot $0.15 | Bingo $0 | Fortune $0
Board [2s 3h 7c 3c 8d]
Seat 1: 27665868 (button) folded before Flop (didn't bet)
Seat 2: Hero (small blind) folded before Flop
Seat 3: ba05cd4d (big blind) folded on the Flop
Seat 4: fcd427f2 folded before Flop (didn't bet)
Seat 5: e8e611a won ($4.23)
Seat 6: 2356722 folded on the River


Poker Hand #RC1467965018: Hold'em No Limit  ($0.05/$0.1) - 2023/04/12 15:28:30
Table 'RushAndCash5510278' 6-max Seat #1 is the button
Seat 1: fa1fe519 ($16.24 in chips)
Seat 2: 8aa5fae1 ($9.9 in chips)
Seat 3: Hero ($7.7 in chips)
Seat 4: 8abdc81c ($9.85 in chips)
Seat 5: dcb052b3 ($20.7 in chips)
Seat 6: e44f2012 ($11.18 in chips)
8aa5fae1: posts small blind $0.05
Hero: posts big blind $0.1
*** HOLE CARDS ***
Dealt to fa1fe519 
Dealt to 8aa5fae1 
Dealt to Hero [3h 4s]
Dealt to 8abdc81c 
Dealt to dcb052b3 
Dealt to e44f2012 
8abdc81c: folds
dcb052b3: raises $0.2 to $0.3
e44f2012: folds
fa1fe519: folds
8aa5fae1: folds
Hero: folds
Uncalled bet ($0.2) returned to dcb052b3
*** SHOWDOWN ***
dcb052b3 collected $0.25 from pot
*** SUMMARY ***
Total pot $0.25 | Rake $0 | Jackpot $0 | Bingo $0 | Fortune $0
Seat 1: fa1fe519 (button) folded before Flop (didn't bet)
Seat 2: 8aa5fae1 (small blind) folded before Flop
Seat 3: Hero (big blind) folded before Flop
Seat 4: 8abdc81c folded before Flop (didn't bet)
Seat 5: dcb052b3 collected ($0.25)
Seat 6: e44f2012 folded before Flop (didn't bet)


Poker Hand #RC1467914416: Hold'em No Limit  ($0.05/$0.1) - 2023/04/12 15:27:12
Table 'RushAndCash5509676' 6-max Seat #1 is the button
Seat 1: 6787f85a ($10.37 in chips)
Seat 2: d0f0dced ($10.2 in chips)
Seat 3: 90ccc4ea ($10 in chips)
Seat 4: Hero ($9.26 in chips)
Seat 5: 9c359e44 ($10 in chips)
Seat 6: 8aa5fae1 ($8.49 in chips)
d0f0dced: posts small blind $0.05
90ccc4ea: posts big blind $0.1
*** HOLE CARDS ***
Dealt to 6787f85a 
Dealt to d0f0dced 
Dealt to 90ccc4ea 
Dealt to Hero [Qh Kc]
Dealt to 9c359e44 
Dealt to 8aa5fae1 
Hero: raises $0.15 to $0.25
9c359e44: folds
8aa5fae1: raises $0.49 to $0.74
6787f85a: folds
d0f0dced: folds
90ccc4ea: folds
Hero: calls $0.49
*** FLOP *** [Qc 9c 8h]
Hero: checks
8aa5fae1: checks
*** TURN *** [Qc 9c 8h] [2d]
Hero: bets $0.82
8aa5fae1: calls $0.82
*** RIVER *** [Qc 9c 8h 2d] [Tc]
Hero: checks
8aa5fae1: bets $2.46
Hero: folds
Uncalled bet ($2.46) returned to 8aa5fae1
*** SHOWDOWN ***
8aa5fae1 collected $2.97 from pot
*** SUMMARY ***
Total pot $3.27 | Rake $0.15 | Jackpot $0.15 | Bingo $0 | Fortune $0
Board [Qc 9c 8h 2d Tc]
Seat 1: 6787f85a (button) folded before Flop (didn't bet)
Seat 2: d0f0dced (small blind) folded before Flop
Seat 3: 90ccc4ea (big blind) folded before Flop
Seat 4: Hero folded on the River
Seat 5: 9c359e44 folded before Flop (didn't bet)
Seat 6: 8aa5fae1 won ($2.97)


Poker Hand #RC1467914064: Hold'em No Limit  ($0.05/$0.1) - 2023/04/12 15:26:28
Table 'RushAndCash5509324' 6-max Seat #1 is the button
Seat 1: da06203 ($25.65 in chips)
Seat 2: a83ae7bf ($10 in chips)
Seat 3: b9a72970 ($10 in chips)
Seat 4: 8061b980 ($20.72 in chips)
Seat 5: 476059f3 ($14.21 in chips)
Seat 6: Hero ($9.51 in chips)
a83ae7bf: posts small blind $0.05
b9a72970: posts big blind $0.1
*** HOLE CARDS ***
Dealt to da06203 
Dealt to a83ae7bf 
Dealt to b9a72970 
Dealt to 8061b980 
Dealt to 476059f3 
Dealt to Hero [Ks Jd]
8061b980: folds
476059f3: folds
Hero: raises $0.15 to $0.25
da06203: folds
a83ae7bf: calls $0.2
b9a72970: folds
*** FLOP *** [Ts 6d 3c]
a83ae7bf: checks
Hero: checks
*** TURN *** [Ts 6d 3c] [4s]
a83ae7bf: checks
Hero: checks
*** RIVER *** [Ts 6d 3c 4s] [Td]
a83ae7bf: bets $1.2
Hero: folds
Uncalled bet ($1.2) returned to a83ae7bf
*** SHOWDOWN ***
a83ae7bf collected $0.57 from pot
*** SUMMARY ***
Total pot $0.6 | Rake $0.03 | Jackpot $0 | Bingo $0 | Fortune $0
Board [Ts 6d 3c 4s Td]
Seat 1: da06203 (button) folded before Flop (didn't bet)
Seat 2: a83ae7bf (small blind) won ($0.57)
Seat 3: b9a72970 (big blind) folded before Flop
Seat 4: 8061b980 folded before Flop (didn't bet)
Seat 5: 476059f3 folded before Flop (didn't bet)
Seat 6: Hero folded on the River


Poker Hand #RC1467914026: Hold'em No Limit  ($0.05/$0.1) - 2023/04/12 15:26:24
Table 'RushAndCash5509286' 6-max Seat #1 is the button
Seat 1: ae679003 ($10 in chips)
Seat 2: e44f2012 ($11.15 in chips)
Seat 3: 76aab391 ($11.83 in chips)
Seat 4: d3740883 ($15.64 in chips)
Seat 5: be0b6517 ($12.92 in chips)
Seat 6: Hero ($9.51 in chips)
e44f2012: posts small blind $0.05
76aab391: posts big blind $0.1
*** HOLE CARDS ***
Dealt to ae679003 
Dealt to e44f2012 
Dealt to 76aab391 
Dealt to d3740883 
Dealt to be0b6517 
Dealt to Hero [Qs 6d]
d3740883: folds
be0b6517: raises $0.13 to $0.23
Hero: folds
ae679003: folds
e44f2012: folds
76aab391: folds
Uncalled bet ($0.13) returned to be0b6517
*** SHOWDOWN ***
be0b6517 collected $0.25 from pot
*** SUMMARY ***
Total pot $0.25 | Rake $0 | Jackpot $0 | Bingo $0 | Fortune $0
Seat 1: ae679003 (button) folded before Flop (didn't bet)
Seat 2: e44f2012 (small blind) folded before Flop
Seat 3: 76aab391 (big blind) folded before Flop
Seat 4: d3740883 folded before Flop (didn't bet)
Seat 5: be0b6517 collected ($0.25)
Seat 6: Hero folded before Flop (didn't bet)


Poker Hand #RC1467913989: Hold'em No Limit  ($0.05/$0.1) - 2023/04/12 15:26:19
Table 'RushAndCash5509249' 6-max Seat #1 is the button
Seat 1: 80c73401 ($41.25 in chips)
Seat 2: Hero ($9.56 in chips)
Seat 3: df8d522d ($21.2 in chips)
Seat 4: 22a3e1df ($29.24 in chips)
Seat 5: d220d7e3 ($9.5 in chips)
Seat 6: 54887889 ($10.76 in chips)
Hero: posts small blind $0.05
df8d522d: posts big blind $0.1
*** HOLE CARDS ***
Dealt to 80c73401 
Dealt to Hero [5s 8d]
Dealt to df8d522d 
Dealt to 22a3e1df 
Dealt to d220d7e3 
Dealt to 54887889 
22a3e1df: folds
d220d7e3: folds
54887889: folds
80c73401: raises $0.15 to $0.25
Hero: folds
df8d522d: folds
Uncalled bet ($0.15) returned to 80c73401
*** SHOWDOWN ***
80c73401 collected $0.25 from pot
*** SUMMARY ***
Total pot $0.25 | Rake $0 | Jackpot $0 | Bingo $0 | Fortune $0
Seat 1: 80c73401 (button) collected ($0.25)
Seat 2: Hero (small blind) folded before Flop
Seat 3: df8d522d (big blind) folded before Flop
Seat 4: 22a3e1df folded before Flop (didn't bet)
Seat 5: d220d7e3 folded before Flop (didn't bet)
Seat 6: 54887889 folded before Flop (didn't bet)


Poker Hand #RC1467913933: Hold'em No Limit  ($0.05/$0.1) - 2023/04/12 15:26:13
Table 'RushAndCash5509193' 6-max Seat #1 is the button
Seat 1: 40cc1594 ($10.83 in chips)
Seat 2: 88159f9c ($11.31 in chips)
Seat 3: Hero ($9.66 in chips)
Seat 4: c70a6586 ($10 in chips)
Seat 5: ba61a188 ($10.25 in chips)
Seat 6: 3c2eb6cf ($9.34 in chips)
88159f9c: posts small blind $0.05
Hero: posts big blind $0.1
*** HOLE CARDS ***
Dealt to 40cc1594 
Dealt to 88159f9c 
Dealt to Hero [2h 6d]
Dealt to c70a6586 
Dealt to ba61a188 
Dealt to 3c2eb6cf 
c70a6586: folds
ba61a188: folds
3c2eb6cf: raises $0.13 to $0.23
40cc1594: raises $0.47 to $0.7
88159f9c: folds
Hero: folds
3c2eb6cf: calls $0.47
*** FLOP *** [8c Kh As]
3c2eb6cf: checks
40cc1594: checks
*** TURN *** [8c Kh As] [4s]
3c2eb6cf: checks
40cc1594: bets $0.75
3c2eb6cf: calls $0.75
*** RIVER *** [8c Kh As 4s] [8h]
3c2eb6cf: checks
40cc1594: checks
3c2eb6cf: shows [Kd Jd] (Pair of Kings and Pair of Eights)
40cc1594: shows [Kc Qc] (Pair of Kings and Pair of Eights)
*** SHOWDOWN ***
3c2eb6cf collected $1.38 from pot
40cc1594 collected $1.38 from pot
*** SUMMARY ***
Total pot $3.05 | Rake $0.14 | Jackpot $0.15 | Bingo $0 | Fortune $0
Board [8c Kh As 4s 8h]
Seat 1: 40cc1594 (button) showed [Kc Qc] and won ($1.38) with Pair of Kings and Pair of Eights
Seat 2: 88159f9c (small blind) folded before Flop
Seat 3: Hero (big blind) folded before Flop
Seat 4: c70a6586 folded before Flop (didn't bet)
Seat 5: ba61a188 folded before Flop (didn't bet)
Seat 6: 3c2eb6cf showed [Kd Jd] and won ($1.38) with Pair of Kings and Pair of Eights


Poker Hand #RC1467913850: Hold'em No Limit  ($0.05/$0.1) - 2023/04/12 15:26:03
Table 'RushAndCash5509110' 6-max Seat #1 is the button
Seat 1: Hero ($9.66 in chips)
Seat 2: ba93781a ($12.44 in chips)
Seat 3: bd2a55c2 ($13.05 in chips)
Seat 4: 36094f35 ($8.31 in chips)
Seat 5: e8e611a ($12.16 in chips)
Seat 6: cf6273d1 ($9.89 in chips)
ba93781a: posts small blind $0.05
bd2a55c2: posts big blind $0.1
*** HOLE CARDS ***
Dealt to Hero [Td 9c]
Dealt to ba93781a 
Dealt to bd2a55c2 
Dealt to 36094f35 
Dealt to e8e611a 
Dealt to cf6273d1 
36094f35: folds
e8e611a: folds
cf6273d1: raises $0.15 to $0.25
Hero: folds
ba93781a: calls $0.2
bd2a55c2: folds
*** FLOP *** [8d 8s Ks]
ba93781a: checks
cf6273d1: checks
*** TURN *** [8d 8s Ks] [4h]
ba93781a: checks
cf6273d1: bets $0.4
ba93781a: folds
Uncalled bet ($0.4) returned to cf6273d1
*** SHOWDOWN ***
cf6273d1 collected $0.57 from pot
*** SUMMARY ***
Total pot $0.6 | Rake $0.03 | Jackpot $0 | Bingo $0 | Fortune $0
Board [8d 8s Ks 4h]
Seat 1: Hero (button) folded before Flop (didn't bet)
Seat 2: ba93781a (small blind) folded on the Turn
Seat 3: bd2a55c2 (big blind) folded before Flop
Seat 4: 36094f35 folded before Flop (didn't bet)
Seat 5: e8e611a folded before Flop (didn't bet)
Seat 6: cf6273d1 won ($0.57)


Poker Hand #RC1467909299: Hold'em No Limit  ($0.05/$0.1) - 2023/04/12 15:16:14
Table 'RushAndCash5504559' 6-max Seat #1 is the button
Seat 1: b8271fd1 ($10 in chips)
Seat 2: a2dc963b ($10.1 in chips)
Seat 3: 570acedf ($9.85 in chips)
Seat 4: d79d18f4 ($20.45 in chips)
Seat 5: 26fa5e82 ($30.89 in chips)
Seat 6: Hero ($10.6 in chips)
a2dc963b: posts small blind $0.05
570acedf: posts big blind $0.1
*** HOLE CARDS ***
Dealt to b8271fd1 
Dealt to a2dc963b 
Dealt to 570acedf 
Dealt to d79d18f4 
Dealt to 26fa5e82 
Dealt to Hero [Jd Ad]
d79d18f4: folds
26fa5e82: folds
Hero: raises $0.15 to $0.25
b8271fd1: folds
a2dc963b: folds
570acedf: calls $0.15
*** FLOP *** [Ks 7s Kh]
570acedf: checks
Hero: checks
*** TURN *** [Ks 7s Kh] [Ah]
570acedf: bets $0.19
Hero: calls $0.19
*** RIVER *** [Ks 7s Kh Ah] [7d]
570acedf: bets $0.5
Hero: calls $0.5
570acedf: shows [Th Kc] (Kings Full over Sevens)
Hero: shows [Jd Ad] (Pair of Aces and Pair of Kings)
*** SHOWDOWN ***
570acedf collected $1.84 from pot
*** SUMMARY ***
Total pot $1.93 | Rake $0.09 | Jackpot $0 | Bingo $0 | Fortune $0
Board [Ks 7s Kh Ah 7d]
Seat 1: b8271fd1 (button) folded before Flop (didn't bet)
Seat 2: a2dc963b (small blind) folded before Flop
Seat 3: 570acedf (big blind) showed [Th Kc] and won ($1.84) with Kings Full over Sevens
Seat 4: d79d18f4 folded before Flop (didn't bet)
Seat 5: 26fa5e82 folded before Flop (didn't bet)
Seat 6: Hero showed [Jd Ad] and lost with Pair of Aces and Pair of Kings


Poker Hand #RC1467909122: Hold'em No Limit  ($0.05/$0.1) - 2023/04/12 15:15:50
Table 'RushAndCash5504382' 6-max Seat #1 is the button
Seat 1: Hero ($10.6 in chips)
Seat 2: 44416926 ($10.21 in chips)
Seat 3: 38e8c71f ($13.54 in chips)
Seat 4: 42d4c710 ($12.39 in chips)
Seat 5: fc8a4b2f ($14.45 in chips)
Seat 6: 9403e4ce ($13.13 in chips)
44416926: posts small blind $0.05
38e8c71f: posts big blind $0.1
*** HOLE CARDS ***
Dealt to Hero [Kc 2c]
Dealt to 44416926 
Dealt to 38e8c71f 
Dealt to 42d4c710 
Dealt to fc8a4b2f 
Dealt to 9403e4ce 
42d4c710: folds
fc8a4b2f: raises $0.12 to $0.22
9403e4ce: folds
Hero: folds
44416926: folds
38e8c71f: folds
Uncalled bet ($0.12) returned to fc8a4b2f
*** SHOWDOWN ***
fc8a4b2f collected $0.25 from pot
*** SUMMARY ***
Total pot $0.25 | Rake $0 | Jackpot $0 | Bingo $0 | Fortune $0
Seat 1: Hero (button) folded before Flop (didn't bet)
Seat 2: 44416926 (small blind) folded before Flop
Seat 3: 38e8c71f (big blind) folded before Flop
Seat 4: 42d4c710 folded before Flop (didn't bet)
Seat 5: fc8a4b2f collected ($0.25)
Seat 6: 9403e4ce folded before Flop (didn't bet)


Poker Hand #RC1467909035: Hold'em No Limit  ($0.05/$0.1) - 2023/04/12 15:15:39
Table 'RushAndCash5504295' 6-max Seat #1 is the button
Seat 1: 3772f1f2 ($10.74 in chips)
Seat 2: Hero ($10.5 in chips)
Seat 3: 337c59a8 ($8.42 in chips)
Seat 4: fda2ca77 ($16.41 in chips)
Seat 5: 2295769 ($22.1 in chips)
Seat 6: f4c0b2d ($12.3 in chips)
Hero: posts small blind $0.05
337c59a8: posts big blind $0.1
*** HOLE CARDS ***
Dealt to 3772f1f2 
Dealt to Hero [5h 4h]
Dealt to 337c59a8 
Dealt to fda2ca77 
Dealt to 2295769 
Dealt to f4c0b2d 
fda2ca77: folds
2295769: folds
f4c0b2d: folds
3772f1f2: folds
Hero: raises $0.2 to $0.3
337c59a8: folds
Uncalled bet ($0.2) returned to Hero
*** SHOWDOWN ***
Hero collected $0.2 from pot
*** SUMMARY ***
Total pot $0.2 | Rake $0 | Jackpot $0 | Bingo $0 | Fortune $0
Seat 1: 3772f1f2 (button) folded before Flop (didn't bet)
Seat 2: Hero (small blind) collected ($0.2)
Seat 3: 337c59a8 (big blind) folded before Flop
Seat 4: fda2ca77 folded before Flop (didn't bet)
Seat 5: 2295769 folded before Flop (didn't bet)
Seat 6: f4c0b2d folded before Flop (didn't bet)


Poker Hand #RC1467908991: Hold'em No Limit  ($0.05/$0.1) - 2023/04/12 15:15:33
Table 'RushAndCash5504251' 6-max Seat #1 is the button
Seat 1: 2486e0c3 ($10.71 in chips)
Seat 2: b51c2f48 ($10 in chips)
Seat 3: Hero ($10.6 in chips)
Seat 4: d7c7769f ($34.68 in chips)
Seat 5: 8cbed37d ($10.15 in chips)
Seat 6: 43ed2541 ($10 in chips)
b51c2f48: posts small blind $0.05
Hero: posts big blind $0.1
*** HOLE CARDS ***
Dealt to 2486e0c3 
Dealt to b51c2f48 
Dealt to Hero [5s Jh]
Dealt to d7c7769f 
Dealt to 8cbed37d 
Dealt to 43ed2541 
d7c7769f: folds
8cbed37d: folds
43ed2541: folds
2486e0c3: raises $0.15 to $0.25
b51c2f48: folds
Hero: folds
Uncalled bet ($0.15) returned to 2486e0c3
*** SHOWDOWN ***
2486e0c3 collected $0.25 from pot
*** SUMMARY ***
Total pot $0.25 | Rake $0 | Jackpot $0 | Bingo $0 | Fortune $0
Seat 1: 2486e0c3 (button) collected ($0.25)
Seat 2: b51c2f48 (small blind) folded before Flop
Seat 3: Hero (big blind) folded before Flop
Seat 4: d7c7769f folded before Flop (didn't bet)
Seat 5: 8cbed37d folded before Flop (didn't bet)
Seat 6: 43ed2541 folded before Flop (didn't bet)


Poker Hand #RC1467908945: Hold'em No Limit  ($0.05/$0.1) - 2023/04/12 15:15:27
Table 'RushAndCash5504205' 6-max Seat #1 is the button
Seat 1: fbb9e3eb ($10 in chips)
Seat 2: 4d109d20 ($19.05 in chips)
Seat 3: 82655b4f ($10 in chips)
Seat 4: d0c78fb7 ($11.72 in chips)
Seat 5: 3e673b5a ($15.06 in chips)
Seat 6: Hero ($10.6 in chips)
4d109d20: posts small blind $0.05
82655b4f: posts big blind $0.1
*** HOLE CARDS ***
Dealt to fbb9e3eb 
Dealt to 4d109d20 
Dealt to 82655b4f 
Dealt to d0c78fb7 
Dealt to 3e673b5a 
Dealt to Hero [Tc 8s]
d0c78fb7: folds
3e673b5a: folds
Hero: folds
fbb9e3eb: raises $0.15 to $0.25
4d109d20: folds
82655b4f: folds
Uncalled bet ($0.15) returned to fbb9e3eb
*** SHOWDOWN ***
fbb9e3eb collected $0.25 from pot
*** SUMMARY ***
Total pot $0.25 | Rake $0 | Jackpot $0 | Bingo $0 | Fortune $0
Seat 1: fbb9e3eb (button) collected ($0.25)
Seat 2: 4d109d20 (small blind) folded before Flop
Seat 3: 82655b4f (big blind) folded before Flop
Seat 4: d0c78fb7 folded before Flop (didn't bet)
Seat 5: 3e673b5a folded before Flop (didn't bet)
Seat 6: Hero folded before Flop (didn't bet)


Poker Hand #RC1467908891: Hold'em No Limit  ($0.05/$0.1) - 2023/04/12 15:15:20
Table 'RushAndCash5504151' 6-max Seat #1 is the button
Seat 1: dc33865b ($6.65 in chips)
Seat 2: ba93781a ($10 in chips)
Seat 3: ab12869e ($10.38 in chips)
Seat 4: Hero ($10.6 in chips)
Seat 5: 410e7fa3 ($9.2 in chips)
Seat 6: 8cbed37d ($10 in chips)
ba93781a: posts small blind $0.05
ab12869e: posts big blind $0.1
*** HOLE CARDS ***
Dealt to dc33865b 
Dealt to ba93781a 
Dealt to ab12869e 
Dealt to Hero [6c Qd]
Dealt to 410e7fa3 
Dealt to 8cbed37d 
Hero: folds
410e7fa3: folds
8cbed37d: raises $0.15 to $0.25
dc33865b: folds
ba93781a: folds
ab12869e: folds
Uncalled bet ($0.15) returned to 8cbed37d
*** SHOWDOWN ***
8cbed37d collected $0.25 from pot
*** SUMMARY ***
Total pot $0.25 | Rake $0 | Jackpot $0 | Bingo $0 | Fortune $0
Seat 1: dc33865b (button) folded before Flop (didn't bet)
Seat 2: ba93781a (small blind) folded before Flop
Seat 3: ab12869e (big blind) folded before Flop
Seat 4: Hero folded before Flop (didn't bet)
Seat 5: 410e7fa3 folded before Flop (didn't bet)
Seat 6: 8cbed37d collected ($0.25)


Poker Hand #RC1467908795: Hold'em No Limit  ($0.05/$0.1) - 2023/04/12 15:15:08
Table 'RushAndCash5504055' 6-max Seat #1 is the button
Seat 1: 2f287e6c ($19.52 in chips)
Seat 2: f2bf2ac4 ($21.33 in chips)
Seat 3: af3a1e97 ($10.11 in chips)
Seat 4: dae474fb ($10 in chips)
Seat 5: Hero ($10.6 in chips)
Seat 6: 88159f9c ($10 in chips)
f2bf2ac4: posts small blind $0.05
af3a1e97: posts big blind $0.1
*** HOLE CARDS ***
Dealt to 2f287e6c 
Dealt to f2bf2ac4 
Dealt to af3a1e97 
Dealt to dae474fb 
Dealt to Hero [Jd Th]
Dealt to 88159f9c 
dae474fb: folds
Hero: folds
88159f9c: folds
2f287e6c: folds
f2bf2ac4: folds
Uncalled bet ($0.05) returned to af3a1e97
*** SHOWDOWN ***
af3a1e97 collected $0.1 from pot
*** SUMMARY ***
Total pot $0.1 | Rake $0 | Jackpot $0 | Bingo $0 | Fortune $0
Seat 1: 2f287e6c (button) folded before Flop (didn't bet)
Seat 2: f2bf2ac4 (small blind) folded before Flop
Seat 3: af3a1e97 (big blind) collected ($0.1)
Seat 4: dae474fb folded before Flop (didn't bet)
Seat 5: Hero folded before Flop (didn't bet)
Seat 6: 88159f9c folded before Flop (didn't bet)


Poker Hand #RC1467908702: Hold'em No Limit  ($0.05/$0.1) - 2023/04/12 15:14:56
Table 'RushAndCash5503962' 6-max Seat #1 is the button
Seat 1: d3e2bdd4 ($10.47 in chips)
Seat 2: bf10b5a3 ($9.64 in chips)
Seat 3: ab50da08 ($8.47 in chips)
Seat 4: af3a1e97 ($10.11 in chips)
Seat 5: Hero ($10.45 in chips)
Seat 6: 6bb948b2 ($18.06 in chips)
bf10b5a3: posts small blind $0.05
ab50da08: posts big blind $0.1
*** HOLE CARDS ***
Dealt to d3e2bdd4 
Dealt to bf10b5a3 
Dealt to ab50da08 
Dealt to af3a1e97 
Dealt to Hero [4s 4c]
Dealt to 6bb948b2 
af3a1e97: folds
Hero: raises $0.15 to $0.25
6bb948b2: folds
d3e2bdd4: folds
bf10b5a3: folds
ab50da08: folds
Uncalled bet ($0.15) returned to Hero
*** SHOWDOWN ***
Hero collected $0.25 from pot
*** SUMMARY ***
Total pot $0.25 | Rake $0 | Jackpot $0 | Bingo $0 | Fortune $0
Seat 1: d3e2bdd4 (button) folded before Flop (didn't bet)
Seat 2: bf10b5a3 (small blind) folded before Flop
Seat 3: ab50da08 (big blind) folded before Flop
Seat 4: af3a1e97 folded before Flop (didn't bet)
Seat 5: Hero collected ($0.25)
Seat 6: 6bb948b2 folded before Flop (didn't bet)


Poker Hand #RC1467908622: Hold'em No Limit  ($0.05/$0.1) - 2023/04/12 15:14:46
Table 'RushAndCash5503882' 6-max Seat #1 is the button
Seat 1: Hero ($10.45 in chips)
Seat 2: cb4aebd8 ($10.27 in chips)
Seat 3: c54cdbdf ($13.47 in chips)
Seat 4: 1d9dc806 ($20.63 in chips)
Seat 5: 4ba30345 ($13.84 in chips)
Seat 6: c795ab0b ($10.38 in chips)
cb4aebd8: posts small blind $0.05
c54cdbdf: posts big blind $0.1
*** HOLE CARDS ***
Dealt to Hero [7c 5c]
Dealt to cb4aebd8 
Dealt to c54cdbdf 
Dealt to 1d9dc806 
Dealt to 4ba30345 
Dealt to c795ab0b 
1d9dc806: folds
4ba30345: folds
c795ab0b: raises $0.11 to $0.21
Hero: folds
cb4aebd8: folds
c54cdbdf: folds
Uncalled bet ($0.11) returned to c795ab0b
*** SHOWDOWN ***
c795ab0b collected $0.25 from pot
*** SUMMARY ***
Total pot $0.25 | Rake $0 | Jackpot $0 | Bingo $0 | Fortune $0
Seat 1: Hero (button) folded before Flop (didn't bet)
Seat 2: cb4aebd8 (small blind) folded before Flop
Seat 3: c54cdbdf (big blind) folded before Flop
Seat 4: 1d9dc806 folded before Flop (didn't bet)
Seat 5: 4ba30345 folded before Flop (didn't bet)
Seat 6: c795ab0b collected ($0.25)


Poker Hand #RC1467908591: Hold'em No Limit  ($0.05/$0.1) - 2023/04/12 15:14:41
Table 'RushAndCash5503851' 6-max Seat #1 is the button
Seat 1: ee19d492 ($16.87 in chips)
Seat 2: Hero ($10.5 in chips)
Seat 3: b78e78d0 ($15.86 in chips)
Seat 4: fd164dc5 ($10.48 in chips)
Seat 5: dedbc7ed ($14.35 in chips)
Seat 6: 9e73201d ($10.56 in chips)
Hero: posts small blind $0.05
b78e78d0: posts big blind $0.1
*** HOLE CARDS ***
Dealt to ee19d492 
Dealt to Hero [8c 5s]
Dealt to b78e78d0 
Dealt to fd164dc5 
Dealt to dedbc7ed 
Dealt to 9e73201d 
fd164dc5: folds
dedbc7ed: folds
9e73201d: folds
ee19d492: folds
Hero: folds
Uncalled bet ($0.05) returned to b78e78d0
*** SHOWDOWN ***
b78e78d0 collected $0.1 from pot
*** SUMMARY ***
Total pot $0.1 | Rake $0 | Jackpot $0 | Bingo $0 | Fortune $0
Seat 1: ee19d492 (button) folded before Flop (didn't bet)
Seat 2: Hero (small blind) folded before Flop
Seat 3: b78e78d0 (big blind) collected ($0.1)
Seat 4: fd164dc5 folded before Flop (didn't bet)
Seat 5: dedbc7ed folded before Flop (didn't bet)
Seat 6: 9e73201d folded before Flop (didn't bet)


Poker Hand #RC1467908517: Hold'em No Limit  ($0.05/$0.1) - 2023/04/12 15:14:32
Table 'RushAndCash5503777' 6-max Seat #1 is the button
Seat 1: 305d487 ($19.58 in chips)
Seat 2: afc196f1 ($12.45 in chips)
Seat 3: Hero ($10.6 in chips)
Seat 4: ed0bb5ab ($12.86 in chips)
Seat 5: 20813343 ($10 in chips)
Seat 6: c8aa5373 ($10 in chips)
afc196f1: posts small blind $0.05
Hero: posts big blind $0.1
*** HOLE CARDS ***
Dealt to 305d487 
Dealt to afc196f1 
Dealt to Hero [Td 4s]
Dealt to ed0bb5ab 
Dealt to 20813343 
Dealt to c8aa5373 
ed0bb5ab: folds
20813343: raises $0.15 to $0.25
c8aa5373: folds
305d487: calls $0.25
afc196f1: folds
Hero: folds
*** FLOP *** [3s Tc Jd]
20813343: checks
305d487: checks
*** TURN *** [3s Tc Jd] [Ad]
20813343: checks
305d487: bets $0.3
20813343: calls $0.3
*** RIVER *** [3s Tc Jd Ad] [6c]
20813343: checks
305d487: checks
20813343: shows [Ks Kd] (Pair of Kings)
305d487: shows [8s Js] (Pair of Jacks)
*** SHOWDOWN ***
20813343 collected $1.19 from pot
*** SUMMARY ***
Total pot $1.25 | Rake $0.06 | Jackpot $0 | Bingo $0 | Fortune $0
Board [3s Tc Jd Ad 6c]
Seat 1: 305d487 (button) showed [8s Js] and lost with Pair of Jacks
Seat 2: afc196f1 (small blind) folded before Flop
Seat 3: Hero (big blind) folded before Flop
Seat 4: ed0bb5ab folded before Flop (didn't bet)
Seat 5: 20813343 showed [Ks Kd] and won ($1.19) with Pair of Kings
Seat 6: c8aa5373 folded before Flop (didn't bet)


Poker Hand #RC1467908397: Hold'em No Limit  ($0.05/$0.1) - 2023/04/12 15:14:17
Table 'RushAndCash5503657' 6-max Seat #1 is the button
Seat 1: b955f0e2 ($12.75 in chips)
Seat 2: 39361d0 ($10.31 in chips)
Seat 3: a857da8e ($13.46 in chips)
Seat 4: fc29cdac ($14.01 in chips)
Seat 5: e57f93b7 ($10 in chips)
Seat 6: Hero ($10.6 in chips)
39361d0: posts small blind $0.05
a857da8e: posts big blind $0.1
*** HOLE CARDS ***
Dealt to b955f0e2 
Dealt to 39361d0 
Dealt to a857da8e 
Dealt to fc29cdac 
Dealt to e57f93b7 
Dealt to Hero [Qs 5c]
fc29cdac: raises $0.12 to $0.22
e57f93b7: folds
Hero: folds
b955f0e2: folds
39361d0: folds
a857da8e: folds
Uncalled bet ($0.12) returned to fc29cdac
*** SHOWDOWN ***
fc29cdac collected $0.25 from pot
*** SUMMARY ***
Total pot $0.25 | Rake $0 | Jackpot $0 | Bingo $0 | Fortune $0
Seat 1: b955f0e2 (button) folded before Flop (didn't bet)
Seat 2: 39361d0 (small blind) folded before Flop
Seat 3: a857da8e (big blind) folded before Flop
Seat 4: fc29cdac collected ($0.25)
Seat 5: e57f93b7 folded before Flop (didn't bet)
Seat 6: Hero folded before Flop (didn't bet)


Poker Hand #RC1467908343: Hold'em No Limit  ($0.05/$0.1) - 2023/04/12 15:14:09
Table 'RushAndCash5503603' 6-max Seat #1 is the button
Seat 1: 410e7fa3 ($9.35 in chips)
Seat 2: 4df7250d ($10.05 in chips)
Seat 3: 3e673b5a ($15.46 in chips)
Seat 4: d8da962c ($26.85 in chips)
Seat 5: e13a368f ($10.84 in chips)
Seat 6: Hero ($10.6 in chips)
4df7250d: posts small blind $0.05
3e673b5a: posts big blind $0.1
*** HOLE CARDS ***
Dealt to 410e7fa3 
Dealt to 4df7250d 
Dealt to 3e673b5a 
Dealt to d8da962c 
Dealt to e13a368f 
Dealt to Hero [3c 9h]
d8da962c: folds
e13a368f: folds
Hero: folds
410e7fa3: folds
4df7250d: folds
Uncalled bet ($0.05) returned to 3e673b5a
*** SHOWDOWN ***
3e673b5a collected $0.1 from pot
*** SUMMARY ***
Total pot $0.1 | Rake $0 | Jackpot $0 | Bingo $0 | Fortune $0
Seat 1: 410e7fa3 (button) folded before Flop (didn't bet)
Seat 2: 4df7250d (small blind) folded before Flop
Seat 3: 3e673b5a (big blind) collected ($0.1)
Seat 4: d8da962c folded before Flop (didn't bet)
Seat 5: e13a368f folded before Flop (didn't bet)
Seat 6: Hero folded before Flop (didn't bet)


Poker Hand #RC1467908275: Hold'em No Limit  ($0.05/$0.1) - 2023/04/12 15:13:59
Table 'RushAndCash5503535' 6-max Seat #1 is the button
Seat 1: 6f193529 ($15.57 in chips)
Seat 2: af3a1e97 ($9.9 in chips)
Seat 3: 109a9abf ($31.28 in chips)
Seat 4: ba05cd4d ($11.41 in chips)
Seat 5: Hero ($10.6 in chips)
Seat 6: db181c62 ($15.8 in chips)
af3a1e97: posts small blind $0.05
109a9abf: posts big blind $0.1
*** HOLE CARDS ***
Dealt to 6f193529 
Dealt to af3a1e97 
Dealt to 109a9abf 
Dealt to ba05cd4d 
Dealt to Hero [6s 9s]
Dealt to db181c62 
ba05cd4d: folds
Hero: folds
db181c62: folds
6f193529: raises $0.15 to $0.25
af3a1e97: folds
109a9abf: folds
Uncalled bet ($0.15) returned to 6f193529
*** SHOWDOWN ***
6f193529 collected $0.25 from pot
*** SUMMARY ***
Total pot $0.25 | Rake $0 | Jackpot $0 | Bingo $0 | Fortune $0
Seat 1: 6f193529 (button) collected ($0.25)
Seat 2: af3a1e97 (small blind) folded before Flop
Seat 3: 109a9abf (big blind) folded before Flop
Seat 4: ba05cd4d folded before Flop (didn't bet)
Seat 5: Hero folded before Flop (didn't bet)
Seat 6: db181c62 folded before Flop (didn't bet)


Poker Hand #RC1467908021: Hold'em No Limit  ($0.05/$0.1) - 2023/04/12 15:13:24
Table 'RushAndCash5503281' 6-max Seat #1 is the button
Seat 1: Hero ($10.85 in chips)
Seat 2: 1de59488 ($10 in chips)
Seat 3: 6f193529 ($15.29 in chips)
Seat 4: a857da8e ($13.47 in chips)
Seat 5: d393b0ae ($15.08 in chips)
Seat 6: 3bc9f7ca ($10.7 in chips)
1de59488: posts small blind $0.05
6f193529: posts big blind $0.1
*** HOLE CARDS ***
Dealt to Hero [8c 8d]
Dealt to 1de59488 
Dealt to 6f193529 
Dealt to a857da8e 
Dealt to d393b0ae 
Dealt to 3bc9f7ca 
a857da8e: folds
d393b0ae: folds
3bc9f7ca: folds
Hero: raises $0.15 to $0.25
1de59488: folds
6f193529: raises $0.95 to $1.2
Hero: folds
Uncalled bet ($0.95) returned to 6f193529
*** SHOWDOWN ***
6f193529 collected $0.53 from pot
*** SUMMARY ***
Total pot $0.55 | Rake $0.02 | Jackpot $0 | Bingo $0 | Fortune $0
Seat 1: Hero (button) folded before Flop
Seat 2: 1de59488 (small blind) folded before Flop
Seat 3: 6f193529 (big blind) collected ($0.53)
Seat 4: a857da8e folded before Flop (didn't bet)
Seat 5: d393b0ae folded before Flop (didn't bet)
Seat 6: 3bc9f7ca folded before Flop (didn't bet)


Poker Hand #RC1467907891: Hold'em No Limit  ($0.05/$0.1) - 2023/04/12 15:13:06
Table 'RushAndCash5503151' 6-max Seat #1 is the button
Seat 1: 870c7d99 ($10 in chips)
Seat 2: Hero ($10.9 in chips)
Seat 3: fc64a2f6 ($10.62 in chips)
Seat 4: 636ee82d ($19.42 in chips)
Seat 5: dcb052b3 ($17.58 in chips)
Seat 6: 6a7b2285 ($39.76 in chips)
Hero: posts small blind $0.05
fc64a2f6: posts big blind $0.1
*** HOLE CARDS ***
Dealt to 870c7d99 
Dealt to Hero [Js Qc]
Dealt to fc64a2f6 
Dealt to 636ee82d 
Dealt to dcb052b3 
Dealt to 6a7b2285 
636ee82d: folds
dcb052b3: folds
6a7b2285: folds
870c7d99: raises $0.15 to $0.25
Hero: folds
fc64a2f6: folds
Uncalled bet ($0.15) returned to 870c7d99
*** SHOWDOWN ***
870c7d99 collected $0.25 from pot
*** SUMMARY ***
Total pot $0.25 | Rake $0 | Jackpot $0 | Bingo $0 | Fortune $0
Seat 1: 870c7d99 (button) collected ($0.25)
Seat 2: Hero (small blind) folded before Flop
Seat 3: fc64a2f6 (big blind) folded before Flop
Seat 4: 636ee82d folded before Flop (didn't bet)
Seat 5: dcb052b3 folded before Flop (didn't bet)
Seat 6: 6a7b2285 folded before Flop (didn't bet)


Poker Hand #RC1467907790: Hold'em No Limit  ($0.05/$0.1) - 2023/04/12 15:12:54
Table 'RushAndCash5503050' 6-max Seat #1 is the button
Seat 1: ae03fcc6 ($10.05 in chips)
Seat 2: 2f45435d ($9.46 in chips)
Seat 3: Hero ($11 in chips)
Seat 4: 2e3c443 ($18.1 in chips)
Seat 5: fea382e7 ($14.25 in chips)
Seat 6: f4a001ee ($10.25 in chips)
2f45435d: posts small blind $0.05
Hero: posts big blind $0.1
*** HOLE CARDS ***
Dealt to ae03fcc6 
Dealt to 2f45435d 
Dealt to Hero [Qs 5d]
Dealt to 2e3c443 
Dealt to fea382e7 
Dealt to f4a001ee 
2e3c443: folds
fea382e7: folds
f4a001ee: folds
ae03fcc6: folds
2f45435d: raises $0.14 to $0.24
Hero: folds
Uncalled bet ($0.14) returned to 2f45435d
*** SHOWDOWN ***
2f45435d collected $0.2 from pot
*** SUMMARY ***
Total pot $0.2 | Rake $0 | Jackpot $0 | Bingo $0 | Fortune $0
Seat 1: ae03fcc6 (button) folded before Flop (didn't bet)
Seat 2: 2f45435d (small blind) collected ($0.2)
Seat 3: Hero (big blind) folded before Flop
Seat 4: 2e3c443 folded before Flop (didn't bet)
Seat 5: fea382e7 folded before Flop (didn't bet)
Seat 6: f4a001ee folded before Flop (didn't bet)


Poker Hand #RC1467907723: Hold'em No Limit  ($0.05/$0.1) - 2023/04/12 15:12:44
Table 'RushAndCash5502983' 6-max Seat #1 is the button
Seat 1: 83bb0133 ($11.14 in chips)
Seat 2: 8b8d7bb9 ($10 in chips)
Seat 3: 5e304ffe ($27.67 in chips)
Seat 4: 62ac821a ($17.72 in chips)
Seat 5: Hero ($11 in chips)
Seat 6: b7e527d9 ($41.32 in chips)
8b8d7bb9: posts small blind $0.05
5e304ffe: posts big blind $0.1
*** HOLE CARDS ***
Dealt to 83bb0133 
Dealt to 8b8d7bb9 
Dealt to 5e304ffe 
Dealt to 62ac821a 
Dealt to Hero [5d 8h]
Dealt to b7e527d9 
62ac821a: folds
Hero: folds
b7e527d9: folds
83bb0133: folds
8b8d7bb9: raises $0.2 to $0.3
5e304ffe: raises $0.5 to $0.8
8b8d7bb9: folds
Uncalled bet ($0.5) returned to 5e304ffe
*** SHOWDOWN ***
5e304ffe collected $0.57 from pot
*** SUMMARY ***
Total pot $0.6 | Rake $0.03 | Jackpot $0 | Bingo $0 | Fortune $0
Seat 1: 83bb0133 (button) folded before Flop (didn't bet)
Seat 2: 8b8d7bb9 (small blind) folded before Flop
Seat 3: 5e304ffe (big blind) collected ($0.57)
Seat 4: 62ac821a folded before Flop (didn't bet)
Seat 5: Hero folded before Flop (didn't bet)
Seat 6: b7e527d9 folded before Flop (didn't bet)


Poker Hand #RC1467907630: Hold'em No Limit  ($0.05/$0.1) - 2023/04/12 15:12:31
Table 'RushAndCash5502890' 6-max Seat #1 is the button
Seat 1: e4691041 ($17.07 in chips)
Seat 2: fc8a4b2f ($13.68 in chips)
Seat 3: 17ed0cd5 ($18.67 in chips)
Seat 4: Hero ($11 in chips)
Seat 5: be0b6517 ($17.48 in chips)
Seat 6: 5d5a5867 ($10 in chips)
fc8a4b2f: posts small blind $0.05
17ed0cd5: posts big blind $0.1
*** HOLE CARDS ***
Dealt to e4691041 
Dealt to fc8a4b2f 
Dealt to 17ed0cd5 
Dealt to Hero [4h 7c]
Dealt to be0b6517 
Dealt to 5d5a5867 
Hero: folds
be0b6517: folds
5d5a5867: folds
e4691041: raises $0.12 to $0.22
fc8a4b2f: raises $0.98 to $1.2
17ed0cd5: folds
e4691041: folds
Uncalled bet ($0.98) returned to fc8a4b2f
*** SHOWDOWN ***
fc8a4b2f collected $0.52 from pot
*** SUMMARY ***
Total pot $0.54 | Rake $0.02 | Jackpot $0 | Bingo $0 | Fortune $0
Seat 1: e4691041 (button) folded before Flop
Seat 2: fc8a4b2f (small blind) collected ($0.52)
Seat 3: 17ed0cd5 (big blind) folded before Flop
Seat 4: Hero folded before Flop (didn't bet)
Seat 5: be0b6517 folded before Flop (didn't bet)
Seat 6: 5d5a5867 folded before Flop (didn't bet)


Poker Hand #RC1467907582: Hold'em No Limit  ($0.05/$0.1) - 2023/04/12 15:12:25
Table 'RushAndCash5502842' 6-max Seat #1 is the button
Seat 1: 4607d77f ($9.32 in chips)
Seat 2: 85329f4e ($8.37 in chips)
Seat 3: ddeddc27 ($1.8 in chips)
Seat 4: Hero ($11 in chips)
Seat 5: 400d9dea ($11.2 in chips)
Seat 6: 113afe75 ($13 in chips)
85329f4e: posts small blind $0.05
ddeddc27: posts big blind $0.1
*** HOLE CARDS ***
Dealt to 4607d77f 
Dealt to 85329f4e 
Dealt to ddeddc27 
Dealt to Hero [9h 5h]
Dealt to 400d9dea 
Dealt to 113afe75 
Hero: folds
400d9dea: folds
113afe75: raises $0.15 to $0.25
4607d77f: folds
85329f4e: folds
ddeddc27: folds
Uncalled bet ($0.15) returned to 113afe75
*** SHOWDOWN ***
113afe75 collected $0.25 from pot
*** SUMMARY ***
Total pot $0.25 | Rake $0 | Jackpot $0 | Bingo $0 | Fortune $0
Seat 1: 4607d77f (button) folded before Flop (didn't bet)
Seat 2: 85329f4e (small blind) folded before Flop
Seat 3: ddeddc27 (big blind) folded before Flop
Seat 4: Hero folded before Flop (didn't bet)
Seat 5: 400d9dea folded before Flop (didn't bet)
Seat 6: 113afe75 collected ($0.25)


Poker Hand #RC1467907555: Hold'em No Limit  ($0.05/$0.1) - 2023/04/12 15:12:20
Table 'RushAndCash5502815' 6-max Seat #1 is the button
Seat 1: bbc7a77a ($11.17 in chips)
Seat 2: 4e73f163 ($10.22 in chips)
Seat 3: 3772f1f2 ($11.76 in chips)
Seat 4: e974108b ($10.11 in chips)
Seat 5: 48dc5f4d ($18.08 in chips)
Seat 6: Hero ($11 in chips)
4e73f163: posts small blind $0.05
3772f1f2: posts big blind $0.1
*** HOLE CARDS ***
Dealt to bbc7a77a 
Dealt to 4e73f163 
Dealt to 3772f1f2 
Dealt to e974108b 
Dealt to 48dc5f4d 
Dealt to Hero [2c 8h]
e974108b: folds
48dc5f4d: folds
Hero: folds
bbc7a77a: folds
4e73f163: raises $0.2 to $0.3
3772f1f2: folds
Uncalled bet ($0.2) returned to 4e73f163
*** SHOWDOWN ***
4e73f163 collected $0.2 from pot
*** SUMMARY ***
Total pot $0.2 | Rake $0 | Jackpot $0 | Bingo $0 | Fortune $0
Seat 1: bbc7a77a (button) folded before Flop (didn't bet)
Seat 2: 4e73f163 (small blind) collected ($0.2)
Seat 3: 3772f1f2 (big blind) folded before Flop
Seat 4: e974108b folded before Flop (didn't bet)
Seat 5: 48dc5f4d folded before Flop (didn't bet)
Seat 6: Hero folded before Flop (didn't bet)


Poker Hand #RC1467907500: Hold'em No Limit  ($0.05/$0.1) - 2023/04/12 15:12:13
Table 'RushAndCash5502760' 6-max Seat #1 is the button
Seat 1: Hero ($11 in chips)
Seat 2: 85329f4e ($8.52 in chips)
Seat 3: 299bca27 ($23.02 in chips)
Seat 4: 615363c0 ($10 in chips)
Seat 5: 91289e8e ($18.8 in chips)
Seat 6: 5bdfb6c2 ($9.08 in chips)
85329f4e: posts small blind $0.05
299bca27: posts big blind $0.1
*** HOLE CARDS ***
Dealt to Hero [6c 9h]
Dealt to 85329f4e 
Dealt to 299bca27 
Dealt to 615363c0 
Dealt to 91289e8e 
Dealt to 5bdfb6c2 
615363c0: raises $0.15 to $0.25
91289e8e: folds
5bdfb6c2: folds
Hero: folds
85329f4e: folds
299bca27: calls $0.15
*** FLOP *** [Qh 5c Tc]
299bca27: checks
615363c0: checks
*** TURN *** [Qh 5c Tc] [6d]
299bca27: bets $0.45
615363c0: folds
Uncalled bet ($0.45) returned to 299bca27
*** SHOWDOWN ***
299bca27 collected $0.53 from pot
*** SUMMARY ***
Total pot $0.55 | Rake $0.02 | Jackpot $0 | Bingo $0 | Fortune $0
Board [Qh 5c Tc 6d]
Seat 1: Hero (button) folded before Flop (didn't bet)
Seat 2: 85329f4e (small blind) folded before Flop
Seat 3: 299bca27 (big blind) won ($0.53)
Seat 4: 615363c0 folded on the Turn
Seat 5: 91289e8e folded before Flop (didn't bet)
Seat 6: 5bdfb6c2 folded before Flop (didn't bet)


Poker Hand #RC1467907437: Hold'em No Limit  ($0.05/$0.1) - 2023/04/12 15:12:05
Table 'RushAndCash5502697' 6-max Seat #1 is the button
Seat 1: 65b91a8d ($10 in chips)
Seat 2: Hero ($11.05 in chips)
Seat 3: f1f32720 ($22.59 in chips)
Seat 4: db427209 ($9.37 in chips)
Seat 5: 615363c0 ($10 in chips)
Seat 6: e77b7178 ($15.99 in chips)
Hero: posts small blind $0.05
f1f32720: posts big blind $0.1
*** HOLE CARDS ***
Dealt to 65b91a8d 
Dealt to Hero [Kc 4s]
Dealt to f1f32720 
Dealt to db427209 
Dealt to 615363c0 
Dealt to e77b7178 
db427209: folds
615363c0: folds
e77b7178: folds
65b91a8d: folds
Hero: folds
Uncalled bet ($0.05) returned to f1f32720
*** SHOWDOWN ***
f1f32720 collected $0.1 from pot
*** SUMMARY ***
Total pot $0.1 | Rake $0 | Jackpot $0 | Bingo $0 | Fortune $0
Seat 1: 65b91a8d (button) folded before Flop (didn't bet)
Seat 2: Hero (small blind) folded before Flop
Seat 3: f1f32720 (big blind) collected ($0.1)
Seat 4: db427209 folded before Flop (didn't bet)
Seat 5: 615363c0 folded before Flop (didn't bet)
Seat 6: e77b7178 folded before Flop (didn't bet)


Poker Hand #RC1467906980: Hold'em No Limit  ($0.05/$0.1) - 2023/04/12 15:11:02
Table 'RushAndCash5502240' 6-max Seat #1 is the button
Seat 1: d5e1a6b5 ($4.63 in chips)
Seat 2: 723bff68 ($10 in chips)
Seat 3: Hero ($10 in chips)
Seat 4: 20813343 ($10 in chips)
Seat 5: 301f35eb ($8.65 in chips)
Seat 6: 9751054 ($14.8 in chips)
723bff68: posts small blind $0.05
Hero: posts big blind $0.1
*** HOLE CARDS ***
Dealt to d5e1a6b5 
Dealt to 723bff68 
Dealt to Hero [Jc Jd]
Dealt to 20813343 
Dealt to 301f35eb 
Dealt to 9751054 
20813343: folds
301f35eb: folds
9751054: folds
d5e1a6b5: folds
723bff68: raises $0.13 to $0.23
Hero: raises $0.35 to $0.58
723bff68: calls $0.35
*** FLOP *** [3h Td 9d]
723bff68: checks
Hero: bets $0.58
723bff68: calls $0.58
*** TURN *** [3h Td 9d] [9s]
723bff68: checks
Hero: bets $0.77
723bff68: folds
Uncalled bet ($0.77) returned to Hero
*** SHOWDOWN ***
Hero collected $2.21 from pot
*** SUMMARY ***
Total pot $2.32 | Rake $0.11 | Jackpot $0 | Bingo $0 | Fortune $0
Board [3h Td 9d 9s]
Seat 1: d5e1a6b5 (button) folded before Flop (didn't bet)
Seat 2: 723bff68 (small blind) folded on the Turn
Seat 3: Hero (big blind) won ($2.21)
Seat 4: 20813343 folded before Flop (didn't bet)
Seat 5: 301f35eb folded before Flop (didn't bet)
Seat 6: 9751054 folded before Flop (didn't bet)


