Poker Hand #RC1460028531: Hold'em No Limit  ($0.05/$0.1) - 2023/04/08 21:45:16
Table 'RushAndCash3793791' 6-max Seat #1 is the button
Seat 1: 80783716 ($8.49 in chips)
Seat 2: 175d11e7 ($11.06 in chips)
Seat 3: 9c96aadf ($21.76 in chips)
Seat 4: a8745400 ($13.65 in chips)
Seat 5: 61b2f0b ($6.51 in chips)
Seat 6: Hero ($8.01 in chips)
175d11e7: posts small blind $0.05
9c96aadf: posts big blind $0.1
*** HOLE CARDS ***
Dealt to 80783716 
Dealt to 175d11e7 
Dealt to 9c96aadf 
Dealt to a8745400 
Dealt to 61b2f0b 
Dealt to Hero [Ac Ks]
a8745400: folds
61b2f0b: folds
Hero: raises $0.15 to $0.25
80783716: calls $0.25
175d11e7: folds
9c96aadf: raises $1.1 to $1.35
Hero: raises $6.66 to $8.01 and is all-in
80783716: raises $0.48 to $8.49 and is all-in
9c96aadf: folds
Uncalled bet ($0.48) returned to 80783716
80783716: shows [Ad As]
Hero: shows [Ac Ks]
*** FLOP *** [Jc 8s 8h]
*** TURN *** [Jc 8s 8h] [Js]
*** RIVER *** [Jc 8s 8h Js] [3h]
*** SHOWDOWN ***
80783716 collected $16.97 from pot
*** SUMMARY ***
Total pot $17.42 | Rake $0.3 | Jackpot $0.15 | Bingo $0 | Fortune $0
Board [Jc 8s 8h Js 3h]
Seat 1: 80783716 (button) showed [Ad As] and won ($16.97) with Pair of Aces and Pair of Jacks
Seat 2: 175d11e7 (small blind) folded before Flop
Seat 3: 9c96aadf (big blind) folded before Flop
Seat 4: a8745400 folded before Flop (didn't bet)
Seat 5: 61b2f0b folded before Flop (didn't bet)
Seat 6: Hero showed [Ac Ks] and lost with Pair of Jacks and Pair of Eights


Poker Hand #RC1460028502: Hold'em No Limit  ($0.05/$0.1) - 2023/04/08 21:45:11
Table 'RushAndCash3793762' 6-max Seat #1 is the button
Seat 1: 457142b5 ($40.62 in chips)
Seat 2: Hero ($8.06 in chips)
Seat 3: 8f6da20c ($12.79 in chips)
Seat 4: ae477070 ($10 in chips)
Seat 5: 2f7d31ea ($11.1 in chips)
Seat 6: bf8d8396 ($10.7 in chips)
Hero: posts small blind $0.05
8f6da20c: posts big blind $0.1
*** HOLE CARDS ***
Dealt to 457142b5 
Dealt to Hero [4c 3c]
Dealt to 8f6da20c 
Dealt to ae477070 
Dealt to 2f7d31ea 
Dealt to bf8d8396 
ae477070: folds
2f7d31ea: folds
bf8d8396: folds
457142b5: folds
Hero: folds
Uncalled bet ($0.05) returned to 8f6da20c
*** SHOWDOWN ***
8f6da20c collected $0.1 from pot
*** SUMMARY ***
Total pot $0.1 | Rake $0 | Jackpot $0 | Bingo $0 | Fortune $0
Seat 1: 457142b5 (button) folded before Flop (didn't bet)
Seat 2: Hero (small blind) folded before Flop
Seat 3: 8f6da20c (big blind) collected ($0.1)
Seat 4: ae477070 folded before Flop (didn't bet)
Seat 5: 2f7d31ea folded before Flop (didn't bet)
Seat 6: bf8d8396 folded before Flop (didn't bet)


Poker Hand #RC1460028471: Hold'em No Limit  ($0.05/$0.1) - 2023/04/08 21:45:06
Table 'RushAndCash3793731' 6-max Seat #1 is the button
Seat 1: 2f3c8996 ($13.23 in chips)
Seat 2: b6746050 ($84.91 in chips)
Seat 3: 5ffd8e33 ($20.54 in chips)
Seat 4: 59d7bce3 ($14.19 in chips)
Seat 5: Hero ($8.06 in chips)
Seat 6: ca24ac96 ($10 in chips)
b6746050: posts small blind $0.05
5ffd8e33: posts big blind $0.1
*** HOLE CARDS ***
Dealt to 2f3c8996 
Dealt to b6746050 
Dealt to 5ffd8e33 
Dealt to 59d7bce3 
Dealt to Hero [Qc 6s]
Dealt to ca24ac96 
59d7bce3: folds
Hero: folds
ca24ac96: folds
2f3c8996: raises $0.15 to $0.25
b6746050: folds
5ffd8e33: calls $0.15
*** FLOP *** [8d 3d Jd]
5ffd8e33: checks
2f3c8996: bets $0.28
5ffd8e33: raises $0.37 to $0.65
2f3c8996: folds
Uncalled bet ($0.37) returned to 5ffd8e33
*** SHOWDOWN ***
5ffd8e33 collected $1.06 from pot
*** SUMMARY ***
Total pot $1.11 | Rake $0.05 | Jackpot $0 | Bingo $0 | Fortune $0
Board [8d 3d Jd]
Seat 1: 2f3c8996 (button) folded on the Flop
Seat 2: b6746050 (small blind) folded before Flop
Seat 3: 5ffd8e33 (big blind) won ($1.06)
Seat 4: 59d7bce3 folded before Flop (didn't bet)
Seat 5: Hero folded before Flop (didn't bet)
Seat 6: ca24ac96 folded before Flop (didn't bet)


Poker Hand #RC1460028417: Hold'em No Limit  ($0.05/$0.1) - 2023/04/08 21:44:57
Table 'RushAndCash3793677' 6-max Seat #1 is the button
Seat 1: ec14ff9f ($9.06 in chips)
Seat 2: 13df74b7 ($10 in chips)
Seat 3: b05af00f ($5.96 in chips)
Seat 4: 32655b8a ($11.72 in chips)
Seat 5: df76427d ($13.63 in chips)
Seat 6: Hero ($8.06 in chips)
13df74b7: posts small blind $0.05
b05af00f: posts big blind $0.1
*** HOLE CARDS ***
Dealt to ec14ff9f 
Dealt to 13df74b7 
Dealt to b05af00f 
Dealt to 32655b8a 
Dealt to df76427d 
Dealt to Hero [Qh 4s]
32655b8a: folds
df76427d: folds
Hero: folds
ec14ff9f: folds
13df74b7: raises $0.2 to $0.3
b05af00f: calls $0.2
*** FLOP *** [9c 3h Jh]
13df74b7: checks
b05af00f: checks
*** TURN *** [9c 3h Jh] [6d]
13df74b7: checks
b05af00f: checks
*** RIVER *** [9c 3h Jh 6d] [2d]
13df74b7: checks
b05af00f: checks
13df74b7: shows [8d Ah] (Ace-High)
b05af00f: shows [7c 7s] (Pair of Sevens)
*** SHOWDOWN ***
b05af00f collected $0.57 from pot
*** SUMMARY ***
Total pot $0.6 | Rake $0.03 | Jackpot $0 | Bingo $0 | Fortune $0
Board [9c 3h Jh 6d 2d]
Seat 1: ec14ff9f (button) folded before Flop (didn't bet)
Seat 2: 13df74b7 (small blind) showed [8d Ah] and lost with Ace-High
Seat 3: b05af00f (big blind) showed [7c 7s] and won ($0.57) with Pair of Sevens
Seat 4: 32655b8a folded before Flop (didn't bet)
Seat 5: df76427d folded before Flop (didn't bet)
Seat 6: Hero folded before Flop (didn't bet)


Poker Hand #RC1460028362: Hold'em No Limit  ($0.05/$0.1) - 2023/04/08 21:44:48
Table 'RushAndCash3793622' 6-max Seat #1 is the button
Seat 1: 3d55903e ($13.06 in chips)
Seat 2: 3610c1a3 ($10 in chips)
Seat 3: Hero ($8.16 in chips)
Seat 4: a9cd0c44 ($10 in chips)
Seat 5: cde395d6 ($10.42 in chips)
Seat 6: 76db26dd ($12.37 in chips)
3610c1a3: posts small blind $0.05
Hero: posts big blind $0.1
*** HOLE CARDS ***
Dealt to 3d55903e 
Dealt to 3610c1a3 
Dealt to Hero [2s Qs]
Dealt to a9cd0c44 
Dealt to cde395d6 
Dealt to 76db26dd 
a9cd0c44: folds
cde395d6: folds
76db26dd: raises $0.15 to $0.25
3d55903e: folds
3610c1a3: folds
Hero: folds
Uncalled bet ($0.15) returned to 76db26dd
*** SHOWDOWN ***
76db26dd collected $0.25 from pot
*** SUMMARY ***
Total pot $0.25 | Rake $0 | Jackpot $0 | Bingo $0 | Fortune $0
Seat 1: 3d55903e (button) folded before Flop (didn't bet)
Seat 2: 3610c1a3 (small blind) folded before Flop
Seat 3: Hero (big blind) folded before Flop
Seat 4: a9cd0c44 folded before Flop (didn't bet)
Seat 5: cde395d6 folded before Flop (didn't bet)
Seat 6: 76db26dd collected ($0.25)


Poker Hand #RC1460028069: Hold'em No Limit  ($0.05/$0.1) - 2023/04/08 21:43:59
Table 'RushAndCash3793329' 6-max Seat #1 is the button
Seat 1: 2b717329 ($14.27 in chips)
Seat 2: 1199caee ($1.8 in chips)
Seat 3: caed7b6f ($13.06 in chips)
Seat 4: f3c40c35 ($23.58 in chips)
Seat 5: Hero ($4.28 in chips)
Seat 6: 4a8c7660 ($68.12 in chips)
1199caee: posts small blind $0.05
caed7b6f: posts big blind $0.1
*** HOLE CARDS ***
Dealt to 2b717329 
Dealt to 1199caee 
Dealt to caed7b6f 
Dealt to f3c40c35 
Dealt to Hero [Ah 5h]
Dealt to 4a8c7660 
f3c40c35: folds
Hero: raises $0.15 to $0.25
4a8c7660: folds
2b717329: folds
1199caee: folds
caed7b6f: calls $0.15
*** FLOP *** [Ac 5c Kd]
caed7b6f: checks
Hero: bets $0.28
caed7b6f: raises $0.84 to $1.12
Hero: raises $2.91 to $4.03 and is all-in
caed7b6f: calls $2.91
Hero: shows [Ah 5h] (Pair of Aces and Pair of Fives)
caed7b6f: shows [Qc 9c] (Ace-High)
*** TURN *** [Ac 5c Kd] [8s]
*** RIVER *** [Ac 5c Kd 8s] [8d]
*** SHOWDOWN ***
Hero collected $8.16 from pot
*** SUMMARY ***
Total pot $8.61 | Rake $0.3 | Jackpot $0.15 | Bingo $0 | Fortune $0
Board [Ac 5c Kd 8s 8d]
Seat 1: 2b717329 (button) folded before Flop (didn't bet)
Seat 2: 1199caee (small blind) folded before Flop
Seat 3: caed7b6f (big blind) showed [Qc 9c] and lost with Pair of Eights
Seat 4: f3c40c35 folded before Flop (didn't bet)
Seat 5: Hero showed [Ah 5h] and won ($8.16) with Pair of Aces and Pair of Eights
Seat 6: 4a8c7660 folded before Flop (didn't bet)


Poker Hand #RC1460028037: Hold'em No Limit  ($0.05/$0.1) - 2023/04/08 21:43:54
Table 'RushAndCash3793297' 6-max Seat #1 is the button
Seat 1: d6be1ace ($7.02 in chips)
Seat 2: Hero ($4.33 in chips)
Seat 3: 68d58f0b ($21.38 in chips)
Seat 4: 4dd18d68 ($27.05 in chips)
Seat 5: 457142b5 ($40.92 in chips)
Seat 6: 8a8bce3 ($33.02 in chips)
Hero: posts small blind $0.05
68d58f0b: posts big blind $0.1
*** HOLE CARDS ***
Dealt to d6be1ace 
Dealt to Hero [4h 5d]
Dealt to 68d58f0b 
Dealt to 4dd18d68 
Dealt to 457142b5 
Dealt to 8a8bce3 
4dd18d68: raises $0.15 to $0.25
457142b5: folds
8a8bce3: folds
d6be1ace: folds
Hero: folds
68d58f0b: calls $0.15
*** FLOP *** [4s 3s 7s]
68d58f0b: checks
4dd18d68: bets $0.2
68d58f0b: calls $0.2
*** TURN *** [4s 3s 7s] [9h]
68d58f0b: checks
4dd18d68: checks
*** RIVER *** [4s 3s 7s 9h] [3d]
68d58f0b: bets $0.72
4dd18d68: folds
Uncalled bet ($0.72) returned to 68d58f0b
*** SHOWDOWN ***
68d58f0b collected $0.91 from pot
*** SUMMARY ***
Total pot $0.95 | Rake $0.04 | Jackpot $0 | Bingo $0 | Fortune $0
Board [4s 3s 7s 9h 3d]
Seat 1: d6be1ace (button) folded before Flop (didn't bet)
Seat 2: Hero (small blind) folded before Flop
Seat 3: 68d58f0b (big blind) won ($0.91)
Seat 4: 4dd18d68 folded on the River
Seat 5: 457142b5 folded before Flop (didn't bet)
Seat 6: 8a8bce3 folded before Flop (didn't bet)


Poker Hand #RC1460028013: Hold'em No Limit  ($0.05/$0.1) - 2023/04/08 21:43:50
Table 'RushAndCash3793273' 6-max Seat #1 is the button
Seat 1: 4ade6da2 ($8.21 in chips)
Seat 2: 5939553a ($10.75 in chips)
Seat 3: dfe0f72a ($10 in chips)
Seat 4: 92be4bf ($18.4 in chips)
Seat 5: Hero ($4.33 in chips)
Seat 6: 3bfa3e10 ($19.95 in chips)
5939553a: posts small blind $0.05
dfe0f72a: posts big blind $0.1
*** HOLE CARDS ***
Dealt to 4ade6da2 
Dealt to 5939553a 
Dealt to dfe0f72a 
Dealt to 92be4bf 
Dealt to Hero [Kd 7s]
Dealt to 3bfa3e10 
92be4bf: folds
Hero: folds
3bfa3e10: folds
4ade6da2: folds
5939553a: raises $0.1 to $0.2
dfe0f72a: folds
Uncalled bet ($0.1) returned to 5939553a
*** SHOWDOWN ***
5939553a collected $0.2 from pot
*** SUMMARY ***
Total pot $0.2 | Rake $0 | Jackpot $0 | Bingo $0 | Fortune $0
Seat 1: 4ade6da2 (button) folded before Flop (didn't bet)
Seat 2: 5939553a (small blind) collected ($0.2)
Seat 3: dfe0f72a (big blind) folded before Flop
Seat 4: 92be4bf folded before Flop (didn't bet)
Seat 5: Hero folded before Flop (didn't bet)
Seat 6: 3bfa3e10 folded before Flop (didn't bet)


Poker Hand #RC1460027937: Hold'em No Limit  ($0.05/$0.1) - 2023/04/08 21:43:36
Table 'RushAndCash3793197' 6-max Seat #1 is the button
Seat 1: 583bb900 ($56.16 in chips)
Seat 2: Hero ($4.38 in chips)
Seat 3: 3610c1a3 ($10.13 in chips)
Seat 4: 91c9f683 ($10.24 in chips)
Seat 5: 2746b81b ($9.5 in chips)
Seat 6: c4b939d ($15 in chips)
Hero: posts small blind $0.05
3610c1a3: posts big blind $0.1
*** HOLE CARDS ***
Dealt to 583bb900 
Dealt to Hero [3d Kd]
Dealt to 3610c1a3 
Dealt to 91c9f683 
Dealt to 2746b81b 
Dealt to c4b939d 
91c9f683: raises $0.12 to $0.22
2746b81b: folds
c4b939d: folds
583bb900: folds
Hero: folds
3610c1a3: folds
Uncalled bet ($0.12) returned to 91c9f683
*** SHOWDOWN ***
91c9f683 collected $0.25 from pot
*** SUMMARY ***
Total pot $0.25 | Rake $0 | Jackpot $0 | Bingo $0 | Fortune $0
Seat 1: 583bb900 (button) folded before Flop (didn't bet)
Seat 2: Hero (small blind) folded before Flop
Seat 3: 3610c1a3 (big blind) folded before Flop
Seat 4: 91c9f683 collected ($0.25)
Seat 5: 2746b81b folded before Flop (didn't bet)
Seat 6: c4b939d folded before Flop (didn't bet)


Poker Hand #RC1460027893: Hold'em No Limit  ($0.05/$0.1) - 2023/04/08 21:43:29
Table 'RushAndCash3793153' 6-max Seat #1 is the button
Seat 1: 4c71c38c ($7.77 in chips)
Seat 2: 89398444 ($19.04 in chips)
Seat 3: Hero ($4.48 in chips)
Seat 4: 5939553a ($10.75 in chips)
Seat 5: e790267c ($17.12 in chips)
Seat 6: 38bd8899 ($35.42 in chips)
89398444: posts small blind $0.05
Hero: posts big blind $0.1
*** HOLE CARDS ***
Dealt to 4c71c38c 
Dealt to 89398444 
Dealt to Hero [4d 8c]
Dealt to 5939553a 
Dealt to e790267c 
Dealt to 38bd8899 
5939553a: folds
e790267c: folds
38bd8899: folds
4c71c38c: raises $0.15 to $0.25
89398444: calls $0.2
Hero: folds
*** FLOP *** [2d Ts 5s]
89398444: checks
4c71c38c: bets $0.2
89398444: calls $0.2
*** TURN *** [2d Ts 5s] [4s]
89398444: checks
4c71c38c: checks
*** RIVER *** [2d Ts 5s 4s] [Ks]
89398444: bets $1
4c71c38c: folds
Uncalled bet ($1) returned to 89398444
*** SHOWDOWN ***
89398444 collected $0.95 from pot
*** SUMMARY ***
Total pot $1 | Rake $0.05 | Jackpot $0 | Bingo $0 | Fortune $0
Board [2d Ts 5s 4s Ks]
Seat 1: 4c71c38c (button) folded on the River
Seat 2: 89398444 (small blind) won ($0.95)
Seat 3: Hero (big blind) folded before Flop
Seat 4: 5939553a folded before Flop (didn't bet)
Seat 5: e790267c folded before Flop (didn't bet)
Seat 6: 38bd8899 folded before Flop (didn't bet)


Poker Hand #RC1460027866: Hold'em No Limit  ($0.05/$0.1) - 2023/04/08 21:43:24
Table 'RushAndCash3793126' 6-max Seat #1 is the button
Seat 1: 1d46a013 ($9.6 in chips)
Seat 2: a8745400 ($16.25 in chips)
Seat 3: Hero ($4.58 in chips)
Seat 4: ef3ad6a8 ($6.67 in chips)
Seat 5: 75972b39 ($5.53 in chips)
Seat 6: e40de4b2 ($12.98 in chips)
a8745400: posts small blind $0.05
Hero: posts big blind $0.1
*** HOLE CARDS ***
Dealt to 1d46a013 
Dealt to a8745400 
Dealt to Hero [3h 7d]
Dealt to ef3ad6a8 
Dealt to 75972b39 
Dealt to e40de4b2 
ef3ad6a8: raises $0.1 to $0.2
75972b39: folds
e40de4b2: folds
1d46a013: folds
a8745400: folds
Hero: folds
Uncalled bet ($0.1) returned to ef3ad6a8
*** SHOWDOWN ***
ef3ad6a8 collected $0.25 from pot
*** SUMMARY ***
Total pot $0.25 | Rake $0 | Jackpot $0 | Bingo $0 | Fortune $0
Seat 1: 1d46a013 (button) folded before Flop (didn't bet)
Seat 2: a8745400 (small blind) folded before Flop
Seat 3: Hero (big blind) folded before Flop
Seat 4: ef3ad6a8 collected ($0.25)
Seat 5: 75972b39 folded before Flop (didn't bet)
Seat 6: e40de4b2 folded before Flop (didn't bet)


Poker Hand #RC1460027841: Hold'em No Limit  ($0.05/$0.1) - 2023/04/08 21:43:20
Table 'RushAndCash3793101' 6-max Seat #1 is the button
Seat 1: 1dd65d52 ($12.41 in chips)
Seat 2: 2766c05e ($10.34 in chips)
Seat 3: aaae6007 ($21.32 in chips)
Seat 4: 92a48d51 ($8.45 in chips)
Seat 5: Hero ($4.58 in chips)
Seat 6: a331059d ($10.52 in chips)
2766c05e: posts small blind $0.05
aaae6007: posts big blind $0.1
*** HOLE CARDS ***
Dealt to 1dd65d52 
Dealt to 2766c05e 
Dealt to aaae6007 
Dealt to 92a48d51 
Dealt to Hero [6d Ac]
Dealt to a331059d 
92a48d51: folds
Hero: folds
a331059d: folds
1dd65d52: raises $0.15 to $0.25
2766c05e: folds
aaae6007: folds
Uncalled bet ($0.15) returned to 1dd65d52
*** SHOWDOWN ***
1dd65d52 collected $0.25 from pot
*** SUMMARY ***
Total pot $0.25 | Rake $0 | Jackpot $0 | Bingo $0 | Fortune $0
Seat 1: 1dd65d52 (button) collected ($0.25)
Seat 2: 2766c05e (small blind) folded before Flop
Seat 3: aaae6007 (big blind) folded before Flop
Seat 4: 92a48d51 folded before Flop (didn't bet)
Seat 5: Hero folded before Flop (didn't bet)
Seat 6: a331059d folded before Flop (didn't bet)


Poker Hand #RC1460027814: Hold'em No Limit  ($0.05/$0.1) - 2023/04/08 21:43:16
Table 'RushAndCash3793074' 6-max Seat #1 is the button
Seat 1: aaae6007 ($21.32 in chips)
Seat 2: 8fcef37 ($7.9 in chips)
Seat 3: a9cd0c44 ($10 in chips)
Seat 4: 6c44c3f2 ($17.44 in chips)
Seat 5: Hero ($4.58 in chips)
Seat 6: 2101b7fa ($30.92 in chips)
8fcef37: posts small blind $0.05
a9cd0c44: posts big blind $0.1
*** HOLE CARDS ***
Dealt to aaae6007 
Dealt to 8fcef37 
Dealt to a9cd0c44 
Dealt to 6c44c3f2 
Dealt to Hero [5c 9s]
Dealt to 2101b7fa 
6c44c3f2: raises $0.1 to $0.2
Hero: folds
2101b7fa: folds
aaae6007: folds
8fcef37: calls $0.15
a9cd0c44: folds
*** FLOP *** [6c Kc 5h]
8fcef37: checks
6c44c3f2: bets $0.5
8fcef37: calls $0.5
*** TURN *** [6c Kc 5h] [4s]
8fcef37: checks
6c44c3f2: checks
*** RIVER *** [6c Kc 5h 4s] [3d]
8fcef37: bets $1.13
6c44c3f2: folds
Uncalled bet ($1.13) returned to 8fcef37
*** SHOWDOWN ***
8fcef37 collected $1.43 from pot
*** SUMMARY ***
Total pot $1.5 | Rake $0.07 | Jackpot $0 | Bingo $0 | Fortune $0
Board [6c Kc 5h 4s 3d]
Seat 1: aaae6007 (button) folded before Flop (didn't bet)
Seat 2: 8fcef37 (small blind) won ($1.43)
Seat 3: a9cd0c44 (big blind) folded before Flop
Seat 4: 6c44c3f2 folded on the River
Seat 5: Hero folded before Flop (didn't bet)
Seat 6: 2101b7fa folded before Flop (didn't bet)


Poker Hand #RC1460027790: Hold'em No Limit  ($0.05/$0.1) - 2023/04/08 21:43:11
Table 'RushAndCash3793050' 6-max Seat #1 is the button
Seat 1: 3bfa3e10 ($20.1 in chips)
Seat 2: 96844adf ($13.22 in chips)
Seat 3: ec14ff9f ($8.82 in chips)
Seat 4: b96d280 ($15.05 in chips)
Seat 5: Hero ($4.58 in chips)
Seat 6: a8745400 ($16.1 in chips)
96844adf: posts small blind $0.05
ec14ff9f: posts big blind $0.1
*** HOLE CARDS ***
Dealt to 3bfa3e10 
Dealt to 96844adf 
Dealt to ec14ff9f 
Dealt to b96d280 
Dealt to Hero [2s Ks]
Dealt to a8745400 
b96d280: folds
Hero: folds
a8745400: raises $0.15 to $0.25
3bfa3e10: folds
96844adf: folds
ec14ff9f: folds
Uncalled bet ($0.15) returned to a8745400
*** SHOWDOWN ***
a8745400 collected $0.25 from pot
*** SUMMARY ***
Total pot $0.25 | Rake $0 | Jackpot $0 | Bingo $0 | Fortune $0
Seat 1: 3bfa3e10 (button) folded before Flop (didn't bet)
Seat 2: 96844adf (small blind) folded before Flop
Seat 3: ec14ff9f (big blind) folded before Flop
Seat 4: b96d280 folded before Flop (didn't bet)
Seat 5: Hero folded before Flop (didn't bet)
Seat 6: a8745400 collected ($0.25)


Poker Hand #RC1460027767: Hold'em No Limit  ($0.05/$0.1) - 2023/04/08 21:43:07
Table 'RushAndCash3793027' 6-max Seat #1 is the button
Seat 1: a2f36faa ($17.31 in chips)
Seat 2: 4c996243 ($21.92 in chips)
Seat 3: ab8bb21d ($6.36 in chips)
Seat 4: Hero ($4.58 in chips)
Seat 5: 814da258 ($2.88 in chips)
Seat 6: 3282e3a7 ($1.8 in chips)
4c996243: posts small blind $0.05
ab8bb21d: posts big blind $0.1
*** HOLE CARDS ***
Dealt to a2f36faa 
Dealt to 4c996243 
Dealt to ab8bb21d 
Dealt to Hero [3s 4c]
Dealt to 814da258 
Dealt to 3282e3a7 
Hero: folds
814da258: folds
3282e3a7: folds
a2f36faa: folds
4c996243: folds
Uncalled bet ($0.05) returned to ab8bb21d
*** SHOWDOWN ***
ab8bb21d collected $0.1 from pot
*** SUMMARY ***
Total pot $0.1 | Rake $0 | Jackpot $0 | Bingo $0 | Fortune $0
Seat 1: a2f36faa (button) folded before Flop (didn't bet)
Seat 2: 4c996243 (small blind) folded before Flop
Seat 3: ab8bb21d (big blind) collected ($0.1)
Seat 4: Hero folded before Flop (didn't bet)
Seat 5: 814da258 folded before Flop (didn't bet)
Seat 6: 3282e3a7 folded before Flop (didn't bet)


Poker Hand #RC1460027562: Hold'em No Limit  ($0.05/$0.1) - 2023/04/08 21:42:31
Table 'RushAndCash3792822' 6-max Seat #1 is the button
Seat 1: Hero ($5.45 in chips)
Seat 2: 4447b906 ($10.32 in chips)
Seat 3: a8745400 ($16.35 in chips)
Seat 4: 3282e3a7 ($0.87 in chips)
Seat 5: f53cdad ($44.88 in chips)
Seat 6: 1199caee ($1.85 in chips)
4447b906: posts small blind $0.05
a8745400: posts big blind $0.1
*** HOLE CARDS ***
Dealt to Hero [5s 6s]
Dealt to 4447b906 
Dealt to a8745400 
Dealt to 3282e3a7 
Dealt to f53cdad 
Dealt to 1199caee 
3282e3a7: raises $0.1 to $0.2
f53cdad: folds
1199caee: folds
Hero: calls $0.2
4447b906: folds
a8745400: folds
*** FLOP *** [9s 4s Jd]
3282e3a7: bets $0.55
Hero: raises $0.55 to $1.1
3282e3a7: calls $0.12 and is all-in
Uncalled bet ($0.43) returned to Hero
Hero: shows [5s 6s] (Jack-High)
3282e3a7: shows [6d 4d] (Pair of Fours)
*** TURN *** [9s 4s Jd] [8c]
*** RIVER *** [9s 4s Jd 8c] [3d]
*** SHOWDOWN ***
3282e3a7 collected $1.8 from pot
*** SUMMARY ***
Total pot $1.89 | Rake $0.09 | Jackpot $0 | Bingo $0 | Fortune $0
Board [9s 4s Jd 8c 3d]
Seat 1: Hero (button) showed [5s 6s] and lost with Jack-High
Seat 2: 4447b906 (small blind) folded before Flop
Seat 3: a8745400 (big blind) folded before Flop
Seat 4: 3282e3a7 showed [6d 4d] and won ($1.8) with Pair of Fours
Seat 5: f53cdad folded before Flop (didn't bet)
Seat 6: 1199caee folded before Flop (didn't bet)


Poker Hand #RC1460027536: Hold'em No Limit  ($0.05/$0.1) - 2023/04/08 21:42:27
Table 'RushAndCash3792796' 6-max Seat #1 is the button
Seat 1: 44ed445f ($11.58 in chips)
Seat 2: 1196d30c ($10.2 in chips)
Seat 3: cc018f2 ($20.7 in chips)
Seat 4: Hero ($5.45 in chips)
Seat 5: 3294ece5 ($60.91 in chips)
Seat 6: 9c1a67d5 ($5.18 in chips)
1196d30c: posts small blind $0.05
cc018f2: posts big blind $0.1
*** HOLE CARDS ***
Dealt to 44ed445f 
Dealt to 1196d30c 
Dealt to cc018f2 
Dealt to Hero [9c 4h]
Dealt to 3294ece5 
Dealt to 9c1a67d5 
Hero: folds
3294ece5: raises $0.15 to $0.25
9c1a67d5: raises $0.49 to $0.74
44ed445f: folds
1196d30c: folds
cc018f2: folds
3294ece5: folds
Uncalled bet ($0.49) returned to 9c1a67d5
*** SHOWDOWN ***
9c1a67d5 collected $0.62 from pot
*** SUMMARY ***
Total pot $0.65 | Rake $0.03 | Jackpot $0 | Bingo $0 | Fortune $0
Seat 1: 44ed445f (button) folded before Flop (didn't bet)
Seat 2: 1196d30c (small blind) folded before Flop
Seat 3: cc018f2 (big blind) folded before Flop
Seat 4: Hero folded before Flop (didn't bet)
Seat 5: 3294ece5 folded before Flop
Seat 6: 9c1a67d5 collected ($0.62)


Poker Hand #RC1460027514: Hold'em No Limit  ($0.05/$0.1) - 2023/04/08 21:42:23
Table 'RushAndCash3792774' 6-max Seat #1 is the button
Seat 1: 6dc4f553 ($14.02 in chips)
Seat 2: 2261b544 ($10 in chips)
Seat 3: df76427d ($15.28 in chips)
Seat 4: 3294ece5 ($60.91 in chips)
Seat 5: Hero ($5.45 in chips)
Seat 6: cc63a377 ($16.66 in chips)
2261b544: posts small blind $0.05
df76427d: posts big blind $0.1
*** HOLE CARDS ***
Dealt to 6dc4f553 
Dealt to 2261b544 
Dealt to df76427d 
Dealt to 3294ece5 
Dealt to Hero [Ac 6h]
Dealt to cc63a377 
3294ece5: folds
Hero: folds
cc63a377: raises $0.15 to $0.25
6dc4f553: folds
2261b544: folds
df76427d: folds
Uncalled bet ($0.15) returned to cc63a377
*** SHOWDOWN ***
cc63a377 collected $0.25 from pot
*** SUMMARY ***
Total pot $0.25 | Rake $0 | Jackpot $0 | Bingo $0 | Fortune $0
Seat 1: 6dc4f553 (button) folded before Flop (didn't bet)
Seat 2: 2261b544 (small blind) folded before Flop
Seat 3: df76427d (big blind) folded before Flop
Seat 4: 3294ece5 folded before Flop (didn't bet)
Seat 5: Hero folded before Flop (didn't bet)
Seat 6: cc63a377 collected ($0.25)


Poker Hand #RC1460027488: Hold'em No Limit  ($0.05/$0.1) - 2023/04/08 21:42:18
Table 'RushAndCash3792748' 6-max Seat #1 is the button
Seat 1: cd49688f ($10.73 in chips)
Seat 2: 4ade6da2 ($8.26 in chips)
Seat 3: 2261b544 ($10 in chips)
Seat 4: 310637c9 ($6.1 in chips)
Seat 5: Hero ($5.45 in chips)
Seat 6: 6dc4f553 ($14.02 in chips)
4ade6da2: posts small blind $0.05
2261b544: posts big blind $0.1
*** HOLE CARDS ***
Dealt to cd49688f 
Dealt to 4ade6da2 
Dealt to 2261b544 
Dealt to 310637c9 
Dealt to Hero [Tc Qh]
Dealt to 6dc4f553 
310637c9: folds
Hero: folds
6dc4f553: folds
cd49688f: raises $0.15 to $0.25
4ade6da2: folds
2261b544: folds
Uncalled bet ($0.15) returned to cd49688f
*** SHOWDOWN ***
cd49688f collected $0.25 from pot
*** SUMMARY ***
Total pot $0.25 | Rake $0 | Jackpot $0 | Bingo $0 | Fortune $0
Seat 1: cd49688f (button) collected ($0.25)
Seat 2: 4ade6da2 (small blind) folded before Flop
Seat 3: 2261b544 (big blind) folded before Flop
Seat 4: 310637c9 folded before Flop (didn't bet)
Seat 5: Hero folded before Flop (didn't bet)
Seat 6: 6dc4f553 folded before Flop (didn't bet)


Poker Hand #RC1460027430: Hold'em No Limit  ($0.05/$0.1) - 2023/04/08 21:42:06
Table 'RushAndCash3792690' 6-max Seat #1 is the button
Seat 1: 6b06664c ($12.67 in chips)
Seat 2: 3609d703 ($11.82 in chips)
Seat 3: Hero ($5.55 in chips)
Seat 4: 23afa86c ($10 in chips)
Seat 5: dd4ee8bc ($10.12 in chips)
Seat 6: 6b6b5b7d ($23.13 in chips)
3609d703: posts small blind $0.05
Hero: posts big blind $0.1
*** HOLE CARDS ***
Dealt to 6b06664c 
Dealt to 3609d703 
Dealt to Hero [3d Qc]
Dealt to 23afa86c 
Dealt to dd4ee8bc 
Dealt to 6b6b5b7d 
23afa86c: folds
dd4ee8bc: folds
6b6b5b7d: folds
6b06664c: raises $0.1 to $0.2
3609d703: folds
Hero: folds
Uncalled bet ($0.1) returned to 6b06664c
*** SHOWDOWN ***
6b06664c collected $0.25 from pot
*** SUMMARY ***
Total pot $0.25 | Rake $0 | Jackpot $0 | Bingo $0 | Fortune $0
Seat 1: 6b06664c (button) collected ($0.25)
Seat 2: 3609d703 (small blind) folded before Flop
Seat 3: Hero (big blind) folded before Flop
Seat 4: 23afa86c folded before Flop (didn't bet)
Seat 5: dd4ee8bc folded before Flop (didn't bet)
Seat 6: 6b6b5b7d folded before Flop (didn't bet)


Poker Hand #RC1460027351: Hold'em No Limit  ($0.05/$0.1) - 2023/04/08 21:41:54
Table 'RushAndCash3792611' 6-max Seat #1 is the button
Seat 1: Hero ($5.55 in chips)
Seat 2: 5360b858 ($8.57 in chips)
Seat 3: 89d24b76 ($16.7 in chips)
Seat 4: 3e5d895a ($34.83 in chips)
Seat 5: 175d11e7 ($11.09 in chips)
Seat 6: e1e15e9a ($10.1 in chips)
5360b858: posts small blind $0.05
89d24b76: posts big blind $0.1
*** HOLE CARDS ***
Dealt to Hero [5s 7h]
Dealt to 5360b858 
Dealt to 89d24b76 
Dealt to 3e5d895a 
Dealt to 175d11e7 
Dealt to e1e15e9a 
3e5d895a: folds
175d11e7: folds
e1e15e9a: folds
Hero: folds
5360b858: folds
Uncalled bet ($0.05) returned to 89d24b76
*** SHOWDOWN ***
89d24b76 collected $0.1 from pot
*** SUMMARY ***
Total pot $0.1 | Rake $0 | Jackpot $0 | Bingo $0 | Fortune $0
Seat 1: Hero (button) folded before Flop (didn't bet)
Seat 2: 5360b858 (small blind) folded before Flop
Seat 3: 89d24b76 (big blind) collected ($0.1)
Seat 4: 3e5d895a folded before Flop (didn't bet)
Seat 5: 175d11e7 folded before Flop (didn't bet)
Seat 6: e1e15e9a folded before Flop (didn't bet)


Poker Hand #RC1460027278: Hold'em No Limit  ($0.05/$0.1) - 2023/04/08 21:41:41
Table 'RushAndCash3792538' 6-max Seat #1 is the button
Seat 1: a331059d ($10.2 in chips)
Seat 2: Hero ($5.6 in chips)
Seat 3: 3f9fe36d ($19.46 in chips)
Seat 4: 8265c379 ($11.25 in chips)
Seat 5: 310637c9 ($6.25 in chips)
Seat 6: b96d280 ($15.1 in chips)
Hero: posts small blind $0.05
3f9fe36d: posts big blind $0.1
*** HOLE CARDS ***
Dealt to a331059d 
Dealt to Hero [7d 6d]
Dealt to 3f9fe36d 
Dealt to 8265c379 
Dealt to 310637c9 
Dealt to b96d280 
8265c379: folds
310637c9: folds
b96d280: raises $0.3 to $0.4
a331059d: folds
Hero: folds
3f9fe36d: raises $0.95 to $1.35
b96d280: folds
Uncalled bet ($0.95) returned to 3f9fe36d
*** SHOWDOWN ***
3f9fe36d collected $0.81 from pot
*** SUMMARY ***
Total pot $0.85 | Rake $0.04 | Jackpot $0 | Bingo $0 | Fortune $0
Seat 1: a331059d (button) folded before Flop (didn't bet)
Seat 2: Hero (small blind) folded before Flop
Seat 3: 3f9fe36d (big blind) collected ($0.81)
Seat 4: 8265c379 folded before Flop (didn't bet)
Seat 5: 310637c9 folded before Flop (didn't bet)
Seat 6: b96d280 folded before Flop


Poker Hand #RC1460027219: Hold'em No Limit  ($0.05/$0.1) - 2023/04/08 21:41:31
Table 'RushAndCash3792479' 6-max Seat #1 is the button
Seat 1: 92be4bf ($18.75 in chips)
Seat 2: 89a660e7 ($9.45 in chips)
Seat 3: f4362c8f ($17.13 in chips)
Seat 4: Hero ($5.6 in chips)
Seat 5: d47c361a ($27.14 in chips)
Seat 6: cd49688f ($10.88 in chips)
89a660e7: posts small blind $0.05
f4362c8f: posts big blind $0.1
*** HOLE CARDS ***
Dealt to 92be4bf 
Dealt to 89a660e7 
Dealt to f4362c8f 
Dealt to Hero [Jc 6d]
Dealt to d47c361a 
Dealt to cd49688f 
Hero: folds
d47c361a: folds
cd49688f: folds
92be4bf: folds
89a660e7: raises $0.2 to $0.3
f4362c8f: folds
Uncalled bet ($0.2) returned to 89a660e7
*** SHOWDOWN ***
89a660e7 collected $0.2 from pot
*** SUMMARY ***
Total pot $0.2 | Rake $0 | Jackpot $0 | Bingo $0 | Fortune $0
Seat 1: 92be4bf (button) folded before Flop (didn't bet)
Seat 2: 89a660e7 (small blind) collected ($0.2)
Seat 3: f4362c8f (big blind) folded before Flop
Seat 4: Hero folded before Flop (didn't bet)
Seat 5: d47c361a folded before Flop (didn't bet)
Seat 6: cd49688f folded before Flop (didn't bet)


Poker Hand #RC1460027151: Hold'em No Limit  ($0.05/$0.1) - 2023/04/08 21:41:20
Table 'RushAndCash3792411' 6-max Seat #1 is the button
Seat 1: Hero ($5.6 in chips)
Seat 2: 161caf38 ($10.05 in chips)
Seat 3: db15d716 ($20.15 in chips)
Seat 4: 1570da99 ($10 in chips)
Seat 5: f0cc1551 ($15.77 in chips)
Seat 6: 31e18fe4 ($10.28 in chips)
161caf38: posts small blind $0.05
db15d716: posts big blind $0.1
*** HOLE CARDS ***
Dealt to Hero [8c Jh]
Dealt to 161caf38 
Dealt to db15d716 
Dealt to 1570da99 
Dealt to f0cc1551 
Dealt to 31e18fe4 
1570da99: folds
f0cc1551: folds
31e18fe4: folds
Hero: folds
161caf38: folds
Uncalled bet ($0.05) returned to db15d716
*** SHOWDOWN ***
db15d716 collected $0.1 from pot
*** SUMMARY ***
Total pot $0.1 | Rake $0 | Jackpot $0 | Bingo $0 | Fortune $0
Seat 1: Hero (button) folded before Flop (didn't bet)
Seat 2: 161caf38 (small blind) folded before Flop
Seat 3: db15d716 (big blind) collected ($0.1)
Seat 4: 1570da99 folded before Flop (didn't bet)
Seat 5: f0cc1551 folded before Flop (didn't bet)
Seat 6: 31e18fe4 folded before Flop (didn't bet)


Poker Hand #RC1460027078: Hold'em No Limit  ($0.05/$0.1) - 2023/04/08 21:41:07
Table 'RushAndCash3792338' 6-max Seat #1 is the button
Seat 1: 46e6bf72 ($8.75 in chips)
Seat 2: 8064075d ($45.34 in chips)
Seat 3: Hero ($5.7 in chips)
Seat 4: 6a419085 ($9.97 in chips)
Seat 5: ae2c0557 ($11.66 in chips)
Seat 6: 89a660e7 ($9.45 in chips)
8064075d: posts small blind $0.05
Hero: posts big blind $0.1
*** HOLE CARDS ***
Dealt to 46e6bf72 
Dealt to 8064075d 
Dealt to Hero [7c 3s]
Dealt to 6a419085 
Dealt to ae2c0557 
Dealt to 89a660e7 
6a419085: folds
ae2c0557: folds
89a660e7: folds
46e6bf72: raises $0.15 to $0.25
8064075d: raises $0.54 to $0.79
Hero: folds
46e6bf72: calls $0.54
*** FLOP *** [As Ac 6d]
8064075d: checks
46e6bf72: checks
*** TURN *** [As Ac 6d] [3h]
8064075d: bets $0.56
46e6bf72: calls $0.56
*** RIVER *** [As Ac 6d 3h] [8c]
8064075d: checks
46e6bf72: bets $2.1
8064075d: folds
Uncalled bet ($2.1) returned to 46e6bf72
*** SHOWDOWN ***
46e6bf72 collected $2.66 from pot
*** SUMMARY ***
Total pot $2.8 | Rake $0.14 | Jackpot $0 | Bingo $0 | Fortune $0
Board [As Ac 6d 3h 8c]
Seat 1: 46e6bf72 (button) won ($2.66)
Seat 2: 8064075d (small blind) folded on the River
Seat 3: Hero (big blind) folded before Flop
Seat 4: 6a419085 folded before Flop (didn't bet)
Seat 5: ae2c0557 folded before Flop (didn't bet)
Seat 6: 89a660e7 folded before Flop (didn't bet)


Poker Hand #RC1460027035: Hold'em No Limit  ($0.05/$0.1) - 2023/04/08 21:40:59
Table 'RushAndCash3792295' 6-max Seat #1 is the button
Seat 1: 9049c022 ($8.91 in chips)
Seat 2: 4117f135 ($18.99 in chips)
Seat 3: 46e6bf72 ($8.9 in chips)
Seat 4: 8265c379 ($11.25 in chips)
Seat 5: 92a48d51 ($8.25 in chips)
Seat 6: Hero ($5.7 in chips)
4117f135: posts small blind $0.05
46e6bf72: posts big blind $0.1
*** HOLE CARDS ***
Dealt to 9049c022 
Dealt to 4117f135 
Dealt to 46e6bf72 
Dealt to 8265c379 
Dealt to 92a48d51 
Dealt to Hero [5h 6d]
8265c379: raises $0.13 to $0.23
92a48d51: folds
Hero: folds
9049c022: folds
4117f135: folds
46e6bf72: folds
Uncalled bet ($0.13) returned to 8265c379
*** SHOWDOWN ***
8265c379 collected $0.25 from pot
*** SUMMARY ***
Total pot $0.25 | Rake $0 | Jackpot $0 | Bingo $0 | Fortune $0
Seat 1: 9049c022 (button) folded before Flop (didn't bet)
Seat 2: 4117f135 (small blind) folded before Flop
Seat 3: 46e6bf72 (big blind) folded before Flop
Seat 4: 8265c379 collected ($0.25)
Seat 5: 92a48d51 folded before Flop (didn't bet)
Seat 6: Hero folded before Flop (didn't bet)


Poker Hand #RC1460026988: Hold'em No Limit  ($0.05/$0.1) - 2023/04/08 21:40:50
Table 'RushAndCash3792248' 6-max Seat #1 is the button
Seat 1: caed7b6f ($14.45 in chips)
Seat 2: a2f36faa ($10.74 in chips)
Seat 3: 556685d2 ($39.11 in chips)
Seat 4: Hero ($5.7 in chips)
Seat 5: 5877f207 ($9.75 in chips)
Seat 6: 587a017c ($118.29 in chips)
a2f36faa: posts small blind $0.05
556685d2: posts big blind $0.1
*** HOLE CARDS ***
Dealt to caed7b6f 
Dealt to a2f36faa 
Dealt to 556685d2 
Dealt to Hero [2c Js]
Dealt to 5877f207 
Dealt to 587a017c 
Hero: folds
5877f207: folds
587a017c: raises $0.15 to $0.25
caed7b6f: folds
a2f36faa: folds
556685d2: calls $0.15
*** FLOP *** [4d 8h Qs]
556685d2: checks
587a017c: bets $0.19
556685d2: calls $0.19
*** TURN *** [4d 8h Qs] [5h]
556685d2: checks
587a017c: checks
*** RIVER *** [4d 8h Qs 5h] [7h]
556685d2: bets $1.03
587a017c: folds
Uncalled bet ($1.03) returned to 556685d2
*** SHOWDOWN ***
556685d2 collected $0.89 from pot
*** SUMMARY ***
Total pot $0.93 | Rake $0.04 | Jackpot $0 | Bingo $0 | Fortune $0
Board [4d 8h Qs 5h 7h]
Seat 1: caed7b6f (button) folded before Flop (didn't bet)
Seat 2: a2f36faa (small blind) folded before Flop
Seat 3: 556685d2 (big blind) won ($0.89)
Seat 4: Hero folded before Flop (didn't bet)
Seat 5: 5877f207 folded before Flop (didn't bet)
Seat 6: 587a017c folded on the River


Poker Hand #RC1460026940: Hold'em No Limit  ($0.05/$0.1) - 2023/04/08 21:40:40
Table 'RushAndCash3792200' 6-max Seat #1 is the button
Seat 1: 3bb96cf5 ($55.97 in chips)
Seat 2: d215562f ($10 in chips)
Seat 3: 8ff246af ($32.05 in chips)
Seat 4: 5606876c ($17.78 in chips)
Seat 5: a8e7c7bc ($12.27 in chips)
Seat 6: Hero ($5.7 in chips)
d215562f: posts small blind $0.05
8ff246af: posts big blind $0.1
*** HOLE CARDS ***
Dealt to 3bb96cf5 
Dealt to d215562f 
Dealt to 8ff246af 
Dealt to 5606876c 
Dealt to a8e7c7bc 
Dealt to Hero [6h 5c]
5606876c: folds
a8e7c7bc: folds
Hero: folds
3bb96cf5: raises $0.15 to $0.25
d215562f: folds
8ff246af: folds
Uncalled bet ($0.15) returned to 3bb96cf5
*** SHOWDOWN ***
3bb96cf5 collected $0.25 from pot
*** SUMMARY ***
Total pot $0.25 | Rake $0 | Jackpot $0 | Bingo $0 | Fortune $0
Seat 1: 3bb96cf5 (button) collected ($0.25)
Seat 2: d215562f (small blind) folded before Flop
Seat 3: 8ff246af (big blind) folded before Flop
Seat 4: 5606876c folded before Flop (didn't bet)
Seat 5: a8e7c7bc folded before Flop (didn't bet)
Seat 6: Hero folded before Flop (didn't bet)


Poker Hand #RC1460026774: Hold'em No Limit  ($0.05/$0.1) - 2023/04/08 21:40:10
Table 'RushAndCash3792034' 6-max Seat #1 is the button
Seat 1: d436350b ($13.47 in chips)
Seat 2: Hero ($5.75 in chips)
Seat 3: 3cf396cc ($10.3 in chips)
Seat 4: 4117f135 ($19.24 in chips)
Seat 5: 82827b54 ($9.82 in chips)
Seat 6: fa2c2cc3 ($11.25 in chips)
Hero: posts small blind $0.05
3cf396cc: posts big blind $0.1
*** HOLE CARDS ***
Dealt to d436350b 
Dealt to Hero [Ks 8s]
Dealt to 3cf396cc 
Dealt to 4117f135 
Dealt to 82827b54 
Dealt to fa2c2cc3 
4117f135: folds
82827b54: folds
fa2c2cc3: folds
d436350b: raises $0.18 to $0.28
Hero: folds
3cf396cc: folds
Uncalled bet ($0.18) returned to d436350b
*** SHOWDOWN ***
d436350b collected $0.25 from pot
*** SUMMARY ***
Total pot $0.25 | Rake $0 | Jackpot $0 | Bingo $0 | Fortune $0
Seat 1: d436350b (button) collected ($0.25)
Seat 2: Hero (small blind) folded before Flop
Seat 3: 3cf396cc (big blind) folded before Flop
Seat 4: 4117f135 folded before Flop (didn't bet)
Seat 5: 82827b54 folded before Flop (didn't bet)
Seat 6: fa2c2cc3 folded before Flop (didn't bet)


Poker Hand #RC1460026508: Hold'em No Limit  ($0.05/$0.1) - 2023/04/08 21:39:17
Table 'RushAndCash3791768' 6-max Seat #1 is the button
Seat 1: c49a4612 ($19.49 in chips)
Seat 2: fb15ce92 ($3.73 in chips)
Seat 3: eb1406b7 ($14.23 in chips)
Seat 4: f64a92ce ($13.8 in chips)
Seat 5: Hero ($4.36 in chips)
Seat 6: 792a6517 ($10 in chips)
fb15ce92: posts small blind $0.05
eb1406b7: posts big blind $0.1
*** HOLE CARDS ***
Dealt to c49a4612 
Dealt to fb15ce92 
Dealt to eb1406b7 
Dealt to f64a92ce 
Dealt to Hero [Ah Qs]
Dealt to 792a6517 
f64a92ce: folds
Hero: raises $0.15 to $0.25
792a6517: raises $0.55 to $0.8
c49a4612: folds
fb15ce92: folds
eb1406b7: folds
Hero: calls $0.55
*** FLOP *** [Kd 2h 4s]
Hero: checks
792a6517: bets $0.58
Hero: raises $0.92 to $1.5
792a6517: folds
Uncalled bet ($0.92) returned to Hero
Hero: shows [Ah Qs] (Ace-High)
*** SHOWDOWN ***
Hero collected $2.77 from pot
*** SUMMARY ***
Total pot $2.91 | Rake $0.14 | Jackpot $0 | Bingo $0 | Fortune $0
Board [Kd 2h 4s]
Seat 1: c49a4612 (button) folded before Flop (didn't bet)
Seat 2: fb15ce92 (small blind) folded before Flop
Seat 3: eb1406b7 (big blind) folded before Flop
Seat 4: f64a92ce folded before Flop (didn't bet)
Seat 5: Hero showed [Ah Qs] and won ($2.77) with Ace-High
Seat 6: 792a6517 folded on the Flop


Poker Hand #RC1460026478: Hold'em No Limit  ($0.05/$0.1) - 2023/04/08 21:39:12
Table 'RushAndCash3791738' 6-max Seat #1 is the button
Seat 1: a4b2285d ($10 in chips)
Seat 2: 7b4ca30b ($10 in chips)
Seat 3: 920f7e7b ($12.53 in chips)
Seat 4: 45d9152 ($4.23 in chips)
Seat 5: Hero ($4.36 in chips)
Seat 6: 44a0012b ($11.88 in chips)
7b4ca30b: posts small blind $0.05
920f7e7b: posts big blind $0.1
*** HOLE CARDS ***
Dealt to a4b2285d 
Dealt to 7b4ca30b 
Dealt to 920f7e7b 
Dealt to 45d9152 
Dealt to Hero [2s 7s]
Dealt to 44a0012b 
45d9152: folds
Hero: folds
44a0012b: folds
a4b2285d: folds
7b4ca30b: folds
Uncalled bet ($0.05) returned to 920f7e7b
*** SHOWDOWN ***
920f7e7b collected $0.1 from pot
*** SUMMARY ***
Total pot $0.1 | Rake $0 | Jackpot $0 | Bingo $0 | Fortune $0
Seat 1: a4b2285d (button) folded before Flop (didn't bet)
Seat 2: 7b4ca30b (small blind) folded before Flop
Seat 3: 920f7e7b (big blind) collected ($0.1)
Seat 4: 45d9152 folded before Flop (didn't bet)
Seat 5: Hero folded before Flop (didn't bet)
Seat 6: 44a0012b folded before Flop (didn't bet)


Poker Hand #RC1460026400: Hold'em No Limit  ($0.05/$0.1) - 2023/04/08 21:38:56
Table 'RushAndCash3791660' 6-max Seat #1 is the button
Seat 1: 5360b858 ($9.04 in chips)
Seat 2: 86094ff0 ($10.96 in chips)
Seat 3: 1dc164b ($10.14 in chips)
Seat 4: 1196d30c ($10.17 in chips)
Seat 5: ffd5f754 ($10.9 in chips)
Seat 6: Hero ($4.36 in chips)
86094ff0: posts small blind $0.05
1dc164b: posts big blind $0.1
*** HOLE CARDS ***
Dealt to 5360b858 
Dealt to 86094ff0 
Dealt to 1dc164b 
Dealt to 1196d30c 
Dealt to ffd5f754 
Dealt to Hero [3d Tc]
1196d30c: folds
ffd5f754: folds
Hero: folds
5360b858: raises $0.12 to $0.22
86094ff0: folds
1dc164b: raises $0.88 to $1.1
5360b858: folds
Uncalled bet ($0.88) returned to 1dc164b
*** SHOWDOWN ***
1dc164b collected $0.47 from pot
*** SUMMARY ***
Total pot $0.49 | Rake $0.02 | Jackpot $0 | Bingo $0 | Fortune $0
Seat 1: 5360b858 (button) folded before Flop
Seat 2: 86094ff0 (small blind) folded before Flop
Seat 3: 1dc164b (big blind) collected ($0.47)
Seat 4: 1196d30c folded before Flop (didn't bet)
Seat 5: ffd5f754 folded before Flop (didn't bet)
Seat 6: Hero folded before Flop (didn't bet)


Poker Hand #RC1460026355: Hold'em No Limit  ($0.05/$0.1) - 2023/04/08 21:38:47
Table 'RushAndCash3791615' 6-max Seat #1 is the button
Seat 1: 9a3904f1 ($3.99 in chips)
Seat 2: 8a94799b ($10 in chips)
Seat 3: Hero ($4.31 in chips)
Seat 4: 4a8c7660 ($69.13 in chips)
Seat 5: 3c1b3703 ($10.59 in chips)
Seat 6: ae2c0557 ($10.97 in chips)
8a94799b: posts small blind $0.05
Hero: posts big blind $0.1
*** HOLE CARDS ***
Dealt to 9a3904f1 
Dealt to 8a94799b 
Dealt to Hero [Ts 5c]
Dealt to 4a8c7660 
Dealt to 3c1b3703 
Dealt to ae2c0557 
4a8c7660: folds
3c1b3703: folds
ae2c0557: folds
9a3904f1: folds
8a94799b: folds
Uncalled bet ($0.05) returned to Hero
*** SHOWDOWN ***
Hero collected $0.1 from pot
*** SUMMARY ***
Total pot $0.1 | Rake $0 | Jackpot $0 | Bingo $0 | Fortune $0
Seat 1: 9a3904f1 (button) folded before Flop (didn't bet)
Seat 2: 8a94799b (small blind) folded before Flop
Seat 3: Hero (big blind) collected ($0.1)
Seat 4: 4a8c7660 folded before Flop (didn't bet)
Seat 5: 3c1b3703 folded before Flop (didn't bet)
Seat 6: ae2c0557 folded before Flop (didn't bet)


Poker Hand #RC1460026259: Hold'em No Limit  ($0.05/$0.1) - 2023/04/08 21:38:29
Table 'RushAndCash3791519' 6-max Seat #1 is the button
Seat 1: d4f8a497 ($10.54 in chips)
Seat 2: 92a48d51 ($8.6 in chips)
Seat 3: 287f225b ($7.13 in chips)
Seat 4: b48125 ($11.32 in chips)
Seat 5: Hero ($4.31 in chips)
Seat 6: f3c40c35 ($10.58 in chips)
92a48d51: posts small blind $0.05
287f225b: posts big blind $0.1
*** HOLE CARDS ***
Dealt to d4f8a497 
Dealt to 92a48d51 
Dealt to 287f225b 
Dealt to b48125 
Dealt to Hero [9h 4h]
Dealt to f3c40c35 
b48125: folds
Hero: folds
f3c40c35: folds
d4f8a497: raises $0.15 to $0.25
92a48d51: folds
287f225b: raises $0.79 to $1.04
d4f8a497: folds
Uncalled bet ($0.79) returned to 287f225b
*** SHOWDOWN ***
287f225b collected $0.52 from pot
*** SUMMARY ***
Total pot $0.55 | Rake $0.03 | Jackpot $0 | Bingo $0 | Fortune $0
Seat 1: d4f8a497 (button) folded before Flop
Seat 2: 92a48d51 (small blind) folded before Flop
Seat 3: 287f225b (big blind) collected ($0.52)
Seat 4: b48125 folded before Flop (didn't bet)
Seat 5: Hero folded before Flop (didn't bet)
Seat 6: f3c40c35 folded before Flop (didn't bet)


Poker Hand #RC1460026215: Hold'em No Limit  ($0.05/$0.1) - 2023/04/08 21:38:22
Table 'RushAndCash3791475' 6-max Seat #1 is the button
Seat 1: Hero ($4.31 in chips)
Seat 2: 93dd5318 ($22.74 in chips)
Seat 3: 7eaf00c1 ($23.24 in chips)
Seat 4: 1c0156da ($12.21 in chips)
Seat 5: e6e7efa4 ($22 in chips)
Seat 6: bf8d8396 ($12.06 in chips)
93dd5318: posts small blind $0.05
7eaf00c1: posts big blind $0.1
*** HOLE CARDS ***
Dealt to Hero [4c 2s]
Dealt to 93dd5318 
Dealt to 7eaf00c1 
Dealt to 1c0156da 
Dealt to e6e7efa4 
Dealt to bf8d8396 
1c0156da: folds
e6e7efa4: folds
bf8d8396: raises $0.12 to $0.22
Hero: folds
93dd5318: folds
7eaf00c1: raises $0.22 to $0.44
bf8d8396: calls $0.22
*** FLOP *** [Js 4s 5s]
7eaf00c1: checks
bf8d8396: checks
*** TURN *** [Js 4s 5s] [2d]
7eaf00c1: bets $1.2
bf8d8396: folds
Uncalled bet ($1.2) returned to 7eaf00c1
*** SHOWDOWN ***
7eaf00c1 collected $0.89 from pot
*** SUMMARY ***
Total pot $0.93 | Rake $0.04 | Jackpot $0 | Bingo $0 | Fortune $0
Board [Js 4s 5s 2d]
Seat 1: Hero (button) folded before Flop (didn't bet)
Seat 2: 93dd5318 (small blind) folded before Flop
Seat 3: 7eaf00c1 (big blind) won ($0.89)
Seat 4: 1c0156da folded before Flop (didn't bet)
Seat 5: e6e7efa4 folded before Flop (didn't bet)
Seat 6: bf8d8396 folded on the Turn


Poker Hand #RC1460026070: Hold'em No Limit  ($0.05/$0.1) - 2023/04/08 21:37:56
Table 'RushAndCash3791330' 6-max Seat #1 is the button
Seat 1: 8265c379 ($11.65 in chips)
Seat 2: Hero ($4.36 in chips)
Seat 3: d73e2c6f ($6.72 in chips)
Seat 4: d5789236 ($9.85 in chips)
Seat 5: 54403935 ($19.39 in chips)
Seat 6: b51aff68 ($16.89 in chips)
Hero: posts small blind $0.05
d73e2c6f: posts big blind $0.1
*** HOLE CARDS ***
Dealt to 8265c379 
Dealt to Hero [7c Js]
Dealt to d73e2c6f 
Dealt to d5789236 
Dealt to 54403935 
Dealt to b51aff68 
d5789236: raises $0.1 to $0.2
54403935: calls $0.2
b51aff68: folds
8265c379: folds
Hero: folds
d73e2c6f: calls $0.1
*** FLOP *** [2d 6d 6h]
d73e2c6f: checks
d5789236: bets $0.17
54403935: calls $0.17
d73e2c6f: folds
*** TURN *** [2d 6d 6h] [Jd]
d5789236: bets $0.25
54403935: calls $0.25
*** RIVER *** [2d 6d 6h Jd] [4h]
d5789236: checks
54403935: checks
d5789236: shows [9s 9c] (Pair of Nines and Pair of Sixes)
54403935: shows [Kc Ks] (Pair of Kings and Pair of Sixes)
*** SHOWDOWN ***
54403935 collected $1.42 from pot
*** SUMMARY ***
Total pot $1.49 | Rake $0.07 | Jackpot $0 | Bingo $0 | Fortune $0
Board [2d 6d 6h Jd 4h]
Seat 1: 8265c379 (button) folded before Flop (didn't bet)
Seat 2: Hero (small blind) folded before Flop
Seat 3: d73e2c6f (big blind) folded on the Flop
Seat 4: d5789236 showed [9s 9c] and lost with Pair of Nines and Pair of Sixes
Seat 5: 54403935 showed [Kc Ks] and won ($1.42) with Pair of Kings and Pair of Sixes
Seat 6: b51aff68 folded before Flop (didn't bet)


Poker Hand #RC1460026027: Hold'em No Limit  ($0.05/$0.1) - 2023/04/08 21:37:49
Table 'RushAndCash3791287' 6-max Seat #1 is the button
Seat 1: Hero ($4.36 in chips)
Seat 2: b2773b71 ($10.25 in chips)
Seat 3: dc8c828b ($5.32 in chips)
Seat 4: ec14ff9f ($9.87 in chips)
Seat 5: 587a017c ($107.38 in chips)
Seat 6: 8e54405d ($13.23 in chips)
b2773b71: posts small blind $0.05
dc8c828b: posts big blind $0.1
*** HOLE CARDS ***
Dealt to Hero [5s 7c]
Dealt to b2773b71 
Dealt to dc8c828b 
Dealt to ec14ff9f 
Dealt to 587a017c 
Dealt to 8e54405d 
ec14ff9f: folds
587a017c: raises $0.15 to $0.25
8e54405d: folds
Hero: folds
b2773b71: folds
dc8c828b: calls $0.15
*** FLOP *** [6c 3h Qh]
dc8c828b: checks
587a017c: checks
*** TURN *** [6c 3h Qh] [5c]
dc8c828b: bets $0.28
587a017c: calls $0.28
*** RIVER *** [6c 3h Qh 5c] [Jd]
dc8c828b: checks
587a017c: checks
dc8c828b: shows [8d Ks] (King-High)
587a017c: shows [5d Ad] (Pair of Fives)
*** SHOWDOWN ***
587a017c collected $1.06 from pot
*** SUMMARY ***
Total pot $1.11 | Rake $0.05 | Jackpot $0 | Bingo $0 | Fortune $0
Board [6c 3h Qh 5c Jd]
Seat 1: Hero (button) folded before Flop (didn't bet)
Seat 2: b2773b71 (small blind) folded before Flop
Seat 3: dc8c828b (big blind) showed [8d Ks] and lost with King-High
Seat 4: ec14ff9f folded before Flop (didn't bet)
Seat 5: 587a017c showed [5d Ad] and won ($1.06) with Pair of Fives
Seat 6: 8e54405d folded before Flop (didn't bet)


Poker Hand #RC1460025948: Hold'em No Limit  ($0.05/$0.1) - 2023/04/08 21:37:36
Table 'RushAndCash3791208' 6-max Seat #1 is the button
Seat 1: fe55c1f5 ($9.6 in chips)
Seat 2: Hero ($4.41 in chips)
Seat 3: 11f2bfc9 ($10.1 in chips)
Seat 4: 92a48d51 ($8.42 in chips)
Seat 5: 9f127eb1 ($11.05 in chips)
Seat 6: 9022b505 ($20.86 in chips)
Hero: posts small blind $0.05
11f2bfc9: posts big blind $0.1
*** HOLE CARDS ***
Dealt to fe55c1f5 
Dealt to Hero [7h 4c]
Dealt to 11f2bfc9 
Dealt to 92a48d51 
Dealt to 9f127eb1 
Dealt to 9022b505 
92a48d51: folds
9f127eb1: folds
9022b505: folds
fe55c1f5: folds
Hero: folds
Uncalled bet ($0.05) returned to 11f2bfc9
*** SHOWDOWN ***
11f2bfc9 collected $0.1 from pot
*** SUMMARY ***
Total pot $0.1 | Rake $0 | Jackpot $0 | Bingo $0 | Fortune $0
Seat 1: fe55c1f5 (button) folded before Flop (didn't bet)
Seat 2: Hero (small blind) folded before Flop
Seat 3: 11f2bfc9 (big blind) collected ($0.1)
Seat 4: 92a48d51 folded before Flop (didn't bet)
Seat 5: 9f127eb1 folded before Flop (didn't bet)
Seat 6: 9022b505 folded before Flop (didn't bet)


Poker Hand #RC1460025911: Hold'em No Limit  ($0.05/$0.1) - 2023/04/08 21:37:29
Table 'RushAndCash3791171' 6-max Seat #1 is the button
Seat 1: 88f2bf87 ($5.12 in chips)
Seat 2: fd5dd891 ($10 in chips)
Seat 3: a438ad41 ($14.35 in chips)
Seat 4: Hero ($4.41 in chips)
Seat 5: 4d3f64b1 ($22.29 in chips)
Seat 6: 82a20311 ($14 in chips)
fd5dd891: posts small blind $0.05
a438ad41: posts big blind $0.1
*** HOLE CARDS ***
Dealt to 88f2bf87 
Dealt to fd5dd891 
Dealt to a438ad41 
Dealt to Hero [Qs 9h]
Dealt to 4d3f64b1 
Dealt to 82a20311 
Hero: folds
4d3f64b1: folds
82a20311: raises $0.13 to $0.23
88f2bf87: folds
fd5dd891: folds
a438ad41: calls $0.13
*** FLOP *** [8c 7s 3s]
a438ad41: checks
82a20311: bets $0.17
a438ad41: calls $0.17
*** TURN *** [8c 7s 3s] [2c]
a438ad41: checks
82a20311: checks
*** RIVER *** [8c 7s 3s 2c] [7c]
a438ad41: checks
82a20311: checks
a438ad41: shows [6d 6c] (Pair of Sevens and Pair of Sixes)
82a20311: shows [Td Ac] (Pair of Sevens)
*** SHOWDOWN ***
a438ad41 collected $0.81 from pot
*** SUMMARY ***
Total pot $0.85 | Rake $0.04 | Jackpot $0 | Bingo $0 | Fortune $0
Board [8c 7s 3s 2c 7c]
Seat 1: 88f2bf87 (button) folded before Flop (didn't bet)
Seat 2: fd5dd891 (small blind) folded before Flop
Seat 3: a438ad41 (big blind) showed [6d 6c] and won ($0.81) with Pair of Sevens and Pair of Sixes
Seat 4: Hero folded before Flop (didn't bet)
Seat 5: 4d3f64b1 folded before Flop (didn't bet)
Seat 6: 82a20311 showed [Td Ac] and lost with Pair of Sevens


Poker Hand #RC1460025782: Hold'em No Limit  ($0.05/$0.1) - 2023/04/08 21:37:06
Table 'RushAndCash3791042' 6-max Seat #1 is the button
Seat 1: 909716ea ($31.28 in chips)
Seat 2: 38bd8899 ($33.87 in chips)
Seat 3: Hero ($4.51 in chips)
Seat 4: e2d5581 ($9.85 in chips)
Seat 5: 583bb900 ($47.32 in chips)
Seat 6: 92be4bf ($20.04 in chips)
38bd8899: posts small blind $0.05
Hero: posts big blind $0.1
*** HOLE CARDS ***
Dealt to 909716ea 
Dealt to 38bd8899 
Dealt to Hero [8d Jd]
Dealt to e2d5581 
Dealt to 583bb900 
Dealt to 92be4bf 
e2d5581: folds
583bb900: raises $0.2 to $0.3
92be4bf: folds
909716ea: folds
38bd8899: folds
Hero: folds
Uncalled bet ($0.2) returned to 583bb900
*** SHOWDOWN ***
583bb900 collected $0.25 from pot
*** SUMMARY ***
Total pot $0.25 | Rake $0 | Jackpot $0 | Bingo $0 | Fortune $0
Seat 1: 909716ea (button) folded before Flop (didn't bet)
Seat 2: 38bd8899 (small blind) folded before Flop
Seat 3: Hero (big blind) folded before Flop
Seat 4: e2d5581 folded before Flop (didn't bet)
Seat 5: 583bb900 collected ($0.25)
Seat 6: 92be4bf folded before Flop (didn't bet)


Poker Hand #RC1460025758: Hold'em No Limit  ($0.05/$0.1) - 2023/04/08 21:37:01
Table 'RushAndCash3791018' 6-max Seat #1 is the button
Seat 1: 38f22774 ($8.53 in chips)
Seat 2: 78269ebc ($18.27 in chips)
Seat 3: 80783716 ($12.16 in chips)
Seat 4: e2d5581 ($9.85 in chips)
Seat 5: Hero ($4.51 in chips)
Seat 6: 8952f163 ($10.3 in chips)
78269ebc: posts small blind $0.05
80783716: posts big blind $0.1
*** HOLE CARDS ***
Dealt to 38f22774 
Dealt to 78269ebc 
Dealt to 80783716 
Dealt to e2d5581 
Dealt to Hero [Js 5d]
Dealt to 8952f163 
e2d5581: folds
Hero: folds
8952f163: folds
38f22774: folds
78269ebc: folds
Uncalled bet ($0.05) returned to 80783716
*** SHOWDOWN ***
80783716 collected $0.1 from pot
*** SUMMARY ***
Total pot $0.1 | Rake $0 | Jackpot $0 | Bingo $0 | Fortune $0
Seat 1: 38f22774 (button) folded before Flop (didn't bet)
Seat 2: 78269ebc (small blind) folded before Flop
Seat 3: 80783716 (big blind) collected ($0.1)
Seat 4: e2d5581 folded before Flop (didn't bet)
Seat 5: Hero folded before Flop (didn't bet)
Seat 6: 8952f163 folded before Flop (didn't bet)


Poker Hand #RC1460025666: Hold'em No Limit  ($0.05/$0.1) - 2023/04/08 21:36:44
Table 'RushAndCash3790926' 6-max Seat #1 is the button
Seat 1: b0b419d6 ($16.49 in chips)
Seat 2: 8e5d11a9 ($13.88 in chips)
Seat 3: 4d7567a0 ($8.94 in chips)
Seat 4: Hero ($4.51 in chips)
Seat 5: 55c00f94 ($17.28 in chips)
Seat 6: 6b06664c ($11.64 in chips)
8e5d11a9: posts small blind $0.05
4d7567a0: posts big blind $0.1
*** HOLE CARDS ***
Dealt to b0b419d6 
Dealt to 8e5d11a9 
Dealt to 4d7567a0 
Dealt to Hero [3h 8d]
Dealt to 55c00f94 
Dealt to 6b06664c 
Hero: folds
55c00f94: folds
6b06664c: folds
b0b419d6: folds
8e5d11a9: folds
Uncalled bet ($0.05) returned to 4d7567a0
*** SHOWDOWN ***
4d7567a0 collected $0.1 from pot
*** SUMMARY ***
Total pot $0.1 | Rake $0 | Jackpot $0 | Bingo $0 | Fortune $0
Seat 1: b0b419d6 (button) folded before Flop (didn't bet)
Seat 2: 8e5d11a9 (small blind) folded before Flop
Seat 3: 4d7567a0 (big blind) collected ($0.1)
Seat 4: Hero folded before Flop (didn't bet)
Seat 5: 55c00f94 folded before Flop (didn't bet)
Seat 6: 6b06664c folded before Flop (didn't bet)


Poker Hand #RC1460025556: Hold'em No Limit  ($0.05/$0.1) - 2023/04/08 21:36:23
Table 'RushAndCash3790816' 6-max Seat #1 is the button
Seat 1: Hero ($4.51 in chips)
Seat 2: b8ae2cb ($23.17 in chips)
Seat 3: 105ba0d9 ($10 in chips)
Seat 4: 85080760 ($9.9 in chips)
Seat 5: 4d7567a0 ($8.94 in chips)
Seat 6: 587a017c ($105.68 in chips)
b8ae2cb: posts small blind $0.05
105ba0d9: posts big blind $0.1
*** HOLE CARDS ***
Dealt to Hero [As 6c]
Dealt to b8ae2cb 
Dealt to 105ba0d9 
Dealt to 85080760 
Dealt to 4d7567a0 
Dealt to 587a017c 
85080760: raises $0.1 to $0.2
4d7567a0: folds
587a017c: folds
Hero: folds
b8ae2cb: folds
105ba0d9: folds
Uncalled bet ($0.1) returned to 85080760
*** SHOWDOWN ***
85080760 collected $0.25 from pot
*** SUMMARY ***
Total pot $0.25 | Rake $0 | Jackpot $0 | Bingo $0 | Fortune $0
Seat 1: Hero (button) folded before Flop (didn't bet)
Seat 2: b8ae2cb (small blind) folded before Flop
Seat 3: 105ba0d9 (big blind) folded before Flop
Seat 4: 85080760 collected ($0.25)
Seat 5: 4d7567a0 folded before Flop (didn't bet)
Seat 6: 587a017c folded before Flop (didn't bet)


Poker Hand #RC1460025516: Hold'em No Limit  ($0.05/$0.1) - 2023/04/08 21:36:16
Table 'RushAndCash3790776' 6-max Seat #1 is the button
Seat 1: 583bb900 ($47.27 in chips)
Seat 2: 2b99d2e6 ($10.47 in chips)
Seat 3: 238ede5a ($40.76 in chips)
Seat 4: 21a9eb3 ($4.87 in chips)
Seat 5: Hero ($4.51 in chips)
Seat 6: 77b3b1b3 ($10 in chips)
2b99d2e6: posts small blind $0.05
238ede5a: posts big blind $0.1
*** HOLE CARDS ***
Dealt to 583bb900 
Dealt to 2b99d2e6 
Dealt to 238ede5a 
Dealt to 21a9eb3 
Dealt to Hero [Kc Th]
Dealt to 77b3b1b3 
21a9eb3: folds
Hero: folds
77b3b1b3: folds
583bb900: folds
2b99d2e6: folds
Uncalled bet ($0.05) returned to 238ede5a
*** SHOWDOWN ***
238ede5a collected $0.1 from pot
*** SUMMARY ***
Total pot $0.1 | Rake $0 | Jackpot $0 | Bingo $0 | Fortune $0
Seat 1: 583bb900 (button) folded before Flop (didn't bet)
Seat 2: 2b99d2e6 (small blind) folded before Flop
Seat 3: 238ede5a (big blind) collected ($0.1)
Seat 4: 21a9eb3 folded before Flop (didn't bet)
Seat 5: Hero folded before Flop (didn't bet)
Seat 6: 77b3b1b3 folded before Flop (didn't bet)


Poker Hand #RC1460025441: Hold'em No Limit  ($0.05/$0.1) - 2023/04/08 21:36:02
Table 'RushAndCash3790701' 6-max Seat #1 is the button
Seat 1: 71d28e01 ($6.6 in chips)
Seat 2: 673eb49c ($13.51 in chips)
Seat 3: Hero ($4.61 in chips)
Seat 4: ac01ce29 ($13.94 in chips)
Seat 5: 86440a84 ($22.6 in chips)
Seat 6: c0deed59 ($10.55 in chips)
673eb49c: posts small blind $0.05
Hero: posts big blind $0.1
*** HOLE CARDS ***
Dealt to 71d28e01 
Dealt to 673eb49c 
Dealt to Hero [Qc 6s]
Dealt to ac01ce29 
Dealt to 86440a84 
Dealt to c0deed59 
ac01ce29: raises $0.15 to $0.25
86440a84: folds
c0deed59: calls $0.25
71d28e01: folds
673eb49c: raises $0.75 to $1
Hero: folds
ac01ce29: calls $0.75
c0deed59: folds
*** FLOP *** [Qd 5h Kc]
673eb49c: bets $1.58
ac01ce29: calls $1.58
*** TURN *** [Qd 5h Kc] [Jc]
673eb49c: bets $4.25
ac01ce29: folds
Uncalled bet ($4.25) returned to 673eb49c
*** SHOWDOWN ***
673eb49c collected $5.1 from pot
*** SUMMARY ***
Total pot $5.51 | Rake $0.26 | Jackpot $0.15 | Bingo $0 | Fortune $0
Board [Qd 5h Kc Jc]
Seat 1: 71d28e01 (button) folded before Flop (didn't bet)
Seat 2: 673eb49c (small blind) won ($5.1)
Seat 3: Hero (big blind) folded before Flop
Seat 4: ac01ce29 folded on the Turn
Seat 5: 86440a84 folded before Flop (didn't bet)
Seat 6: c0deed59 folded before Flop


Poker Hand #RC1460025341: Hold'em No Limit  ($0.05/$0.1) - 2023/04/08 21:35:44
Table 'RushAndCash3790601' 6-max Seat #1 is the button
Seat 1: Hero ($4.61 in chips)
Seat 2: 920f7e7b ($10.5 in chips)
Seat 3: 73388517 ($13.78 in chips)
Seat 4: 922b54b ($18.27 in chips)
Seat 5: 7e2585dd ($10.86 in chips)
Seat 6: 2f7d31ea ($11.45 in chips)
920f7e7b: posts small blind $0.05
73388517: posts big blind $0.1
*** HOLE CARDS ***
Dealt to Hero [3h Kd]
Dealt to 920f7e7b 
Dealt to 73388517 
Dealt to 922b54b 
Dealt to 7e2585dd 
Dealt to 2f7d31ea 
922b54b: folds
7e2585dd: raises $0.13 to $0.23
2f7d31ea: folds
Hero: folds
920f7e7b: folds
73388517: folds
Uncalled bet ($0.13) returned to 7e2585dd
*** SHOWDOWN ***
7e2585dd collected $0.25 from pot
*** SUMMARY ***
Total pot $0.25 | Rake $0 | Jackpot $0 | Bingo $0 | Fortune $0
Seat 1: Hero (button) folded before Flop (didn't bet)
Seat 2: 920f7e7b (small blind) folded before Flop
Seat 3: 73388517 (big blind) folded before Flop
Seat 4: 922b54b folded before Flop (didn't bet)
Seat 5: 7e2585dd collected ($0.25)
Seat 6: 2f7d31ea folded before Flop (didn't bet)


Poker Hand #RC1460025275: Hold'em No Limit  ($0.05/$0.1) - 2023/04/08 21:35:32
Table 'RushAndCash3790535' 6-max Seat #1 is the button
Seat 1: ed5c10b4 ($3.41 in chips)
Seat 2: Hero ($4.66 in chips)
Seat 3: bf8d8396 ($11.89 in chips)
Seat 4: d4f8a497 ($10.06 in chips)
Seat 5: 35ef27be ($12.75 in chips)
Seat 6: fa54704d ($20.82 in chips)
Hero: posts small blind $0.05
bf8d8396: posts big blind $0.1
*** HOLE CARDS ***
Dealt to ed5c10b4 
Dealt to Hero [7d 8h]
Dealt to bf8d8396 
Dealt to d4f8a497 
Dealt to 35ef27be 
Dealt to fa54704d 
d4f8a497: folds
35ef27be: folds
fa54704d: folds
ed5c10b4: raises $0.2 to $0.3
Hero: folds
bf8d8396: folds
Uncalled bet ($0.2) returned to ed5c10b4
*** SHOWDOWN ***
ed5c10b4 collected $0.25 from pot
*** SUMMARY ***
Total pot $0.25 | Rake $0 | Jackpot $0 | Bingo $0 | Fortune $0
Seat 1: ed5c10b4 (button) collected ($0.25)
Seat 2: Hero (small blind) folded before Flop
Seat 3: bf8d8396 (big blind) folded before Flop
Seat 4: d4f8a497 folded before Flop (didn't bet)
Seat 5: 35ef27be folded before Flop (didn't bet)
Seat 6: fa54704d folded before Flop (didn't bet)


Poker Hand #RC1460025194: Hold'em No Limit  ($0.05/$0.1) - 2023/04/08 21:35:18
Table 'RushAndCash3790454' 6-max Seat #1 is the button
Seat 1: 95d2128f ($56.09 in chips)
Seat 2: d59033f9 ($10.84 in chips)
Seat 3: e8154e27 ($10 in chips)
Seat 4: 81206ee ($17.79 in chips)
Seat 5: Hero ($4.66 in chips)
Seat 6: 85efbf4d ($5.44 in chips)
d59033f9: posts small blind $0.05
e8154e27: posts big blind $0.1
*** HOLE CARDS ***
Dealt to 95d2128f 
Dealt to d59033f9 
Dealt to e8154e27 
Dealt to 81206ee 
Dealt to Hero [Th Jd]
Dealt to 85efbf4d 
81206ee: folds
Hero: folds
85efbf4d: folds
95d2128f: folds
d59033f9: folds
Uncalled bet ($0.05) returned to e8154e27
*** SHOWDOWN ***
e8154e27 collected $0.1 from pot
*** SUMMARY ***
Total pot $0.1 | Rake $0 | Jackpot $0 | Bingo $0 | Fortune $0
Seat 1: 95d2128f (button) folded before Flop (didn't bet)
Seat 2: d59033f9 (small blind) folded before Flop
Seat 3: e8154e27 (big blind) collected ($0.1)
Seat 4: 81206ee folded before Flop (didn't bet)
Seat 5: Hero folded before Flop (didn't bet)
Seat 6: 85efbf4d folded before Flop (didn't bet)


Poker Hand #RC1460025137: Hold'em No Limit  ($0.05/$0.1) - 2023/04/08 21:35:06
Table 'RushAndCash3790397' 6-max Seat #1 is the button
Seat 1: 497ac189 ($8.95 in chips)
Seat 2: c2fa77d3 ($10 in chips)
Seat 3: b96d280 ($15.22 in chips)
Seat 4: Hero ($4.66 in chips)
Seat 5: b2773b71 ($10.89 in chips)
Seat 6: c49a4612 ($21.29 in chips)
c2fa77d3: posts small blind $0.05
b96d280: posts big blind $0.1
*** HOLE CARDS ***
Dealt to 497ac189 
Dealt to c2fa77d3 
Dealt to b96d280 
Dealt to Hero [Ks 3h]
Dealt to b2773b71 
Dealt to c49a4612 
Hero: folds
b2773b71: folds
c49a4612: folds
497ac189: folds
c2fa77d3: folds
Uncalled bet ($0.05) returned to b96d280
*** SHOWDOWN ***
b96d280 collected $0.1 from pot
*** SUMMARY ***
Total pot $0.1 | Rake $0 | Jackpot $0 | Bingo $0 | Fortune $0
Seat 1: 497ac189 (button) folded before Flop (didn't bet)
Seat 2: c2fa77d3 (small blind) folded before Flop
Seat 3: b96d280 (big blind) collected ($0.1)
Seat 4: Hero folded before Flop (didn't bet)
Seat 5: b2773b71 folded before Flop (didn't bet)
Seat 6: c49a4612 folded before Flop (didn't bet)


Poker Hand #RC1460025113: Hold'em No Limit  ($0.05/$0.1) - 2023/04/08 21:35:02
Table 'RushAndCash3790373' 6-max Seat #1 is the button
Seat 1: 1cf38f48 ($17.71 in chips)
Seat 2: e34f410c ($25.96 in chips)
Seat 3: c49a4612 ($21.39 in chips)
Seat 4: 56ee26a3 ($11.07 in chips)
Seat 5: Hero ($4.66 in chips)
Seat 6: 37cbbd34 ($14.79 in chips)
e34f410c: posts small blind $0.05
c49a4612: posts big blind $0.1
*** HOLE CARDS ***
Dealt to 1cf38f48 
Dealt to e34f410c 
Dealt to c49a4612 
Dealt to 56ee26a3 
Dealt to Hero [8s 3c]
Dealt to 37cbbd34 
56ee26a3: folds
Hero: folds
37cbbd34: raises $0.15 to $0.25
1cf38f48: folds
e34f410c: folds
c49a4612: folds
Uncalled bet ($0.15) returned to 37cbbd34
*** SHOWDOWN ***
37cbbd34 collected $0.25 from pot
*** SUMMARY ***
Total pot $0.25 | Rake $0 | Jackpot $0 | Bingo $0 | Fortune $0
Seat 1: 1cf38f48 (button) folded before Flop (didn't bet)
Seat 2: e34f410c (small blind) folded before Flop
Seat 3: c49a4612 (big blind) folded before Flop
Seat 4: 56ee26a3 folded before Flop (didn't bet)
Seat 5: Hero folded before Flop (didn't bet)
Seat 6: 37cbbd34 collected ($0.25)


Poker Hand #RC1460024997: Hold'em No Limit  ($0.05/$0.1) - 2023/04/08 21:34:39
Table 'RushAndCash3790257' 6-max Seat #1 is the button
Seat 1: c41992fa ($27.97 in chips)
Seat 2: a331059d ($10.38 in chips)
Seat 3: 39304d43 ($5.3 in chips)
Seat 4: 9022b505 ($12.12 in chips)
Seat 5: Hero ($4.66 in chips)
Seat 6: c948d937 ($10.04 in chips)
a331059d: posts small blind $0.05
39304d43: posts big blind $0.1
*** HOLE CARDS ***
Dealt to c41992fa 
Dealt to a331059d 
Dealt to 39304d43 
Dealt to 9022b505 
Dealt to Hero [4s 7c]
Dealt to c948d937 
9022b505: folds
Hero: folds
c948d937: folds
c41992fa: folds
a331059d: folds
Uncalled bet ($0.05) returned to 39304d43
*** SHOWDOWN ***
39304d43 collected $0.1 from pot
*** SUMMARY ***
Total pot $0.1 | Rake $0 | Jackpot $0 | Bingo $0 | Fortune $0
Seat 1: c41992fa (button) folded before Flop (didn't bet)
Seat 2: a331059d (small blind) folded before Flop
Seat 3: 39304d43 (big blind) collected ($0.1)
Seat 4: 9022b505 folded before Flop (didn't bet)
Seat 5: Hero folded before Flop (didn't bet)
Seat 6: c948d937 folded before Flop (didn't bet)


Poker Hand #RC1460024922: Hold'em No Limit  ($0.05/$0.1) - 2023/04/08 21:34:24
Table 'RushAndCash3790182' 6-max Seat #1 is the button
Seat 1: cc0187a4 ($11.17 in chips)
Seat 2: 7a3e4c38 ($47.09 in chips)
Seat 3: Hero ($4.76 in chips)
Seat 4: 423ab6ff ($23.84 in chips)
Seat 5: ee266a57 ($12.63 in chips)
Seat 6: 79a6a81d ($11.08 in chips)
7a3e4c38: posts small blind $0.05
Hero: posts big blind $0.1
*** HOLE CARDS ***
Dealt to cc0187a4 
Dealt to 7a3e4c38 
Dealt to Hero [9s 2s]
Dealt to 423ab6ff 
Dealt to ee266a57 
Dealt to 79a6a81d 
423ab6ff: folds
ee266a57: folds
79a6a81d: raises $0.12 to $0.22
cc0187a4: folds
7a3e4c38: raises $0.64 to $0.86
Hero: folds
79a6a81d: folds
Uncalled bet ($0.64) returned to 7a3e4c38
*** SHOWDOWN ***
7a3e4c38 collected $0.52 from pot
*** SUMMARY ***
Total pot $0.54 | Rake $0.02 | Jackpot $0 | Bingo $0 | Fortune $0
Seat 1: cc0187a4 (button) folded before Flop (didn't bet)
Seat 2: 7a3e4c38 (small blind) collected ($0.52)
Seat 3: Hero (big blind) folded before Flop
Seat 4: 423ab6ff folded before Flop (didn't bet)
Seat 5: ee266a57 folded before Flop (didn't bet)
Seat 6: 79a6a81d folded before Flop


Poker Hand #RC1460024878: Hold'em No Limit  ($0.05/$0.1) - 2023/04/08 21:34:16
Table 'RushAndCash3790138' 6-max Seat #1 is the button
Seat 1: 65715b31 ($14.9 in chips)
Seat 2: Hero ($4.81 in chips)
Seat 3: 2901baf ($11.2 in chips)
Seat 4: 9562ba62 ($9.33 in chips)
Seat 5: 8e54405d ($13.08 in chips)
Seat 6: 7e2cd429 ($11.92 in chips)
Hero: posts small blind $0.05
2901baf: posts big blind $0.1
*** HOLE CARDS ***
Dealt to 65715b31 
Dealt to Hero [Tc Jd]
Dealt to 2901baf 
Dealt to 9562ba62 
Dealt to 8e54405d 
Dealt to 7e2cd429 
9562ba62: folds
8e54405d: folds
7e2cd429: folds
65715b31: raises $0.2 to $0.3
Hero: folds
2901baf: folds
Uncalled bet ($0.2) returned to 65715b31
*** SHOWDOWN ***
65715b31 collected $0.25 from pot
*** SUMMARY ***
Total pot $0.25 | Rake $0 | Jackpot $0 | Bingo $0 | Fortune $0
Seat 1: 65715b31 (button) collected ($0.25)
Seat 2: Hero (small blind) folded before Flop
Seat 3: 2901baf (big blind) folded before Flop
Seat 4: 9562ba62 folded before Flop (didn't bet)
Seat 5: 8e54405d folded before Flop (didn't bet)
Seat 6: 7e2cd429 folded before Flop (didn't bet)


Poker Hand #RC1460024849: Hold'em No Limit  ($0.05/$0.1) - 2023/04/08 21:34:11
Table 'RushAndCash3790109' 6-max Seat #1 is the button
Seat 1: a438ad41 ($16.18 in chips)
Seat 2: 71d28e01 ($6.77 in chips)
Seat 3: 9994f92e ($10.1 in chips)
Seat 4: 794841c4 ($22.2 in chips)
Seat 5: Hero ($4.81 in chips)
Seat 6: f7a1d148 ($9.02 in chips)
71d28e01: posts small blind $0.05
9994f92e: posts big blind $0.1
*** HOLE CARDS ***
Dealt to a438ad41 
Dealt to 71d28e01 
Dealt to 9994f92e 
Dealt to 794841c4 
Dealt to Hero [2h 7h]
Dealt to f7a1d148 
794841c4: folds
Hero: folds
f7a1d148: raises $0.11 to $0.21
a438ad41: calls $0.21
71d28e01: folds
9994f92e: calls $0.11
*** FLOP *** [7d Ks 2d]
9994f92e: checks
f7a1d148: bets $0.23
a438ad41: calls $0.23
9994f92e: folds
*** TURN *** [7d Ks 2d] [Js]
f7a1d148: bets $0.65
a438ad41: raises $1.35 to $2
f7a1d148: calls $1.35
*** RIVER *** [7d Ks 2d Js] [5h]
f7a1d148: checks
a438ad41: checks
f7a1d148: shows [Qc Kc] (Pair of Kings)
a438ad41: shows [6s 8s] (King-High)
*** SHOWDOWN ***
f7a1d148 collected $4.74 from pot
*** SUMMARY ***
Total pot $5.14 | Rake $0.25 | Jackpot $0.15 | Bingo $0 | Fortune $0
Board [7d Ks 2d Js 5h]
Seat 1: a438ad41 (button) showed [6s 8s] and lost with King-High
Seat 2: 71d28e01 (small blind) folded before Flop
Seat 3: 9994f92e (big blind) folded on the Flop
Seat 4: 794841c4 folded before Flop (didn't bet)
Seat 5: Hero folded before Flop (didn't bet)
Seat 6: f7a1d148 showed [Qc Kc] and won ($4.74) with Pair of Kings


Poker Hand #RC1460024805: Hold'em No Limit  ($0.05/$0.1) - 2023/04/08 21:34:03
Table 'RushAndCash3790065' 6-max Seat #1 is the button
Seat 1: Hero ($4.81 in chips)
Seat 2: 5a721ebb ($14.19 in chips)
Seat 3: 25a5e2f9 ($8.61 in chips)
Seat 4: 86094ff0 ($10.25 in chips)
Seat 5: 8ad6250d ($9.77 in chips)
Seat 6: b2773b71 ($10.82 in chips)
5a721ebb: posts small blind $0.05
25a5e2f9: posts big blind $0.1
*** HOLE CARDS ***
Dealt to Hero [Qh 3c]
Dealt to 5a721ebb 
Dealt to 25a5e2f9 
Dealt to 86094ff0 
Dealt to 8ad6250d 
Dealt to b2773b71 
86094ff0: folds
8ad6250d: folds
b2773b71: folds
Hero: folds
5a721ebb: raises $0.2 to $0.3
25a5e2f9: calls $0.2
*** FLOP *** [4c 6s 6d]
5a721ebb: checks
25a5e2f9: bets $0.2
5a721ebb: folds
Uncalled bet ($0.2) returned to 25a5e2f9
*** SHOWDOWN ***
25a5e2f9 collected $0.57 from pot
*** SUMMARY ***
Total pot $0.6 | Rake $0.03 | Jackpot $0 | Bingo $0 | Fortune $0
Board [4c 6s 6d]
Seat 1: Hero (button) folded before Flop (didn't bet)
Seat 2: 5a721ebb (small blind) folded on the Flop
Seat 3: 25a5e2f9 (big blind) won ($0.57)
Seat 4: 86094ff0 folded before Flop (didn't bet)
Seat 5: 8ad6250d folded before Flop (didn't bet)
Seat 6: b2773b71 folded before Flop (didn't bet)


Poker Hand #RC1459954707: Hold'em No Limit  ($0.05/$0.1) - 2023/04/08 21:33:46
Table 'RushAndCash3789967' 6-max Seat #1 is the button
Seat 1: 8967e899 ($15.47 in chips)
Seat 2: 92a48d51 ($10.02 in chips)
Seat 3: Hero ($4.91 in chips)
Seat 4: 89d24b76 ($17.05 in chips)
Seat 5: 8fcef37 ($11.25 in chips)
Seat 6: 497ac189 ($9.35 in chips)
92a48d51: posts small blind $0.05
Hero: posts big blind $0.1
*** HOLE CARDS ***
Dealt to 8967e899 
Dealt to 92a48d51 
Dealt to Hero [9d 8h]
Dealt to 89d24b76 
Dealt to 8fcef37 
Dealt to 497ac189 
89d24b76: raises $0.15 to $0.25
8fcef37: folds
497ac189: calls $0.25
8967e899: folds
92a48d51: folds
Hero: folds
*** FLOP *** [2c 9h 8c]
89d24b76: bets $0.22
497ac189: folds
Uncalled bet ($0.22) returned to 89d24b76
*** SHOWDOWN ***
89d24b76 collected $0.62 from pot
*** SUMMARY ***
Total pot $0.65 | Rake $0.03 | Jackpot $0 | Bingo $0 | Fortune $0
Board [2c 9h 8c]
Seat 1: 8967e899 (button) folded before Flop (didn't bet)
Seat 2: 92a48d51 (small blind) folded before Flop
Seat 3: Hero (big blind) folded before Flop
Seat 4: 89d24b76 won ($0.62)
Seat 5: 8fcef37 folded before Flop (didn't bet)
Seat 6: 497ac189 folded on the Flop


Poker Hand #RC1459954561: Hold'em No Limit  ($0.05/$0.1) - 2023/04/08 21:33:19
Table 'RushAndCash3789821' 6-max Seat #1 is the button
Seat 1: 65715b31 ($15.7 in chips)
Seat 2: Hero ($4.44 in chips)
Seat 3: ea1988b ($10 in chips)
Seat 4: e40de4b2 ($10.06 in chips)
Seat 5: 497ac189 ($9.55 in chips)
Seat 6: 9e5cd98c ($6.49 in chips)
Hero: posts small blind $0.05
ea1988b: posts big blind $0.1
*** HOLE CARDS ***
Dealt to 65715b31 
Dealt to Hero [Qc Qh]
Dealt to ea1988b 
Dealt to e40de4b2 
Dealt to 497ac189 
Dealt to 9e5cd98c 
e40de4b2: folds
497ac189: raises $0.1 to $0.2
9e5cd98c: calls $0.2
65715b31: folds
Hero: raises $0.7 to $0.9
ea1988b: folds
497ac189: folds
9e5cd98c: folds
Uncalled bet ($0.7) returned to Hero
*** SHOWDOWN ***
Hero collected $0.67 from pot
*** SUMMARY ***
Total pot $0.7 | Rake $0.03 | Jackpot $0 | Bingo $0 | Fortune $0
Seat 1: 65715b31 (button) folded before Flop (didn't bet)
Seat 2: Hero (small blind) collected ($0.67)
Seat 3: ea1988b (big blind) folded before Flop
Seat 4: e40de4b2 folded before Flop (didn't bet)
Seat 5: 497ac189 folded before Flop
Seat 6: 9e5cd98c folded before Flop


Poker Hand #RC1459954412: Hold'em No Limit  ($0.05/$0.1) - 2023/04/08 21:32:51
Table 'RushAndCash3789672' 6-max Seat #1 is the button
Seat 1: Hero ($4.44 in chips)
Seat 2: 987fbaa8 ($9.9 in chips)
Seat 3: 909716ea ($30.82 in chips)
Seat 4: b0946193 ($10 in chips)
Seat 5: 2746b81b ($9.5 in chips)
Seat 6: 32655b8a ($10 in chips)
987fbaa8: posts small blind $0.05
909716ea: posts big blind $0.1
*** HOLE CARDS ***
Dealt to Hero [6d 2s]
Dealt to 987fbaa8 
Dealt to 909716ea 
Dealt to b0946193 
Dealt to 2746b81b 
Dealt to 32655b8a 
b0946193: raises $0.14 to $0.24
2746b81b: calls $0.24
32655b8a: folds
Hero: folds
987fbaa8: folds
909716ea: folds
*** FLOP *** [4h 8c Ts]
b0946193: checks
2746b81b: checks
*** TURN *** [4h 8c Ts] [3c]
b0946193: checks
2746b81b: checks
*** RIVER *** [4h 8c Ts 3c] [Jc]
b0946193: checks
2746b81b: bets $0.21
b0946193: folds
Uncalled bet ($0.21) returned to 2746b81b
*** SHOWDOWN ***
2746b81b collected $0.6 from pot
*** SUMMARY ***
Total pot $0.63 | Rake $0.03 | Jackpot $0 | Bingo $0 | Fortune $0
Board [4h 8c Ts 3c Jc]
Seat 1: Hero (button) folded before Flop (didn't bet)
Seat 2: 987fbaa8 (small blind) folded before Flop
Seat 3: 909716ea (big blind) folded before Flop
Seat 4: b0946193 folded on the River
Seat 5: 2746b81b won ($0.6)
Seat 6: 32655b8a folded before Flop (didn't bet)


Poker Hand #RC1459954320: Hold'em No Limit  ($0.05/$0.1) - 2023/04/08 21:32:32
Table 'RushAndCash3789580' 6-max Seat #1 is the button
Seat 1: 4e377dd5 ($10.15 in chips)
Seat 2: 84ca6d57 ($31.86 in chips)
Seat 3: Hero ($4.54 in chips)
Seat 4: fab3c860 ($10.28 in chips)
Seat 5: 78269ebc ($16.37 in chips)
Seat 6: 44ed445f ($10.69 in chips)
84ca6d57: posts small blind $0.05
Hero: posts big blind $0.1
*** HOLE CARDS ***
Dealt to 4e377dd5 
Dealt to 84ca6d57 
Dealt to Hero [6c Tc]
Dealt to fab3c860 
Dealt to 78269ebc 
Dealt to 44ed445f 
fab3c860: folds
78269ebc: folds
44ed445f: folds
4e377dd5: raises $0.15 to $0.25
84ca6d57: raises $0.45 to $0.7
Hero: folds
4e377dd5: calls $0.45
*** FLOP *** [5c 6s 3c]
84ca6d57: bets $0.5
4e377dd5: calls $0.5
*** TURN *** [5c 6s 3c] [7h]
84ca6d57: bets $1.33
4e377dd5: folds
Uncalled bet ($1.33) returned to 84ca6d57
*** SHOWDOWN ***
84ca6d57 collected $2.38 from pot
*** SUMMARY ***
Total pot $2.5 | Rake $0.12 | Jackpot $0 | Bingo $0 | Fortune $0
Board [5c 6s 3c 7h]
Seat 1: 4e377dd5 (button) folded on the Turn
Seat 2: 84ca6d57 (small blind) won ($2.38)
Seat 3: Hero (big blind) folded before Flop
Seat 4: fab3c860 folded before Flop (didn't bet)
Seat 5: 78269ebc folded before Flop (didn't bet)
Seat 6: 44ed445f folded before Flop (didn't bet)


Poker Hand #RC1459954203: Hold'em No Limit  ($0.05/$0.1) - 2023/04/08 21:32:09
Table 'RushAndCash3789463' 6-max Seat #1 is the button
Seat 1: 9b7ef238 ($2.97 in chips)
Seat 2: 35ef27be ($13.21 in chips)
Seat 3: f8911afc ($18.68 in chips)
Seat 4: 6dc4f553 ($13 in chips)
Seat 5: 605a2171 ($25.91 in chips)
Seat 6: Hero ($4.39 in chips)
35ef27be: posts small blind $0.05
f8911afc: posts big blind $0.1
*** HOLE CARDS ***
Dealt to 9b7ef238 
Dealt to 35ef27be 
Dealt to f8911afc 
Dealt to 6dc4f553 
Dealt to 605a2171 
Dealt to Hero [Ac 7d]
6dc4f553: folds
605a2171: folds
Hero: raises $0.15 to $0.25
9b7ef238: folds
35ef27be: folds
f8911afc: folds
Uncalled bet ($0.15) returned to Hero
*** SHOWDOWN ***
Hero collected $0.25 from pot
*** SUMMARY ***
Total pot $0.25 | Rake $0 | Jackpot $0 | Bingo $0 | Fortune $0
Seat 1: 9b7ef238 (button) folded before Flop (didn't bet)
Seat 2: 35ef27be (small blind) folded before Flop
Seat 3: f8911afc (big blind) folded before Flop
Seat 4: 6dc4f553 folded before Flop (didn't bet)
Seat 5: 605a2171 folded before Flop (didn't bet)
Seat 6: Hero collected ($0.25)


Poker Hand #RC1459953870: Hold'em No Limit  ($0.05/$0.1) - 2023/04/08 21:31:03
Table 'RushAndCash3789130' 6-max Seat #1 is the button
Seat 1: Hero ($5.91 in chips)
Seat 2: 70cd5c03 ($19.44 in chips)
Seat 3: 35ef27be ($11.96 in chips)
Seat 4: b8f000db ($10.93 in chips)
Seat 5: c3d0bc2b ($6.15 in chips)
Seat 6: 157fc37b ($21.94 in chips)
70cd5c03: posts small blind $0.05
35ef27be: posts big blind $0.1
*** HOLE CARDS ***
Dealt to Hero [Tc 9c]
Dealt to 70cd5c03 
Dealt to 35ef27be 
Dealt to b8f000db 
Dealt to c3d0bc2b 
Dealt to 157fc37b 
b8f000db: folds
c3d0bc2b: folds
157fc37b: folds
Hero: raises $0.15 to $0.25
70cd5c03: folds
35ef27be: calls $0.15
*** FLOP *** [6h 7c Ac]
35ef27be: checks
Hero: bets $0.42
35ef27be: calls $0.42
*** TURN *** [6h 7c Ac] [Ks]
35ef27be: checks
Hero: bets $0.85
35ef27be: calls $0.85
*** RIVER *** [6h 7c Ac Ks] [6d]
35ef27be: checks
Hero: checks
35ef27be: shows [Ad 5c] (Pair of Aces and Pair of Sixes)
Hero: shows [Tc 9c] (Pair of Sixes)
*** SHOWDOWN ***
35ef27be collected $2.77 from pot
*** SUMMARY ***
Total pot $3.09 | Rake $0.17 | Jackpot $0.15 | Bingo $0 | Fortune $0
Board [6h 7c Ac Ks 6d]
Seat 1: Hero (button) showed [Tc 9c] and lost with Pair of Sixes
Seat 2: 70cd5c03 (small blind) folded before Flop
Seat 3: 35ef27be (big blind) showed [Ad 5c] and won ($2.77) with Pair of Aces and Pair of Sixes
Seat 4: b8f000db folded before Flop (didn't bet)
Seat 5: c3d0bc2b folded before Flop (didn't bet)
Seat 6: 157fc37b folded before Flop (didn't bet)


Poker Hand #RC1459953803: Hold'em No Limit  ($0.05/$0.1) - 2023/04/08 21:30:51
Table 'RushAndCash3789063' 6-max Seat #1 is the button
Seat 1: bf9dc4c2 ($47.46 in chips)
Seat 2: Hero ($5.96 in chips)
Seat 3: 4b62130d ($10.1 in chips)
Seat 4: 2c3a8763 ($20.85 in chips)
Seat 5: b8e0478f ($10 in chips)
Seat 6: 9cf48e0c ($10 in chips)
Hero: posts small blind $0.05
4b62130d: posts big blind $0.1
*** HOLE CARDS ***
Dealt to bf9dc4c2 
Dealt to Hero [9c Ah]
Dealt to 4b62130d 
Dealt to 2c3a8763 
Dealt to b8e0478f 
Dealt to 9cf48e0c 
2c3a8763: folds
b8e0478f: raises $0.1 to $0.2
9cf48e0c: folds
bf9dc4c2: folds
Hero: folds
4b62130d: calls $0.1
*** FLOP *** [Ac Jd Qs]
4b62130d: checks
b8e0478f: checks
*** TURN *** [Ac Jd Qs] [5d]
4b62130d: checks
b8e0478f: checks
*** RIVER *** [Ac Jd Qs 5d] [Ts]
4b62130d: bets $0.4
b8e0478f: calls $0.4
4b62130d: shows [5s Ks] (Aces-High Straight)
b8e0478f: shows [8h 9h] (Queens-High Straight)
*** SHOWDOWN ***
4b62130d collected $1.19 from pot
*** SUMMARY ***
Total pot $1.25 | Rake $0.06 | Jackpot $0 | Bingo $0 | Fortune $0
Board [Ac Jd Qs 5d Ts]
Seat 1: bf9dc4c2 (button) folded before Flop (didn't bet)
Seat 2: Hero (small blind) folded before Flop
Seat 3: 4b62130d (big blind) showed [5s Ks] and won ($1.19) with Aces-High Straight
Seat 4: 2c3a8763 folded before Flop (didn't bet)
Seat 5: b8e0478f showed [8h 9h] and lost with Queens-High Straight
Seat 6: 9cf48e0c folded before Flop (didn't bet)


Poker Hand #RC1459953693: Hold'em No Limit  ($0.05/$0.1) - 2023/04/08 21:30:31
Table 'RushAndCash3788953' 6-max Seat #1 is the button
Seat 1: 9b7ef238 ($3.87 in chips)
Seat 2: 147c2132 ($10 in chips)
Seat 3: Hero ($6.06 in chips)
Seat 4: 1c0156da ($11.8 in chips)
Seat 5: 1cf38f48 ($21.11 in chips)
Seat 6: f18ec573 ($31.16 in chips)
147c2132: posts small blind $0.05
Hero: posts big blind $0.1
*** HOLE CARDS ***
Dealt to 9b7ef238 
Dealt to 147c2132 
Dealt to Hero [9c Kd]
Dealt to 1c0156da 
Dealt to 1cf38f48 
Dealt to f18ec573 
1c0156da: folds
1cf38f48: folds
f18ec573: raises $0.15 to $0.25
9b7ef238: folds
147c2132: folds
Hero: folds
Uncalled bet ($0.15) returned to f18ec573
*** SHOWDOWN ***
f18ec573 collected $0.25 from pot
*** SUMMARY ***
Total pot $0.25 | Rake $0 | Jackpot $0 | Bingo $0 | Fortune $0
Seat 1: 9b7ef238 (button) folded before Flop (didn't bet)
Seat 2: 147c2132 (small blind) folded before Flop
Seat 3: Hero (big blind) folded before Flop
Seat 4: 1c0156da folded before Flop (didn't bet)
Seat 5: 1cf38f48 folded before Flop (didn't bet)
Seat 6: f18ec573 collected ($0.25)


Poker Hand #RC1459953649: Hold'em No Limit  ($0.05/$0.1) - 2023/04/08 21:30:22
Table 'RushAndCash3788909' 6-max Seat #1 is the button
Seat 1: c9c4143d ($9.41 in chips)
Seat 2: 5bd35e2c ($19.32 in chips)
Seat 3: 4898d3fb ($10.32 in chips)
Seat 4: Hero ($6.06 in chips)
Seat 5: cd80bf76 ($21.16 in chips)
Seat 6: 7800aeef ($10 in chips)
5bd35e2c: posts small blind $0.05
4898d3fb: posts big blind $0.1
*** HOLE CARDS ***
Dealt to c9c4143d 
Dealt to 5bd35e2c 
Dealt to 4898d3fb 
Dealt to Hero [4h 8d]
Dealt to cd80bf76 
Dealt to 7800aeef 
Hero: folds
cd80bf76: raises $0.15 to $0.25
7800aeef: raises $0.75 to $1
c9c4143d: folds
5bd35e2c: folds
4898d3fb: folds
cd80bf76: folds
Uncalled bet ($0.75) returned to 7800aeef
*** SHOWDOWN ***
7800aeef collected $0.62 from pot
*** SUMMARY ***
Total pot $0.65 | Rake $0.03 | Jackpot $0 | Bingo $0 | Fortune $0
Seat 1: c9c4143d (button) folded before Flop (didn't bet)
Seat 2: 5bd35e2c (small blind) folded before Flop
Seat 3: 4898d3fb (big blind) folded before Flop
Seat 4: Hero folded before Flop (didn't bet)
Seat 5: cd80bf76 folded before Flop
Seat 6: 7800aeef collected ($0.62)


Poker Hand #RC1459953620: Hold'em No Limit  ($0.05/$0.1) - 2023/04/08 21:30:17
Table 'RushAndCash3788880' 6-max Seat #1 is the button
Seat 1: 62fb2705 ($11.87 in chips)
Seat 2: 85efbf4d ($8.08 in chips)
Seat 3: 7a8ec93c ($1.83 in chips)
Seat 4: Hero ($6.06 in chips)
Seat 5: 9dd15c16 ($13.63 in chips)
Seat 6: 84ca6d57 ($34.12 in chips)
85efbf4d: posts small blind $0.05
7a8ec93c: posts big blind $0.1
*** HOLE CARDS ***
Dealt to 62fb2705 
Dealt to 85efbf4d 
Dealt to 7a8ec93c 
Dealt to Hero [9c 3s]
Dealt to 9dd15c16 
Dealt to 84ca6d57 
Hero: folds
9dd15c16: folds
84ca6d57: folds
62fb2705: folds
85efbf4d: folds
Uncalled bet ($0.05) returned to 7a8ec93c
*** SHOWDOWN ***
7a8ec93c collected $0.1 from pot
*** SUMMARY ***
Total pot $0.1 | Rake $0 | Jackpot $0 | Bingo $0 | Fortune $0
Seat 1: 62fb2705 (button) folded before Flop (didn't bet)
Seat 2: 85efbf4d (small blind) folded before Flop
Seat 3: 7a8ec93c (big blind) collected ($0.1)
Seat 4: Hero folded before Flop (didn't bet)
Seat 5: 9dd15c16 folded before Flop (didn't bet)
Seat 6: 84ca6d57 folded before Flop (didn't bet)


Poker Hand #RC1459953568: Hold'em No Limit  ($0.05/$0.1) - 2023/04/08 21:30:07
Table 'RushAndCash3788828' 6-max Seat #1 is the button
Seat 1: 2f12e642 ($6.56 in chips)
Seat 2: 3d55903e ($12.07 in chips)
Seat 3: 92be4bf ($10 in chips)
Seat 4: cd80bf76 ($21.16 in chips)
Seat 5: Hero ($6.06 in chips)
Seat 6: d728232d ($11.02 in chips)
3d55903e: posts small blind $0.05
92be4bf: posts big blind $0.1
*** HOLE CARDS ***
Dealt to 2f12e642 
Dealt to 3d55903e 
Dealt to 92be4bf 
Dealt to cd80bf76 
Dealt to Hero [5d 8h]
Dealt to d728232d 
cd80bf76: folds
Hero: folds
d728232d: folds
2f12e642: raises $0.12 to $0.22
3d55903e: folds
92be4bf: folds
Uncalled bet ($0.12) returned to 2f12e642
*** SHOWDOWN ***
2f12e642 collected $0.25 from pot
*** SUMMARY ***
Total pot $0.25 | Rake $0 | Jackpot $0 | Bingo $0 | Fortune $0
Seat 1: 2f12e642 (button) collected ($0.25)
Seat 2: 3d55903e (small blind) folded before Flop
Seat 3: 92be4bf (big blind) folded before Flop
Seat 4: cd80bf76 folded before Flop (didn't bet)
Seat 5: Hero folded before Flop (didn't bet)
Seat 6: d728232d folded before Flop (didn't bet)


Poker Hand #RC1459953528: Hold'em No Limit  ($0.05/$0.1) - 2023/04/08 21:30:00
Table 'RushAndCash3788788' 6-max Seat #1 is the button
Seat 1: 72565a6f ($10.05 in chips)
Seat 2: c6513b32 ($9.12 in chips)
Seat 3: 7bfc260f ($23.27 in chips)
Seat 4: 93028ba3 ($19.12 in chips)
Seat 5: Hero ($6.06 in chips)
Seat 6: 609aa77c ($4.22 in chips)
c6513b32: posts small blind $0.05
7bfc260f: posts big blind $0.1
*** HOLE CARDS ***
Dealt to 72565a6f 
Dealt to c6513b32 
Dealt to 7bfc260f 
Dealt to 93028ba3 
Dealt to Hero [3s 3c]
Dealt to 609aa77c 
93028ba3: folds
Hero: folds
609aa77c: folds
72565a6f: raises $0.17 to $0.27
c6513b32: calls $0.22
7bfc260f: calls $0.17
*** FLOP *** [9s Qh 3h]
c6513b32: checks
7bfc260f: checks
72565a6f: checks
*** TURN *** [9s Qh 3h] [9c]
c6513b32: bets $0.27
7bfc260f: raises $0.63 to $0.9
72565a6f: folds
c6513b32: folds
Uncalled bet ($0.63) returned to 7bfc260f
*** SHOWDOWN ***
7bfc260f collected $1.29 from pot
*** SUMMARY ***
Total pot $1.35 | Rake $0.06 | Jackpot $0 | Bingo $0 | Fortune $0
Board [9s Qh 3h 9c]
Seat 1: 72565a6f (button) folded on the Turn
Seat 2: c6513b32 (small blind) folded on the Turn
Seat 3: 7bfc260f (big blind) won ($1.29)
Seat 4: 93028ba3 folded before Flop (didn't bet)
Seat 5: Hero folded before Flop (didn't bet)
Seat 6: 609aa77c folded before Flop (didn't bet)


Poker Hand #RC1459953325: Hold'em No Limit  ($0.05/$0.1) - 2023/04/08 21:29:20
Table 'RushAndCash3788585' 6-max Seat #1 is the button
Seat 1: 9dd15c16 ($13.4 in chips)
Seat 2: Hero ($6.26 in chips)
Seat 3: c6513b32 ($8.75 in chips)
Seat 4: 3bfa3e10 ($18.86 in chips)
Seat 5: 430a055a ($11.66 in chips)
Seat 6: 609aa77c ($4.42 in chips)
Hero: posts small blind $0.05
c6513b32: posts big blind $0.1
*** HOLE CARDS ***
Dealt to 9dd15c16 
Dealt to Hero [4c 4s]
Dealt to c6513b32 
Dealt to 3bfa3e10 
Dealt to 430a055a 
Dealt to 609aa77c 
3bfa3e10: folds
430a055a: folds
609aa77c: raises $0.1 to $0.2
9dd15c16: folds
Hero: calls $0.15
c6513b32: raises $0.75 to $0.95
609aa77c: folds
Hero: folds
Uncalled bet ($0.75) returned to c6513b32
*** SHOWDOWN ***
c6513b32 collected $0.57 from pot
*** SUMMARY ***
Total pot $0.6 | Rake $0.03 | Jackpot $0 | Bingo $0 | Fortune $0
Seat 1: 9dd15c16 (button) folded before Flop (didn't bet)
Seat 2: Hero (small blind) folded before Flop
Seat 3: c6513b32 (big blind) collected ($0.57)
Seat 4: 3bfa3e10 folded before Flop (didn't bet)
Seat 5: 430a055a folded before Flop (didn't bet)
Seat 6: 609aa77c folded before Flop


Poker Hand #RC1459953305: Hold'em No Limit  ($0.05/$0.1) - 2023/04/08 21:29:16
Table 'RushAndCash3788565' 6-max Seat #1 is the button
Seat 1: c6513b32 ($8.75 in chips)
Seat 2: a3dfec44 ($16.3 in chips)
Seat 3: 13df74b7 ($11.08 in chips)
Seat 4: Hero ($6.26 in chips)
Seat 5: 60537085 ($10 in chips)
Seat 6: c739ac5c ($13.71 in chips)
a3dfec44: posts small blind $0.05
13df74b7: posts big blind $0.1
*** HOLE CARDS ***
Dealt to c6513b32 
Dealt to a3dfec44 
Dealt to 13df74b7 
Dealt to Hero [5c 8s]
Dealt to 60537085 
Dealt to c739ac5c 
Hero: folds
60537085: raises $0.1 to $0.2
c739ac5c: folds
c6513b32: folds
a3dfec44: folds
13df74b7: folds
Uncalled bet ($0.1) returned to 60537085
*** SHOWDOWN ***
60537085 collected $0.25 from pot
*** SUMMARY ***
Total pot $0.25 | Rake $0 | Jackpot $0 | Bingo $0 | Fortune $0
Seat 1: c6513b32 (button) folded before Flop (didn't bet)
Seat 2: a3dfec44 (small blind) folded before Flop
Seat 3: 13df74b7 (big blind) folded before Flop
Seat 4: Hero folded before Flop (didn't bet)
Seat 5: 60537085 collected ($0.25)
Seat 6: c739ac5c folded before Flop (didn't bet)


Poker Hand #RC1459953243: Hold'em No Limit  ($0.05/$0.1) - 2023/04/08 21:29:04
Table 'RushAndCash3788503' 6-max Seat #1 is the button
Seat 1: Hero ($6.26 in chips)
Seat 2: 3609d703 ($10.28 in chips)
Seat 3: 1353b9bd ($10 in chips)
Seat 4: 80783716 ($10.44 in chips)
Seat 5: 1cf38f48 ($21.26 in chips)
Seat 6: f2e88fdb ($10.24 in chips)
3609d703: posts small blind $0.05
1353b9bd: posts big blind $0.1
*** HOLE CARDS ***
Dealt to Hero [9d Qs]
Dealt to 3609d703 
Dealt to 1353b9bd 
Dealt to 80783716 
Dealt to 1cf38f48 
Dealt to f2e88fdb 
80783716: folds
1cf38f48: raises $0.15 to $0.25
f2e88fdb: folds
Hero: folds
3609d703: folds
1353b9bd: folds
Uncalled bet ($0.15) returned to 1cf38f48
*** SHOWDOWN ***
1cf38f48 collected $0.25 from pot
*** SUMMARY ***
Total pot $0.25 | Rake $0 | Jackpot $0 | Bingo $0 | Fortune $0
Seat 1: Hero (button) folded before Flop (didn't bet)
Seat 2: 3609d703 (small blind) folded before Flop
Seat 3: 1353b9bd (big blind) folded before Flop
Seat 4: 80783716 folded before Flop (didn't bet)
Seat 5: 1cf38f48 collected ($0.25)
Seat 6: f2e88fdb folded before Flop (didn't bet)


Poker Hand #RC1459953221: Hold'em No Limit  ($0.05/$0.1) - 2023/04/08 21:29:00
Table 'RushAndCash3788481' 6-max Seat #1 is the button
Seat 1: c597b3ca ($10 in chips)
Seat 2: 35ef27be ($8.95 in chips)
Seat 3: 3c8bca42 ($11.98 in chips)
Seat 4: 22e10f51 ($12.88 in chips)
Seat 5: 3a385427 ($13.81 in chips)
Seat 6: Hero ($6.26 in chips)
35ef27be: posts small blind $0.05
3c8bca42: posts big blind $0.1
*** HOLE CARDS ***
Dealt to c597b3ca 
Dealt to 35ef27be 
Dealt to 3c8bca42 
Dealt to 22e10f51 
Dealt to 3a385427 
Dealt to Hero [8d 6s]
22e10f51: folds
3a385427: folds
Hero: folds
c597b3ca: folds
35ef27be: folds
Uncalled bet ($0.05) returned to 3c8bca42
*** SHOWDOWN ***
3c8bca42 collected $0.1 from pot
*** SUMMARY ***
Total pot $0.1 | Rake $0 | Jackpot $0 | Bingo $0 | Fortune $0
Seat 1: c597b3ca (button) folded before Flop (didn't bet)
Seat 2: 35ef27be (small blind) folded before Flop
Seat 3: 3c8bca42 (big blind) collected ($0.1)
Seat 4: 22e10f51 folded before Flop (didn't bet)
Seat 5: 3a385427 folded before Flop (didn't bet)
Seat 6: Hero folded before Flop (didn't bet)


Poker Hand #RC1459953193: Hold'em No Limit  ($0.05/$0.1) - 2023/04/08 21:28:54
Table 'RushAndCash3788453' 6-max Seat #1 is the button
Seat 1: e534119 ($10.4 in chips)
Seat 2: e790267c ($14.69 in chips)
Seat 3: c89af454 ($33.63 in chips)
Seat 4: Hero ($6.26 in chips)
Seat 5: 457142b5 ($33.98 in chips)
Seat 6: 4ec6caba ($14.06 in chips)
e790267c: posts small blind $0.05
c89af454: posts big blind $0.1
*** HOLE CARDS ***
Dealt to e534119 
Dealt to e790267c 
Dealt to c89af454 
Dealt to Hero [6s Ad]
Dealt to 457142b5 
Dealt to 4ec6caba 
Hero: folds
457142b5: folds
4ec6caba: raises $0.15 to $0.25
e534119: folds
e790267c: folds
c89af454: folds
Uncalled bet ($0.15) returned to 4ec6caba
*** SHOWDOWN ***
4ec6caba collected $0.25 from pot
*** SUMMARY ***
Total pot $0.25 | Rake $0 | Jackpot $0 | Bingo $0 | Fortune $0
Seat 1: e534119 (button) folded before Flop (didn't bet)
Seat 2: e790267c (small blind) folded before Flop
Seat 3: c89af454 (big blind) folded before Flop
Seat 4: Hero folded before Flop (didn't bet)
Seat 5: 457142b5 folded before Flop (didn't bet)
Seat 6: 4ec6caba collected ($0.25)


Poker Hand #RC1459953130: Hold'em No Limit  ($0.05/$0.1) - 2023/04/08 21:28:42
Table 'RushAndCash3788390' 6-max Seat #1 is the button
Seat 1: Hero ($6.26 in chips)
Seat 2: 587a017c ($104.19 in chips)
Seat 3: cf0fd6d6 ($12.33 in chips)
Seat 4: 3ad6bdfe ($8.86 in chips)
Seat 5: 3f9fe36d ($12.18 in chips)
Seat 6: ace67604 ($10 in chips)
587a017c: posts small blind $0.05
cf0fd6d6: posts big blind $0.1
*** HOLE CARDS ***
Dealt to Hero [2d 2c]
Dealt to 587a017c 
Dealt to cf0fd6d6 
Dealt to 3ad6bdfe 
Dealt to 3f9fe36d 
Dealt to ace67604 
3ad6bdfe: raises $0.15 to $0.25
3f9fe36d: folds
ace67604: folds
Hero: folds
587a017c: folds
cf0fd6d6: folds
Uncalled bet ($0.15) returned to 3ad6bdfe
*** SHOWDOWN ***
3ad6bdfe collected $0.25 from pot
*** SUMMARY ***
Total pot $0.25 | Rake $0 | Jackpot $0 | Bingo $0 | Fortune $0
Seat 1: Hero (button) folded before Flop (didn't bet)
Seat 2: 587a017c (small blind) folded before Flop
Seat 3: cf0fd6d6 (big blind) folded before Flop
Seat 4: 3ad6bdfe collected ($0.25)
Seat 5: 3f9fe36d folded before Flop (didn't bet)
Seat 6: ace67604 folded before Flop (didn't bet)


Poker Hand #RC1459953086: Hold'em No Limit  ($0.05/$0.1) - 2023/04/08 21:28:34
Table 'RushAndCash3788346' 6-max Seat #1 is the button
Seat 1: db15d716 ($26.22 in chips)
Seat 2: 700cd47d ($11.48 in chips)
Seat 3: 8d5340db ($12.25 in chips)
Seat 4: 556685d2 ($41.67 in chips)
Seat 5: 47bd79f0 ($18.73 in chips)
Seat 6: Hero ($6.26 in chips)
700cd47d: posts small blind $0.05
8d5340db: posts big blind $0.1
*** HOLE CARDS ***
Dealt to db15d716 
Dealt to 700cd47d 
Dealt to 8d5340db 
Dealt to 556685d2 
Dealt to 47bd79f0 
Dealt to Hero [4s 8h]
556685d2: folds
47bd79f0: folds
Hero: folds
db15d716: folds
700cd47d: folds
Uncalled bet ($0.05) returned to 8d5340db
*** SHOWDOWN ***
8d5340db collected $0.1 from pot
*** SUMMARY ***
Total pot $0.1 | Rake $0 | Jackpot $0 | Bingo $0 | Fortune $0
Seat 1: db15d716 (button) folded before Flop (didn't bet)
Seat 2: 700cd47d (small blind) folded before Flop
Seat 3: 8d5340db (big blind) collected ($0.1)
Seat 4: 556685d2 folded before Flop (didn't bet)
Seat 5: 47bd79f0 folded before Flop (didn't bet)
Seat 6: Hero folded before Flop (didn't bet)


Poker Hand #RC1459953056: Hold'em No Limit  ($0.05/$0.1) - 2023/04/08 21:28:28
Table 'RushAndCash3788316' 6-max Seat #1 is the button
Seat 1: df76427d ($16.77 in chips)
Seat 2: 79e4f48b ($9.8 in chips)
Seat 3: ada08ebe ($9.46 in chips)
Seat 4: fd16d5f3 ($3.51 in chips)
Seat 5: Hero ($6.26 in chips)
Seat 6: 9dd15c16 ($13.25 in chips)
79e4f48b: posts small blind $0.05
ada08ebe: posts big blind $0.1
*** HOLE CARDS ***
Dealt to df76427d 
Dealt to 79e4f48b 
Dealt to ada08ebe 
Dealt to fd16d5f3 
Dealt to Hero [8c 4s]
Dealt to 9dd15c16 
fd16d5f3: folds
Hero: folds
9dd15c16: raises $0.2 to $0.3
df76427d: folds
79e4f48b: folds
ada08ebe: folds
Uncalled bet ($0.2) returned to 9dd15c16
*** SHOWDOWN ***
9dd15c16 collected $0.25 from pot
*** SUMMARY ***
Total pot $0.25 | Rake $0 | Jackpot $0 | Bingo $0 | Fortune $0
Seat 1: df76427d (button) folded before Flop (didn't bet)
Seat 2: 79e4f48b (small blind) folded before Flop
Seat 3: ada08ebe (big blind) folded before Flop
Seat 4: fd16d5f3 folded before Flop (didn't bet)
Seat 5: Hero folded before Flop (didn't bet)
Seat 6: 9dd15c16 collected ($0.25)


Poker Hand #RC1459953031: Hold'em No Limit  ($0.05/$0.1) - 2023/04/08 21:28:23
Table 'RushAndCash3788291' 6-max Seat #1 is the button
Seat 1: 1a4940d9 ($10.15 in chips)
Seat 2: 63257d79 ($10.73 in chips)
Seat 3: d728232d ($10.87 in chips)
Seat 4: ec70935a ($10.19 in chips)
Seat 5: 60537085 ($10 in chips)
Seat 6: Hero ($6.26 in chips)
63257d79: posts small blind $0.05
d728232d: posts big blind $0.1
*** HOLE CARDS ***
Dealt to 1a4940d9 
Dealt to 63257d79 
Dealt to d728232d 
Dealt to ec70935a 
Dealt to 60537085 
Dealt to Hero [Jh 8h]
ec70935a: folds
60537085: folds
Hero: folds
1a4940d9: folds
63257d79: folds
Uncalled bet ($0.05) returned to d728232d
*** SHOWDOWN ***
d728232d collected $0.1 from pot
*** SUMMARY ***
Total pot $0.1 | Rake $0 | Jackpot $0 | Bingo $0 | Fortune $0
Seat 1: 1a4940d9 (button) folded before Flop (didn't bet)
Seat 2: 63257d79 (small blind) folded before Flop
Seat 3: d728232d (big blind) collected ($0.1)
Seat 4: ec70935a folded before Flop (didn't bet)
Seat 5: 60537085 folded before Flop (didn't bet)
Seat 6: Hero folded before Flop (didn't bet)


Poker Hand #RC1459952985: Hold'em No Limit  ($0.05/$0.1) - 2023/04/08 21:28:14
Table 'RushAndCash3788245' 6-max Seat #1 is the button
Seat 1: 4c13e75f ($10.15 in chips)
Seat 2: 264a43b0 ($13.2 in chips)
Seat 3: Hero ($6.21 in chips)
Seat 4: fcd4bfc4 ($10.19 in chips)
Seat 5: f2e88fdb ($10.49 in chips)
Seat 6: f3cd5dc1 ($14.69 in chips)
264a43b0: posts small blind $0.05
Hero: posts big blind $0.1
*** HOLE CARDS ***
Dealt to 4c13e75f 
Dealt to 264a43b0 
Dealt to Hero [8h 7c]
Dealt to fcd4bfc4 
Dealt to f2e88fdb 
Dealt to f3cd5dc1 
fcd4bfc4: folds
f2e88fdb: folds
f3cd5dc1: folds
4c13e75f: folds
264a43b0: folds
Uncalled bet ($0.05) returned to Hero
*** SHOWDOWN ***
Hero collected $0.1 from pot
*** SUMMARY ***
Total pot $0.1 | Rake $0 | Jackpot $0 | Bingo $0 | Fortune $0
Seat 1: 4c13e75f (button) folded before Flop (didn't bet)
Seat 2: 264a43b0 (small blind) folded before Flop
Seat 3: Hero (big blind) collected ($0.1)
Seat 4: fcd4bfc4 folded before Flop (didn't bet)
Seat 5: f2e88fdb folded before Flop (didn't bet)
Seat 6: f3cd5dc1 folded before Flop (didn't bet)


Poker Hand #RC1459952964: Hold'em No Limit  ($0.05/$0.1) - 2023/04/08 21:28:10
Table 'RushAndCash3788224' 6-max Seat #1 is the button
Seat 1: fcd4bfc4 ($10.19 in chips)
Seat 2: Hero ($6.26 in chips)
Seat 3: 2101b7fa ($31.91 in chips)
Seat 4: 65715b31 ($15.58 in chips)
Seat 5: c0deed59 ($12.32 in chips)
Seat 6: c9c4143d ($9.26 in chips)
Hero: posts small blind $0.05
2101b7fa: posts big blind $0.1
*** HOLE CARDS ***
Dealt to fcd4bfc4 
Dealt to Hero [3h 8h]
Dealt to 2101b7fa 
Dealt to 65715b31 
Dealt to c0deed59 
Dealt to c9c4143d 
65715b31: folds
c0deed59: raises $0.17 to $0.27
c9c4143d: folds
fcd4bfc4: folds
Hero: folds
2101b7fa: folds
Uncalled bet ($0.17) returned to c0deed59
*** SHOWDOWN ***
c0deed59 collected $0.25 from pot
*** SUMMARY ***
Total pot $0.25 | Rake $0 | Jackpot $0 | Bingo $0 | Fortune $0
Seat 1: fcd4bfc4 (button) folded before Flop (didn't bet)
Seat 2: Hero (small blind) folded before Flop
Seat 3: 2101b7fa (big blind) folded before Flop
Seat 4: 65715b31 folded before Flop (didn't bet)
Seat 5: c0deed59 collected ($0.25)
Seat 6: c9c4143d folded before Flop (didn't bet)


Poker Hand #RC1459952899: Hold'em No Limit  ($0.05/$0.1) - 2023/04/08 21:27:59
Table 'RushAndCash3788159' 6-max Seat #1 is the button
Seat 1: 74b2f923 ($11.1 in chips)
Seat 2: 8910adf5 ($9.9 in chips)
Seat 3: 3bfa3e10 ($16.71 in chips)
Seat 4: 89d24b76 ($19.62 in chips)
Seat 5: 2261b544 ($13.69 in chips)
Seat 6: Hero ($6.26 in chips)
8910adf5: posts small blind $0.05
3bfa3e10: posts big blind $0.1
*** HOLE CARDS ***
Dealt to 74b2f923 
Dealt to 8910adf5 
Dealt to 3bfa3e10 
Dealt to 89d24b76 
Dealt to 2261b544 
Dealt to Hero [6h Kd]
89d24b76: raises $0.15 to $0.25
2261b544: folds
Hero: folds
74b2f923: folds
8910adf5: calls $0.2
3bfa3e10: calls $0.15
*** FLOP *** [Qd 3s 8c]
8910adf5: checks
3bfa3e10: checks
89d24b76: checks
*** TURN *** [Qd 3s 8c] [9c]
8910adf5: checks
3bfa3e10: bets $0.5
89d24b76: calls $0.5
8910adf5: folds
*** RIVER *** [Qd 3s 8c 9c] [7c]
3bfa3e10: checks
89d24b76: bets $1.58
3bfa3e10: calls $1.58
89d24b76: shows [Kh Th] (King-High)
3bfa3e10: shows [Td Jc] (Queens-High Straight)
*** SHOWDOWN ***
3bfa3e10 collected $4.53 from pot
*** SUMMARY ***
Total pot $4.91 | Rake $0.23 | Jackpot $0.15 | Bingo $0 | Fortune $0
Board [Qd 3s 8c 9c 7c]
Seat 1: 74b2f923 (button) folded before Flop (didn't bet)
Seat 2: 8910adf5 (small blind) folded on the Turn
Seat 3: 3bfa3e10 (big blind) showed [Td Jc] and won ($4.53) with Queens-High Straight
Seat 4: 89d24b76 showed [Kh Th] and lost with King-High
Seat 5: 2261b544 folded before Flop (didn't bet)
Seat 6: Hero folded before Flop (didn't bet)


Poker Hand #RC1459952862: Hold'em No Limit  ($0.05/$0.1) - 2023/04/08 21:27:52
Table 'RushAndCash3788122' 6-max Seat #1 is the button
Seat 1: cd49688f ($15.92 in chips)
Seat 2: 1ec2747d ($9.9 in chips)
Seat 3: 8a46d84c ($21.63 in chips)
Seat 4: 95c94948 ($22.2 in chips)
Seat 5: Hero ($6.26 in chips)
Seat 6: 3fdcb188 ($17.5 in chips)
1ec2747d: posts small blind $0.05
8a46d84c: posts big blind $0.1
*** HOLE CARDS ***
Dealt to cd49688f 
Dealt to 1ec2747d 
Dealt to 8a46d84c 
Dealt to 95c94948 
Dealt to Hero [Js 6s]
Dealt to 3fdcb188 
95c94948: folds
Hero: folds
3fdcb188: folds
cd49688f: raises $0.15 to $0.25
1ec2747d: calls $0.2
8a46d84c: folds
*** FLOP *** [Qs 2c Ah]
1ec2747d: checks
cd49688f: checks
*** TURN *** [Qs 2c Ah] [7s]
1ec2747d: checks
cd49688f: checks
*** RIVER *** [Qs 2c Ah 7s] [Qd]
1ec2747d: checks
cd49688f: checks
1ec2747d: shows [Tc Kc] (Pair of Queens)
cd49688f: shows [8c Ks] (Pair of Queens)
*** SHOWDOWN ***
1ec2747d collected $0.57 from pot
*** SUMMARY ***
Total pot $0.6 | Rake $0.03 | Jackpot $0 | Bingo $0 | Fortune $0
Board [Qs 2c Ah 7s Qd]
Seat 1: cd49688f (button) showed [8c Ks] and lost with Pair of Queens
Seat 2: 1ec2747d (small blind) showed [Tc Kc] and won ($0.57) with Pair of Queens
Seat 3: 8a46d84c (big blind) folded before Flop
Seat 4: 95c94948 folded before Flop (didn't bet)
Seat 5: Hero folded before Flop (didn't bet)
Seat 6: 3fdcb188 folded before Flop (didn't bet)


Poker Hand #RC1459952794: Hold'em No Limit  ($0.05/$0.1) - 2023/04/08 21:27:38
Table 'RushAndCash3788054' 6-max Seat #1 is the button
Seat 1: 5489eecc ($31.9 in chips)
Seat 2: Hero ($6.31 in chips)
Seat 3: fe74b7c3 ($19.09 in chips)
Seat 4: 5b3db7f5 ($10 in chips)
Seat 5: 82827b54 ($11.6 in chips)
Seat 6: 9bd24777 ($10 in chips)
Hero: posts small blind $0.05
fe74b7c3: posts big blind $0.1
*** HOLE CARDS ***
Dealt to 5489eecc 
Dealt to Hero [8c 7c]
Dealt to fe74b7c3 
Dealt to 5b3db7f5 
Dealt to 82827b54 
Dealt to 9bd24777 
5b3db7f5: raises $0.13 to $0.23
82827b54: folds
9bd24777: folds
5489eecc: folds
Hero: folds
fe74b7c3: folds
Uncalled bet ($0.13) returned to 5b3db7f5
*** SHOWDOWN ***
5b3db7f5 collected $0.25 from pot
*** SUMMARY ***
Total pot $0.25 | Rake $0 | Jackpot $0 | Bingo $0 | Fortune $0
Seat 1: 5489eecc (button) folded before Flop (didn't bet)
Seat 2: Hero (small blind) folded before Flop
Seat 3: fe74b7c3 (big blind) folded before Flop
Seat 4: 5b3db7f5 collected ($0.25)
Seat 5: 82827b54 folded before Flop (didn't bet)
Seat 6: 9bd24777 folded before Flop (didn't bet)


Poker Hand #RC1459952731: Hold'em No Limit  ($0.05/$0.1) - 2023/04/08 21:27:27
Table 'RushAndCash3787991' 6-max Seat #1 is the button
Seat 1: 5ef07beb ($52.25 in chips)
Seat 2: 70de75aa ($9.9 in chips)
Seat 3: Hero ($6.41 in chips)
Seat 4: f8847b43 ($29.66 in chips)
Seat 5: 63257d79 ($10.98 in chips)
Seat 6: 8f6da20c ($12.99 in chips)
70de75aa: posts small blind $0.05
Hero: posts big blind $0.1
*** HOLE CARDS ***
Dealt to 5ef07beb 
Dealt to 70de75aa 
Dealt to Hero [5h Kc]
Dealt to f8847b43 
Dealt to 63257d79 
Dealt to 8f6da20c 
f8847b43: raises $0.15 to $0.25
63257d79: folds
8f6da20c: folds
5ef07beb: calls $0.25
70de75aa: folds
Hero: folds
*** FLOP *** [Qd 3c Th]
f8847b43: checks
5ef07beb: checks
*** TURN *** [Qd 3c Th] [Js]
f8847b43: bets $0.22
5ef07beb: calls $0.22
*** RIVER *** [Qd 3c Th Js] [9c]
f8847b43: bets $0.55
5ef07beb: calls $0.55
f8847b43: shows [Kh Ks] (Kings-High Straight)
5ef07beb: shows [6d Kd] (Kings-High Straight)
*** SHOWDOWN ***
f8847b43 collected $1.05 from pot
5ef07beb collected $1.04 from pot
*** SUMMARY ***
Total pot $2.19 | Rake $0.1 | Jackpot $0 | Bingo $0 | Fortune $0
Board [Qd 3c Th Js 9c]
Seat 1: 5ef07beb (button) showed [6d Kd] and won ($1.04) with Kings-High Straight
Seat 2: 70de75aa (small blind) folded before Flop
Seat 3: Hero (big blind) folded before Flop
Seat 4: f8847b43 showed [Kh Ks] and won ($1.05) with Kings-High Straight
Seat 5: 63257d79 folded before Flop (didn't bet)
Seat 6: 8f6da20c folded before Flop (didn't bet)


Poker Hand #RC1459952707: Hold'em No Limit  ($0.05/$0.1) - 2023/04/08 21:27:22
Table 'RushAndCash3787967' 6-max Seat #1 is the button
Seat 1: Hero ($6.41 in chips)
Seat 2: eb1406b7 ($10.28 in chips)
Seat 3: 900b9cb4 ($10 in chips)
Seat 4: c57a3d6 ($15.64 in chips)
Seat 5: 31782351 ($36.44 in chips)
Seat 6: 4898d3fb ($10 in chips)
eb1406b7: posts small blind $0.05
900b9cb4: posts big blind $0.1
*** HOLE CARDS ***
Dealt to Hero [8c 6h]
Dealt to eb1406b7 
Dealt to 900b9cb4 
Dealt to c57a3d6 
Dealt to 31782351 
Dealt to 4898d3fb 
c57a3d6: folds
31782351: raises $0.1 to $0.2
4898d3fb: folds
Hero: folds
eb1406b7: folds
900b9cb4: folds
Uncalled bet ($0.1) returned to 31782351
*** SHOWDOWN ***
31782351 collected $0.25 from pot
*** SUMMARY ***
Total pot $0.25 | Rake $0 | Jackpot $0 | Bingo $0 | Fortune $0
Seat 1: Hero (button) folded before Flop (didn't bet)
Seat 2: eb1406b7 (small blind) folded before Flop
Seat 3: 900b9cb4 (big blind) folded before Flop
Seat 4: c57a3d6 folded before Flop (didn't bet)
Seat 5: 31782351 collected ($0.25)
Seat 6: 4898d3fb folded before Flop (didn't bet)


Poker Hand #RC1459952590: Hold'em No Limit  ($0.05/$0.1) - 2023/04/08 21:27:00
Table 'RushAndCash3787850' 6-max Seat #1 is the button
Seat 1: 47a149bb ($10.52 in chips)
Seat 2: Hero ($6.31 in chips)
Seat 3: 78269ebc ($14.77 in chips)
Seat 4: a02f13bb ($41.19 in chips)
Seat 5: 55e63fc7 ($10 in chips)
Seat 6: 7800aeef ($10 in chips)
Hero: posts small blind $0.05
78269ebc: posts big blind $0.1
*** HOLE CARDS ***
Dealt to 47a149bb 
Dealt to Hero [Td Qs]
Dealt to 78269ebc 
Dealt to a02f13bb 
Dealt to 55e63fc7 
Dealt to 7800aeef 
a02f13bb: folds
55e63fc7: folds
7800aeef: folds
47a149bb: folds
Hero: raises $0.2 to $0.3
78269ebc: folds
Uncalled bet ($0.2) returned to Hero
*** SHOWDOWN ***
Hero collected $0.2 from pot
*** SUMMARY ***
Total pot $0.2 | Rake $0 | Jackpot $0 | Bingo $0 | Fortune $0
Seat 1: 47a149bb (button) folded before Flop (didn't bet)
Seat 2: Hero (small blind) collected ($0.2)
Seat 3: 78269ebc (big blind) folded before Flop
Seat 4: a02f13bb folded before Flop (didn't bet)
Seat 5: 55e63fc7 folded before Flop (didn't bet)
Seat 6: 7800aeef folded before Flop (didn't bet)


Poker Hand #RC1459952510: Hold'em No Limit  ($0.05/$0.1) - 2023/04/08 21:26:46
Table 'RushAndCash3787770' 6-max Seat #1 is the button
Seat 1: b8ae2cb ($23.38 in chips)
Seat 2: 23cd8cbf ($7.67 in chips)
Seat 3: 75972b39 ($6.55 in chips)
Seat 4: Hero ($6.31 in chips)
Seat 5: 3bfa3e10 ($16.71 in chips)
Seat 6: d436350b ($17.29 in chips)
23cd8cbf: posts small blind $0.05
75972b39: posts big blind $0.1
*** HOLE CARDS ***
Dealt to b8ae2cb 
Dealt to 23cd8cbf 
Dealt to 75972b39 
Dealt to Hero [Kc 2c]
Dealt to 3bfa3e10 
Dealt to d436350b 
Hero: folds
3bfa3e10: folds
d436350b: folds
b8ae2cb: folds
23cd8cbf: raises $0.3 to $0.4
75972b39: folds
Uncalled bet ($0.3) returned to 23cd8cbf
*** SHOWDOWN ***
23cd8cbf collected $0.2 from pot
*** SUMMARY ***
Total pot $0.2 | Rake $0 | Jackpot $0 | Bingo $0 | Fortune $0
Seat 1: b8ae2cb (button) folded before Flop (didn't bet)
Seat 2: 23cd8cbf (small blind) collected ($0.2)
Seat 3: 75972b39 (big blind) folded before Flop
Seat 4: Hero folded before Flop (didn't bet)
Seat 5: 3bfa3e10 folded before Flop (didn't bet)
Seat 6: d436350b folded before Flop (didn't bet)


Poker Hand #RC1459952477: Hold'em No Limit  ($0.05/$0.1) - 2023/04/08 21:26:40
Table 'RushAndCash3787737' 6-max Seat #1 is the button
Seat 1: 39c1fa2c ($30.3 in chips)
Seat 2: 98569319 ($11.4 in chips)
Seat 3: 9b77a3cc ($10.51 in chips)
Seat 4: Hero ($6.31 in chips)
Seat 5: e18a2bbd ($9.12 in chips)
Seat 6: 85efbf4d ($7.97 in chips)
98569319: posts small blind $0.05
9b77a3cc: posts big blind $0.1
*** HOLE CARDS ***
Dealt to 39c1fa2c 
Dealt to 98569319 
Dealt to 9b77a3cc 
Dealt to Hero [7h 8s]
Dealt to e18a2bbd 
Dealt to 85efbf4d 
Hero: folds
e18a2bbd: folds
85efbf4d: folds
39c1fa2c: raises $0.15 to $0.25
98569319: folds
9b77a3cc: folds
Uncalled bet ($0.15) returned to 39c1fa2c
*** SHOWDOWN ***
39c1fa2c collected $0.25 from pot
*** SUMMARY ***
Total pot $0.25 | Rake $0 | Jackpot $0 | Bingo $0 | Fortune $0
Seat 1: 39c1fa2c (button) collected ($0.25)
Seat 2: 98569319 (small blind) folded before Flop
Seat 3: 9b77a3cc (big blind) folded before Flop
Seat 4: Hero folded before Flop (didn't bet)
Seat 5: e18a2bbd folded before Flop (didn't bet)
Seat 6: 85efbf4d folded before Flop (didn't bet)


Poker Hand #RC1459952426: Hold'em No Limit  ($0.05/$0.1) - 2023/04/08 21:26:29
Table 'RushAndCash3787686' 6-max Seat #1 is the button
Seat 1: 6a138b47 ($19.56 in chips)
Seat 2: ec70935a ($10.05 in chips)
Seat 3: 5a721ebb ($9.92 in chips)
Seat 4: c75dc099 ($10.62 in chips)
Seat 5: bac4dd05 ($10.18 in chips)
Seat 6: Hero ($6.31 in chips)
ec70935a: posts small blind $0.05
5a721ebb: posts big blind $0.1
*** HOLE CARDS ***
Dealt to 6a138b47 
Dealt to ec70935a 
Dealt to 5a721ebb 
Dealt to c75dc099 
Dealt to bac4dd05 
Dealt to Hero [4c Jd]
c75dc099: folds
bac4dd05: folds
Hero: folds
6a138b47: raises $0.1 to $0.2
ec70935a: folds
5a721ebb: folds
Uncalled bet ($0.1) returned to 6a138b47
*** SHOWDOWN ***
6a138b47 collected $0.25 from pot
*** SUMMARY ***
Total pot $0.25 | Rake $0 | Jackpot $0 | Bingo $0 | Fortune $0
Seat 1: 6a138b47 (button) collected ($0.25)
Seat 2: ec70935a (small blind) folded before Flop
Seat 3: 5a721ebb (big blind) folded before Flop
Seat 4: c75dc099 folded before Flop (didn't bet)
Seat 5: bac4dd05 folded before Flop (didn't bet)
Seat 6: Hero folded before Flop (didn't bet)


Poker Hand #RC1459952403: Hold'em No Limit  ($0.05/$0.1) - 2023/04/08 21:26:24
Table 'RushAndCash3787663' 6-max Seat #1 is the button
Seat 1: 9c133621 ($9.8 in chips)
Seat 2: 17544013 ($10.37 in chips)
Seat 3: a2f36faa ($12.74 in chips)
Seat 4: Hero ($6.31 in chips)
Seat 5: 63257d79 ($11.18 in chips)
Seat 6: 583bb900 ($41.02 in chips)
17544013: posts small blind $0.05
a2f36faa: posts big blind $0.1
*** HOLE CARDS ***
Dealt to 9c133621 
Dealt to 17544013 
Dealt to a2f36faa 
Dealt to Hero [Jd 6h]
Dealt to 63257d79 
Dealt to 583bb900 
Hero: folds
63257d79: folds
583bb900: folds
9c133621: raises $0.1 to $0.2
17544013: folds
a2f36faa: folds
Uncalled bet ($0.1) returned to 9c133621
*** SHOWDOWN ***
9c133621 collected $0.25 from pot
*** SUMMARY ***
Total pot $0.25 | Rake $0 | Jackpot $0 | Bingo $0 | Fortune $0
Seat 1: 9c133621 (button) collected ($0.25)
Seat 2: 17544013 (small blind) folded before Flop
Seat 3: a2f36faa (big blind) folded before Flop
Seat 4: Hero folded before Flop (didn't bet)
Seat 5: 63257d79 folded before Flop (didn't bet)
Seat 6: 583bb900 folded before Flop (didn't bet)


Poker Hand #RC1459952180: Hold'em No Limit  ($0.05/$0.1) - 2023/04/08 21:25:39
Table 'RushAndCash3787440' 6-max Seat #1 is the button
Seat 1: 96844adf ($11.97 in chips)
Seat 2: 6c8c1a78 ($10.75 in chips)
Seat 3: 63257d79 ($10.63 in chips)
Seat 4: d436350b ($17.42 in chips)
Seat 5: 2f12e642 ($5.13 in chips)
Seat 6: Hero ($6.86 in chips)
6c8c1a78: posts small blind $0.05
63257d79: posts big blind $0.1
*** HOLE CARDS ***
Dealt to 96844adf 
Dealt to 6c8c1a78 
Dealt to 63257d79 
Dealt to d436350b 
Dealt to 2f12e642 
Dealt to Hero [Qc Jh]
d436350b: folds
2f12e642: folds
Hero: raises $0.15 to $0.25
96844adf: folds
6c8c1a78: folds
63257d79: calls $0.15
*** FLOP *** [Qs Ks 4c]
63257d79: checks
Hero: checks
*** TURN *** [Qs Ks 4c] [6h]
63257d79: bets $0.3
Hero: calls $0.3
*** RIVER *** [Qs Ks 4c 6h] [3d]
63257d79: checks
Hero: checks
63257d79: shows [Kc Jc] (Pair of Kings)
Hero: shows [Qc Jh] (Pair of Queens)
*** SHOWDOWN ***
63257d79 collected $1.1 from pot
*** SUMMARY ***
Total pot $1.15 | Rake $0.05 | Jackpot $0 | Bingo $0 | Fortune $0
Board [Qs Ks 4c 6h 3d]
Seat 1: 96844adf (button) folded before Flop (didn't bet)
Seat 2: 6c8c1a78 (small blind) folded before Flop
Seat 3: 63257d79 (big blind) showed [Kc Jc] and won ($1.1) with Pair of Kings
Seat 4: d436350b folded before Flop (didn't bet)
Seat 5: 2f12e642 folded before Flop (didn't bet)
Seat 6: Hero showed [Qc Jh] and lost with Pair of Queens


Poker Hand #RC1459952123: Hold'em No Limit  ($0.05/$0.1) - 2023/04/08 21:25:28
Table 'RushAndCash3787383' 6-max Seat #1 is the button
Seat 1: 71d28e01 ($8.14 in chips)
Seat 2: f3cd5dc1 ($10.83 in chips)
Seat 3: Hero ($6.96 in chips)
Seat 4: d3b518cb ($2.71 in chips)
Seat 5: 69f90ce5 ($22.11 in chips)
Seat 6: 147c2132 ($10.52 in chips)
f3cd5dc1: posts small blind $0.05
Hero: posts big blind $0.1
*** HOLE CARDS ***
Dealt to 71d28e01 
Dealt to f3cd5dc1 
Dealt to Hero [8c 5c]
Dealt to d3b518cb 
Dealt to 69f90ce5 
Dealt to 147c2132 
d3b518cb: folds
69f90ce5: folds
147c2132: folds
71d28e01: folds
f3cd5dc1: raises $0.15 to $0.25
Hero: folds
Uncalled bet ($0.15) returned to f3cd5dc1
*** SHOWDOWN ***
f3cd5dc1 collected $0.2 from pot
*** SUMMARY ***
Total pot $0.2 | Rake $0 | Jackpot $0 | Bingo $0 | Fortune $0
Seat 1: 71d28e01 (button) folded before Flop (didn't bet)
Seat 2: f3cd5dc1 (small blind) collected ($0.2)
Seat 3: Hero (big blind) folded before Flop
Seat 4: d3b518cb folded before Flop (didn't bet)
Seat 5: 69f90ce5 folded before Flop (didn't bet)
Seat 6: 147c2132 folded before Flop (didn't bet)


Poker Hand #RC1459951923: Hold'em No Limit  ($0.05/$0.1) - 2023/04/08 21:24:52
Table 'RushAndCash3787183' 6-max Seat #1 is the button
Seat 1: 6a138b47 ($20.11 in chips)
Seat 2: ada08ebe ($11.74 in chips)
Seat 3: f3cd5dc1 ($10.36 in chips)
Seat 4: fd5dd891 ($10.55 in chips)
Seat 5: d92b35c1 ($10 in chips)
Seat 6: Hero ($7.21 in chips)
ada08ebe: posts small blind $0.05
f3cd5dc1: posts big blind $0.1
*** HOLE CARDS ***
Dealt to 6a138b47 
Dealt to ada08ebe 
Dealt to f3cd5dc1 
Dealt to fd5dd891 
Dealt to d92b35c1 
Dealt to Hero [Jd Tc]
fd5dd891: folds
d92b35c1: folds
Hero: raises $0.15 to $0.25
6a138b47: folds
ada08ebe: calls $0.2
f3cd5dc1: raises $0.67 to $0.92
Hero: folds
ada08ebe: folds
Uncalled bet ($0.67) returned to f3cd5dc1
*** SHOWDOWN ***
f3cd5dc1 collected $0.72 from pot
*** SUMMARY ***
Total pot $0.75 | Rake $0.03 | Jackpot $0 | Bingo $0 | Fortune $0
Seat 1: 6a138b47 (button) folded before Flop (didn't bet)
Seat 2: ada08ebe (small blind) folded before Flop
Seat 3: f3cd5dc1 (big blind) collected ($0.72)
Seat 4: fd5dd891 folded before Flop (didn't bet)
Seat 5: d92b35c1 folded before Flop (didn't bet)
Seat 6: Hero folded before Flop


Poker Hand #RC1459951701: Hold'em No Limit  ($0.05/$0.1) - 2023/04/08 21:24:14
Table 'RushAndCash3786961' 6-max Seat #1 is the button
Seat 1: Hero ($7.61 in chips)
Seat 2: 6a138b47 ($19.65 in chips)
Seat 3: 4b62130d ($10 in chips)
Seat 4: 8930d5b0 ($7.03 in chips)
Seat 5: dfe0f72a ($11.71 in chips)
Seat 6: 9c1a67d5 ($4.05 in chips)
6a138b47: posts small blind $0.05
4b62130d: posts big blind $0.1
*** HOLE CARDS ***
Dealt to Hero [2c 2s]
Dealt to 6a138b47 
Dealt to 4b62130d 
Dealt to 8930d5b0 
Dealt to dfe0f72a 
Dealt to 9c1a67d5 
8930d5b0: folds
dfe0f72a: folds
9c1a67d5: folds
Hero: raises $0.15 to $0.25
6a138b47: calls $0.2
4b62130d: folds
*** FLOP *** [8h 3c 3d]
6a138b47: bets $0.15
Hero: calls $0.15
*** TURN *** [8h 3c 3d] [Kd]
6a138b47: bets $0.25
Hero: folds
Uncalled bet ($0.25) returned to 6a138b47
*** SHOWDOWN ***
6a138b47 collected $0.86 from pot
*** SUMMARY ***
Total pot $0.9 | Rake $0.04 | Jackpot $0 | Bingo $0 | Fortune $0
Board [8h 3c 3d Kd]
Seat 1: Hero (button) folded on the Turn
Seat 2: 6a138b47 (small blind) won ($0.86)
Seat 3: 4b62130d (big blind) folded before Flop
Seat 4: 8930d5b0 folded before Flop (didn't bet)
Seat 5: dfe0f72a folded before Flop (didn't bet)
Seat 6: 9c1a67d5 folded before Flop (didn't bet)


Poker Hand #RC1459951436: Hold'em No Limit  ($0.05/$0.1) - 2023/04/08 21:23:26
Table 'RushAndCash3786696' 6-max Seat #1 is the button
Seat 1: 58fb3f0d ($21.7 in chips)
Seat 2: 878660b3 ($10 in chips)
Seat 3: Hero ($7.81 in chips)
Seat 4: 4a52a0a8 ($10.76 in chips)
Seat 5: 909716ea ($33.6 in chips)
Seat 6: f8911afc ($21.44 in chips)
878660b3: posts small blind $0.05
Hero: posts big blind $0.1
*** HOLE CARDS ***
Dealt to 58fb3f0d 
Dealt to 878660b3 
Dealt to Hero [Ad 5c]
Dealt to 4a52a0a8 
Dealt to 909716ea 
Dealt to f8911afc 
4a52a0a8: raises $0.1 to $0.2
909716ea: folds
f8911afc: folds
58fb3f0d: folds
878660b3: folds
Hero: calls $0.1
*** FLOP *** [4s 8h Qs]
Hero: checks
4a52a0a8: bets $0.23
Hero: folds
Uncalled bet ($0.23) returned to 4a52a0a8
*** SHOWDOWN ***
4a52a0a8 collected $0.43 from pot
*** SUMMARY ***
Total pot $0.45 | Rake $0.02 | Jackpot $0 | Bingo $0 | Fortune $0
Board [4s 8h Qs]
Seat 1: 58fb3f0d (button) folded before Flop (didn't bet)
Seat 2: 878660b3 (small blind) folded before Flop
Seat 3: Hero (big blind) folded on the Flop
Seat 4: 4a52a0a8 won ($0.43)
Seat 5: 909716ea folded before Flop (didn't bet)
Seat 6: f8911afc folded before Flop (didn't bet)


Poker Hand #RC1459951402: Hold'em No Limit  ($0.05/$0.1) - 2023/04/08 21:23:20
Table 'RushAndCash3786662' 6-max Seat #1 is the button
Seat 1: 82c97636 ($18.79 in chips)
Seat 2: 10af315d ($8.99 in chips)
Seat 3: a5829bf8 ($10.84 in chips)
Seat 4: 878660b3 ($10 in chips)
Seat 5: 147c2132 ($12.24 in chips)
Seat 6: Hero ($7.81 in chips)
10af315d: posts small blind $0.05
a5829bf8: posts big blind $0.1
*** HOLE CARDS ***
Dealt to 82c97636 
Dealt to 10af315d 
Dealt to a5829bf8 
Dealt to 878660b3 
Dealt to 147c2132 
Dealt to Hero [Td 7h]
878660b3: folds
147c2132: raises $0.15 to $0.25
Hero: folds
82c97636: calls $0.25
10af315d: folds
a5829bf8: folds
*** FLOP *** [2s Jd 5d]
147c2132: checks
82c97636: checks
*** TURN *** [2s Jd 5d] [Ks]
147c2132: bets $0.33
82c97636: raises $0.99 to $1.32
147c2132: calls $0.99
*** RIVER *** [2s Jd 5d Ks] [9h]
147c2132: checks
82c97636: bets $4.8
147c2132: folds
Uncalled bet ($4.8) returned to 82c97636
*** SHOWDOWN ***
82c97636 collected $2.99 from pot
*** SUMMARY ***
Total pot $3.29 | Rake $0.15 | Jackpot $0.15 | Bingo $0 | Fortune $0
Board [2s Jd 5d Ks 9h]
Seat 1: 82c97636 (button) won ($2.99)
Seat 2: 10af315d (small blind) folded before Flop
Seat 3: a5829bf8 (big blind) folded before Flop
Seat 4: 878660b3 folded before Flop (didn't bet)
Seat 5: 147c2132 folded on the River
Seat 6: Hero folded before Flop (didn't bet)


Poker Hand #RC1459951367: Hold'em No Limit  ($0.05/$0.1) - 2023/04/08 21:23:13
Table 'RushAndCash3786627' 6-max Seat #1 is the button
Seat 1: 7800aeef ($10.15 in chips)
Seat 2: 1353b9bd ($10.37 in chips)
Seat 3: Hero ($7.91 in chips)
Seat 4: 264a43b0 ($12.85 in chips)
Seat 5: db15d716 ($28.06 in chips)
Seat 6: 70cd5c03 ($14.55 in chips)
1353b9bd: posts small blind $0.05
Hero: posts big blind $0.1
*** HOLE CARDS ***
Dealt to 7800aeef 
Dealt to 1353b9bd 
Dealt to Hero [8d Js]
Dealt to 264a43b0 
Dealt to db15d716 
Dealt to 70cd5c03 
264a43b0: folds
db15d716: folds
70cd5c03: folds
7800aeef: folds
1353b9bd: raises $0.15 to $0.25
Hero: folds
Uncalled bet ($0.15) returned to 1353b9bd
*** SHOWDOWN ***
1353b9bd collected $0.2 from pot
*** SUMMARY ***
Total pot $0.2 | Rake $0 | Jackpot $0 | Bingo $0 | Fortune $0
Seat 1: 7800aeef (button) folded before Flop (didn't bet)
Seat 2: 1353b9bd (small blind) collected ($0.2)
Seat 3: Hero (big blind) folded before Flop
Seat 4: 264a43b0 folded before Flop (didn't bet)
Seat 5: db15d716 folded before Flop (didn't bet)
Seat 6: 70cd5c03 folded before Flop (didn't bet)


Poker Hand #RC1459951275: Hold'em No Limit  ($0.05/$0.1) - 2023/04/08 21:22:57
Table 'RushAndCash3786535' 6-max Seat #1 is the button
Seat 1: 922b54b ($12.05 in chips)
Seat 2: Hero ($7.96 in chips)
Seat 3: 683b66d2 ($16.19 in chips)
Seat 4: 6737e568 ($10.23 in chips)
Seat 5: b17673e1 ($14.26 in chips)
Seat 6: b6746050 ($81.44 in chips)
Hero: posts small blind $0.05
683b66d2: posts big blind $0.1
*** HOLE CARDS ***
Dealt to 922b54b 
Dealt to Hero [3s Kc]
Dealt to 683b66d2 
Dealt to 6737e568 
Dealt to b17673e1 
Dealt to b6746050 
6737e568: folds
b17673e1: folds
b6746050: folds
922b54b: folds
Hero: folds
Uncalled bet ($0.05) returned to 683b66d2
*** SHOWDOWN ***
683b66d2 collected $0.1 from pot
*** SUMMARY ***
Total pot $0.1 | Rake $0 | Jackpot $0 | Bingo $0 | Fortune $0
Seat 1: 922b54b (button) folded before Flop (didn't bet)
Seat 2: Hero (small blind) folded before Flop
Seat 3: 683b66d2 (big blind) collected ($0.1)
Seat 4: 6737e568 folded before Flop (didn't bet)
Seat 5: b17673e1 folded before Flop (didn't bet)
Seat 6: b6746050 folded before Flop (didn't bet)


Poker Hand #RC1459951142: Hold'em No Limit  ($0.05/$0.1) - 2023/04/08 21:22:34
Table 'RushAndCash3786402' 6-max Seat #1 is the button
Seat 1: c3d0bc2b ($10.15 in chips)
Seat 2: 92640b5c ($10.98 in chips)
Seat 3: 50f2bcd ($9.72 in chips)
Seat 4: 66fcdeab ($11.64 in chips)
Seat 5: f4a9c82c ($10.15 in chips)
Seat 6: Hero ($7.96 in chips)
92640b5c: posts small blind $0.05
50f2bcd: posts big blind $0.1
*** HOLE CARDS ***
Dealt to c3d0bc2b 
Dealt to 92640b5c 
Dealt to 50f2bcd 
Dealt to 66fcdeab 
Dealt to f4a9c82c 
Dealt to Hero [2c Jh]
66fcdeab: folds
f4a9c82c: folds
Hero: folds
c3d0bc2b: folds
92640b5c: folds
Uncalled bet ($0.05) returned to 50f2bcd
*** SHOWDOWN ***
50f2bcd collected $0.1 from pot
*** SUMMARY ***
Total pot $0.1 | Rake $0 | Jackpot $0 | Bingo $0 | Fortune $0
Seat 1: c3d0bc2b (button) folded before Flop (didn't bet)
Seat 2: 92640b5c (small blind) folded before Flop
Seat 3: 50f2bcd (big blind) collected ($0.1)
Seat 4: 66fcdeab folded before Flop (didn't bet)
Seat 5: f4a9c82c folded before Flop (didn't bet)
Seat 6: Hero folded before Flop (didn't bet)


Poker Hand #RC1459950889: Hold'em No Limit  ($0.05/$0.1) - 2023/04/08 21:21:51
Table 'RushAndCash3786149' 6-max Seat #1 is the button
Seat 1: Hero ($8.75 in chips)
Seat 2: 4a52a0a8 ($10.91 in chips)
Seat 3: e534119 ($10.2 in chips)
Seat 4: 9e5cd98c ($5 in chips)
Seat 5: 597b09ac ($9.57 in chips)
Seat 6: 66fcdeab ($10.78 in chips)
4a52a0a8: posts small blind $0.05
e534119: posts big blind $0.1
*** HOLE CARDS ***
Dealt to Hero [7d 7h]
Dealt to 4a52a0a8 
Dealt to e534119 
Dealt to 9e5cd98c 
Dealt to 597b09ac 
Dealt to 66fcdeab 
9e5cd98c: folds
597b09ac: folds
66fcdeab: raises $0.15 to $0.25
Hero: raises $0.54 to $0.79
4a52a0a8: folds
e534119: folds
66fcdeab: raises $1.16 to $1.95
Hero: folds
Uncalled bet ($1.16) returned to 66fcdeab
*** SHOWDOWN ***
66fcdeab collected $1.65 from pot
*** SUMMARY ***
Total pot $1.73 | Rake $0.08 | Jackpot $0 | Bingo $0 | Fortune $0
Seat 1: Hero (button) folded before Flop
Seat 2: 4a52a0a8 (small blind) folded before Flop
Seat 3: e534119 (big blind) folded before Flop
Seat 4: 9e5cd98c folded before Flop (didn't bet)
Seat 5: 597b09ac folded before Flop (didn't bet)
Seat 6: 66fcdeab collected ($1.65)


Poker Hand #RC1459950809: Hold'em No Limit  ($0.05/$0.1) - 2023/04/08 21:21:38
Table 'RushAndCash3786069' 6-max Seat #1 is the button
Seat 1: a331059d ($10.15 in chips)
Seat 2: f9cc9468 ($12.29 in chips)
Seat 3: b60787b3 ($10.28 in chips)
Seat 4: 3dbb79e7 ($9.4 in chips)
Seat 5: 9022b505 ($10 in chips)
Seat 6: Hero ($8.75 in chips)
f9cc9468: posts small blind $0.05
b60787b3: posts big blind $0.1
*** HOLE CARDS ***
Dealt to a331059d 
Dealt to f9cc9468 
Dealt to b60787b3 
Dealt to 3dbb79e7 
Dealt to 9022b505 
Dealt to Hero [Qc 5d]
3dbb79e7: folds
9022b505: folds
Hero: folds
a331059d: folds
f9cc9468: raises $0.1 to $0.2
b60787b3: folds
Uncalled bet ($0.1) returned to f9cc9468
*** SHOWDOWN ***
f9cc9468 collected $0.2 from pot
*** SUMMARY ***
Total pot $0.2 | Rake $0 | Jackpot $0 | Bingo $0 | Fortune $0
Seat 1: a331059d (button) folded before Flop (didn't bet)
Seat 2: f9cc9468 (small blind) collected ($0.2)
Seat 3: b60787b3 (big blind) folded before Flop
Seat 4: 3dbb79e7 folded before Flop (didn't bet)
Seat 5: 9022b505 folded before Flop (didn't bet)
Seat 6: Hero folded before Flop (didn't bet)


Poker Hand #RC1459950707: Hold'em No Limit  ($0.05/$0.1) - 2023/04/08 21:21:20
Table 'RushAndCash3785967' 6-max Seat #1 is the button
Seat 1: 6c98edc ($15.05 in chips)
Seat 2: ec14ff9f ($9.45 in chips)
Seat 3: 3bfa3e10 ($17.22 in chips)
Seat 4: 41a252da ($13.13 in chips)
Seat 5: 73388517 ($8.8 in chips)
Seat 6: Hero ($8.6 in chips)
ec14ff9f: posts small blind $0.05
3bfa3e10: posts big blind $0.1
*** HOLE CARDS ***
Dealt to 6c98edc 
Dealt to ec14ff9f 
Dealt to 3bfa3e10 
Dealt to 41a252da 
Dealt to 73388517 
Dealt to Hero [Qh Ah]
41a252da: folds
73388517: folds
Hero: raises $0.15 to $0.25
6c98edc: folds
ec14ff9f: folds
3bfa3e10: folds
Uncalled bet ($0.15) returned to Hero
*** SHOWDOWN ***
Hero collected $0.25 from pot
*** SUMMARY ***
Total pot $0.25 | Rake $0 | Jackpot $0 | Bingo $0 | Fortune $0
Seat 1: 6c98edc (button) folded before Flop (didn't bet)
Seat 2: ec14ff9f (small blind) folded before Flop
Seat 3: 3bfa3e10 (big blind) folded before Flop
Seat 4: 41a252da folded before Flop (didn't bet)
Seat 5: 73388517 folded before Flop (didn't bet)
Seat 6: Hero collected ($0.25)


Poker Hand #RC1459950679: Hold'em No Limit  ($0.05/$0.1) - 2023/04/08 21:21:16
Table 'RushAndCash3785939' 6-max Seat #1 is the button
Seat 1: 169f7bd0 ($13.91 in chips)
Seat 2: Hero ($8.65 in chips)
Seat 3: 1dc33ced ($10.45 in chips)
Seat 4: b60787b3 ($10.28 in chips)
Seat 5: b7d9ddcf ($10.15 in chips)
Seat 6: 902be4f1 ($11.64 in chips)
Hero: posts small blind $0.05
1dc33ced: posts big blind $0.1
*** HOLE CARDS ***
Dealt to 169f7bd0 
Dealt to Hero [5s 2c]
Dealt to 1dc33ced 
Dealt to b60787b3 
Dealt to b7d9ddcf 
Dealt to 902be4f1 
b60787b3: folds
b7d9ddcf: folds
902be4f1: folds
169f7bd0: raises $0.15 to $0.25
Hero: folds
1dc33ced: folds
Uncalled bet ($0.15) returned to 169f7bd0
*** SHOWDOWN ***
169f7bd0 collected $0.25 from pot
*** SUMMARY ***
Total pot $0.25 | Rake $0 | Jackpot $0 | Bingo $0 | Fortune $0
Seat 1: 169f7bd0 (button) collected ($0.25)
Seat 2: Hero (small blind) folded before Flop
Seat 3: 1dc33ced (big blind) folded before Flop
Seat 4: b60787b3 folded before Flop (didn't bet)
Seat 5: b7d9ddcf folded before Flop (didn't bet)
Seat 6: 902be4f1 folded before Flop (didn't bet)


Poker Hand #RC1459950646: Hold'em No Limit  ($0.05/$0.1) - 2023/04/08 21:21:11
Table 'RushAndCash3785906' 6-max Seat #1 is the button
Seat 1: Hero ($8.65 in chips)
Seat 2: 7fe7efea ($10 in chips)
Seat 3: 3b57852c ($32.01 in chips)
Seat 4: a0b5d1f3 ($26.15 in chips)
Seat 5: 5061f0c8 ($10 in chips)
Seat 6: 9a5b2022 ($10.58 in chips)
7fe7efea: posts small blind $0.05
3b57852c: posts big blind $0.1
*** HOLE CARDS ***
Dealt to Hero [8c Js]
Dealt to 7fe7efea 
Dealt to 3b57852c 
Dealt to a0b5d1f3 
Dealt to 5061f0c8 
Dealt to 9a5b2022 
a0b5d1f3: folds
5061f0c8: folds
9a5b2022: folds
Hero: folds
7fe7efea: raises $0.15 to $0.25
3b57852c: calls $0.15
*** FLOP *** [Qd Th 5d]
7fe7efea: bets $0.26
3b57852c: calls $0.26
*** TURN *** [Qd Th 5d] [2h]
7fe7efea: bets $0.63
3b57852c: calls $0.63
*** RIVER *** [Qd Th 5d 2h] [9d]
7fe7efea: checks
3b57852c: bets $1.71
7fe7efea: raises $7.15 to $8.86 and is all-in
3b57852c: calls $7.15
7fe7efea: shows [Kh Ad] (Ace-High)
3b57852c: shows [6d Jd] (Queen High Flush)
*** SHOWDOWN ***
3b57852c collected $19.55 from pot
*** SUMMARY ***
Total pot $20 | Rake $0.3 | Jackpot $0.15 | Bingo $0 | Fortune $0
Board [Qd Th 5d 2h 9d]
Seat 1: Hero (button) folded before Flop (didn't bet)
Seat 2: 7fe7efea (small blind) showed [Kh Ad] and lost with Ace-High
Seat 3: 3b57852c (big blind) showed [6d Jd] and won ($19.55) with Queen High Flush
Seat 4: a0b5d1f3 folded before Flop (didn't bet)
Seat 5: 5061f0c8 folded before Flop (didn't bet)
Seat 6: 9a5b2022 folded before Flop (didn't bet)


Poker Hand #RC1459950620: Hold'em No Limit  ($0.05/$0.1) - 2023/04/08 21:21:05
Table 'RushAndCash3785880' 6-max Seat #1 is the button
Seat 1: 70cd5c03 ($14.48 in chips)
Seat 2: 30a6792d ($10.05 in chips)
Seat 3: 974620e8 ($14.23 in chips)
Seat 4: ff1b66c8 ($2.1 in chips)
Seat 5: 7eed5c57 ($14.2 in chips)
Seat 6: Hero ($8.65 in chips)
30a6792d: posts small blind $0.05
974620e8: posts big blind $0.1
*** HOLE CARDS ***
Dealt to 70cd5c03 
Dealt to 30a6792d 
Dealt to 974620e8 
Dealt to ff1b66c8 
Dealt to 7eed5c57 
Dealt to Hero [Js 6h]
ff1b66c8: folds
7eed5c57: folds
Hero: folds
70cd5c03: raises $0.2 to $0.3
30a6792d: raises $0.9 to $1.2
974620e8: folds
70cd5c03: folds
Uncalled bet ($0.9) returned to 30a6792d
*** SHOWDOWN ***
30a6792d collected $0.67 from pot
*** SUMMARY ***
Total pot $0.7 | Rake $0.03 | Jackpot $0 | Bingo $0 | Fortune $0
Seat 1: 70cd5c03 (button) folded before Flop
Seat 2: 30a6792d (small blind) collected ($0.67)
Seat 3: 974620e8 (big blind) folded before Flop
Seat 4: ff1b66c8 folded before Flop (didn't bet)
Seat 5: 7eed5c57 folded before Flop (didn't bet)
Seat 6: Hero folded before Flop (didn't bet)


Poker Hand #RC1459950338: Hold'em No Limit  ($0.05/$0.1) - 2023/04/08 21:20:10
Table 'RushAndCash3785598' 6-max Seat #1 is the button
Seat 1: 78269ebc ($12.97 in chips)
Seat 2: 3b57852c ($32.76 in chips)
Seat 3: Hero ($7.69 in chips)
Seat 4: 2f7d31ea ($10.32 in chips)
Seat 5: 11fbee3d ($10 in chips)
Seat 6: ff1b66c8 ($2.25 in chips)
3b57852c: posts small blind $0.05
Hero: posts big blind $0.1
*** HOLE CARDS ***
Dealt to 78269ebc 
Dealt to 3b57852c 
Dealt to Hero [Tc Ac]
Dealt to 2f7d31ea 
Dealt to 11fbee3d 
Dealt to ff1b66c8 
2f7d31ea: folds
11fbee3d: folds
ff1b66c8: raises $0.2 to $0.3
78269ebc: folds
3b57852c: calls $0.25
Hero: calls $0.2
*** FLOP *** [6c Ah 7h]
3b57852c: checks
Hero: bets $0.45
ff1b66c8: folds
3b57852c: calls $0.45
*** TURN *** [6c Ah 7h] [Jd]
3b57852c: checks
Hero: bets $0.9
3b57852c: folds
Uncalled bet ($0.9) returned to Hero
*** SHOWDOWN ***
Hero collected $1.71 from pot
*** SUMMARY ***
Total pot $1.8 | Rake $0.09 | Jackpot $0 | Bingo $0 | Fortune $0
Board [6c Ah 7h Jd]
Seat 1: 78269ebc (button) folded before Flop (didn't bet)
Seat 2: 3b57852c (small blind) folded on the Turn
Seat 3: Hero (big blind) won ($1.71)
Seat 4: 2f7d31ea folded before Flop (didn't bet)
Seat 5: 11fbee3d folded before Flop (didn't bet)
Seat 6: ff1b66c8 folded on the Flop


Poker Hand #RC1459950310: Hold'em No Limit  ($0.05/$0.1) - 2023/04/08 21:20:05
Table 'RushAndCash3785570' 6-max Seat #1 is the button
Seat 1: 556685d2 ($43.07 in chips)
Seat 2: 9a235145 ($66.42 in chips)
Seat 3: 8f9f7b9e ($10 in chips)
Seat 4: Hero ($7.69 in chips)
Seat 5: 7e2cd429 ($10.6 in chips)
Seat 6: 43e4ec83 ($10.08 in chips)
9a235145: posts small blind $0.05
8f9f7b9e: posts big blind $0.1
*** HOLE CARDS ***
Dealt to 556685d2 
Dealt to 9a235145 
Dealt to 8f9f7b9e 
Dealt to Hero [6c As]
Dealt to 7e2cd429 
Dealt to 43e4ec83 
Hero: folds
7e2cd429: folds
43e4ec83: folds
556685d2: folds
9a235145: folds
Uncalled bet ($0.05) returned to 8f9f7b9e
*** SHOWDOWN ***
8f9f7b9e collected $0.1 from pot
*** SUMMARY ***
Total pot $0.1 | Rake $0 | Jackpot $0 | Bingo $0 | Fortune $0
Seat 1: 556685d2 (button) folded before Flop (didn't bet)
Seat 2: 9a235145 (small blind) folded before Flop
Seat 3: 8f9f7b9e (big blind) collected ($0.1)
Seat 4: Hero folded before Flop (didn't bet)
Seat 5: 7e2cd429 folded before Flop (didn't bet)
Seat 6: 43e4ec83 folded before Flop (didn't bet)


Poker Hand #RC1459950273: Hold'em No Limit  ($0.05/$0.1) - 2023/04/08 21:19:59
Table 'RushAndCash3785533' 6-max Seat #1 is the button
Seat 1: 3f5172f1 ($9.4 in chips)
Seat 2: db15d716 ($26.4 in chips)
Seat 3: 61911ab2 ($10 in chips)
Seat 4: e34f410c ($29.56 in chips)
Seat 5: Hero ($7.69 in chips)
Seat 6: b6746050 ($81.61 in chips)
db15d716: posts small blind $0.05
61911ab2: posts big blind $0.1
*** HOLE CARDS ***
Dealt to 3f5172f1 
Dealt to db15d716 
Dealt to 61911ab2 
Dealt to e34f410c 
Dealt to Hero [Qc 5h]
Dealt to b6746050 
e34f410c: folds
Hero: folds
b6746050: folds
3f5172f1: folds
db15d716: folds
Uncalled bet ($0.05) returned to 61911ab2
*** SHOWDOWN ***
61911ab2 collected $0.1 from pot
*** SUMMARY ***
Total pot $0.1 | Rake $0 | Jackpot $0 | Bingo $0 | Fortune $0
Seat 1: 3f5172f1 (button) folded before Flop (didn't bet)
Seat 2: db15d716 (small blind) folded before Flop
Seat 3: 61911ab2 (big blind) collected ($0.1)
Seat 4: e34f410c folded before Flop (didn't bet)
Seat 5: Hero folded before Flop (didn't bet)
Seat 6: b6746050 folded before Flop (didn't bet)


Poker Hand #RC1459950243: Hold'em No Limit  ($0.05/$0.1) - 2023/04/08 21:19:52
Table 'RushAndCash3785503' 6-max Seat #1 is the button
Seat 1: 794841c4 ($10.85 in chips)
Seat 2: ee266a57 ($10.82 in chips)
Seat 3: 7954718f ($10.35 in chips)
Seat 4: cacd032a ($23.22 in chips)
Seat 5: 69f90ce5 ($23.73 in chips)
Seat 6: Hero ($7.69 in chips)
ee266a57: posts small blind $0.05
7954718f: posts big blind $0.1
*** HOLE CARDS ***
Dealt to 794841c4 
Dealt to ee266a57 
Dealt to 7954718f 
Dealt to cacd032a 
Dealt to 69f90ce5 
Dealt to Hero [6s Ac]
cacd032a: folds
69f90ce5: folds
Hero: folds
794841c4: raises $0.15 to $0.25
ee266a57: folds
7954718f: calls $0.15
*** FLOP *** [2c Kc Td]
7954718f: checks
794841c4: checks
*** TURN *** [2c Kc Td] [Ad]
7954718f: checks
794841c4: checks
*** RIVER *** [2c Kc Td Ad] [Kd]
7954718f: checks
794841c4: checks
7954718f: shows [7s 7c] (Pair of Kings and Pair of Sevens)
794841c4: shows [5s Qs] (Pair of Kings)
*** SHOWDOWN ***
7954718f collected $0.53 from pot
*** SUMMARY ***
Total pot $0.55 | Rake $0.02 | Jackpot $0 | Bingo $0 | Fortune $0
Board [2c Kc Td Ad Kd]
Seat 1: 794841c4 (button) showed [5s Qs] and lost with Pair of Kings
Seat 2: ee266a57 (small blind) folded before Flop
Seat 3: 7954718f (big blind) showed [7s 7c] and won ($0.53) with Pair of Kings and Pair of Sevens
Seat 4: cacd032a folded before Flop (didn't bet)
Seat 5: 69f90ce5 folded before Flop (didn't bet)
Seat 6: Hero folded before Flop (didn't bet)


Poker Hand #RC1459950195: Hold'em No Limit  ($0.05/$0.1) - 2023/04/08 21:19:43
Table 'RushAndCash3785455' 6-max Seat #1 is the button
Seat 1: ed5c10b4 ($8.2 in chips)
Seat 2: 8930d5b0 ($7.75 in chips)
Seat 3: b7c5ed84 ($18.04 in chips)
Seat 4: 38bd8899 ($26.93 in chips)
Seat 5: 2f3c8996 ($12.71 in chips)
Seat 6: Hero ($7.69 in chips)
8930d5b0: posts small blind $0.05
b7c5ed84: posts big blind $0.1
*** HOLE CARDS ***
Dealt to ed5c10b4 
Dealt to 8930d5b0 
Dealt to b7c5ed84 
Dealt to 38bd8899 
Dealt to 2f3c8996 
Dealt to Hero [Kd 8s]
38bd8899: folds
2f3c8996: folds
Hero: folds
ed5c10b4: raises $0.2 to $0.3
8930d5b0: folds
b7c5ed84: calls $0.2
*** FLOP *** [As Tc Qc]
b7c5ed84: checks
ed5c10b4: bets $0.33
b7c5ed84: calls $0.33
*** TURN *** [As Tc Qc] [3c]
b7c5ed84: checks
ed5c10b4: checks
*** RIVER *** [As Tc Qc 3c] [Ks]
b7c5ed84: checks
ed5c10b4: checks
b7c5ed84: shows [Ah 9d] (Pair of Aces)
ed5c10b4: shows [4s 4h] (Pair of Fours)
*** SHOWDOWN ***
b7c5ed84 collected $1.25 from pot
*** SUMMARY ***
Total pot $1.31 | Rake $0.06 | Jackpot $0 | Bingo $0 | Fortune $0
Board [As Tc Qc 3c Ks]
Seat 1: ed5c10b4 (button) showed [4s 4h] and lost with Pair of Fours
Seat 2: 8930d5b0 (small blind) folded before Flop
Seat 3: b7c5ed84 (big blind) showed [Ah 9d] and won ($1.25) with Pair of Aces
Seat 4: 38bd8899 folded before Flop (didn't bet)
Seat 5: 2f3c8996 folded before Flop (didn't bet)
Seat 6: Hero folded before Flop (didn't bet)


Poker Hand #RC1459950175: Hold'em No Limit  ($0.05/$0.1) - 2023/04/08 21:19:39
Table 'RushAndCash3785435' 6-max Seat #1 is the button
Seat 1: Hero ($7.69 in chips)
Seat 2: e7258593 ($14.89 in chips)
Seat 3: 6c98edc ($13.31 in chips)
Seat 4: f18ec573 ($31.98 in chips)
Seat 5: b1e0c6b6 ($10 in chips)
Seat 6: 54cabc29 ($9.85 in chips)
e7258593: posts small blind $0.05
6c98edc: posts big blind $0.1
*** HOLE CARDS ***
Dealt to Hero [8c 6d]
Dealt to e7258593 
Dealt to 6c98edc 
Dealt to f18ec573 
Dealt to b1e0c6b6 
Dealt to 54cabc29 
f18ec573: folds
b1e0c6b6: folds
54cabc29: folds
Hero: folds
e7258593: raises $0.2 to $0.3
6c98edc: folds
Uncalled bet ($0.2) returned to e7258593
*** SHOWDOWN ***
e7258593 collected $0.2 from pot
*** SUMMARY ***
Total pot $0.2 | Rake $0 | Jackpot $0 | Bingo $0 | Fortune $0
Seat 1: Hero (button) folded before Flop (didn't bet)
Seat 2: e7258593 (small blind) collected ($0.2)
Seat 3: 6c98edc (big blind) folded before Flop
Seat 4: f18ec573 folded before Flop (didn't bet)
Seat 5: b1e0c6b6 folded before Flop (didn't bet)
Seat 6: 54cabc29 folded before Flop (didn't bet)


Poker Hand #RC1459950140: Hold'em No Limit  ($0.05/$0.1) - 2023/04/08 21:19:32
Table 'RushAndCash3785400' 6-max Seat #1 is the button
Seat 1: 2937cd70 ($14.97 in chips)
Seat 2: 93dd5318 ($21.71 in chips)
Seat 3: 683b66d2 ($14.47 in chips)
Seat 4: 4a8c7660 ($69.4 in chips)
Seat 5: Hero ($7.69 in chips)
Seat 6: 79e4f48b ($15.46 in chips)
93dd5318: posts small blind $0.05
683b66d2: posts big blind $0.1
*** HOLE CARDS ***
Dealt to 2937cd70 
Dealt to 93dd5318 
Dealt to 683b66d2 
Dealt to 4a8c7660 
Dealt to Hero [3s 8d]
Dealt to 79e4f48b 
4a8c7660: folds
Hero: folds
79e4f48b: raises $0.15 to $0.25
2937cd70: folds
93dd5318: folds
683b66d2: folds
Uncalled bet ($0.15) returned to 79e4f48b
*** SHOWDOWN ***
79e4f48b collected $0.25 from pot
*** SUMMARY ***
Total pot $0.25 | Rake $0 | Jackpot $0 | Bingo $0 | Fortune $0
Seat 1: 2937cd70 (button) folded before Flop (didn't bet)
Seat 2: 93dd5318 (small blind) folded before Flop
Seat 3: 683b66d2 (big blind) folded before Flop
Seat 4: 4a8c7660 folded before Flop (didn't bet)
Seat 5: Hero folded before Flop (didn't bet)
Seat 6: 79e4f48b collected ($0.25)


Poker Hand #RC1459950105: Hold'em No Limit  ($0.05/$0.1) - 2023/04/08 21:19:25
Table 'RushAndCash3785365' 6-max Seat #1 is the button
Seat 1: baddceb ($24.26 in chips)
Seat 2: 1c4a5bb8 ($10 in chips)
Seat 3: 17baa9ca ($7.51 in chips)
Seat 4: f336d5a7 ($11.84 in chips)
Seat 5: Hero ($7.69 in chips)
Seat 6: ed5c10b4 ($8.3 in chips)
1c4a5bb8: posts small blind $0.05
17baa9ca: posts big blind $0.1
*** HOLE CARDS ***
Dealt to baddceb 
Dealt to 1c4a5bb8 
Dealt to 17baa9ca 
Dealt to f336d5a7 
Dealt to Hero [5h 8s]
Dealt to ed5c10b4 
f336d5a7: folds
Hero: folds
ed5c10b4: folds
baddceb: folds
1c4a5bb8: folds
Uncalled bet ($0.05) returned to 17baa9ca
*** SHOWDOWN ***
17baa9ca collected $0.1 from pot
*** SUMMARY ***
Total pot $0.1 | Rake $0 | Jackpot $0 | Bingo $0 | Fortune $0
Seat 1: baddceb (button) folded before Flop (didn't bet)
Seat 2: 1c4a5bb8 (small blind) folded before Flop
Seat 3: 17baa9ca (big blind) collected ($0.1)
Seat 4: f336d5a7 folded before Flop (didn't bet)
Seat 5: Hero folded before Flop (didn't bet)
Seat 6: ed5c10b4 folded before Flop (didn't bet)


Poker Hand #RC1459949957: Hold'em No Limit  ($0.05/$0.1) - 2023/04/08 21:18:58
Table 'RushAndCash3785217' 6-max Seat #1 is the button
Seat 1: 1dd65d52 ($14.54 in chips)
Seat 2: Hero ($7.32 in chips)
Seat 3: 1aaef8f4 ($11 in chips)
Seat 4: bac4dd05 ($10 in chips)
Seat 5: ed5c10b4 ($8.6 in chips)
Seat 6: 3dbb79e7 ($9.85 in chips)
Hero: posts small blind $0.05
1aaef8f4: posts big blind $0.1
*** HOLE CARDS ***
Dealt to 1dd65d52 
Dealt to Hero [Qh Ks]
Dealt to 1aaef8f4 
Dealt to bac4dd05 
Dealt to ed5c10b4 
Dealt to 3dbb79e7 
bac4dd05: folds
ed5c10b4: raises $0.2 to $0.3
3dbb79e7: folds
1dd65d52: folds
Hero: raises $0.9 to $1.2
1aaef8f4: folds
ed5c10b4: folds
Uncalled bet ($0.9) returned to Hero
*** SHOWDOWN ***
Hero collected $0.67 from pot
*** SUMMARY ***
Total pot $0.7 | Rake $0.03 | Jackpot $0 | Bingo $0 | Fortune $0
Seat 1: 1dd65d52 (button) folded before Flop (didn't bet)
Seat 2: Hero (small blind) collected ($0.67)
Seat 3: 1aaef8f4 (big blind) folded before Flop
Seat 4: bac4dd05 folded before Flop (didn't bet)
Seat 5: ed5c10b4 folded before Flop
Seat 6: 3dbb79e7 folded before Flop (didn't bet)


Poker Hand #RC1459949896: Hold'em No Limit  ($0.05/$0.1) - 2023/04/08 21:18:46
Table 'RushAndCash3785156' 6-max Seat #1 is the button
Seat 1: Hero ($7.17 in chips)
Seat 2: ee5241c6 ($14.33 in chips)
Seat 3: 9d36e43b ($10 in chips)
Seat 4: 22e10f51 ($13.62 in chips)
Seat 5: f44721f5 ($5.01 in chips)
Seat 6: 1aaef8f4 ($11 in chips)
ee5241c6: posts small blind $0.05
9d36e43b: posts big blind $0.1
*** HOLE CARDS ***
Dealt to Hero [Qs Js]
Dealt to ee5241c6 
Dealt to 9d36e43b 
Dealt to 22e10f51 
Dealt to f44721f5 
Dealt to 1aaef8f4 
22e10f51: folds
f44721f5: folds
1aaef8f4: folds
Hero: raises $0.15 to $0.25
ee5241c6: folds
9d36e43b: folds
Uncalled bet ($0.15) returned to Hero
*** SHOWDOWN ***
Hero collected $0.25 from pot
*** SUMMARY ***
Total pot $0.25 | Rake $0 | Jackpot $0 | Bingo $0 | Fortune $0
Seat 1: Hero (button) collected ($0.25)
Seat 2: ee5241c6 (small blind) folded before Flop
Seat 3: 9d36e43b (big blind) folded before Flop
Seat 4: 22e10f51 folded before Flop (didn't bet)
Seat 5: f44721f5 folded before Flop (didn't bet)
Seat 6: 1aaef8f4 folded before Flop (didn't bet)


Poker Hand #RC1459949743: Hold'em No Limit  ($0.05/$0.1) - 2023/04/08 21:18:18
Table 'RushAndCash3785003' 6-max Seat #1 is the button
Seat 1: 3fdcb188 ($22.47 in chips)
Seat 2: Hero ($8.17 in chips)
Seat 3: 9c1a67d5 ($14.95 in chips)
Seat 4: b1e0c6b6 ($10.02 in chips)
Seat 5: 1aaef8f4 ($10 in chips)
Seat 6: f4fbd3ee ($22.45 in chips)
Hero: posts small blind $0.05
9c1a67d5: posts big blind $0.1
*** HOLE CARDS ***
Dealt to 3fdcb188 
Dealt to Hero [Js As]
Dealt to 9c1a67d5 
Dealt to b1e0c6b6 
Dealt to 1aaef8f4 
Dealt to f4fbd3ee 
b1e0c6b6: folds
1aaef8f4: raises $0.15 to $0.25
f4fbd3ee: folds
3fdcb188: folds
Hero: raises $0.75 to $1
9c1a67d5: folds
1aaef8f4: raises $1.58 to $2.58
Hero: folds
Uncalled bet ($1.58) returned to 1aaef8f4
*** SHOWDOWN ***
1aaef8f4 collected $2 from pot
*** SUMMARY ***
Total pot $2.1 | Rake $0.1 | Jackpot $0 | Bingo $0 | Fortune $0
Seat 1: 3fdcb188 (button) folded before Flop (didn't bet)
Seat 2: Hero (small blind) folded before Flop
Seat 3: 9c1a67d5 (big blind) folded before Flop
Seat 4: b1e0c6b6 folded before Flop (didn't bet)
Seat 5: 1aaef8f4 collected ($2)
Seat 6: f4fbd3ee folded before Flop (didn't bet)


Poker Hand #RC1459949667: Hold'em No Limit  ($0.05/$0.1) - 2023/04/08 21:18:03
Table 'RushAndCash3784927' 6-max Seat #1 is the button
Seat 1: a0b5d1f3 ($25.14 in chips)
Seat 2: Hero ($8.07 in chips)
Seat 3: 3dbb79e7 ($10 in chips)
Seat 4: 1353b9bd ($10 in chips)
Seat 5: 238ede5a ($24.22 in chips)
Seat 6: 6c44c3f2 ($18.79 in chips)
Hero: posts small blind $0.05
3dbb79e7: posts big blind $0.1
*** HOLE CARDS ***
Dealt to a0b5d1f3 
Dealt to Hero [Kh Qs]
Dealt to 3dbb79e7 
Dealt to 1353b9bd 
Dealt to 238ede5a 
Dealt to 6c44c3f2 
1353b9bd: folds
238ede5a: folds
6c44c3f2: folds
a0b5d1f3: folds
Hero: raises $0.2 to $0.3
3dbb79e7: folds
Uncalled bet ($0.2) returned to Hero
*** SHOWDOWN ***
Hero collected $0.2 from pot
*** SUMMARY ***
Total pot $0.2 | Rake $0 | Jackpot $0 | Bingo $0 | Fortune $0
Seat 1: a0b5d1f3 (button) folded before Flop (didn't bet)
Seat 2: Hero (small blind) collected ($0.2)
Seat 3: 3dbb79e7 (big blind) folded before Flop
Seat 4: 1353b9bd folded before Flop (didn't bet)
Seat 5: 238ede5a folded before Flop (didn't bet)
Seat 6: 6c44c3f2 folded before Flop (didn't bet)


Poker Hand #RC1459949641: Hold'em No Limit  ($0.05/$0.1) - 2023/04/08 21:17:59
Table 'RushAndCash3784901' 6-max Seat #1 is the button
Seat 1: 17baa9ca ($7.66 in chips)
Seat 2: 86440a84 ($10.57 in chips)
Seat 3: a0b5d1f3 ($25.24 in chips)
Seat 4: Hero ($8.07 in chips)
Seat 5: 7faf8c75 ($29.81 in chips)
Seat 6: 175d11e7 ($11.94 in chips)
86440a84: posts small blind $0.05
a0b5d1f3: posts big blind $0.1
*** HOLE CARDS ***
Dealt to 17baa9ca 
Dealt to 86440a84 
Dealt to a0b5d1f3 
Dealt to Hero [Jd 5s]
Dealt to 7faf8c75 
Dealt to 175d11e7 
Hero: folds
7faf8c75: folds
175d11e7: folds
17baa9ca: folds
86440a84: folds
Uncalled bet ($0.05) returned to a0b5d1f3
*** SHOWDOWN ***
a0b5d1f3 collected $0.1 from pot
*** SUMMARY ***
Total pot $0.1 | Rake $0 | Jackpot $0 | Bingo $0 | Fortune $0
Seat 1: 17baa9ca (button) folded before Flop (didn't bet)
Seat 2: 86440a84 (small blind) folded before Flop
Seat 3: a0b5d1f3 (big blind) collected ($0.1)
Seat 4: Hero folded before Flop (didn't bet)
Seat 5: 7faf8c75 folded before Flop (didn't bet)
Seat 6: 175d11e7 folded before Flop (didn't bet)


Poker Hand #RC1459949615: Hold'em No Limit  ($0.05/$0.1) - 2023/04/08 21:17:55
Table 'RushAndCash3784875' 6-max Seat #1 is the button
Seat 1: e3e4b226 ($11.21 in chips)
Seat 2: 78269ebc ($13.29 in chips)
Seat 3: 11f2bfc9 ($11.29 in chips)
Seat 4: Hero ($8.07 in chips)
Seat 5: 597b09ac ($10.19 in chips)
Seat 6: 551d9a48 ($9.53 in chips)
78269ebc: posts small blind $0.05
11f2bfc9: posts big blind $0.1
*** HOLE CARDS ***
Dealt to e3e4b226 
Dealt to 78269ebc 
Dealt to 11f2bfc9 
Dealt to Hero [7h 5d]
Dealt to 597b09ac 
Dealt to 551d9a48 
Hero: folds
597b09ac: folds
551d9a48: folds
e3e4b226: raises $0.15 to $0.25
78269ebc: raises $0.85 to $1.1
11f2bfc9: folds
e3e4b226: raises $1.2 to $2.3
78269ebc: folds
Uncalled bet ($1.2) returned to e3e4b226
*** SHOWDOWN ***
e3e4b226 collected $2.19 from pot
*** SUMMARY ***
Total pot $2.3 | Rake $0.11 | Jackpot $0 | Bingo $0 | Fortune $0
Seat 1: e3e4b226 (button) collected ($2.19)
Seat 2: 78269ebc (small blind) folded before Flop
Seat 3: 11f2bfc9 (big blind) folded before Flop
Seat 4: Hero folded before Flop (didn't bet)
Seat 5: 597b09ac folded before Flop (didn't bet)
Seat 6: 551d9a48 folded before Flop (didn't bet)


Poker Hand #RC1459949512: Hold'em No Limit  ($0.05/$0.1) - 2023/04/08 21:17:35
Table 'RushAndCash3784772' 6-max Seat #1 is the button
Seat 1: 92be4bf ($11.18 in chips)
Seat 2: 794841c4 ($10.31 in chips)
Seat 3: Hero ($8.17 in chips)
Seat 4: c1f26eb7 ($13.43 in chips)
Seat 5: fb15ce92 ($9.74 in chips)
Seat 6: 7feebe1e ($10.95 in chips)
794841c4: posts small blind $0.05
Hero: posts big blind $0.1
*** HOLE CARDS ***
Dealt to 92be4bf 
Dealt to 794841c4 
Dealt to Hero [Jh Qd]
Dealt to c1f26eb7 
Dealt to fb15ce92 
Dealt to 7feebe1e 
c1f26eb7: raises $0.15 to $0.25
fb15ce92: calls $0.25
7feebe1e: folds
92be4bf: folds
794841c4: folds
Hero: folds
*** FLOP *** [3h 8c 6h]
c1f26eb7: checks
fb15ce92: bets $0.33
c1f26eb7: folds
Uncalled bet ($0.33) returned to fb15ce92
*** SHOWDOWN ***
fb15ce92 collected $0.62 from pot
*** SUMMARY ***
Total pot $0.65 | Rake $0.03 | Jackpot $0 | Bingo $0 | Fortune $0
Board [3h 8c 6h]
Seat 1: 92be4bf (button) folded before Flop (didn't bet)
Seat 2: 794841c4 (small blind) folded before Flop
Seat 3: Hero (big blind) folded before Flop
Seat 4: c1f26eb7 folded on the Flop
Seat 5: fb15ce92 won ($0.62)
Seat 6: 7feebe1e folded before Flop (didn't bet)


Poker Hand #RC1459949359: Hold'em No Limit  ($0.05/$0.1) - 2023/04/08 21:17:07
Table 'RushAndCash3784619' 6-max Seat #1 is the button
Seat 1: 794841c4 ($10.56 in chips)
Seat 2: 7feebe1e ($10.48 in chips)
Seat 3: Hero ($8.42 in chips)
Seat 4: 6dbca9dd ($15.45 in chips)
Seat 5: c89af454 ($32.59 in chips)
Seat 6: 76db26dd ($8.42 in chips)
7feebe1e: posts small blind $0.05
Hero: posts big blind $0.1
*** HOLE CARDS ***
Dealt to 794841c4 
Dealt to 7feebe1e 
Dealt to Hero [4c Ac]
Dealt to 6dbca9dd 
Dealt to c89af454 
Dealt to 76db26dd 
6dbca9dd: folds
c89af454: folds
76db26dd: folds
794841c4: raises $0.15 to $0.25
7feebe1e: calls $0.2
Hero: calls $0.15
*** FLOP *** [8s 3s 8d]
7feebe1e: bets $0.4
Hero: folds
794841c4: folds
Uncalled bet ($0.4) returned to 7feebe1e
*** SHOWDOWN ***
7feebe1e collected $0.72 from pot
*** SUMMARY ***
Total pot $0.75 | Rake $0.03 | Jackpot $0 | Bingo $0 | Fortune $0
Board [8s 3s 8d]
Seat 1: 794841c4 (button) folded on the Flop
Seat 2: 7feebe1e (small blind) won ($0.72)
Seat 3: Hero (big blind) folded on the Flop
Seat 4: 6dbca9dd folded before Flop (didn't bet)
Seat 5: c89af454 folded before Flop (didn't bet)
Seat 6: 76db26dd folded before Flop (didn't bet)


Poker Hand #RC1459949303: Hold'em No Limit  ($0.05/$0.1) - 2023/04/08 21:16:57
Table 'RushAndCash3784563' 6-max Seat #1 is the button
Seat 1: Hero ($8.42 in chips)
Seat 2: 157fc37b ($18.56 in chips)
Seat 3: f4a099d8 ($10 in chips)
Seat 4: 7bfc260f ($18.46 in chips)
Seat 5: 166da242 ($20.99 in chips)
Seat 6: 1c08072e ($8.16 in chips)
157fc37b: posts small blind $0.05
f4a099d8: posts big blind $0.1
*** HOLE CARDS ***
Dealt to Hero [8c 9h]
Dealt to 157fc37b 
Dealt to f4a099d8 
Dealt to 7bfc260f 
Dealt to 166da242 
Dealt to 1c08072e 
7bfc260f: folds
166da242: raises $0.13 to $0.23
1c08072e: raises $0.57 to $0.8
Hero: folds
157fc37b: folds
f4a099d8: folds
166da242: folds
Uncalled bet ($0.57) returned to 1c08072e
*** SHOWDOWN ***
1c08072e collected $0.58 from pot
*** SUMMARY ***
Total pot $0.61 | Rake $0.03 | Jackpot $0 | Bingo $0 | Fortune $0
Seat 1: Hero (button) folded before Flop (didn't bet)
Seat 2: 157fc37b (small blind) folded before Flop
Seat 3: f4a099d8 (big blind) folded before Flop
Seat 4: 7bfc260f folded before Flop (didn't bet)
Seat 5: 166da242 folded before Flop
Seat 6: 1c08072e collected ($0.58)


Poker Hand #RC1459949278: Hold'em No Limit  ($0.05/$0.1) - 2023/04/08 21:16:52
Table 'RushAndCash3784538' 6-max Seat #1 is the button
Seat 1: 62b97b93 ($10.2 in chips)
Seat 2: f95370cb ($10.2 in chips)
Seat 3: 1dc33ced ($10 in chips)
Seat 4: 9a83057 ($11.29 in chips)
Seat 5: b17673e1 ($10.1 in chips)
Seat 6: Hero ($8.42 in chips)
f95370cb: posts small blind $0.05
1dc33ced: posts big blind $0.1
*** HOLE CARDS ***
Dealt to 62b97b93 
Dealt to f95370cb 
Dealt to 1dc33ced 
Dealt to 9a83057 
Dealt to b17673e1 
Dealt to Hero [8d 5s]
9a83057: folds
b17673e1: folds
Hero: folds
62b97b93: raises $0.1 to $0.2
f95370cb: folds
1dc33ced: folds
Uncalled bet ($0.1) returned to 62b97b93
*** SHOWDOWN ***
62b97b93 collected $0.25 from pot
*** SUMMARY ***
Total pot $0.25 | Rake $0 | Jackpot $0 | Bingo $0 | Fortune $0
Seat 1: 62b97b93 (button) collected ($0.25)
Seat 2: f95370cb (small blind) folded before Flop
Seat 3: 1dc33ced (big blind) folded before Flop
Seat 4: 9a83057 folded before Flop (didn't bet)
Seat 5: b17673e1 folded before Flop (didn't bet)
Seat 6: Hero folded before Flop (didn't bet)


Poker Hand #RC1459949213: Hold'em No Limit  ($0.05/$0.1) - 2023/04/08 21:16:41
Table 'RushAndCash3784473' 6-max Seat #1 is the button
Seat 1: e534119 ($10.75 in chips)
Seat 2: a45cc184 ($10 in chips)
Seat 3: 6ac40c7b ($9.56 in chips)
Seat 4: Hero ($8.42 in chips)
Seat 5: f876a2d1 ($8.09 in chips)
Seat 6: 4c855208 ($30.52 in chips)
a45cc184: posts small blind $0.05
6ac40c7b: posts big blind $0.1
*** HOLE CARDS ***
Dealt to e534119 
Dealt to a45cc184 
Dealt to 6ac40c7b 
Dealt to Hero [2d Js]
Dealt to f876a2d1 
Dealt to 4c855208 
Hero: folds
f876a2d1: folds
4c855208: folds
e534119: folds
a45cc184: raises $0.2 to $0.3
6ac40c7b: folds
Uncalled bet ($0.2) returned to a45cc184
*** SHOWDOWN ***
a45cc184 collected $0.2 from pot
*** SUMMARY ***
Total pot $0.2 | Rake $0 | Jackpot $0 | Bingo $0 | Fortune $0
Seat 1: e534119 (button) folded before Flop (didn't bet)
Seat 2: a45cc184 (small blind) collected ($0.2)
Seat 3: 6ac40c7b (big blind) folded before Flop
Seat 4: Hero folded before Flop (didn't bet)
Seat 5: f876a2d1 folded before Flop (didn't bet)
Seat 6: 4c855208 folded before Flop (didn't bet)


Poker Hand #RC1459949085: Hold'em No Limit  ($0.05/$0.1) - 2023/04/08 21:16:18
Table 'RushAndCash3784345' 6-max Seat #1 is the button
Seat 1: 3fbf9b28 ($10.4 in chips)
Seat 2: Hero ($8.47 in chips)
Seat 3: a2ce439 ($12.22 in chips)
Seat 4: 55e63fc7 ($10.61 in chips)
Seat 5: 2cd46eba ($9.45 in chips)
Seat 6: eb1d5743 ($10.15 in chips)
Hero: posts small blind $0.05
a2ce439: posts big blind $0.1
*** HOLE CARDS ***
Dealt to 3fbf9b28 
Dealt to Hero [9h Jh]
Dealt to a2ce439 
Dealt to 55e63fc7 
Dealt to 2cd46eba 
Dealt to eb1d5743 
55e63fc7: folds
2cd46eba: folds
eb1d5743: raises $0.13 to $0.23
3fbf9b28: raises $0.46 to $0.69
Hero: folds
a2ce439: folds
eb1d5743: folds
Uncalled bet ($0.46) returned to 3fbf9b28
*** SHOWDOWN ***
3fbf9b28 collected $0.58 from pot
*** SUMMARY ***
Total pot $0.61 | Rake $0.03 | Jackpot $0 | Bingo $0 | Fortune $0
Seat 1: 3fbf9b28 (button) collected ($0.58)
Seat 2: Hero (small blind) folded before Flop
Seat 3: a2ce439 (big blind) folded before Flop
Seat 4: 55e63fc7 folded before Flop (didn't bet)
Seat 5: 2cd46eba folded before Flop (didn't bet)
Seat 6: eb1d5743 folded before Flop


Poker Hand #RC1459948613: Hold'em No Limit  ($0.05/$0.1) - 2023/04/08 21:14:52
Table 'RushAndCash3783873' 6-max Seat #1 is the button
Seat 1: 457142b5 ($30.61 in chips)
Seat 2: bb06b732 ($10 in chips)
Seat 3: Hero ($7.19 in chips)
Seat 4: 7800aeef ($10.73 in chips)
Seat 5: 3c7913d0 ($10 in chips)
Seat 6: 3610c1a3 ($10.24 in chips)
bb06b732: posts small blind $0.05
Hero: posts big blind $0.1
*** HOLE CARDS ***
Dealt to 457142b5 
Dealt to bb06b732 
Dealt to Hero [8c 8d]
Dealt to 7800aeef 
Dealt to 3c7913d0 
Dealt to 3610c1a3 
7800aeef: folds
3c7913d0: folds
3610c1a3: raises $0.15 to $0.25
457142b5: folds
bb06b732: folds
Hero: calls $0.15
*** FLOP *** [2c Ad 6d]
Hero: checks
3610c1a3: checks
*** TURN *** [2c Ad 6d] [9c]
Hero: checks
3610c1a3: bets $0.41
Hero: calls $0.41
*** RIVER *** [2c Ad 6d 9c] [8s]
Hero: checks
3610c1a3: bets $0.86
Hero: raises $1.59 to $2.45
3610c1a3: folds
Uncalled bet ($1.59) returned to Hero
*** SHOWDOWN ***
Hero collected $2.8 from pot
*** SUMMARY ***
Total pot $3.09 | Rake $0.14 | Jackpot $0.15 | Bingo $0 | Fortune $0
Board [2c Ad 6d 9c 8s]
Seat 1: 457142b5 (button) folded before Flop (didn't bet)
Seat 2: bb06b732 (small blind) folded before Flop
Seat 3: Hero (big blind) won ($2.8)
Seat 4: 7800aeef folded before Flop (didn't bet)
Seat 5: 3c7913d0 folded before Flop (didn't bet)
Seat 6: 3610c1a3 folded on the River


Poker Hand #RC1459948569: Hold'em No Limit  ($0.05/$0.1) - 2023/04/08 21:14:42
Table 'RushAndCash3783829' 6-max Seat #1 is the button
Seat 1: a438ad41 ($24.85 in chips)
Seat 2: 44ed445f ($11.1 in chips)
Seat 3: dfe0f72a ($11.8 in chips)
Seat 4: Hero ($7.19 in chips)
Seat 5: 11ef0c8 ($14 in chips)
Seat 6: 966aa306 ($8.32 in chips)
44ed445f: posts small blind $0.05
dfe0f72a: posts big blind $0.1
*** HOLE CARDS ***
Dealt to a438ad41 
Dealt to 44ed445f 
Dealt to dfe0f72a 
Dealt to Hero [7h As]
Dealt to 11ef0c8 
Dealt to 966aa306 
Hero: folds
11ef0c8: folds
966aa306: folds
a438ad41: raises $0.16 to $0.26
44ed445f: folds
dfe0f72a: folds
Uncalled bet ($0.16) returned to a438ad41
*** SHOWDOWN ***
a438ad41 collected $0.25 from pot
*** SUMMARY ***
Total pot $0.25 | Rake $0 | Jackpot $0 | Bingo $0 | Fortune $0
Seat 1: a438ad41 (button) collected ($0.25)
Seat 2: 44ed445f (small blind) folded before Flop
Seat 3: dfe0f72a (big blind) folded before Flop
Seat 4: Hero folded before Flop (didn't bet)
Seat 5: 11ef0c8 folded before Flop (didn't bet)
Seat 6: 966aa306 folded before Flop (didn't bet)


Poker Hand #RC1459948550: Hold'em No Limit  ($0.05/$0.1) - 2023/04/08 21:14:38
Table 'RushAndCash3783810' 6-max Seat #1 is the button
Seat 1: 1cf38f48 ($23.09 in chips)
Seat 2: edcaa5e3 ($17.04 in chips)
Seat 3: d5f45f3c ($8.81 in chips)
Seat 4: Hero ($7.19 in chips)
Seat 5: 3fdcb188 ($22.72 in chips)
Seat 6: 9f65c8a ($27.71 in chips)
edcaa5e3: posts small blind $0.05
d5f45f3c: posts big blind $0.1
*** HOLE CARDS ***
Dealt to 1cf38f48 
Dealt to edcaa5e3 
Dealt to d5f45f3c 
Dealt to Hero [5c Qs]
Dealt to 3fdcb188 
Dealt to 9f65c8a 
Hero: folds
3fdcb188: folds
9f65c8a: raises $0.15 to $0.25
1cf38f48: folds
edcaa5e3: folds
d5f45f3c: calls $0.15
*** FLOP *** [5s 2d Th]
d5f45f3c: checks
9f65c8a: bets $0.19
d5f45f3c: calls $0.19
*** TURN *** [5s 2d Th] [3h]
d5f45f3c: checks
9f65c8a: bets $0.31
d5f45f3c: raises $0.78 to $1.09
9f65c8a: folds
Uncalled bet ($0.78) returned to d5f45f3c
*** SHOWDOWN ***
d5f45f3c collected $1.48 from pot
*** SUMMARY ***
Total pot $1.55 | Rake $0.07 | Jackpot $0 | Bingo $0 | Fortune $0
Board [5s 2d Th 3h]
Seat 1: 1cf38f48 (button) folded before Flop (didn't bet)
Seat 2: edcaa5e3 (small blind) folded before Flop
Seat 3: d5f45f3c (big blind) won ($1.48)
Seat 4: Hero folded before Flop (didn't bet)
Seat 5: 3fdcb188 folded before Flop (didn't bet)
Seat 6: 9f65c8a folded on the Turn


Poker Hand #RC1459948480: Hold'em No Limit  ($0.05/$0.1) - 2023/04/08 21:14:25
Table 'RushAndCash3783740' 6-max Seat #1 is the button
Seat 1: 98569319 ($9.98 in chips)
Seat 2: 8967e899 ($26.6 in chips)
Seat 3: Hero ($7.29 in chips)
Seat 4: 8a5ae807 ($10.37 in chips)
Seat 5: 589f53c8 ($10.05 in chips)
Seat 6: 85015694 ($9.81 in chips)
8967e899: posts small blind $0.05
Hero: posts big blind $0.1
*** HOLE CARDS ***
Dealt to 98569319 
Dealt to 8967e899 
Dealt to Hero [4c Th]
Dealt to 8a5ae807 
Dealt to 589f53c8 
Dealt to 85015694 
8a5ae807: folds
589f53c8: folds
85015694: raises $0.15 to $0.25
98569319: raises $0.49 to $0.74
8967e899: folds
Hero: folds
85015694: calls $0.49
*** FLOP *** [Tc 2h 2d]
85015694: checks
98569319: bets $0.54
85015694: calls $0.54
*** TURN *** [Tc 2h 2d] [Jh]
85015694: checks
98569319: bets $1.5
85015694: calls $1.5
*** RIVER *** [Tc 2h 2d Jh] [3s]
85015694: checks
98569319: bets $7.2 and is all-in
85015694: folds
Uncalled bet ($7.2) returned to 98569319
*** SHOWDOWN ***
98569319 collected $5.29 from pot
*** SUMMARY ***
Total pot $5.71 | Rake $0.27 | Jackpot $0.15 | Bingo $0 | Fortune $0
Board [Tc 2h 2d Jh 3s]
Seat 1: 98569319 (button) won ($5.29)
Seat 2: 8967e899 (small blind) folded before Flop
Seat 3: Hero (big blind) folded before Flop
Seat 4: 8a5ae807 folded before Flop (didn't bet)
Seat 5: 589f53c8 folded before Flop (didn't bet)
Seat 6: 85015694 folded on the River


Poker Hand #RC1459948458: Hold'em No Limit  ($0.05/$0.1) - 2023/04/08 21:14:21
Table 'RushAndCash3783718' 6-max Seat #1 is the button
Seat 1: Hero ($7.29 in chips)
Seat 2: 808fc86f ($3.36 in chips)
Seat 3: bd47f0c5 ($5.58 in chips)
Seat 4: 1196d30c ($12.33 in chips)
Seat 5: 8d5340db ($11.71 in chips)
Seat 6: 794841c4 ($10.28 in chips)
808fc86f: posts small blind $0.05
bd47f0c5: posts big blind $0.1
*** HOLE CARDS ***
Dealt to Hero [Tc 5c]
Dealt to 808fc86f 
Dealt to bd47f0c5 
Dealt to 1196d30c 
Dealt to 8d5340db 
Dealt to 794841c4 
1196d30c: folds
8d5340db: raises $0.1 to $0.2
794841c4: folds
Hero: folds
808fc86f: folds
bd47f0c5: folds
Uncalled bet ($0.1) returned to 8d5340db
*** SHOWDOWN ***
8d5340db collected $0.25 from pot
*** SUMMARY ***
Total pot $0.25 | Rake $0 | Jackpot $0 | Bingo $0 | Fortune $0
Seat 1: Hero (button) folded before Flop (didn't bet)
Seat 2: 808fc86f (small blind) folded before Flop
Seat 3: bd47f0c5 (big blind) folded before Flop
Seat 4: 1196d30c folded before Flop (didn't bet)
Seat 5: 8d5340db collected ($0.25)
Seat 6: 794841c4 folded before Flop (didn't bet)


Poker Hand #RC1459948049: Hold'em No Limit  ($0.05/$0.1) - 2023/04/08 21:13:09
Table 'RushAndCash3783309' 6-max Seat #1 is the button
Seat 1: Hero ($6.17 in chips)
Seat 2: 3fdcb188 ($23.12 in chips)
Seat 3: fb15ce92 ($9.57 in chips)
Seat 4: e3cc95e4 ($11 in chips)
Seat 5: 175d11e7 ($10.32 in chips)
Seat 6: 7e39b596 ($13.29 in chips)
3fdcb188: posts small blind $0.05
fb15ce92: posts big blind $0.1
*** HOLE CARDS ***
Dealt to Hero [Qh Ts]
Dealt to 3fdcb188 
Dealt to fb15ce92 
Dealt to e3cc95e4 
Dealt to 175d11e7 
Dealt to 7e39b596 
e3cc95e4: folds
175d11e7: folds
7e39b596: folds
Hero: raises $0.15 to $0.25
3fdcb188: folds
fb15ce92: calls $0.15
*** FLOP *** [5h Qs 4c]
fb15ce92: bets $0.28
Hero: calls $0.28
*** TURN *** [5h Qs 4c] [Td]
fb15ce92: checks
Hero: bets $0.66
fb15ce92: calls $0.66
*** RIVER *** [5h Qs 4c Td] [7s]
fb15ce92: checks
Hero: bets $0.86
fb15ce92: folds
Uncalled bet ($0.86) returned to Hero
*** SHOWDOWN ***
Hero collected $2.31 from pot
*** SUMMARY ***
Total pot $2.43 | Rake $0.12 | Jackpot $0 | Bingo $0 | Fortune $0
Board [5h Qs 4c Td 7s]
Seat 1: Hero (button) won ($2.31)
Seat 2: 3fdcb188 (small blind) folded before Flop
Seat 3: fb15ce92 (big blind) folded on the River
Seat 4: e3cc95e4 folded before Flop (didn't bet)
Seat 5: 175d11e7 folded before Flop (didn't bet)
Seat 6: 7e39b596 folded before Flop (didn't bet)


Poker Hand #RC1459947695: Hold'em No Limit  ($0.05/$0.1) - 2023/04/08 21:12:05
Table 'RushAndCash3782955' 6-max Seat #1 is the button
Seat 1: 7bfc260f ($18.24 in chips)
Seat 2: Hero ($6.67 in chips)
Seat 3: e3cc95e4 ($10.55 in chips)
Seat 4: 62b97b93 ($10.94 in chips)
Seat 5: d59033f9 ($11.61 in chips)
Seat 6: 65715b31 ($12.98 in chips)
Hero: posts small blind $0.05
e3cc95e4: posts big blind $0.1
*** HOLE CARDS ***
Dealt to 7bfc260f 
Dealt to Hero [5d 5s]
Dealt to e3cc95e4 
Dealt to 62b97b93 
Dealt to d59033f9 
Dealt to 65715b31 
62b97b93: folds
d59033f9: folds
65715b31: folds
7bfc260f: folds
Hero: raises $0.2 to $0.3
e3cc95e4: calls $0.2
*** FLOP *** [9d Jh 7h]
Hero: checks
e3cc95e4: checks
*** TURN *** [9d Jh 7h] [Ah]
Hero: checks
e3cc95e4: checks
*** RIVER *** [9d Jh 7h Ah] [8h]
Hero: bets $0.2
e3cc95e4: calls $0.2
Hero: shows [5d 5s] (Pair of Fives)
e3cc95e4: shows [Ad Th] (Ace High Flush)
*** SHOWDOWN ***
e3cc95e4 collected $0.95 from pot
*** SUMMARY ***
Total pot $1 | Rake $0.05 | Jackpot $0 | Bingo $0 | Fortune $0
Board [9d Jh 7h Ah 8h]
Seat 1: 7bfc260f (button) folded before Flop (didn't bet)
Seat 2: Hero (small blind) showed [5d 5s] and lost with Pair of Fives
Seat 3: e3cc95e4 (big blind) showed [Ad Th] and won ($0.95) with Ace High Flush
Seat 4: 62b97b93 folded before Flop (didn't bet)
Seat 5: d59033f9 folded before Flop (didn't bet)
Seat 6: 65715b31 folded before Flop (didn't bet)


Poker Hand #RC1459947600: Hold'em No Limit  ($0.05/$0.1) - 2023/04/08 21:11:48
Table 'RushAndCash3782860' 6-max Seat #1 is the button
Seat 1: 97a8c931 ($10.91 in chips)
Seat 2: 9509cf45 ($7.62 in chips)
Seat 3: Hero ($6.62 in chips)
Seat 4: 6ad16dc4 ($10.51 in chips)
Seat 5: 69b20187 ($22.5 in chips)
Seat 6: d0df257c ($10.05 in chips)
9509cf45: posts small blind $0.05
Hero: posts big blind $0.1
*** HOLE CARDS ***
Dealt to 97a8c931 
Dealt to 9509cf45 
Dealt to Hero [5c 5d]
Dealt to 6ad16dc4 
Dealt to 69b20187 
Dealt to d0df257c 
6ad16dc4: folds
69b20187: folds
d0df257c: folds
97a8c931: folds
9509cf45: folds
Uncalled bet ($0.05) returned to Hero
*** SHOWDOWN ***
Hero collected $0.1 from pot
*** SUMMARY ***
Total pot $0.1 | Rake $0 | Jackpot $0 | Bingo $0 | Fortune $0
Seat 1: 97a8c931 (button) folded before Flop (didn't bet)
Seat 2: 9509cf45 (small blind) folded before Flop
Seat 3: Hero (big blind) collected ($0.1)
Seat 4: 6ad16dc4 folded before Flop (didn't bet)
Seat 5: 69b20187 folded before Flop (didn't bet)
Seat 6: d0df257c folded before Flop (didn't bet)


Poker Hand #RC1459947558: Hold'em No Limit  ($0.05/$0.1) - 2023/04/08 21:11:40
Table 'RushAndCash3782818' 6-max Seat #1 is the button
Seat 1: fb15ce92 ($8.36 in chips)
Seat 2: 74baa6a4 ($10.15 in chips)
Seat 3: fed90cff ($9.6 in chips)
Seat 4: e790267c ($21.14 in chips)
Seat 5: f040d85b ($10.36 in chips)
Seat 6: Hero ($6.62 in chips)
74baa6a4: posts small blind $0.05
fed90cff: posts big blind $0.1
*** HOLE CARDS ***
Dealt to fb15ce92 
Dealt to 74baa6a4 
Dealt to fed90cff 
Dealt to e790267c 
Dealt to f040d85b 
Dealt to Hero [2s Th]
e790267c: folds
f040d85b: raises $0.15 to $0.25
Hero: folds
fb15ce92: calls $0.25
74baa6a4: folds
fed90cff: folds
*** FLOP *** [6s 7d 3c]
f040d85b: checks
fb15ce92: checks
*** TURN *** [6s 7d 3c] [9s]
f040d85b: bets $0.3
fb15ce92: raises $0.63 to $0.93
f040d85b: calls $0.63
*** RIVER *** [6s 7d 3c 9s] [5s]
f040d85b: checks
fb15ce92: checks
f040d85b: shows [9h 9c] (Three Nines)
fb15ce92: shows [4h 5h] (Sevens-High Straight)
*** SHOWDOWN ***
fb15ce92 collected $2.39 from pot
*** SUMMARY ***
Total pot $2.51 | Rake $0.12 | Jackpot $0 | Bingo $0 | Fortune $0
Board [6s 7d 3c 9s 5s]
Seat 1: fb15ce92 (button) showed [4h 5h] and won ($2.39) with Sevens-High Straight
Seat 2: 74baa6a4 (small blind) folded before Flop
Seat 3: fed90cff (big blind) folded before Flop
Seat 4: e790267c folded before Flop (didn't bet)
Seat 5: f040d85b showed [9h 9c] and lost with Three Nines
Seat 6: Hero folded before Flop (didn't bet)


Poker Hand #RC1459947335: Hold'em No Limit  ($0.05/$0.1) - 2023/04/08 21:11:00
Table 'RushAndCash3782595' 6-max Seat #1 is the button
Seat 1: eff44734 ($9.11 in chips)
Seat 2: f181dc91 ($50.46 in chips)
Seat 3: 9022b505 ($10.33 in chips)
Seat 4: Hero ($5.76 in chips)
Seat 5: 4a8c7660 ($73.98 in chips)
Seat 6: 5489eecc ($24.5 in chips)
f181dc91: posts small blind $0.05
9022b505: posts big blind $0.1
*** HOLE CARDS ***
Dealt to eff44734 
Dealt to f181dc91 
Dealt to 9022b505 
Dealt to Hero [Qc Kc]
Dealt to 4a8c7660 
Dealt to 5489eecc 
Hero: raises $0.15 to $0.25
4a8c7660: folds
5489eecc: folds
eff44734: folds
f181dc91: folds
9022b505: calls $0.15
*** FLOP *** [Th 8d Jh]
9022b505: checks
Hero: bets $0.28
9022b505: calls $0.28
*** TURN *** [Th 8d Jh] [Tc]
9022b505: checks
Hero: checks
*** RIVER *** [Th 8d Jh Tc] [Ac]
9022b505: bets $0.37
Hero: raises $0.47 to $0.84
9022b505: folds
Uncalled bet ($0.47) returned to Hero
*** SHOWDOWN ***
Hero collected $1.76 from pot
*** SUMMARY ***
Total pot $1.85 | Rake $0.09 | Jackpot $0 | Bingo $0 | Fortune $0
Board [Th 8d Jh Tc Ac]
Seat 1: eff44734 (button) folded before Flop (didn't bet)
Seat 2: f181dc91 (small blind) folded before Flop
Seat 3: 9022b505 (big blind) folded on the River
Seat 4: Hero won ($1.76)
Seat 5: 4a8c7660 folded before Flop (didn't bet)
Seat 6: 5489eecc folded before Flop (didn't bet)


Poker Hand #RC1459947300: Hold'em No Limit  ($0.05/$0.1) - 2023/04/08 21:10:54
Table 'RushAndCash3782560' 6-max Seat #1 is the button
Seat 1: 3294ece5 ($59.26 in chips)
Seat 2: 7800aeef ($10.52 in chips)
Seat 3: c75dc099 ($10.66 in chips)
Seat 4: Hero ($5.76 in chips)
Seat 5: 41a252da ($10 in chips)
Seat 6: caed7b6f ($36.65 in chips)
7800aeef: posts small blind $0.05
c75dc099: posts big blind $0.1
*** HOLE CARDS ***
Dealt to 3294ece5 
Dealt to 7800aeef 
Dealt to c75dc099 
Dealt to Hero [Ts 7d]
Dealt to 41a252da 
Dealt to caed7b6f 
Hero: folds
41a252da: folds
caed7b6f: folds
3294ece5: folds
7800aeef: folds
Uncalled bet ($0.05) returned to c75dc099
*** SHOWDOWN ***
c75dc099 collected $0.1 from pot
*** SUMMARY ***
Total pot $0.1 | Rake $0 | Jackpot $0 | Bingo $0 | Fortune $0
Seat 1: 3294ece5 (button) folded before Flop (didn't bet)
Seat 2: 7800aeef (small blind) folded before Flop
Seat 3: c75dc099 (big blind) collected ($0.1)
Seat 4: Hero folded before Flop (didn't bet)
Seat 5: 41a252da folded before Flop (didn't bet)
Seat 6: caed7b6f folded before Flop (didn't bet)


Poker Hand #RC1459947238: Hold'em No Limit  ($0.05/$0.1) - 2023/04/08 21:10:42
Table 'RushAndCash3782498' 6-max Seat #1 is the button
Seat 1: ff1b66c8 ($9.85 in chips)
Seat 2: Hero ($5.81 in chips)
Seat 3: 8a8bce3 ($40.17 in chips)
Seat 4: 4c996243 ($23.84 in chips)
Seat 5: d47c361a ($30.46 in chips)
Seat 6: 92be4bf ($10 in chips)
Hero: posts small blind $0.05
8a8bce3: posts big blind $0.1
*** HOLE CARDS ***
Dealt to ff1b66c8 
Dealt to Hero [9c Qd]
Dealt to 8a8bce3 
Dealt to 4c996243 
Dealt to d47c361a 
Dealt to 92be4bf 
4c996243: raises $0.2 to $0.3
d47c361a: folds
92be4bf: folds
ff1b66c8: folds
Hero: folds
8a8bce3: folds
Uncalled bet ($0.2) returned to 4c996243
*** SHOWDOWN ***
4c996243 collected $0.25 from pot
*** SUMMARY ***
Total pot $0.25 | Rake $0 | Jackpot $0 | Bingo $0 | Fortune $0
Seat 1: ff1b66c8 (button) folded before Flop (didn't bet)
Seat 2: Hero (small blind) folded before Flop
Seat 3: 8a8bce3 (big blind) folded before Flop
Seat 4: 4c996243 collected ($0.25)
Seat 5: d47c361a folded before Flop (didn't bet)
Seat 6: 92be4bf folded before Flop (didn't bet)


Poker Hand #RC1459947219: Hold'em No Limit  ($0.05/$0.1) - 2023/04/08 21:10:38
Table 'RushAndCash3782479' 6-max Seat #1 is the button
Seat 1: 5489eecc ($24.6 in chips)
Seat 2: 8ea699cf ($10.15 in chips)
Seat 3: 59cb8ca8 ($13.97 in chips)
Seat 4: 11ef0c8 ($14.75 in chips)
Seat 5: Hero ($5.81 in chips)
Seat 6: 690bd577 ($8.73 in chips)
8ea699cf: posts small blind $0.05
59cb8ca8: posts big blind $0.1
*** HOLE CARDS ***
Dealt to 5489eecc 
Dealt to 8ea699cf 
Dealt to 59cb8ca8 
Dealt to 11ef0c8 
Dealt to Hero [9h 8d]
Dealt to 690bd577 
11ef0c8: folds
Hero: folds
690bd577: raises $0.13 to $0.23
5489eecc: folds
8ea699cf: folds
59cb8ca8: calls $0.13
*** FLOP *** [Jd Kd Qc]
59cb8ca8: checks
690bd577: checks
*** TURN *** [Jd Kd Qc] [Jc]
59cb8ca8: bets $0.15
690bd577: calls $0.15
*** RIVER *** [Jd Kd Qc Jc] [3s]
59cb8ca8: checks
690bd577: checks
59cb8ca8: shows [Ts Qh] (Pair of Queens and Pair of Jacks)
690bd577: shows [Ac 5d] (Pair of Jacks)
*** SHOWDOWN ***
59cb8ca8 collected $0.77 from pot
*** SUMMARY ***
Total pot $0.81 | Rake $0.04 | Jackpot $0 | Bingo $0 | Fortune $0
Board [Jd Kd Qc Jc 3s]
Seat 1: 5489eecc (button) folded before Flop (didn't bet)
Seat 2: 8ea699cf (small blind) folded before Flop
Seat 3: 59cb8ca8 (big blind) showed [Ts Qh] and won ($0.77) with Pair of Queens and Pair of Jacks
Seat 4: 11ef0c8 folded before Flop (didn't bet)
Seat 5: Hero folded before Flop (didn't bet)
Seat 6: 690bd577 showed [Ac 5d] and lost with Pair of Jacks


Poker Hand #RC1459947145: Hold'em No Limit  ($0.05/$0.1) - 2023/04/08 21:10:24
Table 'RushAndCash3782405' 6-max Seat #1 is the button
Seat 1: Hero ($5.66 in chips)
Seat 2: 93028ba3 ($14.31 in chips)
Seat 3: 5ff297d1 ($9.98 in chips)
Seat 4: b6746050 ($79.54 in chips)
Seat 5: 1cf38f48 ($25.74 in chips)
Seat 6: b1e0c6b6 ($10 in chips)
93028ba3: posts small blind $0.05
5ff297d1: posts big blind $0.1
*** HOLE CARDS ***
Dealt to Hero [Jc As]
Dealt to 93028ba3 
Dealt to 5ff297d1 
Dealt to b6746050 
Dealt to 1cf38f48 
Dealt to b1e0c6b6 
b6746050: folds
1cf38f48: folds
b1e0c6b6: folds
Hero: raises $0.15 to $0.25
93028ba3: folds
5ff297d1: folds
Uncalled bet ($0.15) returned to Hero
*** SHOWDOWN ***
Hero collected $0.25 from pot
*** SUMMARY ***
Total pot $0.25 | Rake $0 | Jackpot $0 | Bingo $0 | Fortune $0
Seat 1: Hero (button) collected ($0.25)
Seat 2: 93028ba3 (small blind) folded before Flop
Seat 3: 5ff297d1 (big blind) folded before Flop
Seat 4: b6746050 folded before Flop (didn't bet)
Seat 5: 1cf38f48 folded before Flop (didn't bet)
Seat 6: b1e0c6b6 folded before Flop (didn't bet)


Poker Hand #RC1459947015: Hold'em No Limit  ($0.05/$0.1) - 2023/04/08 21:09:59
Table 'RushAndCash3782275' 6-max Seat #1 is the button
Seat 1: 49942850 ($10 in chips)
Seat 2: Hero ($5.71 in chips)
Seat 3: 2937cd70 ($11.18 in chips)
Seat 4: cf6bba13 ($10 in chips)
Seat 5: 589f53c8 ($10 in chips)
Seat 6: 59cb8ca8 ($13.97 in chips)
Hero: posts small blind $0.05
2937cd70: posts big blind $0.1
*** HOLE CARDS ***
Dealt to 49942850 
Dealt to Hero [2c 6s]
Dealt to 2937cd70 
Dealt to cf6bba13 
Dealt to 589f53c8 
Dealt to 59cb8ca8 
cf6bba13: folds
589f53c8: raises $0.2 to $0.3
59cb8ca8: folds
49942850: folds
Hero: folds
2937cd70: folds
Uncalled bet ($0.2) returned to 589f53c8
*** SHOWDOWN ***
589f53c8 collected $0.25 from pot
*** SUMMARY ***
Total pot $0.25 | Rake $0 | Jackpot $0 | Bingo $0 | Fortune $0
Seat 1: 49942850 (button) folded before Flop (didn't bet)
Seat 2: Hero (small blind) folded before Flop
Seat 3: 2937cd70 (big blind) folded before Flop
Seat 4: cf6bba13 folded before Flop (didn't bet)
Seat 5: 589f53c8 collected ($0.25)
Seat 6: 59cb8ca8 folded before Flop (didn't bet)


Poker Hand #RC1459946986: Hold'em No Limit  ($0.05/$0.1) - 2023/04/08 21:09:54
Table 'RushAndCash3782246' 6-max Seat #1 is the button
Seat 1: 34c5ec46 ($13.11 in chips)
Seat 2: ae2c0557 ($10.22 in chips)
Seat 3: 80783716 ($10 in chips)
Seat 4: 4a10fc3e ($10.95 in chips)
Seat 5: 3563eab4 ($7.09 in chips)
Seat 6: Hero ($5.71 in chips)
ae2c0557: posts small blind $0.05
80783716: posts big blind $0.1
*** HOLE CARDS ***
Dealt to 34c5ec46 
Dealt to ae2c0557 
Dealt to 80783716 
Dealt to 4a10fc3e 
Dealt to 3563eab4 
Dealt to Hero [Qh 6h]
4a10fc3e: raises $0.15 to $0.25
3563eab4: folds
Hero: folds
34c5ec46: calls $0.25
ae2c0557: folds
80783716: folds
*** FLOP *** [As Ah 5s]
4a10fc3e: bets $0.2
34c5ec46: calls $0.2
*** TURN *** [As Ah 5s] [6s]
4a10fc3e: checks
34c5ec46: checks
*** RIVER *** [As Ah 5s 6s] [4s]
4a10fc3e: checks
34c5ec46: bets $0.79
4a10fc3e: folds
Uncalled bet ($0.79) returned to 34c5ec46
*** SHOWDOWN ***
34c5ec46 collected $1 from pot
*** SUMMARY ***
Total pot $1.05 | Rake $0.05 | Jackpot $0 | Bingo $0 | Fortune $0
Board [As Ah 5s 6s 4s]
Seat 1: 34c5ec46 (button) won ($1)
Seat 2: ae2c0557 (small blind) folded before Flop
Seat 3: 80783716 (big blind) folded before Flop
Seat 4: 4a10fc3e folded on the River
Seat 5: 3563eab4 folded before Flop (didn't bet)
Seat 6: Hero folded before Flop (didn't bet)


Poker Hand #RC1459946923: Hold'em No Limit  ($0.05/$0.1) - 2023/04/08 21:09:43
Table 'RushAndCash3782183' 6-max Seat #1 is the button
Seat 1: 2f3c8996 ($11.77 in chips)
Seat 2: 55ac3cd6 ($20.14 in chips)
Seat 3: 2df8ed54 ($10 in chips)
Seat 4: Hero ($5.56 in chips)
Seat 5: 2ffc0f9b ($10 in chips)
Seat 6: 5939553a ($10.55 in chips)
55ac3cd6: posts small blind $0.05
2df8ed54: posts big blind $0.1
*** HOLE CARDS ***
Dealt to 2f3c8996 
Dealt to 55ac3cd6 
Dealt to 2df8ed54 
Dealt to Hero [Qc Ks]
Dealt to 2ffc0f9b 
Dealt to 5939553a 
Hero: raises $0.15 to $0.25
2ffc0f9b: folds
5939553a: folds
2f3c8996: folds
55ac3cd6: folds
2df8ed54: folds
Uncalled bet ($0.15) returned to Hero
*** SHOWDOWN ***
Hero collected $0.25 from pot
*** SUMMARY ***
Total pot $0.25 | Rake $0 | Jackpot $0 | Bingo $0 | Fortune $0
Seat 1: 2f3c8996 (button) folded before Flop (didn't bet)
Seat 2: 55ac3cd6 (small blind) folded before Flop
Seat 3: 2df8ed54 (big blind) folded before Flop
Seat 4: Hero collected ($0.25)
Seat 5: 2ffc0f9b folded before Flop (didn't bet)
Seat 6: 5939553a folded before Flop (didn't bet)


Poker Hand #RC1459946869: Hold'em No Limit  ($0.05/$0.1) - 2023/04/08 21:09:33
Table 'RushAndCash3782129' 6-max Seat #1 is the button
Seat 1: Hero ($5.56 in chips)
Seat 2: 8f6da20c ($13.97 in chips)
Seat 3: 8fcef37 ($8.34 in chips)
Seat 4: 93dd5318 ($11.63 in chips)
Seat 5: f95370cb ($10 in chips)
Seat 6: ea1988b ($10.7 in chips)
8f6da20c: posts small blind $0.05
8fcef37: posts big blind $0.1
*** HOLE CARDS ***
Dealt to Hero [4h Ts]
Dealt to 8f6da20c 
Dealt to 8fcef37 
Dealt to 93dd5318 
Dealt to f95370cb 
Dealt to ea1988b 
93dd5318: folds
f95370cb: folds
ea1988b: folds
Hero: folds
8f6da20c: folds
Uncalled bet ($0.05) returned to 8fcef37
*** SHOWDOWN ***
8fcef37 collected $0.1 from pot
*** SUMMARY ***
Total pot $0.1 | Rake $0 | Jackpot $0 | Bingo $0 | Fortune $0
Seat 1: Hero (button) folded before Flop (didn't bet)
Seat 2: 8f6da20c (small blind) folded before Flop
Seat 3: 8fcef37 (big blind) collected ($0.1)
Seat 4: 93dd5318 folded before Flop (didn't bet)
Seat 5: f95370cb folded before Flop (didn't bet)
Seat 6: ea1988b folded before Flop (didn't bet)


Poker Hand #RC1459946639: Hold'em No Limit  ($0.05/$0.1) - 2023/04/08 21:08:48
Table 'RushAndCash3781899' 6-max Seat #1 is the button
Seat 1: e3e4b226 ($18.65 in chips)
Seat 2: f3c40c35 ($10.5 in chips)
Seat 3: Hero ($5.33 in chips)
Seat 4: e4a151fd ($9.91 in chips)
Seat 5: 8747e8cd ($12.18 in chips)
Seat 6: 7340f470 ($53.14 in chips)
f3c40c35: posts small blind $0.05
Hero: posts big blind $0.1
*** HOLE CARDS ***
Dealt to e3e4b226 
Dealt to f3c40c35 
Dealt to Hero [Tc As]
Dealt to e4a151fd 
Dealt to 8747e8cd 
Dealt to 7340f470 
e4a151fd: raises $0.1 to $0.2
8747e8cd: folds
7340f470: folds
e3e4b226: folds
f3c40c35: folds
Hero: calls $0.1
*** FLOP *** [9s 5s Ad]
Hero: checks
e4a151fd: checks
*** TURN *** [9s 5s Ad] [7h]
Hero: bets $0.23
e4a151fd: folds
Uncalled bet ($0.23) returned to Hero
*** SHOWDOWN ***
Hero collected $0.43 from pot
*** SUMMARY ***
Total pot $0.45 | Rake $0.02 | Jackpot $0 | Bingo $0 | Fortune $0
Board [9s 5s Ad 7h]
Seat 1: e3e4b226 (button) folded before Flop (didn't bet)
Seat 2: f3c40c35 (small blind) folded before Flop
Seat 3: Hero (big blind) won ($0.43)
Seat 4: e4a151fd folded on the Turn
Seat 5: 8747e8cd folded before Flop (didn't bet)
Seat 6: 7340f470 folded before Flop (didn't bet)


Poker Hand #RC1459946610: Hold'em No Limit  ($0.05/$0.1) - 2023/04/08 21:08:43
Table 'RushAndCash3781870' 6-max Seat #1 is the button
Seat 1: 4bd29609 ($12.1 in chips)
Seat 2: 3bc9841 ($10 in chips)
Seat 3: 587a017c ($103.98 in chips)
Seat 4: 5a721ebb ($14.25 in chips)
Seat 5: Hero ($5.33 in chips)
Seat 6: fbf276bf ($10.01 in chips)
3bc9841: posts small blind $0.05
587a017c: posts big blind $0.1
*** HOLE CARDS ***
Dealt to 4bd29609 
Dealt to 3bc9841 
Dealt to 587a017c 
Dealt to 5a721ebb 
Dealt to Hero [Kd 7h]
Dealt to fbf276bf 
5a721ebb: folds
Hero: folds
fbf276bf: folds
4bd29609: raises $0.13 to $0.23
3bc9841: folds
587a017c: calls $0.13
*** FLOP *** [2d 7c Ts]
587a017c: checks
4bd29609: bets $0.3
587a017c: calls $0.3
*** TURN *** [2d 7c Ts] [Qs]
587a017c: checks
4bd29609: bets $0.6
587a017c: folds
Uncalled bet ($0.6) returned to 4bd29609
*** SHOWDOWN ***
4bd29609 collected $1.05 from pot
*** SUMMARY ***
Total pot $1.11 | Rake $0.06 | Jackpot $0 | Bingo $0 | Fortune $0
Board [2d 7c Ts Qs]
Seat 1: 4bd29609 (button) won ($1.05)
Seat 2: 3bc9841 (small blind) folded before Flop
Seat 3: 587a017c (big blind) folded on the Turn
Seat 4: 5a721ebb folded before Flop (didn't bet)
Seat 5: Hero folded before Flop (didn't bet)
Seat 6: fbf276bf folded before Flop (didn't bet)


Poker Hand #RC1459946558: Hold'em No Limit  ($0.05/$0.1) - 2023/04/08 21:08:34
Table 'RushAndCash3781818' 6-max Seat #1 is the button
Seat 1: 1054b93b ($15.99 in chips)
Seat 2: caed7b6f ($36.68 in chips)
Seat 3: 70cd5c03 ($10.02 in chips)
Seat 4: 4d7567a0 ($10.39 in chips)
Seat 5: Hero ($5.33 in chips)
Seat 6: 7bfc260f ($18.35 in chips)
caed7b6f: posts small blind $0.05
70cd5c03: posts big blind $0.1
*** HOLE CARDS ***
Dealt to 1054b93b 
Dealt to caed7b6f 
Dealt to 70cd5c03 
Dealt to 4d7567a0 
Dealt to Hero [9s 5h]
Dealt to 7bfc260f 
4d7567a0: folds
Hero: folds
7bfc260f: raises $0.3 to $0.4
1054b93b: folds
caed7b6f: folds
70cd5c03: folds
Uncalled bet ($0.3) returned to 7bfc260f
*** SHOWDOWN ***
7bfc260f collected $0.25 from pot
*** SUMMARY ***
Total pot $0.25 | Rake $0 | Jackpot $0 | Bingo $0 | Fortune $0
Seat 1: 1054b93b (button) folded before Flop (didn't bet)
Seat 2: caed7b6f (small blind) folded before Flop
Seat 3: 70cd5c03 (big blind) folded before Flop
Seat 4: 4d7567a0 folded before Flop (didn't bet)
Seat 5: Hero folded before Flop (didn't bet)
Seat 6: 7bfc260f collected ($0.25)


Poker Hand #RC1459946457: Hold'em No Limit  ($0.05/$0.1) - 2023/04/08 21:08:14
Table 'RushAndCash3781717' 6-max Seat #1 is the button
Seat 1: d59033f9 ($11.23 in chips)
Seat 2: f53cdad ($42.34 in chips)
Seat 3: 7a3e4c38 ($35.04 in chips)
Seat 4: Hero ($5.18 in chips)
Seat 5: 878660b3 ($10 in chips)
Seat 6: 1cf38f48 ($26.54 in chips)
f53cdad: posts small blind $0.05
7a3e4c38: posts big blind $0.1
*** HOLE CARDS ***
Dealt to d59033f9 
Dealt to f53cdad 
Dealt to 7a3e4c38 
Dealt to Hero [Kd Qd]
Dealt to 878660b3 
Dealt to 1cf38f48 
Hero: raises $0.15 to $0.25
878660b3: folds
1cf38f48: folds
d59033f9: folds
f53cdad: folds
7a3e4c38: folds
Uncalled bet ($0.15) returned to Hero
*** SHOWDOWN ***
Hero collected $0.25 from pot
*** SUMMARY ***
Total pot $0.25 | Rake $0 | Jackpot $0 | Bingo $0 | Fortune $0
Seat 1: d59033f9 (button) folded before Flop (didn't bet)
Seat 2: f53cdad (small blind) folded before Flop
Seat 3: 7a3e4c38 (big blind) folded before Flop
Seat 4: Hero collected ($0.25)
Seat 5: 878660b3 folded before Flop (didn't bet)
Seat 6: 1cf38f48 folded before Flop (didn't bet)


Poker Hand #RC1459946376: Hold'em No Limit  ($0.05/$0.1) - 2023/04/08 21:08:00
Table 'RushAndCash3781636' 6-max Seat #1 is the button
Seat 1: ee5241c6 ($15.63 in chips)
Seat 2: 59cb8ca8 ($13.38 in chips)
Seat 3: Hero ($5.28 in chips)
Seat 4: 5ef07beb ($39.39 in chips)
Seat 5: 1cf38f48 ($26.59 in chips)
Seat 6: 4d1954e2 ($27.73 in chips)
59cb8ca8: posts small blind $0.05
Hero: posts big blind $0.1
*** HOLE CARDS ***
Dealt to ee5241c6 
Dealt to 59cb8ca8 
Dealt to Hero [3s Kd]
Dealt to 5ef07beb 
Dealt to 1cf38f48 
Dealt to 4d1954e2 
5ef07beb: folds
1cf38f48: folds
4d1954e2: raises $0.13 to $0.23
ee5241c6: folds
59cb8ca8: folds
Hero: folds
Uncalled bet ($0.13) returned to 4d1954e2
*** SHOWDOWN ***
4d1954e2 collected $0.25 from pot
*** SUMMARY ***
Total pot $0.25 | Rake $0 | Jackpot $0 | Bingo $0 | Fortune $0
Seat 1: ee5241c6 (button) folded before Flop (didn't bet)
Seat 2: 59cb8ca8 (small blind) folded before Flop
Seat 3: Hero (big blind) folded before Flop
Seat 4: 5ef07beb folded before Flop (didn't bet)
Seat 5: 1cf38f48 folded before Flop (didn't bet)
Seat 6: 4d1954e2 collected ($0.25)


Poker Hand #RC1459946308: Hold'em No Limit  ($0.05/$0.1) - 2023/04/08 21:07:48
Table 'RushAndCash3781568' 6-max Seat #1 is the button
Seat 1: 4f1db62d ($10 in chips)
Seat 2: Hero ($5.33 in chips)
Seat 3: 29a17827 ($12.34 in chips)
Seat 4: 95d2128f ($51.08 in chips)
Seat 5: 8967e899 ($27.65 in chips)
Seat 6: 3d17cca8 ($19.2 in chips)
Hero: posts small blind $0.05
29a17827: posts big blind $0.1
*** HOLE CARDS ***
Dealt to 4f1db62d 
Dealt to Hero [6h Kc]
Dealt to 29a17827 
Dealt to 95d2128f 
Dealt to 8967e899 
Dealt to 3d17cca8 
95d2128f: folds
8967e899: raises $0.13 to $0.23
3d17cca8: folds
4f1db62d: folds
Hero: folds
29a17827: folds
Uncalled bet ($0.13) returned to 8967e899
*** SHOWDOWN ***
8967e899 collected $0.25 from pot
*** SUMMARY ***
Total pot $0.25 | Rake $0 | Jackpot $0 | Bingo $0 | Fortune $0
Seat 1: 4f1db62d (button) folded before Flop (didn't bet)
Seat 2: Hero (small blind) folded before Flop
Seat 3: 29a17827 (big blind) folded before Flop
Seat 4: 95d2128f folded before Flop (didn't bet)
Seat 5: 8967e899 collected ($0.25)
Seat 6: 3d17cca8 folded before Flop (didn't bet)


Poker Hand #RC1459946283: Hold'em No Limit  ($0.05/$0.1) - 2023/04/08 21:07:43
Table 'RushAndCash3781543' 6-max Seat #1 is the button
Seat 1: f4a9c82c ($10.45 in chips)
Seat 2: e3cc95e4 ($10 in chips)
Seat 3: 39c1fa2c ($28.06 in chips)
Seat 4: Hero ($5.33 in chips)
Seat 5: a8745400 ($17.56 in chips)
Seat 6: 6b6b5b7d ($10.2 in chips)
e3cc95e4: posts small blind $0.05
39c1fa2c: posts big blind $0.1
*** HOLE CARDS ***
Dealt to f4a9c82c 
Dealt to e3cc95e4 
Dealt to 39c1fa2c 
Dealt to Hero [Kd 8s]
Dealt to a8745400 
Dealt to 6b6b5b7d 
Hero: folds
a8745400: raises $0.1 to $0.2
6b6b5b7d: folds
f4a9c82c: folds
e3cc95e4: folds
39c1fa2c: calls $0.1
*** FLOP *** [Qd Kc 4d]
39c1fa2c: checks
a8745400: bets $0.33
39c1fa2c: raises $0.84 to $1.17
a8745400: folds
Uncalled bet ($0.84) returned to 39c1fa2c
*** SHOWDOWN ***
39c1fa2c collected $1.06 from pot
*** SUMMARY ***
Total pot $1.11 | Rake $0.05 | Jackpot $0 | Bingo $0 | Fortune $0
Board [Qd Kc 4d]
Seat 1: f4a9c82c (button) folded before Flop (didn't bet)
Seat 2: e3cc95e4 (small blind) folded before Flop
Seat 3: 39c1fa2c (big blind) won ($1.06)
Seat 4: Hero folded before Flop (didn't bet)
Seat 5: a8745400 folded on the Flop
Seat 6: 6b6b5b7d folded before Flop (didn't bet)


Poker Hand #RC1459946261: Hold'em No Limit  ($0.05/$0.1) - 2023/04/08 21:07:39
Table 'RushAndCash3781521' 6-max Seat #1 is the button
Seat 1: 6691e39a ($2.86 in chips)
Seat 2: f040d85b ($10.14 in chips)
Seat 3: 6a138b47 ($16.8 in chips)
Seat 4: Hero ($5.33 in chips)
Seat 5: 15fc1793 ($11.54 in chips)
Seat 6: 59cb8ca8 ($13.48 in chips)
f040d85b: posts small blind $0.05
6a138b47: posts big blind $0.1
*** HOLE CARDS ***
Dealt to 6691e39a 
Dealt to f040d85b 
Dealt to 6a138b47 
Dealt to Hero [9h Ts]
Dealt to 15fc1793 
Dealt to 59cb8ca8 
Hero: folds
15fc1793: folds
59cb8ca8: folds
6691e39a: folds
f040d85b: raises $0.2 to $0.3
6a138b47: folds
Uncalled bet ($0.2) returned to f040d85b
*** SHOWDOWN ***
f040d85b collected $0.2 from pot
*** SUMMARY ***
Total pot $0.2 | Rake $0 | Jackpot $0 | Bingo $0 | Fortune $0
Seat 1: 6691e39a (button) folded before Flop (didn't bet)
Seat 2: f040d85b (small blind) collected ($0.2)
Seat 3: 6a138b47 (big blind) folded before Flop
Seat 4: Hero folded before Flop (didn't bet)
Seat 5: 15fc1793 folded before Flop (didn't bet)
Seat 6: 59cb8ca8 folded before Flop (didn't bet)


Poker Hand #RC1459946229: Hold'em No Limit  ($0.05/$0.1) - 2023/04/08 21:07:33
Table 'RushAndCash3781489' 6-max Seat #1 is the button
Seat 1: 4117f135 ($19.91 in chips)
Seat 2: 467f13c7 ($5.34 in chips)
Seat 3: e178f22f ($21.77 in chips)
Seat 4: 74baa6a4 ($10.29 in chips)
Seat 5: Hero ($5.33 in chips)
Seat 6: 6c44c3f2 ($20.35 in chips)
467f13c7: posts small blind $0.05
e178f22f: posts big blind $0.1
*** HOLE CARDS ***
Dealt to 4117f135 
Dealt to 467f13c7 
Dealt to e178f22f 
Dealt to 74baa6a4 
Dealt to Hero [9h 2d]
Dealt to 6c44c3f2 
74baa6a4: folds
Hero: folds
6c44c3f2: raises $0.1 to $0.2
4117f135: calls $0.2
467f13c7: calls $0.15
e178f22f: calls $0.1
*** FLOP *** [3c 7c 7s]
467f13c7: checks
e178f22f: checks
6c44c3f2: checks
4117f135: bets $0.27
467f13c7: folds
e178f22f: folds
6c44c3f2: folds
Uncalled bet ($0.27) returned to 4117f135
*** SHOWDOWN ***
4117f135 collected $0.76 from pot
*** SUMMARY ***
Total pot $0.8 | Rake $0.04 | Jackpot $0 | Bingo $0 | Fortune $0
Board [3c 7c 7s]
Seat 1: 4117f135 (button) won ($0.76)
Seat 2: 467f13c7 (small blind) folded on the Flop
Seat 3: e178f22f (big blind) folded on the Flop
Seat 4: 74baa6a4 folded before Flop (didn't bet)
Seat 5: Hero folded before Flop (didn't bet)
Seat 6: 6c44c3f2 folded on the Flop


Poker Hand #RC1459946165: Hold'em No Limit  ($0.05/$0.1) - 2023/04/08 21:07:22
Table 'RushAndCash3781425' 6-max Seat #1 is the button
Seat 1: Hero ($5.33 in chips)
Seat 2: 1d88318f ($13.51 in chips)
Seat 3: b7c5ed84 ($17.93 in chips)
Seat 4: 41e00e4c ($10.9 in chips)
Seat 5: f4a9c82c ($10.6 in chips)
Seat 6: eecda565 ($21.13 in chips)
1d88318f: posts small blind $0.05
b7c5ed84: posts big blind $0.1
*** HOLE CARDS ***
Dealt to Hero [Ac 3s]
Dealt to 1d88318f 
Dealt to b7c5ed84 
Dealt to 41e00e4c 
Dealt to f4a9c82c 
Dealt to eecda565 
41e00e4c: folds
f4a9c82c: folds
eecda565: raises $0.2 to $0.3
Hero: folds
1d88318f: raises $0.81 to $1.11
b7c5ed84: folds
eecda565: folds
Uncalled bet ($0.81) returned to 1d88318f
*** SHOWDOWN ***
1d88318f collected $0.67 from pot
*** SUMMARY ***
Total pot $0.7 | Rake $0.03 | Jackpot $0 | Bingo $0 | Fortune $0
Seat 1: Hero (button) folded before Flop (didn't bet)
Seat 2: 1d88318f (small blind) collected ($0.67)
Seat 3: b7c5ed84 (big blind) folded before Flop
Seat 4: 41e00e4c folded before Flop (didn't bet)
Seat 5: f4a9c82c folded before Flop (didn't bet)
Seat 6: eecda565 folded before Flop


Poker Hand #RC1459946071: Hold'em No Limit  ($0.05/$0.1) - 2023/04/08 21:07:03
Table 'RushAndCash3781331' 6-max Seat #1 is the button
Seat 1: Hero ($5.33 in chips)
Seat 2: 3b57852c ($30.26 in chips)
Seat 3: 8747e8cd ($12.05 in chips)
Seat 4: ed2461d3 ($26.94 in chips)
Seat 5: 80783716 ($10.01 in chips)
Seat 6: 621c9f28 ($10.15 in chips)
3b57852c: posts small blind $0.05
8747e8cd: posts big blind $0.1
*** HOLE CARDS ***
Dealt to Hero [6c 9c]
Dealt to 3b57852c 
Dealt to 8747e8cd 
Dealt to ed2461d3 
Dealt to 80783716 
Dealt to 621c9f28 
ed2461d3: folds
80783716: folds
621c9f28: folds
Hero: folds
3b57852c: folds
Uncalled bet ($0.05) returned to 8747e8cd
*** SHOWDOWN ***
8747e8cd collected $0.1 from pot
*** SUMMARY ***
Total pot $0.1 | Rake $0 | Jackpot $0 | Bingo $0 | Fortune $0
Seat 1: Hero (button) folded before Flop (didn't bet)
Seat 2: 3b57852c (small blind) folded before Flop
Seat 3: 8747e8cd (big blind) collected ($0.1)
Seat 4: ed2461d3 folded before Flop (didn't bet)
Seat 5: 80783716 folded before Flop (didn't bet)
Seat 6: 621c9f28 folded before Flop (didn't bet)


Poker Hand #RC1459945700: Hold'em No Limit  ($0.05/$0.1) - 2023/04/08 21:05:56
Table 'RushAndCash3780960' 6-max Seat #1 is the button
Seat 1: a54b8b7 ($8.65 in chips)
Seat 2: Hero ($5.58 in chips)
Seat 3: 4bd29609 ($11.93 in chips)
Seat 4: 621c9f28 ($10 in chips)
Seat 5: 73d66cce ($7.15 in chips)
Seat 6: 6c44c3f2 ($19.5 in chips)
Hero: posts small blind $0.05
4bd29609: posts big blind $0.1
*** HOLE CARDS ***
Dealt to a54b8b7 
Dealt to Hero [Qd 5d]
Dealt to 4bd29609 
Dealt to 621c9f28 
Dealt to 73d66cce 
Dealt to 6c44c3f2 
621c9f28: folds
73d66cce: folds
6c44c3f2: folds
a54b8b7: folds
Hero: raises $0.15 to $0.25
4bd29609: calls $0.15
*** FLOP *** [4c 8h 2c]
Hero: checks
4bd29609: checks
*** TURN *** [4c 8h 2c] [8s]
Hero: checks
4bd29609: checks
*** RIVER *** [4c 8h 2c 8s] [7c]
Hero: checks
4bd29609: checks
Hero: shows [Qd 5d] (Pair of Eights)
4bd29609: shows [Kh 5h] (Pair of Eights)
*** SHOWDOWN ***
4bd29609 collected $0.47 from pot
*** SUMMARY ***
Total pot $0.5 | Rake $0.03 | Jackpot $0 | Bingo $0 | Fortune $0
Board [4c 8h 2c 8s 7c]
Seat 1: a54b8b7 (button) folded before Flop (didn't bet)
Seat 2: Hero (small blind) showed [Qd 5d] and lost with Pair of Eights
Seat 3: 4bd29609 (big blind) showed [Kh 5h] and won ($0.47) with Pair of Eights
Seat 4: 621c9f28 folded before Flop (didn't bet)
Seat 5: 73d66cce folded before Flop (didn't bet)
Seat 6: 6c44c3f2 folded before Flop (didn't bet)


Poker Hand #RC1459945672: Hold'em No Limit  ($0.05/$0.1) - 2023/04/08 21:05:51
Table 'RushAndCash3780932' 6-max Seat #1 is the button
Seat 1: cc1db7ef ($13.95 in chips)
Seat 2: 7faf8c75 ($30.84 in chips)
Seat 3: Hero ($5.68 in chips)
Seat 4: f4b5f867 ($10 in chips)
Seat 5: 21a9eb3 ($6.12 in chips)
Seat 6: 9448719a ($24.13 in chips)
7faf8c75: posts small blind $0.05
Hero: posts big blind $0.1
*** HOLE CARDS ***
Dealt to cc1db7ef 
Dealt to 7faf8c75 
Dealt to Hero [7h 5d]
Dealt to f4b5f867 
Dealt to 21a9eb3 
Dealt to 9448719a 
f4b5f867: folds
21a9eb3: raises $0.15 to $0.25
9448719a: folds
cc1db7ef: folds
7faf8c75: raises $0.9 to $1.15
Hero: folds
21a9eb3: raises $4.97 to $6.12 and is all-in
7faf8c75: folds
Uncalled bet ($4.97) returned to 21a9eb3
*** SHOWDOWN ***
21a9eb3 collected $2.28 from pot
*** SUMMARY ***
Total pot $2.4 | Rake $0.12 | Jackpot $0 | Bingo $0 | Fortune $0
Seat 1: cc1db7ef (button) folded before Flop (didn't bet)
Seat 2: 7faf8c75 (small blind) folded before Flop
Seat 3: Hero (big blind) folded before Flop
Seat 4: f4b5f867 folded before Flop (didn't bet)
Seat 5: 21a9eb3 collected ($2.28)
Seat 6: 9448719a folded before Flop (didn't bet)


Poker Hand #RC1459945645: Hold'em No Limit  ($0.05/$0.1) - 2023/04/08 21:05:46
Table 'RushAndCash3780905' 6-max Seat #1 is the button
Seat 1: 7faf8c75 ($30.84 in chips)
Seat 2: bd239c00 ($10 in chips)
Seat 3: 39c1fa2c ($27.14 in chips)
Seat 4: f18ec573 ($28.71 in chips)
Seat 5: 7e48b8ec ($7.01 in chips)
Seat 6: Hero ($5.68 in chips)
bd239c00: posts small blind $0.05
39c1fa2c: posts big blind $0.1
*** HOLE CARDS ***
Dealt to 7faf8c75 
Dealt to bd239c00 
Dealt to 39c1fa2c 
Dealt to f18ec573 
Dealt to 7e48b8ec 
Dealt to Hero [6h 3c]
f18ec573: folds
7e48b8ec: raises $0.2 to $0.3
Hero: folds
7faf8c75: folds
bd239c00: folds
39c1fa2c: folds
Uncalled bet ($0.2) returned to 7e48b8ec
*** SHOWDOWN ***
7e48b8ec collected $0.25 from pot
*** SUMMARY ***
Total pot $0.25 | Rake $0 | Jackpot $0 | Bingo $0 | Fortune $0
Seat 1: 7faf8c75 (button) folded before Flop (didn't bet)
Seat 2: bd239c00 (small blind) folded before Flop
Seat 3: 39c1fa2c (big blind) folded before Flop
Seat 4: f18ec573 folded before Flop (didn't bet)
Seat 5: 7e48b8ec collected ($0.25)
Seat 6: Hero folded before Flop (didn't bet)


Poker Hand #RC1459945618: Hold'em No Limit  ($0.05/$0.1) - 2023/04/08 21:05:40
Table 'RushAndCash3780878' 6-max Seat #1 is the button
Seat 1: 1cf38f48 ($26.21 in chips)
Seat 2: 8dd09433 ($18.81 in chips)
Seat 3: 44ed445f ($12 in chips)
Seat 4: Hero ($5.68 in chips)
Seat 5: 91630bda ($12.49 in chips)
Seat 6: 78269ebc ($11.63 in chips)
8dd09433: posts small blind $0.05
44ed445f: posts big blind $0.1
*** HOLE CARDS ***
Dealt to 1cf38f48 
Dealt to 8dd09433 
Dealt to 44ed445f 
Dealt to Hero [Kd 3s]
Dealt to 91630bda 
Dealt to 78269ebc 
Hero: folds
91630bda: folds
78269ebc: raises $0.15 to $0.25
1cf38f48: folds
8dd09433: folds
44ed445f: folds
Uncalled bet ($0.15) returned to 78269ebc
*** SHOWDOWN ***
78269ebc collected $0.25 from pot
*** SUMMARY ***
Total pot $0.25 | Rake $0 | Jackpot $0 | Bingo $0 | Fortune $0
Seat 1: 1cf38f48 (button) folded before Flop (didn't bet)
Seat 2: 8dd09433 (small blind) folded before Flop
Seat 3: 44ed445f (big blind) folded before Flop
Seat 4: Hero folded before Flop (didn't bet)
Seat 5: 91630bda folded before Flop (didn't bet)
Seat 6: 78269ebc collected ($0.25)


Poker Hand #RC1459945594: Hold'em No Limit  ($0.05/$0.1) - 2023/04/08 21:05:36
Table 'RushAndCash3780854' 6-max Seat #1 is the button
Seat 1: Hero ($5.68 in chips)
Seat 2: b0a8299d ($10.93 in chips)
Seat 3: 93e8500 ($18.94 in chips)
Seat 4: 60bd995c ($10 in chips)
Seat 5: 54403935 ($14.16 in chips)
Seat 6: d33f9dd7 ($12.72 in chips)
b0a8299d: posts small blind $0.05
93e8500: posts big blind $0.1
*** HOLE CARDS ***
Dealt to Hero [7c Ts]
Dealt to b0a8299d 
Dealt to 93e8500 
Dealt to 60bd995c 
Dealt to 54403935 
Dealt to d33f9dd7 
60bd995c: folds
54403935: folds
d33f9dd7: folds
Hero: folds
b0a8299d: raises $0.11 to $0.21
93e8500: folds
Uncalled bet ($0.11) returned to b0a8299d
*** SHOWDOWN ***
b0a8299d collected $0.2 from pot
*** SUMMARY ***
Total pot $0.2 | Rake $0 | Jackpot $0 | Bingo $0 | Fortune $0
Seat 1: Hero (button) folded before Flop (didn't bet)
Seat 2: b0a8299d (small blind) collected ($0.2)
Seat 3: 93e8500 (big blind) folded before Flop
Seat 4: 60bd995c folded before Flop (didn't bet)
Seat 5: 54403935 folded before Flop (didn't bet)
Seat 6: d33f9dd7 folded before Flop (didn't bet)


Poker Hand #RC1459945568: Hold'em No Limit  ($0.05/$0.1) - 2023/04/08 21:05:31
Table 'RushAndCash3780828' 6-max Seat #1 is the button
Seat 1: 690bd577 ($8.31 in chips)
Seat 2: 3294ece5 ($59.54 in chips)
Seat 3: 4ec6caba ($17.86 in chips)
Seat 4: 967fc2b9 ($10.1 in chips)
Seat 5: Hero ($5.68 in chips)
Seat 6: ff98b220 ($25.16 in chips)
3294ece5: posts small blind $0.05
4ec6caba: posts big blind $0.1
*** HOLE CARDS ***
Dealt to 690bd577 
Dealt to 3294ece5 
Dealt to 4ec6caba 
Dealt to 967fc2b9 
Dealt to Hero [Th 6s]
Dealt to ff98b220 
967fc2b9: folds
Hero: folds
ff98b220: raises $0.2 to $0.3
690bd577: calls $0.3
3294ece5: folds
4ec6caba: folds
*** FLOP *** [Qc Js Ah]
ff98b220: checks
690bd577: bets $0.38
ff98b220: folds
Uncalled bet ($0.38) returned to 690bd577
*** SHOWDOWN ***
690bd577 collected $0.72 from pot
*** SUMMARY ***
Total pot $0.75 | Rake $0.03 | Jackpot $0 | Bingo $0 | Fortune $0
Board [Qc Js Ah]
Seat 1: 690bd577 (button) won ($0.72)
Seat 2: 3294ece5 (small blind) folded before Flop
Seat 3: 4ec6caba (big blind) folded before Flop
Seat 4: 967fc2b9 folded before Flop (didn't bet)
Seat 5: Hero folded before Flop (didn't bet)
Seat 6: ff98b220 folded on the Flop


Poker Hand #RC1459945518: Hold'em No Limit  ($0.05/$0.1) - 2023/04/08 21:05:22
Table 'RushAndCash3780778' 6-max Seat #1 is the button
Seat 1: a8e7c7bc ($10 in chips)
Seat 2: 38bd8899 ($28.72 in chips)
Seat 3: Hero ($5.78 in chips)
Seat 4: 77194cea ($10.05 in chips)
Seat 5: 9ab5c9fb ($10 in chips)
Seat 6: 82806f6 ($5.59 in chips)
38bd8899: posts small blind $0.05
Hero: posts big blind $0.1
*** HOLE CARDS ***
Dealt to a8e7c7bc 
Dealt to 38bd8899 
Dealt to Hero [6h Tc]
Dealt to 77194cea 
Dealt to 9ab5c9fb 
Dealt to 82806f6 
77194cea: folds
9ab5c9fb: folds
82806f6: raises $0.1 to $0.2
a8e7c7bc: folds
38bd8899: folds
Hero: folds
Uncalled bet ($0.1) returned to 82806f6
*** SHOWDOWN ***
82806f6 collected $0.25 from pot
*** SUMMARY ***
Total pot $0.25 | Rake $0 | Jackpot $0 | Bingo $0 | Fortune $0
Seat 1: a8e7c7bc (button) folded before Flop (didn't bet)
Seat 2: 38bd8899 (small blind) folded before Flop
Seat 3: Hero (big blind) folded before Flop
Seat 4: 77194cea folded before Flop (didn't bet)
Seat 5: 9ab5c9fb folded before Flop (didn't bet)
Seat 6: 82806f6 collected ($0.25)


Poker Hand #RC1459945391: Hold'em No Limit  ($0.05/$0.1) - 2023/04/08 21:04:58
Table 'RushAndCash3780651' 6-max Seat #1 is the button
Seat 1: 1aa7a900 ($5.98 in chips)
Seat 2: 1d14bbd1 ($5.82 in chips)
Seat 3: 9f5f3bc5 ($13.35 in chips)
Seat 4: cc018f2 ($6.15 in chips)
Seat 5: Hero ($5.63 in chips)
Seat 6: 6dc4f553 ($13.81 in chips)
1d14bbd1: posts small blind $0.05
9f5f3bc5: posts big blind $0.1
*** HOLE CARDS ***
Dealt to 1aa7a900 
Dealt to 1d14bbd1 
Dealt to 9f5f3bc5 
Dealt to cc018f2 
Dealt to Hero [7s As]
Dealt to 6dc4f553 
cc018f2: folds
Hero: raises $0.15 to $0.25
6dc4f553: folds
1aa7a900: folds
1d14bbd1: folds
9f5f3bc5: folds
Uncalled bet ($0.15) returned to Hero
*** SHOWDOWN ***
Hero collected $0.25 from pot
*** SUMMARY ***
Total pot $0.25 | Rake $0 | Jackpot $0 | Bingo $0 | Fortune $0
Seat 1: 1aa7a900 (button) folded before Flop (didn't bet)
Seat 2: 1d14bbd1 (small blind) folded before Flop
Seat 3: 9f5f3bc5 (big blind) folded before Flop
Seat 4: cc018f2 folded before Flop (didn't bet)
Seat 5: Hero collected ($0.25)
Seat 6: 6dc4f553 folded before Flop (didn't bet)


Poker Hand #RC1459945361: Hold'em No Limit  ($0.05/$0.1) - 2023/04/08 21:04:53
Table 'RushAndCash3780621' 6-max Seat #1 is the button
Seat 1: 93dd5318 ($12.11 in chips)
Seat 2: Hero ($5.68 in chips)
Seat 3: c1f26eb7 ($11.29 in chips)
Seat 4: b60787b3 ($14.75 in chips)
Seat 5: 6276705 ($10.76 in chips)
Seat 6: 880937e1 ($22.27 in chips)
Hero: posts small blind $0.05
c1f26eb7: posts big blind $0.1
*** HOLE CARDS ***
Dealt to 93dd5318 
Dealt to Hero [4d Js]
Dealt to c1f26eb7 
Dealt to b60787b3 
Dealt to 6276705 
Dealt to 880937e1 
b60787b3: folds
6276705: folds
880937e1: folds
93dd5318: raises $0.1 to $0.2
Hero: folds
c1f26eb7: calls $0.1
*** FLOP *** [Tc Th 7d]
c1f26eb7: checks
93dd5318: bets $0.1
c1f26eb7: raises $0.33 to $0.43
93dd5318: folds
Uncalled bet ($0.33) returned to c1f26eb7
*** SHOWDOWN ***
c1f26eb7 collected $0.62 from pot
*** SUMMARY ***
Total pot $0.65 | Rake $0.03 | Jackpot $0 | Bingo $0 | Fortune $0
Board [Tc Th 7d]
Seat 1: 93dd5318 (button) folded on the Flop
Seat 2: Hero (small blind) folded before Flop
Seat 3: c1f26eb7 (big blind) won ($0.62)
Seat 4: b60787b3 folded before Flop (didn't bet)
Seat 5: 6276705 folded before Flop (didn't bet)
Seat 6: 880937e1 folded before Flop (didn't bet)


Poker Hand #RC1459945302: Hold'em No Limit  ($0.05/$0.1) - 2023/04/08 21:04:44
Table 'RushAndCash3780562' 6-max Seat #1 is the button
Seat 1: 74baa6a4 ($10.34 in chips)
Seat 2: 8b7f3a1d ($9.12 in chips)
Seat 3: 10d76dd3 ($10 in chips)
Seat 4: 6a138b47 ($21.14 in chips)
Seat 5: ed2461d3 ($27.11 in chips)
Seat 6: Hero ($5.68 in chips)
8b7f3a1d: posts small blind $0.05
10d76dd3: posts big blind $0.1
*** HOLE CARDS ***
Dealt to 74baa6a4 
Dealt to 8b7f3a1d 
Dealt to 10d76dd3 
Dealt to 6a138b47 
Dealt to ed2461d3 
Dealt to Hero [9d Kd]
6a138b47: raises $0.1 to $0.2
ed2461d3: folds
Hero: folds
74baa6a4: folds
8b7f3a1d: calls $0.15
10d76dd3: folds
*** FLOP *** [6s 2d Ts]
8b7f3a1d: checks
6a138b47: bets $0.2
8b7f3a1d: raises $0.3 to $0.5
6a138b47: calls $0.3
*** TURN *** [6s 2d Ts] [Jh]
8b7f3a1d: bets $0.75
6a138b47: folds
Uncalled bet ($0.75) returned to 8b7f3a1d
*** SHOWDOWN ***
8b7f3a1d collected $1.43 from pot
*** SUMMARY ***
Total pot $1.5 | Rake $0.07 | Jackpot $0 | Bingo $0 | Fortune $0
Board [6s 2d Ts Jh]
Seat 1: 74baa6a4 (button) folded before Flop (didn't bet)
Seat 2: 8b7f3a1d (small blind) won ($1.43)
Seat 3: 10d76dd3 (big blind) folded before Flop
Seat 4: 6a138b47 folded on the Turn
Seat 5: ed2461d3 folded before Flop (didn't bet)
Seat 6: Hero folded before Flop (didn't bet)


Poker Hand #RC1459945274: Hold'em No Limit  ($0.05/$0.1) - 2023/04/08 21:04:39
Table 'RushAndCash3780534' 6-max Seat #1 is the button
Seat 1: 90a161ed ($8.83 in chips)
Seat 2: ce8eee04 ($6.93 in chips)
Seat 3: fe74b7c3 ($18.75 in chips)
Seat 4: ed2461d3 ($27.11 in chips)
Seat 5: Hero ($5.68 in chips)
Seat 6: 49300ce ($10.15 in chips)
ce8eee04: posts small blind $0.05
fe74b7c3: posts big blind $0.1
*** HOLE CARDS ***
Dealt to 90a161ed 
Dealt to ce8eee04 
Dealt to fe74b7c3 
Dealt to ed2461d3 
Dealt to Hero [Kh 8h]
Dealt to 49300ce 
ed2461d3: folds
Hero: folds
49300ce: folds
90a161ed: folds
ce8eee04: folds
Uncalled bet ($0.05) returned to fe74b7c3
*** SHOWDOWN ***
fe74b7c3 collected $0.1 from pot
*** SUMMARY ***
Total pot $0.1 | Rake $0 | Jackpot $0 | Bingo $0 | Fortune $0
Seat 1: 90a161ed (button) folded before Flop (didn't bet)
Seat 2: ce8eee04 (small blind) folded before Flop
Seat 3: fe74b7c3 (big blind) collected ($0.1)
Seat 4: ed2461d3 folded before Flop (didn't bet)
Seat 5: Hero folded before Flop (didn't bet)
Seat 6: 49300ce folded before Flop (didn't bet)


Poker Hand #RC1459945146: Hold'em No Limit  ($0.05/$0.1) - 2023/04/08 21:04:15
Table 'RushAndCash3780406' 6-max Seat #1 is the button
Seat 1: 5489eecc ($20.18 in chips)
Seat 2: Hero ($5.58 in chips)
Seat 3: 2165db3f ($10.46 in chips)
Seat 4: 93e8500 ($18.99 in chips)
Seat 5: 84c33ca3 ($10 in chips)
Seat 6: 8b7f3a1d ($9.22 in chips)
Hero: posts small blind $0.05
2165db3f: posts big blind $0.1
*** HOLE CARDS ***
Dealt to 5489eecc 
Dealt to Hero [9c 8h]
Dealt to 2165db3f 
Dealt to 93e8500 
Dealt to 84c33ca3 
Dealt to 8b7f3a1d 
93e8500: folds
84c33ca3: folds
8b7f3a1d: folds
5489eecc: folds
Hero: raises $0.15 to $0.25
2165db3f: folds
Uncalled bet ($0.15) returned to Hero
*** SHOWDOWN ***
Hero collected $0.2 from pot
*** SUMMARY ***
Total pot $0.2 | Rake $0 | Jackpot $0 | Bingo $0 | Fortune $0
Seat 1: 5489eecc (button) folded before Flop (didn't bet)
Seat 2: Hero (small blind) collected ($0.2)
Seat 3: 2165db3f (big blind) folded before Flop
Seat 4: 93e8500 folded before Flop (didn't bet)
Seat 5: 84c33ca3 folded before Flop (didn't bet)
Seat 6: 8b7f3a1d folded before Flop (didn't bet)


Poker Hand #RC1459945083: Hold'em No Limit  ($0.05/$0.1) - 2023/04/08 21:04:04
Table 'RushAndCash3780343' 6-max Seat #1 is the button
Seat 1: c89af454 ($18.68 in chips)
Seat 2: 3a1e6474 ($20.71 in chips)
Seat 3: a7288e4 ($10.76 in chips)
Seat 4: ed2461d3 ($27.16 in chips)
Seat 5: d318a3f7 ($10 in chips)
Seat 6: Hero ($5.58 in chips)
3a1e6474: posts small blind $0.05
a7288e4: posts big blind $0.1
*** HOLE CARDS ***
Dealt to c89af454 
Dealt to 3a1e6474 
Dealt to a7288e4 
Dealt to ed2461d3 
Dealt to d318a3f7 
Dealt to Hero [4h 9h]
ed2461d3: folds
d318a3f7: raises $0.15 to $0.25
Hero: folds
c89af454: folds
3a1e6474: folds
a7288e4: raises $0.75 to $1
d318a3f7: calls $0.75
*** FLOP *** [As 7d 6c]
a7288e4: bets $0.75
d318a3f7: calls $0.75
*** TURN *** [As 7d 6c] [Th]
a7288e4: bets $2.67
d318a3f7: raises $5.58 to $8.25 and is all-in
a7288e4: calls $5.58
d318a3f7: shows [Ts Jc] (Pair of Tens)
a7288e4: shows [Ac Qc] (Pair of Aces)
a7288e4: Chooses to EV Cashout 
*** RIVER *** [As 7d 6c Th] [8c]
a7288e4: Pays Cashout Risk ($2.41)
*** SHOWDOWN ***
a7288e4 collected $19.6 from pot
*** SUMMARY ***
Total pot $20.05 | Rake $0.3 | Jackpot $0.15 | Bingo $0 | Fortune $0
Board [As 7d 6c Th 8c]
Seat 1: c89af454 (button) folded before Flop (didn't bet)
Seat 2: 3a1e6474 (small blind) folded before Flop
Seat 3: a7288e4 (big blind) showed [Ac Qc] and won ($19.6) with Pair of Aces, Cashout Risk ($2.41)
Seat 4: ed2461d3 folded before Flop (didn't bet)
Seat 5: d318a3f7 showed [Ts Jc] and lost with Pair of Tens
Seat 6: Hero folded before Flop (didn't bet)


Poker Hand #RC1459944992: Hold'em No Limit  ($0.05/$0.1) - 2023/04/08 21:03:48
Table 'RushAndCash3780252' 6-max Seat #1 is the button
Seat 1: 3c8bca42 ($15.86 in chips)
Seat 2: 7d679fa8 ($10.43 in chips)
Seat 3: 3563eab4 ($6.82 in chips)
Seat 4: Hero ($5.58 in chips)
Seat 5: b808e640 ($11.9 in chips)
Seat 6: fe74b7c3 ($18.85 in chips)
7d679fa8: posts small blind $0.05
3563eab4: posts big blind $0.1
*** HOLE CARDS ***
Dealt to 3c8bca42 
Dealt to 7d679fa8 
Dealt to 3563eab4 
Dealt to Hero [9s 3s]
Dealt to b808e640 
Dealt to fe74b7c3 
Hero: folds
b808e640: folds
fe74b7c3: folds
3c8bca42: raises $0.15 to $0.25
7d679fa8: folds
3563eab4: calls $0.15
*** FLOP *** [7d Ac 5d]
3563eab4: checks
3c8bca42: bets $0.19
3563eab4: folds
Uncalled bet ($0.19) returned to 3c8bca42
*** SHOWDOWN ***
3c8bca42 collected $0.53 from pot
*** SUMMARY ***
Total pot $0.55 | Rake $0.02 | Jackpot $0 | Bingo $0 | Fortune $0
Board [7d Ac 5d]
Seat 1: 3c8bca42 (button) won ($0.53)
Seat 2: 7d679fa8 (small blind) folded before Flop
Seat 3: 3563eab4 (big blind) folded on the Flop
Seat 4: Hero folded before Flop (didn't bet)
Seat 5: b808e640 folded before Flop (didn't bet)
Seat 6: fe74b7c3 folded before Flop (didn't bet)


Poker Hand #RC1459944817: Hold'em No Limit  ($0.05/$0.1) - 2023/04/08 21:03:15
Table 'RushAndCash3780077' 6-max Seat #1 is the button
Seat 1: 11ef0c8 ($17.35 in chips)
Seat 2: 83aef8ba ($10 in chips)
Seat 3: Hero ($5.68 in chips)
Seat 4: 29a17827 ($10.35 in chips)
Seat 5: 4d7c3654 ($12.46 in chips)
Seat 6: 604f40ce ($10.66 in chips)
83aef8ba: posts small blind $0.05
Hero: posts big blind $0.1
*** HOLE CARDS ***
Dealt to 11ef0c8 
Dealt to 83aef8ba 
Dealt to Hero [Ts 8c]
Dealt to 29a17827 
Dealt to 4d7c3654 
Dealt to 604f40ce 
29a17827: folds
4d7c3654: folds
604f40ce: folds
11ef0c8: folds
83aef8ba: raises $0.15 to $0.25
Hero: folds
Uncalled bet ($0.15) returned to 83aef8ba
*** SHOWDOWN ***
83aef8ba collected $0.2 from pot
*** SUMMARY ***
Total pot $0.2 | Rake $0 | Jackpot $0 | Bingo $0 | Fortune $0
Seat 1: 11ef0c8 (button) folded before Flop (didn't bet)
Seat 2: 83aef8ba (small blind) collected ($0.2)
Seat 3: Hero (big blind) folded before Flop
Seat 4: 29a17827 folded before Flop (didn't bet)
Seat 5: 4d7c3654 folded before Flop (didn't bet)
Seat 6: 604f40ce folded before Flop (didn't bet)


Poker Hand #RC1459944788: Hold'em No Limit  ($0.05/$0.1) - 2023/04/08 21:03:10
Table 'RushAndCash3780048' 6-max Seat #1 is the button
Seat 1: Hero ($5.68 in chips)
Seat 2: e77be94e ($18.23 in chips)
Seat 3: 551d9a48 ($9.36 in chips)
Seat 4: 3077b607 ($11.25 in chips)
Seat 5: 68888d2b ($65.4 in chips)
Seat 6: 41a252da ($10.35 in chips)
e77be94e: posts small blind $0.05
551d9a48: posts big blind $0.1
*** HOLE CARDS ***
Dealt to Hero [5d Jc]
Dealt to e77be94e 
Dealt to 551d9a48 
Dealt to 3077b607 
Dealt to 68888d2b 
Dealt to 41a252da 
3077b607: raises $0.2 to $0.3
68888d2b: folds
41a252da: raises $0.45 to $0.75
Hero: folds
e77be94e: folds
551d9a48: folds
3077b607: raises $1.44 to $2.19
41a252da: folds
Uncalled bet ($1.44) returned to 3077b607
*** SHOWDOWN ***
3077b607 collected $1.57 from pot
*** SUMMARY ***
Total pot $1.65 | Rake $0.08 | Jackpot $0 | Bingo $0 | Fortune $0
Seat 1: Hero (button) folded before Flop (didn't bet)
Seat 2: e77be94e (small blind) folded before Flop
Seat 3: 551d9a48 (big blind) folded before Flop
Seat 4: 3077b607 collected ($1.57)
Seat 5: 68888d2b folded before Flop (didn't bet)
Seat 6: 41a252da folded before Flop


Poker Hand #RC1459914711: Hold'em No Limit  ($0.05/$0.1) - 2023/04/08 21:02:55
Table 'RushAndCash3779971' 6-max Seat #1 is the button
Seat 1: 7e48b8ec ($7.13 in chips)
Seat 2: 93c20dae ($10.3 in chips)
Seat 3: Hero ($5.78 in chips)
Seat 4: 1291d38a ($10.17 in chips)
Seat 5: f50fcede ($10 in chips)
Seat 6: 76db26dd ($11.29 in chips)
93c20dae: posts small blind $0.05
Hero: posts big blind $0.1
*** HOLE CARDS ***
Dealt to 7e48b8ec 
Dealt to 93c20dae 
Dealt to Hero [2h 7c]
Dealt to 1291d38a 
Dealt to f50fcede 
Dealt to 76db26dd 
1291d38a: folds
f50fcede: raises $0.15 to $0.25
76db26dd: folds
7e48b8ec: folds
93c20dae: folds
Hero: folds
Uncalled bet ($0.15) returned to f50fcede
*** SHOWDOWN ***
f50fcede collected $0.25 from pot
*** SUMMARY ***
Total pot $0.25 | Rake $0 | Jackpot $0 | Bingo $0 | Fortune $0
Seat 1: 7e48b8ec (button) folded before Flop (didn't bet)
Seat 2: 93c20dae (small blind) folded before Flop
Seat 3: Hero (big blind) folded before Flop
Seat 4: 1291d38a folded before Flop (didn't bet)
Seat 5: f50fcede collected ($0.25)
Seat 6: 76db26dd folded before Flop (didn't bet)


Poker Hand #RC1459914681: Hold'em No Limit  ($0.05/$0.1) - 2023/04/08 21:02:48
Table 'RushAndCash3779941' 6-max Seat #1 is the button
Seat 1: 353d8669 ($12.49 in chips)
Seat 2: 3077b607 ($11.3 in chips)
Seat 3: 4d15c58 ($10 in chips)
Seat 4: a8745400 ($18.7 in chips)
Seat 5: f4b5f867 ($10 in chips)
Seat 6: Hero ($5.78 in chips)
3077b607: posts small blind $0.05
4d15c58: posts big blind $0.1
*** HOLE CARDS ***
Dealt to 353d8669 
Dealt to 3077b607 
Dealt to 4d15c58 
Dealt to a8745400 
Dealt to f4b5f867 
Dealt to Hero [Ac 5s]
a8745400: folds
f4b5f867: folds
Hero: folds
353d8669: folds
3077b607: folds
Uncalled bet ($0.05) returned to 4d15c58
*** SHOWDOWN ***
4d15c58 collected $0.1 from pot
*** SUMMARY ***
Total pot $0.1 | Rake $0 | Jackpot $0 | Bingo $0 | Fortune $0
Seat 1: 353d8669 (button) folded before Flop (didn't bet)
Seat 2: 3077b607 (small blind) folded before Flop
Seat 3: 4d15c58 (big blind) collected ($0.1)
Seat 4: a8745400 folded before Flop (didn't bet)
Seat 5: f4b5f867 folded before Flop (didn't bet)
Seat 6: Hero folded before Flop (didn't bet)


Poker Hand #RC1459914646: Hold'em No Limit  ($0.05/$0.1) - 2023/04/08 21:02:41
Table 'RushAndCash3779906' 6-max Seat #1 is the button
Seat 1: Hero ($5.78 in chips)
Seat 2: 3f5172f1 ($10.05 in chips)
Seat 3: 3c8bca42 ($15.91 in chips)
Seat 4: cd49688f ($13.78 in chips)
Seat 5: 28631210 ($12.45 in chips)
Seat 6: 6dc4f553 ($13.28 in chips)
3f5172f1: posts small blind $0.05
3c8bca42: posts big blind $0.1
*** HOLE CARDS ***
Dealt to Hero [Kc 2s]
Dealt to 3f5172f1 
Dealt to 3c8bca42 
Dealt to cd49688f 
Dealt to 28631210 
Dealt to 6dc4f553 
cd49688f: folds
28631210: folds
6dc4f553: folds
Hero: folds
3f5172f1: folds
Uncalled bet ($0.05) returned to 3c8bca42
*** SHOWDOWN ***
3c8bca42 collected $0.1 from pot
*** SUMMARY ***
Total pot $0.1 | Rake $0 | Jackpot $0 | Bingo $0 | Fortune $0
Seat 1: Hero (button) folded before Flop (didn't bet)
Seat 2: 3f5172f1 (small blind) folded before Flop
Seat 3: 3c8bca42 (big blind) collected ($0.1)
Seat 4: cd49688f folded before Flop (didn't bet)
Seat 5: 28631210 folded before Flop (didn't bet)
Seat 6: 6dc4f553 folded before Flop (didn't bet)


Poker Hand #RC1459914597: Hold'em No Limit  ($0.05/$0.1) - 2023/04/08 21:02:32
Table 'RushAndCash3779857' 6-max Seat #1 is the button
Seat 1: 86a5a60 ($10 in chips)
Seat 2: 4a10fc3e ($11.27 in chips)
Seat 3: 3cf396cc ($10.25 in chips)
Seat 4: 8b7f3a1d ($10.37 in chips)
Seat 5: cacd032a ($9.6 in chips)
Seat 6: Hero ($5.78 in chips)
4a10fc3e: posts small blind $0.05
3cf396cc: posts big blind $0.1
*** HOLE CARDS ***
Dealt to 86a5a60 
Dealt to 4a10fc3e 
Dealt to 3cf396cc 
Dealt to 8b7f3a1d 
Dealt to cacd032a 
Dealt to Hero [2s 7h]
8b7f3a1d: folds
cacd032a: folds
Hero: folds
86a5a60: raises $0.15 to $0.25
4a10fc3e: folds
3cf396cc: folds
Uncalled bet ($0.15) returned to 86a5a60
*** SHOWDOWN ***
86a5a60 collected $0.25 from pot
*** SUMMARY ***
Total pot $0.25 | Rake $0 | Jackpot $0 | Bingo $0 | Fortune $0
Seat 1: 86a5a60 (button) collected ($0.25)
Seat 2: 4a10fc3e (small blind) folded before Flop
Seat 3: 3cf396cc (big blind) folded before Flop
Seat 4: 8b7f3a1d folded before Flop (didn't bet)
Seat 5: cacd032a folded before Flop (didn't bet)
Seat 6: Hero folded before Flop (didn't bet)


Poker Hand #RC1459914577: Hold'em No Limit  ($0.05/$0.1) - 2023/04/08 21:02:28
Table 'RushAndCash3779837' 6-max Seat #1 is the button
Seat 1: 5a721ebb ($14.01 in chips)
Seat 2: Hero ($5.83 in chips)
Seat 3: 5a0d0450 ($9.85 in chips)
Seat 4: 9bd24777 ($10.15 in chips)
Seat 5: 9046d9c0 ($23.94 in chips)
Seat 6: 8747e8cd ($10.15 in chips)
Hero: posts small blind $0.05
5a0d0450: posts big blind $0.1
*** HOLE CARDS ***
Dealt to 5a721ebb 
Dealt to Hero [8h Qc]
Dealt to 5a0d0450 
Dealt to 9bd24777 
Dealt to 9046d9c0 
Dealt to 8747e8cd 
9bd24777: raises $0.15 to $0.25
9046d9c0: folds
8747e8cd: raises $0.55 to $0.8
5a721ebb: folds
Hero: folds
5a0d0450: folds
9bd24777: calls $0.55
*** FLOP *** [Qd 3s 7s]
9bd24777: checks
8747e8cd: bets $0.44
9bd24777: folds
Uncalled bet ($0.44) returned to 8747e8cd
*** SHOWDOWN ***
8747e8cd collected $1.67 from pot
*** SUMMARY ***
Total pot $1.75 | Rake $0.08 | Jackpot $0 | Bingo $0 | Fortune $0
Board [Qd 3s 7s]
Seat 1: 5a721ebb (button) folded before Flop (didn't bet)
Seat 2: Hero (small blind) folded before Flop
Seat 3: 5a0d0450 (big blind) folded before Flop
Seat 4: 9bd24777 folded on the Flop
Seat 5: 9046d9c0 folded before Flop (didn't bet)
Seat 6: 8747e8cd won ($1.67)


Poker Hand #RC1459914542: Hold'em No Limit  ($0.05/$0.1) - 2023/04/08 21:02:22
Table 'RushAndCash3779802' 6-max Seat #1 is the button
Seat 1: 8dd09433 ($17.14 in chips)
Seat 2: 6a138b47 ($19.08 in chips)
Seat 3: 9ea6cc1 ($18.73 in chips)
Seat 4: Hero ($5.83 in chips)
Seat 5: 61fc2783 ($15.03 in chips)
Seat 6: 2e2255e7 ($19.47 in chips)
6a138b47: posts small blind $0.05
9ea6cc1: posts big blind $0.1
*** HOLE CARDS ***
Dealt to 8dd09433 
Dealt to 6a138b47 
Dealt to 9ea6cc1 
Dealt to Hero [7d Qd]
Dealt to 61fc2783 
Dealt to 2e2255e7 
Hero: folds
61fc2783: folds
2e2255e7: folds
8dd09433: folds
6a138b47: raises $0.1 to $0.2
9ea6cc1: calls $0.1
*** FLOP *** [9h Jd 4s]
6a138b47: bets $0.15
9ea6cc1: calls $0.15
*** TURN *** [9h Jd 4s] [Kh]
6a138b47: bets $0.45
9ea6cc1: folds
Uncalled bet ($0.45) returned to 6a138b47
*** SHOWDOWN ***
6a138b47 collected $0.67 from pot
*** SUMMARY ***
Total pot $0.7 | Rake $0.03 | Jackpot $0 | Bingo $0 | Fortune $0
Board [9h Jd 4s Kh]
Seat 1: 8dd09433 (button) folded before Flop (didn't bet)
Seat 2: 6a138b47 (small blind) won ($0.67)
Seat 3: 9ea6cc1 (big blind) folded on the Turn
Seat 4: Hero folded before Flop (didn't bet)
Seat 5: 61fc2783 folded before Flop (didn't bet)
Seat 6: 2e2255e7 folded before Flop (didn't bet)


Poker Hand #RC1459914499: Hold'em No Limit  ($0.05/$0.1) - 2023/04/08 21:02:15
Table 'RushAndCash3779759' 6-max Seat #1 is the button
Seat 1: dfe0f72a ($10.05 in chips)
Seat 2: c0b0be95 ($29.31 in chips)
Seat 3: Hero ($5.78 in chips)
Seat 4: 55ac3cd6 ($10 in chips)
Seat 5: 39c1fa2c ($29.73 in chips)
Seat 6: 94f887a ($13.17 in chips)
c0b0be95: posts small blind $0.05
Hero: posts big blind $0.1
*** HOLE CARDS ***
Dealt to dfe0f72a 
Dealt to c0b0be95 
Dealt to Hero [Qs 8s]
Dealt to 55ac3cd6 
Dealt to 39c1fa2c 
Dealt to 94f887a 
55ac3cd6: folds
39c1fa2c: folds
94f887a: folds
dfe0f72a: folds
c0b0be95: folds
Uncalled bet ($0.05) returned to Hero
*** SHOWDOWN ***
Hero collected $0.1 from pot
*** SUMMARY ***
Total pot $0.1 | Rake $0 | Jackpot $0 | Bingo $0 | Fortune $0
Seat 1: dfe0f72a (button) folded before Flop (didn't bet)
Seat 2: c0b0be95 (small blind) folded before Flop
Seat 3: Hero (big blind) collected ($0.1)
Seat 4: 55ac3cd6 folded before Flop (didn't bet)
Seat 5: 39c1fa2c folded before Flop (didn't bet)
Seat 6: 94f887a folded before Flop (didn't bet)


Poker Hand #RC1459914475: Hold'em No Limit  ($0.05/$0.1) - 2023/04/08 21:02:10
Table 'RushAndCash3779735' 6-max Seat #1 is the button
Seat 1: 94f887a ($13.17 in chips)
Seat 2: b0a8299d ($10.61 in chips)
Seat 3: 8f6da20c ($9.9 in chips)
Seat 4: Hero ($5.78 in chips)
Seat 5: 95c94948 ($10.27 in chips)
Seat 6: 39c1fa2c ($29.73 in chips)
b0a8299d: posts small blind $0.05
8f6da20c: posts big blind $0.1
*** HOLE CARDS ***
Dealt to 94f887a 
Dealt to b0a8299d 
Dealt to 8f6da20c 
Dealt to Hero [5c 6h]
Dealt to 95c94948 
Dealt to 39c1fa2c 
Hero: folds
95c94948: folds
39c1fa2c: folds
94f887a: folds
b0a8299d: raises $0.11 to $0.21
8f6da20c: folds
Uncalled bet ($0.11) returned to b0a8299d
*** SHOWDOWN ***
b0a8299d collected $0.2 from pot
*** SUMMARY ***
Total pot $0.2 | Rake $0 | Jackpot $0 | Bingo $0 | Fortune $0
Seat 1: 94f887a (button) folded before Flop (didn't bet)
Seat 2: b0a8299d (small blind) collected ($0.2)
Seat 3: 8f6da20c (big blind) folded before Flop
Seat 4: Hero folded before Flop (didn't bet)
Seat 5: 95c94948 folded before Flop (didn't bet)
Seat 6: 39c1fa2c folded before Flop (didn't bet)


Poker Hand #RC1459914454: Hold'em No Limit  ($0.05/$0.1) - 2023/04/08 21:02:06
Table 'RushAndCash3779714' 6-max Seat #1 is the button
Seat 1: cc1db7ef ($14.04 in chips)
Seat 2: Hero ($5.83 in chips)
Seat 3: e19f4a02 ($12.03 in chips)
Seat 4: 7a92f977 ($10.41 in chips)
Seat 5: 29a17827 ($10.2 in chips)
Seat 6: 6c98edc ($10.19 in chips)
Hero: posts small blind $0.05
e19f4a02: posts big blind $0.1
*** HOLE CARDS ***
Dealt to cc1db7ef 
Dealt to Hero [3c 7h]
Dealt to e19f4a02 
Dealt to 7a92f977 
Dealt to 29a17827 
Dealt to 6c98edc 
7a92f977: folds
29a17827: folds
6c98edc: folds
cc1db7ef: raises $0.2 to $0.3
Hero: folds
e19f4a02: calls $0.2
*** FLOP *** [Th 4d 2c]
e19f4a02: checks
cc1db7ef: bets $0.33
e19f4a02: calls $0.33
*** TURN *** [Th 4d 2c] [2h]
e19f4a02: checks
cc1db7ef: checks
*** RIVER *** [Th 4d 2c 2h] [Ts]
e19f4a02: bets $0.6
cc1db7ef: folds
Uncalled bet ($0.6) returned to e19f4a02
*** SHOWDOWN ***
e19f4a02 collected $1.25 from pot
*** SUMMARY ***
Total pot $1.31 | Rake $0.06 | Jackpot $0 | Bingo $0 | Fortune $0
Board [Th 4d 2c 2h Ts]
Seat 1: cc1db7ef (button) folded on the River
Seat 2: Hero (small blind) folded before Flop
Seat 3: e19f4a02 (big blind) won ($1.25)
Seat 4: 7a92f977 folded before Flop (didn't bet)
Seat 5: 29a17827 folded before Flop (didn't bet)
Seat 6: 6c98edc folded before Flop (didn't bet)


Poker Hand #RC1459914429: Hold'em No Limit  ($0.05/$0.1) - 2023/04/08 21:02:02
Table 'RushAndCash3779689' 6-max Seat #1 is the button
Seat 1: Hero ($5.83 in chips)
Seat 2: 8ea699cf ($10 in chips)
Seat 3: 5dd0454d ($9.35 in chips)
Seat 4: e19f4a02 ($12.03 in chips)
Seat 5: 1c6c6beb ($6.26 in chips)
Seat 6: bd239c00 ($10.4 in chips)
8ea699cf: posts small blind $0.05
5dd0454d: posts big blind $0.1
*** HOLE CARDS ***
Dealt to Hero [8s 6d]
Dealt to 8ea699cf 
Dealt to 5dd0454d 
Dealt to e19f4a02 
Dealt to 1c6c6beb 
Dealt to bd239c00 
e19f4a02: folds
1c6c6beb: folds
bd239c00: folds
Hero: folds
8ea699cf: folds
Uncalled bet ($0.05) returned to 5dd0454d
*** SHOWDOWN ***
5dd0454d collected $0.1 from pot
*** SUMMARY ***
Total pot $0.1 | Rake $0 | Jackpot $0 | Bingo $0 | Fortune $0
Seat 1: Hero (button) folded before Flop (didn't bet)
Seat 2: 8ea699cf (small blind) folded before Flop
Seat 3: 5dd0454d (big blind) collected ($0.1)
Seat 4: e19f4a02 folded before Flop (didn't bet)
Seat 5: 1c6c6beb folded before Flop (didn't bet)
Seat 6: bd239c00 folded before Flop (didn't bet)


Poker Hand #RC1459914403: Hold'em No Limit  ($0.05/$0.1) - 2023/04/08 21:01:58
Table 'RushAndCash3779663' 6-max Seat #1 is the button
Seat 1: e7de0df5 ($7.99 in chips)
Seat 2: fc9fb2a6 ($10.38 in chips)
Seat 3: f21ae2a ($21.67 in chips)
Seat 4: 24bc78ed ($13.97 in chips)
Seat 5: 604f40ce ($10.81 in chips)
Seat 6: Hero ($5.83 in chips)
fc9fb2a6: posts small blind $0.05
f21ae2a: posts big blind $0.1
*** HOLE CARDS ***
Dealt to e7de0df5 
Dealt to fc9fb2a6 
Dealt to f21ae2a 
Dealt to 24bc78ed 
Dealt to 604f40ce 
Dealt to Hero [6d 4s]
24bc78ed: folds
604f40ce: folds
Hero: folds
e7de0df5: folds
fc9fb2a6: folds
Uncalled bet ($0.05) returned to f21ae2a
*** SHOWDOWN ***
f21ae2a collected $0.1 from pot
*** SUMMARY ***
Total pot $0.1 | Rake $0 | Jackpot $0 | Bingo $0 | Fortune $0
Seat 1: e7de0df5 (button) folded before Flop (didn't bet)
Seat 2: fc9fb2a6 (small blind) folded before Flop
Seat 3: f21ae2a (big blind) collected ($0.1)
Seat 4: 24bc78ed folded before Flop (didn't bet)
Seat 5: 604f40ce folded before Flop (didn't bet)
Seat 6: Hero folded before Flop (didn't bet)


Poker Hand #RC1459914370: Hold'em No Limit  ($0.05/$0.1) - 2023/04/08 21:01:52
Table 'RushAndCash3779630' 6-max Seat #1 is the button
Seat 1: 83fce378 ($56 in chips)
Seat 2: 8a38d99 ($22.79 in chips)
Seat 3: Hero ($5.93 in chips)
Seat 4: 86440a84 ($10 in chips)
Seat 5: e6643b4c ($9.67 in chips)
Seat 6: f18ec573 ($28.37 in chips)
8a38d99: posts small blind $0.05
Hero: posts big blind $0.1
*** HOLE CARDS ***
Dealt to 83fce378 
Dealt to 8a38d99 
Dealt to Hero [As 3c]
Dealt to 86440a84 
Dealt to e6643b4c 
Dealt to f18ec573 
86440a84: raises $0.12 to $0.22
e6643b4c: raises $0.59 to $0.81
f18ec573: folds
83fce378: folds
8a38d99: folds
Hero: folds
86440a84: calls $0.59
*** FLOP *** [Ad 7d Js]
86440a84: checks
e6643b4c: bets $1.17
86440a84: calls $1.17
*** TURN *** [Ad 7d Js] [6h]
86440a84: checks
e6643b4c: bets $1.36
86440a84: calls $1.36
*** RIVER *** [Ad 7d Js 6h] [5s]
86440a84: checks
e6643b4c: bets $6.33 and is all-in
86440a84: folds
Uncalled bet ($6.33) returned to e6643b4c
*** SHOWDOWN ***
e6643b4c collected $6.38 from pot
*** SUMMARY ***
Total pot $6.83 | Rake $0.3 | Jackpot $0.15 | Bingo $0 | Fortune $0
Board [Ad 7d Js 6h 5s]
Seat 1: 83fce378 (button) folded before Flop (didn't bet)
Seat 2: 8a38d99 (small blind) folded before Flop
Seat 3: Hero (big blind) folded before Flop
Seat 4: 86440a84 folded on the River
Seat 5: e6643b4c won ($6.38)
Seat 6: f18ec573 folded before Flop (didn't bet)


Poker Hand #RC1459914257: Hold'em No Limit  ($0.05/$0.1) - 2023/04/08 21:01:31
Table 'RushAndCash3779517' 6-max Seat #1 is the button
Seat 1: 143e7da4 ($28.9 in chips)
Seat 2: 9046d9c0 ($23.94 in chips)
Seat 3: 3767087b ($6.02 in chips)
Seat 4: Hero ($6.18 in chips)
Seat 5: e6643b4c ($9.3 in chips)
Seat 6: b60787b3 ($13.69 in chips)
9046d9c0: posts small blind $0.05
3767087b: posts big blind $0.1
*** HOLE CARDS ***
Dealt to 143e7da4 
Dealt to 9046d9c0 
Dealt to 3767087b 
Dealt to Hero [Qd Td]
Dealt to e6643b4c 
Dealt to b60787b3 
Hero: raises $0.15 to $0.25
e6643b4c: raises $0.65 to $0.9
b60787b3: folds
143e7da4: folds
9046d9c0: folds
3767087b: folds
Hero: folds
Uncalled bet ($0.65) returned to e6643b4c
*** SHOWDOWN ***
e6643b4c collected $0.62 from pot
*** SUMMARY ***
Total pot $0.65 | Rake $0.03 | Jackpot $0 | Bingo $0 | Fortune $0
Seat 1: 143e7da4 (button) folded before Flop (didn't bet)
Seat 2: 9046d9c0 (small blind) folded before Flop
Seat 3: 3767087b (big blind) folded before Flop
Seat 4: Hero folded before Flop
Seat 5: e6643b4c collected ($0.62)
Seat 6: b60787b3 folded before Flop (didn't bet)


Poker Hand #RC1459914188: Hold'em No Limit  ($0.05/$0.1) - 2023/04/08 21:01:19
Table 'RushAndCash3779448' 6-max Seat #1 is the button
Seat 1: 9f5f3bc5 ($13.47 in chips)
Seat 2: 31782351 ($36.66 in chips)
Seat 3: 94cba572 ($10.15 in chips)
Seat 4: Hero ($6.03 in chips)
Seat 5: 166da242 ($11.32 in chips)
Seat 6: 101ae7e ($12.46 in chips)
31782351: posts small blind $0.05
94cba572: posts big blind $0.1
*** HOLE CARDS ***
Dealt to 9f5f3bc5 
Dealt to 31782351 
Dealt to 94cba572 
Dealt to Hero [9c 8c]
Dealt to 166da242 
Dealt to 101ae7e 
Hero: raises $0.15 to $0.25
166da242: folds
101ae7e: folds
9f5f3bc5: folds
31782351: folds
94cba572: folds
Uncalled bet ($0.15) returned to Hero
*** SHOWDOWN ***
Hero collected $0.25 from pot
*** SUMMARY ***
Total pot $0.25 | Rake $0 | Jackpot $0 | Bingo $0 | Fortune $0
Seat 1: 9f5f3bc5 (button) folded before Flop (didn't bet)
Seat 2: 31782351 (small blind) folded before Flop
Seat 3: 94cba572 (big blind) folded before Flop
Seat 4: Hero collected ($0.25)
Seat 5: 166da242 folded before Flop (didn't bet)
Seat 6: 101ae7e folded before Flop (didn't bet)


Poker Hand #RC1459914162: Hold'em No Limit  ($0.05/$0.1) - 2023/04/08 21:01:14
Table 'RushAndCash3779422' 6-max Seat #1 is the button
Seat 1: 48141ef1 ($8.28 in chips)
Seat 2: Hero ($6.08 in chips)
Seat 3: 47699031 ($10.17 in chips)
Seat 4: 7a227c73 ($11.71 in chips)
Seat 5: eff44734 ($10.89 in chips)
Seat 6: c57a3d6 ($27.48 in chips)
Hero: posts small blind $0.05
47699031: posts big blind $0.1
*** HOLE CARDS ***
Dealt to 48141ef1 
Dealt to Hero [7h 8s]
Dealt to 47699031 
Dealt to 7a227c73 
Dealt to eff44734 
Dealt to c57a3d6 
7a227c73: folds
eff44734: raises $0.2 to $0.3
c57a3d6: folds
48141ef1: folds
Hero: folds
47699031: calls $0.2
*** FLOP *** [2s Qd 8h]
47699031: checks
eff44734: bets $0.22
47699031: calls $0.22
*** TURN *** [2s Qd 8h] [6h]
47699031: checks
eff44734: checks
*** RIVER *** [2s Qd 8h 6h] [Ts]
47699031: bets $0.55
eff44734: folds
Uncalled bet ($0.55) returned to 47699031
*** SHOWDOWN ***
47699031 collected $1.04 from pot
*** SUMMARY ***
Total pot $1.09 | Rake $0.05 | Jackpot $0 | Bingo $0 | Fortune $0
Board [2s Qd 8h 6h Ts]
Seat 1: 48141ef1 (button) folded before Flop (didn't bet)
Seat 2: Hero (small blind) folded before Flop
Seat 3: 47699031 (big blind) won ($1.04)
Seat 4: 7a227c73 folded before Flop (didn't bet)
Seat 5: eff44734 folded on the River
Seat 6: c57a3d6 folded before Flop (didn't bet)


Poker Hand #RC1459914134: Hold'em No Limit  ($0.05/$0.1) - 2023/04/08 21:01:09
Table 'RushAndCash3779394' 6-max Seat #1 is the button
Seat 1: e446e9d0 ($10.05 in chips)
Seat 2: b03e9cca ($14.94 in chips)
Seat 3: 4c996243 ($15.15 in chips)
Seat 4: bec324ab ($9.7 in chips)
Seat 5: Hero ($6.08 in chips)
Seat 6: 9184b3f7 ($10.11 in chips)
b03e9cca: posts small blind $0.05
4c996243: posts big blind $0.1
*** HOLE CARDS ***
Dealt to e446e9d0 
Dealt to b03e9cca 
Dealt to 4c996243 
Dealt to bec324ab 
Dealt to Hero [8h Js]
Dealt to 9184b3f7 
bec324ab: folds
Hero: folds
9184b3f7: raises $0.15 to $0.25
e446e9d0: raises $0.49 to $0.74
b03e9cca: folds
4c996243: folds
9184b3f7: folds
Uncalled bet ($0.49) returned to e446e9d0
*** SHOWDOWN ***
e446e9d0 collected $0.62 from pot
*** SUMMARY ***
Total pot $0.65 | Rake $0.03 | Jackpot $0 | Bingo $0 | Fortune $0
Seat 1: e446e9d0 (button) collected ($0.62)
Seat 2: b03e9cca (small blind) folded before Flop
Seat 3: 4c996243 (big blind) folded before Flop
Seat 4: bec324ab folded before Flop (didn't bet)
Seat 5: Hero folded before Flop (didn't bet)
Seat 6: 9184b3f7 folded before Flop


Poker Hand #RC1459914114: Hold'em No Limit  ($0.05/$0.1) - 2023/04/08 21:01:05
Table 'RushAndCash3779374' 6-max Seat #1 is the button
Seat 1: 7a227c73 ($11.71 in chips)
Seat 2: 9448719a ($20.28 in chips)
Seat 3: 28631210 ($12.9 in chips)
Seat 4: Hero ($6.08 in chips)
Seat 5: a438ad41 ($6.27 in chips)
Seat 6: 54403935 ($12.27 in chips)
9448719a: posts small blind $0.05
28631210: posts big blind $0.1
*** HOLE CARDS ***
Dealt to 7a227c73 
Dealt to 9448719a 
Dealt to 28631210 
Dealt to Hero [Tc 6d]
Dealt to a438ad41 
Dealt to 54403935 
Hero: folds
a438ad41: raises $0.16 to $0.26
54403935: folds
7a227c73: folds
9448719a: raises $0.84 to $1.1
28631210: folds
a438ad41: calls $0.84
*** FLOP *** [Js 8d 5d]
9448719a: checks
a438ad41: checks
*** TURN *** [Js 8d 5d] [4c]
9448719a: bets $1.15
a438ad41: calls $1.15
*** RIVER *** [Js 8d 5d 4c] [3c]
9448719a: bets $2.3
a438ad41: calls $2.3
9448719a: shows [Jc Ac] (Pair of Jacks)
a438ad41: shows [Qh Ad] (Ace-High)
*** SHOWDOWN ***
9448719a collected $8.75 from pot
*** SUMMARY ***
Total pot $9.2 | Rake $0.3 | Jackpot $0.15 | Bingo $0 | Fortune $0
Board [Js 8d 5d 4c 3c]
Seat 1: 7a227c73 (button) folded before Flop (didn't bet)
Seat 2: 9448719a (small blind) showed [Jc Ac] and won ($8.75) with Pair of Jacks
Seat 3: 28631210 (big blind) folded before Flop
Seat 4: Hero folded before Flop (didn't bet)
Seat 5: a438ad41 showed [Qh Ad] and lost with Ace-High
Seat 6: 54403935 folded before Flop (didn't bet)


Poker Hand #RC1459914042: Hold'em No Limit  ($0.05/$0.1) - 2023/04/08 21:00:53
Table 'RushAndCash3779302' 6-max Seat #1 is the button
Seat 1: Hero ($6.08 in chips)
Seat 2: ddc225b6 ($10.64 in chips)
Seat 3: 587a017c ($104.19 in chips)
Seat 4: 9a83057 ($10.15 in chips)
Seat 5: caed7b6f ($18.97 in chips)
Seat 6: 6276705 ($10.57 in chips)
ddc225b6: posts small blind $0.05
587a017c: posts big blind $0.1
*** HOLE CARDS ***
Dealt to Hero [3d Qc]
Dealt to ddc225b6 
Dealt to 587a017c 
Dealt to 9a83057 
Dealt to caed7b6f 
Dealt to 6276705 
9a83057: raises $0.12 to $0.22
caed7b6f: folds
6276705: folds
Hero: folds
ddc225b6: folds
587a017c: folds
Uncalled bet ($0.12) returned to 9a83057
*** SHOWDOWN ***
9a83057 collected $0.25 from pot
*** SUMMARY ***
Total pot $0.25 | Rake $0 | Jackpot $0 | Bingo $0 | Fortune $0
Seat 1: Hero (button) folded before Flop (didn't bet)
Seat 2: ddc225b6 (small blind) folded before Flop
Seat 3: 587a017c (big blind) folded before Flop
Seat 4: 9a83057 collected ($0.25)
Seat 5: caed7b6f folded before Flop (didn't bet)
Seat 6: 6276705 folded before Flop (didn't bet)


Poker Hand #RC1459914001: Hold'em No Limit  ($0.05/$0.1) - 2023/04/08 21:00:43
Table 'RushAndCash3779261' 6-max Seat #1 is the button
Seat 1: 49da03d9 ($31.54 in chips)
Seat 2: ca24ac96 ($10 in chips)
Seat 3: b4d78cbd ($12.33 in chips)
Seat 4: e7de0df5 ($7.77 in chips)
Seat 5: 50f2bcd ($10 in chips)
Seat 6: Hero ($6.08 in chips)
ca24ac96: posts small blind $0.05
b4d78cbd: posts big blind $0.1
*** HOLE CARDS ***
Dealt to 49da03d9 
Dealt to ca24ac96 
Dealt to b4d78cbd 
Dealt to e7de0df5 
Dealt to 50f2bcd 
Dealt to Hero [Td 4d]
e7de0df5: folds
50f2bcd: raises $0.12 to $0.22
Hero: folds
49da03d9: folds
ca24ac96: folds
b4d78cbd: folds
Uncalled bet ($0.12) returned to 50f2bcd
*** SHOWDOWN ***
50f2bcd collected $0.25 from pot
*** SUMMARY ***
Total pot $0.25 | Rake $0 | Jackpot $0 | Bingo $0 | Fortune $0
Seat 1: 49da03d9 (button) folded before Flop (didn't bet)
Seat 2: ca24ac96 (small blind) folded before Flop
Seat 3: b4d78cbd (big blind) folded before Flop
Seat 4: e7de0df5 folded before Flop (didn't bet)
Seat 5: 50f2bcd collected ($0.25)
Seat 6: Hero folded before Flop (didn't bet)


Poker Hand #RC1459913950: Hold'em No Limit  ($0.05/$0.1) - 2023/04/08 21:00:34
Table 'RushAndCash3779210' 6-max Seat #1 is the button
Seat 1: 2101b7fa ($10.8 in chips)
Seat 2: e414f212 ($27.61 in chips)
Seat 3: 447c4e6 ($64.12 in chips)
Seat 4: 8d2b1c55 ($23.82 in chips)
Seat 5: 3ed14450 ($10.15 in chips)
Seat 6: Hero ($6.08 in chips)
e414f212: posts small blind $0.05
447c4e6: posts big blind $0.1
*** HOLE CARDS ***
Dealt to 2101b7fa 
Dealt to e414f212 
Dealt to 447c4e6 
Dealt to 8d2b1c55 
Dealt to 3ed14450 
Dealt to Hero [6s 6d]
8d2b1c55: raises $0.2 to $0.3
3ed14450: folds
Hero: folds
2101b7fa: folds
e414f212: folds
447c4e6: folds
Uncalled bet ($0.2) returned to 8d2b1c55
*** SHOWDOWN ***
8d2b1c55 collected $0.25 from pot
*** SUMMARY ***
Total pot $0.25 | Rake $0 | Jackpot $0 | Bingo $0 | Fortune $0
Seat 1: 2101b7fa (button) folded before Flop (didn't bet)
Seat 2: e414f212 (small blind) folded before Flop
Seat 3: 447c4e6 (big blind) folded before Flop
Seat 4: 8d2b1c55 collected ($0.25)
Seat 5: 3ed14450 folded before Flop (didn't bet)
Seat 6: Hero folded before Flop (didn't bet)


Poker Hand #RC1459913926: Hold'em No Limit  ($0.05/$0.1) - 2023/04/08 21:00:30
Table 'RushAndCash3779186' 6-max Seat #1 is the button
Seat 1: 81b571a ($17.41 in chips)
Seat 2: b022ac81 ($21.04 in chips)
Seat 3: 3610c1a3 ($20.24 in chips)
Seat 4: Hero ($6.08 in chips)
Seat 5: 3294ece5 ($59.67 in chips)
Seat 6: 6c069f64 ($15.11 in chips)
b022ac81: posts small blind $0.05
3610c1a3: posts big blind $0.1
*** HOLE CARDS ***
Dealt to 81b571a 
Dealt to b022ac81 
Dealt to 3610c1a3 
Dealt to Hero [Jd 9h]
Dealt to 3294ece5 
Dealt to 6c069f64 
Hero: folds
3294ece5: raises $0.15 to $0.25
6c069f64: folds
81b571a: folds
b022ac81: calls $0.2
3610c1a3: folds
*** FLOP *** [6h 7d 7h]
b022ac81: checks
3294ece5: bets $0.18
b022ac81: calls $0.18
*** TURN *** [6h 7d 7h] [8s]
b022ac81: checks
3294ece5: checks
*** RIVER *** [6h 7d 7h 8s] [3h]
b022ac81: bets $0.32
3294ece5: folds
Uncalled bet ($0.32) returned to b022ac81
*** SHOWDOWN ***
b022ac81 collected $0.92 from pot
*** SUMMARY ***
Total pot $0.96 | Rake $0.04 | Jackpot $0 | Bingo $0 | Fortune $0
Board [6h 7d 7h 8s 3h]
Seat 1: 81b571a (button) folded before Flop (didn't bet)
Seat 2: b022ac81 (small blind) won ($0.92)
Seat 3: 3610c1a3 (big blind) folded before Flop
Seat 4: Hero folded before Flop (didn't bet)
Seat 5: 3294ece5 folded on the River
Seat 6: 6c069f64 folded before Flop (didn't bet)


Poker Hand #RC1459913880: Hold'em No Limit  ($0.05/$0.1) - 2023/04/08 21:00:22
Table 'RushAndCash3779140' 6-max Seat #1 is the button
Seat 1: 5a0d0450 ($10 in chips)
Seat 2: Hero ($6.13 in chips)
Seat 3: 49da03d9 ($31.69 in chips)
Seat 4: e414f212 ($27.46 in chips)
Seat 5: 675389ad ($7.93 in chips)
Seat 6: 6b6b5b7d ($9.85 in chips)
Hero: posts small blind $0.05
49da03d9: posts big blind $0.1
*** HOLE CARDS ***
Dealt to 5a0d0450 
Dealt to Hero [9s Ad]
Dealt to 49da03d9 
Dealt to e414f212 
Dealt to 675389ad 
Dealt to 6b6b5b7d 
e414f212: raises $0.15 to $0.25
675389ad: folds
6b6b5b7d: folds
5a0d0450: folds
Hero: folds
49da03d9: folds
Uncalled bet ($0.15) returned to e414f212
*** SHOWDOWN ***
e414f212 collected $0.25 from pot
*** SUMMARY ***
Total pot $0.25 | Rake $0 | Jackpot $0 | Bingo $0 | Fortune $0
Seat 1: 5a0d0450 (button) folded before Flop (didn't bet)
Seat 2: Hero (small blind) folded before Flop
Seat 3: 49da03d9 (big blind) folded before Flop
Seat 4: e414f212 collected ($0.25)
Seat 5: 675389ad folded before Flop (didn't bet)
Seat 6: 6b6b5b7d folded before Flop (didn't bet)


Poker Hand #RC1459913853: Hold'em No Limit  ($0.05/$0.1) - 2023/04/08 21:00:18
Table 'RushAndCash3779113' 6-max Seat #1 is the button
Seat 1: ad402a2 ($16.92 in chips)
Seat 2: da6980d ($32.97 in chips)
Seat 3: 3acdf15 ($27.04 in chips)
Seat 4: 4b5309d ($10 in chips)
Seat 5: Hero ($6.13 in chips)
Seat 6: 587a017c ($104.44 in chips)
da6980d: posts small blind $0.05
3acdf15: posts big blind $0.1
*** HOLE CARDS ***
Dealt to ad402a2 
Dealt to da6980d 
Dealt to 3acdf15 
Dealt to 4b5309d 
Dealt to Hero [6c Ad]
Dealt to 587a017c 
4b5309d: folds
Hero: folds
587a017c: raises $0.15 to $0.25
ad402a2: calls $0.25
da6980d: folds
3acdf15: calls $0.15
*** FLOP *** [Jd Qs 3h]
3acdf15: checks
587a017c: checks
ad402a2: bets $0.3
3acdf15: folds
587a017c: folds
Uncalled bet ($0.3) returned to ad402a2
*** SHOWDOWN ***
ad402a2 collected $0.76 from pot
*** SUMMARY ***
Total pot $0.8 | Rake $0.04 | Jackpot $0 | Bingo $0 | Fortune $0
Board [Jd Qs 3h]
Seat 1: ad402a2 (button) won ($0.76)
Seat 2: da6980d (small blind) folded before Flop
Seat 3: 3acdf15 (big blind) folded on the Flop
Seat 4: 4b5309d folded before Flop (didn't bet)
Seat 5: Hero folded before Flop (didn't bet)
Seat 6: 587a017c folded on the Flop


Poker Hand #RC1459913829: Hold'em No Limit  ($0.05/$0.1) - 2023/04/08 21:00:13
Table 'RushAndCash3779089' 6-max Seat #1 is the button
Seat 1: Hero ($6.13 in chips)
Seat 2: 97cca5f4 ($14.13 in chips)
Seat 3: 2261b544 ($12.64 in chips)
Seat 4: f18ec573 ($28.32 in chips)
Seat 5: 8db4f8f6 ($9.63 in chips)
Seat 6: b4d78cbd ($12.33 in chips)
97cca5f4: posts small blind $0.05
2261b544: posts big blind $0.1
*** HOLE CARDS ***
Dealt to Hero [2c Kc]
Dealt to 97cca5f4 
Dealt to 2261b544 
Dealt to f18ec573 
Dealt to 8db4f8f6 
Dealt to b4d78cbd 
f18ec573: folds
8db4f8f6: folds
b4d78cbd: folds
Hero: folds
97cca5f4: folds
Uncalled bet ($0.05) returned to 2261b544
*** SHOWDOWN ***
2261b544 collected $0.1 from pot
*** SUMMARY ***
Total pot $0.1 | Rake $0 | Jackpot $0 | Bingo $0 | Fortune $0
Seat 1: Hero (button) folded before Flop (didn't bet)
Seat 2: 97cca5f4 (small blind) folded before Flop
Seat 3: 2261b544 (big blind) collected ($0.1)
Seat 4: f18ec573 folded before Flop (didn't bet)
Seat 5: 8db4f8f6 folded before Flop (didn't bet)
Seat 6: b4d78cbd folded before Flop (didn't bet)


Poker Hand #RC1459913797: Hold'em No Limit  ($0.05/$0.1) - 2023/04/08 21:00:07
Table 'RushAndCash3779057' 6-max Seat #1 is the button
Seat 1: 51bfaab4 ($21.16 in chips)
Seat 2: 830b1c01 ($10 in chips)
Seat 3: Hero ($6.23 in chips)
Seat 4: a02f13bb ($38.84 in chips)
Seat 5: 238ede5a ($14.85 in chips)
Seat 6: b7c5ed84 ($14.16 in chips)
830b1c01: posts small blind $0.05
Hero: posts big blind $0.1
*** HOLE CARDS ***
Dealt to 51bfaab4 
Dealt to 830b1c01 
Dealt to Hero [Js 6d]
Dealt to a02f13bb 
Dealt to 238ede5a 
Dealt to b7c5ed84 
a02f13bb: folds
238ede5a: folds
b7c5ed84: raises $0.11 to $0.21
51bfaab4: folds
830b1c01: folds
Hero: folds
Uncalled bet ($0.11) returned to b7c5ed84
*** SHOWDOWN ***
b7c5ed84 collected $0.25 from pot
*** SUMMARY ***
Total pot $0.25 | Rake $0 | Jackpot $0 | Bingo $0 | Fortune $0
Seat 1: 51bfaab4 (button) folded before Flop (didn't bet)
Seat 2: 830b1c01 (small blind) folded before Flop
Seat 3: Hero (big blind) folded before Flop
Seat 4: a02f13bb folded before Flop (didn't bet)
Seat 5: 238ede5a folded before Flop (didn't bet)
Seat 6: b7c5ed84 collected ($0.25)


Poker Hand #RC1459913532: Hold'em No Limit  ($0.05/$0.1) - 2023/04/08 20:59:17
Table 'RushAndCash3778792' 6-max Seat #1 is the button
Seat 1: b7c5ed84 ($14.61 in chips)
Seat 2: a7d462f5 ($11.32 in chips)
Seat 3: Hero ($5.77 in chips)
Seat 4: eecda565 ($14.02 in chips)
Seat 5: 3d31fcfb ($11.63 in chips)
Seat 6: 1054b93b ($10.99 in chips)
a7d462f5: posts small blind $0.05
Hero: posts big blind $0.1
*** HOLE CARDS ***
Dealt to b7c5ed84 
Dealt to a7d462f5 
Dealt to Hero [6s As]
Dealt to eecda565 
Dealt to 3d31fcfb 
Dealt to 1054b93b 
eecda565: folds
3d31fcfb: folds
1054b93b: folds
b7c5ed84: raises $0.11 to $0.21
a7d462f5: folds
Hero: calls $0.11
*** FLOP *** [Jh 4c 2s]
Hero: checks
b7c5ed84: bets $0.24
Hero: raises $0.72 to $0.96
b7c5ed84: folds
Uncalled bet ($0.72) returned to Hero
*** SHOWDOWN ***
Hero collected $0.91 from pot
*** SUMMARY ***
Total pot $0.95 | Rake $0.04 | Jackpot $0 | Bingo $0 | Fortune $0
Board [Jh 4c 2s]
Seat 1: b7c5ed84 (button) folded on the Flop
Seat 2: a7d462f5 (small blind) folded before Flop
Seat 3: Hero (big blind) won ($0.91)
Seat 4: eecda565 folded before Flop (didn't bet)
Seat 5: 3d31fcfb folded before Flop (didn't bet)
Seat 6: 1054b93b folded before Flop (didn't bet)


Poker Hand #RC1459913266: Hold'em No Limit  ($0.05/$0.1) - 2023/04/08 20:58:23
Table 'RushAndCash3778526' 6-max Seat #1 is the button
Seat 1: 9f9eb3bb ($9.85 in chips)
Seat 2: b7c5ed84 ($12.81 in chips)
Seat 3: 868582fa ($10 in chips)
Seat 4: Hero ($7.82 in chips)
Seat 5: 7a92f977 ($10.38 in chips)
Seat 6: 28631210 ($14.15 in chips)
b7c5ed84: posts small blind $0.05
868582fa: posts big blind $0.1
*** HOLE CARDS ***
Dealt to 9f9eb3bb 
Dealt to b7c5ed84 
Dealt to 868582fa 
Dealt to Hero [As Qd]
Dealt to 7a92f977 
Dealt to 28631210 
Hero: raises $0.15 to $0.25
7a92f977: folds
28631210: folds
9f9eb3bb: folds
b7c5ed84: raises $0.75 to $1
868582fa: folds
Hero: calls $0.75
*** FLOP *** [8c 2s 3h]
b7c5ed84: bets $1.05
Hero: calls $1.05
*** TURN *** [8c 2s 3h] [8d]
b7c5ed84: bets $2.1
Hero: folds
Uncalled bet ($2.1) returned to b7c5ed84
*** SHOWDOWN ***
b7c5ed84 collected $3.85 from pot
*** SUMMARY ***
Total pot $4.2 | Rake $0.2 | Jackpot $0.15 | Bingo $0 | Fortune $0
Board [8c 2s 3h 8d]
Seat 1: 9f9eb3bb (button) folded before Flop (didn't bet)
Seat 2: b7c5ed84 (small blind) won ($3.85)
Seat 3: 868582fa (big blind) folded before Flop
Seat 4: Hero folded on the Turn
Seat 5: 7a92f977 folded before Flop (didn't bet)
Seat 6: 28631210 folded before Flop (didn't bet)


Poker Hand #RC1459913248: Hold'em No Limit  ($0.05/$0.1) - 2023/04/08 20:58:20
Table 'RushAndCash3778508' 6-max Seat #1 is the button
Seat 1: b69132e4 ($10.68 in chips)
Seat 2: Hero ($7.87 in chips)
Seat 3: 52c9a748 ($9.14 in chips)
Seat 4: 7ffbdfa1 ($3.49 in chips)
Seat 5: 447c4e6 ($63.79 in chips)
Seat 6: e3cc95e4 ($10.02 in chips)
Hero: posts small blind $0.05
52c9a748: posts big blind $0.1
*** HOLE CARDS ***
Dealt to b69132e4 
Dealt to Hero [6h 4c]
Dealt to 52c9a748 
Dealt to 7ffbdfa1 
Dealt to 447c4e6 
Dealt to e3cc95e4 
7ffbdfa1: raises $0.2 to $0.3
447c4e6: folds
e3cc95e4: folds
b69132e4: folds
Hero: folds
52c9a748: folds
Uncalled bet ($0.2) returned to 7ffbdfa1
*** SHOWDOWN ***
7ffbdfa1 collected $0.25 from pot
*** SUMMARY ***
Total pot $0.25 | Rake $0 | Jackpot $0 | Bingo $0 | Fortune $0
Seat 1: b69132e4 (button) folded before Flop (didn't bet)
Seat 2: Hero (small blind) folded before Flop
Seat 3: 52c9a748 (big blind) folded before Flop
Seat 4: 7ffbdfa1 collected ($0.25)
Seat 5: 447c4e6 folded before Flop (didn't bet)
Seat 6: e3cc95e4 folded before Flop (didn't bet)


Poker Hand #RC1459913229: Hold'em No Limit  ($0.05/$0.1) - 2023/04/08 20:58:16
Table 'RushAndCash3778489' 6-max Seat #1 is the button
Seat 1: ce8eee04 ($10.11 in chips)
Seat 2: 4f1db62d ($10 in chips)
Seat 3: 4c996243 ($13.74 in chips)
Seat 4: eb4f934 ($22.21 in chips)
Seat 5: b6746050 ($77.28 in chips)
Seat 6: Hero ($7.87 in chips)
4f1db62d: posts small blind $0.05
4c996243: posts big blind $0.1
*** HOLE CARDS ***
Dealt to ce8eee04 
Dealt to 4f1db62d 
Dealt to 4c996243 
Dealt to eb4f934 
Dealt to b6746050 
Dealt to Hero [9s Qd]
eb4f934: folds
b6746050: raises $0.15 to $0.25
Hero: folds
ce8eee04: calls $0.25
4f1db62d: folds
4c996243: raises $0.95 to $1.2
b6746050: folds
ce8eee04: calls $0.95
*** FLOP *** [Js Ts 4s]
4c996243: bets $0.9
ce8eee04: folds
Uncalled bet ($0.9) returned to 4c996243
*** SHOWDOWN ***
4c996243 collected $2.57 from pot
*** SUMMARY ***
Total pot $2.7 | Rake $0.13 | Jackpot $0 | Bingo $0 | Fortune $0
Board [Js Ts 4s]
Seat 1: ce8eee04 (button) folded on the Flop
Seat 2: 4f1db62d (small blind) folded before Flop
Seat 3: 4c996243 (big blind) won ($2.57)
Seat 4: eb4f934 folded before Flop (didn't bet)
Seat 5: b6746050 folded before Flop
Seat 6: Hero folded before Flop (didn't bet)


Poker Hand #RC1459913196: Hold'em No Limit  ($0.05/$0.1) - 2023/04/08 20:58:10
Table 'RushAndCash3778456' 6-max Seat #1 is the button
Seat 1: 4a8c7660 ($67.69 in chips)
Seat 2: 6fe627cf ($9.9 in chips)
Seat 3: ed2461d3 ($27.81 in chips)
Seat 4: Hero ($7.87 in chips)
Seat 5: 7ffbdfa1 ($3.54 in chips)
Seat 6: d59033f9 ($11.24 in chips)
6fe627cf: posts small blind $0.05
ed2461d3: posts big blind $0.1
*** HOLE CARDS ***
Dealt to 4a8c7660 
Dealt to 6fe627cf 
Dealt to ed2461d3 
Dealt to Hero [Ac Td]
Dealt to 7ffbdfa1 
Dealt to d59033f9 
Hero: folds
7ffbdfa1: folds
d59033f9: folds
4a8c7660: folds
6fe627cf: raises $0.1 to $0.2
ed2461d3: calls $0.1
*** FLOP *** [Js 2s 8h]
6fe627cf: bets $0.2
ed2461d3: folds
Uncalled bet ($0.2) returned to 6fe627cf
*** SHOWDOWN ***
6fe627cf collected $0.38 from pot
*** SUMMARY ***
Total pot $0.4 | Rake $0.02 | Jackpot $0 | Bingo $0 | Fortune $0
Board [Js 2s 8h]
Seat 1: 4a8c7660 (button) folded before Flop (didn't bet)
Seat 2: 6fe627cf (small blind) won ($0.38)
Seat 3: ed2461d3 (big blind) folded on the Flop
Seat 4: Hero folded before Flop (didn't bet)
Seat 5: 7ffbdfa1 folded before Flop (didn't bet)
Seat 6: d59033f9 folded before Flop (didn't bet)


Poker Hand #RC1459913171: Hold'em No Limit  ($0.05/$0.1) - 2023/04/08 20:58:05
Table 'RushAndCash3778431' 6-max Seat #1 is the button
Seat 1: Hero ($7.87 in chips)
Seat 2: f4b5f867 ($10.64 in chips)
Seat 3: 8a5ae807 ($10 in chips)
Seat 4: 9341d946 ($4.1 in chips)
Seat 5: a8745400 ($11 in chips)
Seat 6: 76db26dd ($12.96 in chips)
f4b5f867: posts small blind $0.05
8a5ae807: posts big blind $0.1
*** HOLE CARDS ***
Dealt to Hero [9h 2c]
Dealt to f4b5f867 
Dealt to 8a5ae807 
Dealt to 9341d946 
Dealt to a8745400 
Dealt to 76db26dd 
9341d946: folds
a8745400: raises $0.1 to $0.2
76db26dd: folds
Hero: folds
f4b5f867: folds
8a5ae807: folds
Uncalled bet ($0.1) returned to a8745400
*** SHOWDOWN ***
a8745400 collected $0.25 from pot
*** SUMMARY ***
Total pot $0.25 | Rake $0 | Jackpot $0 | Bingo $0 | Fortune $0
Seat 1: Hero (button) folded before Flop (didn't bet)
Seat 2: f4b5f867 (small blind) folded before Flop
Seat 3: 8a5ae807 (big blind) folded before Flop
Seat 4: 9341d946 folded before Flop (didn't bet)
Seat 5: a8745400 collected ($0.25)
Seat 6: 76db26dd folded before Flop (didn't bet)


Poker Hand #RC1459913144: Hold'em No Limit  ($0.05/$0.1) - 2023/04/08 20:58:00
Table 'RushAndCash3778404' 6-max Seat #1 is the button
Seat 1: fea15071 ($15.45 in chips)
Seat 2: d3f64a2e ($32.76 in chips)
Seat 3: 83fce378 ($54.25 in chips)
Seat 4: 4d2354fa ($15.6 in chips)
Seat 5: Hero ($7.87 in chips)
Seat 6: e8580b53 ($8.81 in chips)
d3f64a2e: posts small blind $0.05
83fce378: posts big blind $0.1
*** HOLE CARDS ***
Dealt to fea15071 
Dealt to d3f64a2e 
Dealt to 83fce378 
Dealt to 4d2354fa 
Dealt to Hero [4h 2d]
Dealt to e8580b53 
4d2354fa: raises $0.12 to $0.22
Hero: folds
e8580b53: folds
fea15071: folds
d3f64a2e: calls $0.17
83fce378: folds
*** FLOP *** [Kh 5h 3h]
d3f64a2e: bets $0.18
4d2354fa: calls $0.18
*** TURN *** [Kh 5h 3h] [6s]
d3f64a2e: bets $0.5
4d2354fa: calls $0.5
*** RIVER *** [Kh 5h 3h 6s] [5c]
d3f64a2e: checks
4d2354fa: bets $1.43
d3f64a2e: folds
Uncalled bet ($1.43) returned to 4d2354fa
*** SHOWDOWN ***
4d2354fa collected $1.81 from pot
*** SUMMARY ***
Total pot $1.9 | Rake $0.09 | Jackpot $0 | Bingo $0 | Fortune $0
Board [Kh 5h 3h 6s 5c]
Seat 1: fea15071 (button) folded before Flop (didn't bet)
Seat 2: d3f64a2e (small blind) folded on the River
Seat 3: 83fce378 (big blind) folded before Flop
Seat 4: 4d2354fa won ($1.81)
Seat 5: Hero folded before Flop (didn't bet)
Seat 6: e8580b53 folded before Flop (didn't bet)


Poker Hand #RC1459913121: Hold'em No Limit  ($0.05/$0.1) - 2023/04/08 20:57:56
Table 'RushAndCash3778381' 6-max Seat #1 is the button
Seat 1: 66765bb7 ($1.21 in chips)
Seat 2: d59033f9 ($11.39 in chips)
Seat 3: 49300ce ($11.35 in chips)
Seat 4: 8e4121e2 ($11.22 in chips)
Seat 5: Hero ($7.87 in chips)
Seat 6: fea15071 ($15.45 in chips)
d59033f9: posts small blind $0.05
49300ce: posts big blind $0.1
*** HOLE CARDS ***
Dealt to 66765bb7 
Dealt to d59033f9 
Dealt to 49300ce 
Dealt to 8e4121e2 
Dealt to Hero [Ks Th]
Dealt to fea15071 
8e4121e2: raises $0.15 to $0.25
Hero: folds
fea15071: folds
66765bb7: folds
d59033f9: folds
49300ce: calls $0.15
*** FLOP *** [Td Jd 3s]
49300ce: checks
8e4121e2: bets $0.28
49300ce: folds
Uncalled bet ($0.28) returned to 8e4121e2
*** SHOWDOWN ***
8e4121e2 collected $0.53 from pot
*** SUMMARY ***
Total pot $0.55 | Rake $0.02 | Jackpot $0 | Bingo $0 | Fortune $0
Board [Td Jd 3s]
Seat 1: 66765bb7 (button) folded before Flop (didn't bet)
Seat 2: d59033f9 (small blind) folded before Flop
Seat 3: 49300ce (big blind) folded on the Flop
Seat 4: 8e4121e2 won ($0.53)
Seat 5: Hero folded before Flop (didn't bet)
Seat 6: fea15071 folded before Flop (didn't bet)


Poker Hand #RC1459913096: Hold'em No Limit  ($0.05/$0.1) - 2023/04/08 20:57:52
Table 'RushAndCash3778356' 6-max Seat #1 is the button
Seat 1: 25ce97de ($9.87 in chips)
Seat 2: 1cf38f48 ($17.07 in chips)
Seat 3: 60ffc5ca ($10.83 in chips)
Seat 4: Hero ($7.87 in chips)
Seat 5: 6b6b5b7d ($2.98 in chips)
Seat 6: 8ea699cf ($11.19 in chips)
1cf38f48: posts small blind $0.05
60ffc5ca: posts big blind $0.1
*** HOLE CARDS ***
Dealt to 25ce97de 
Dealt to 1cf38f48 
Dealt to 60ffc5ca 
Dealt to Hero [2s 5s]
Dealt to 6b6b5b7d 
Dealt to 8ea699cf 
Hero: folds
6b6b5b7d: folds
8ea699cf: folds
25ce97de: folds
1cf38f48: raises $0.15 to $0.25
60ffc5ca: folds
Uncalled bet ($0.15) returned to 1cf38f48
*** SHOWDOWN ***
1cf38f48 collected $0.2 from pot
*** SUMMARY ***
Total pot $0.2 | Rake $0 | Jackpot $0 | Bingo $0 | Fortune $0
Seat 1: 25ce97de (button) folded before Flop (didn't bet)
Seat 2: 1cf38f48 (small blind) collected ($0.2)
Seat 3: 60ffc5ca (big blind) folded before Flop
Seat 4: Hero folded before Flop (didn't bet)
Seat 5: 6b6b5b7d folded before Flop (didn't bet)
Seat 6: 8ea699cf folded before Flop (didn't bet)


Poker Hand #RC1459913072: Hold'em No Limit  ($0.05/$0.1) - 2023/04/08 20:57:48
Table 'RushAndCash3778332' 6-max Seat #1 is the button
Seat 1: 3bb96cf5 ($55.45 in chips)
Seat 2: e8580b53 ($8.86 in chips)
Seat 3: 264b4dc3 ($18.3 in chips)
Seat 4: Hero ($7.87 in chips)
Seat 5: d81ea08f ($24.58 in chips)
Seat 6: a4888fc ($4.35 in chips)
e8580b53: posts small blind $0.05
264b4dc3: posts big blind $0.1
*** HOLE CARDS ***
Dealt to 3bb96cf5 
Dealt to e8580b53 
Dealt to 264b4dc3 
Dealt to Hero [Ks 8d]
Dealt to d81ea08f 
Dealt to a4888fc 
Hero: folds
d81ea08f: folds
a4888fc: folds
3bb96cf5: folds
e8580b53: folds
Uncalled bet ($0.05) returned to 264b4dc3
*** SHOWDOWN ***
264b4dc3 collected $0.1 from pot
*** SUMMARY ***
Total pot $0.1 | Rake $0 | Jackpot $0 | Bingo $0 | Fortune $0
Seat 1: 3bb96cf5 (button) folded before Flop (didn't bet)
Seat 2: e8580b53 (small blind) folded before Flop
Seat 3: 264b4dc3 (big blind) collected ($0.1)
Seat 4: Hero folded before Flop (didn't bet)
Seat 5: d81ea08f folded before Flop (didn't bet)
Seat 6: a4888fc folded before Flop (didn't bet)


Poker Hand #RC1459912992: Hold'em No Limit  ($0.05/$0.1) - 2023/04/08 20:57:34
Table 'RushAndCash3778252' 6-max Seat #1 is the button
Seat 1: f1433a12 ($2.87 in chips)
Seat 2: 1033bb03 ($16.32 in chips)
Seat 3: 1dd65d52 ($14.46 in chips)
Seat 4: Hero ($7.87 in chips)
Seat 5: 956da380 ($21.72 in chips)
Seat 6: 6b6b5b7d ($3.13 in chips)
1033bb03: posts small blind $0.05
1dd65d52: posts big blind $0.1
*** HOLE CARDS ***
Dealt to f1433a12 
Dealt to 1033bb03 
Dealt to 1dd65d52 
Dealt to Hero [6c Th]
Dealt to 956da380 
Dealt to 6b6b5b7d 
Hero: folds
956da380: folds
6b6b5b7d: folds
f1433a12: folds
1033bb03: folds
Uncalled bet ($0.05) returned to 1dd65d52
*** SHOWDOWN ***
1dd65d52 collected $0.1 from pot
*** SUMMARY ***
Total pot $0.1 | Rake $0 | Jackpot $0 | Bingo $0 | Fortune $0
Seat 1: f1433a12 (button) folded before Flop (didn't bet)
Seat 2: 1033bb03 (small blind) folded before Flop
Seat 3: 1dd65d52 (big blind) collected ($0.1)
Seat 4: Hero folded before Flop (didn't bet)
Seat 5: 956da380 folded before Flop (didn't bet)
Seat 6: 6b6b5b7d folded before Flop (didn't bet)


Poker Hand #RC1459912892: Hold'em No Limit  ($0.05/$0.1) - 2023/04/08 20:57:17
Table 'RushAndCash3778152' 6-max Seat #1 is the button
Seat 1: 692de524 ($10 in chips)
Seat 2: d254ce5 ($10.03 in chips)
Seat 3: Hero ($7.97 in chips)
Seat 4: 34c5ec46 ($12 in chips)
Seat 5: e8580b53 ($8.35 in chips)
Seat 6: f336d5a7 ($11.85 in chips)
d254ce5: posts small blind $0.05
Hero: posts big blind $0.1
*** HOLE CARDS ***
Dealt to 692de524 
Dealt to d254ce5 
Dealt to Hero [6h 7d]
Dealt to 34c5ec46 
Dealt to e8580b53 
Dealt to f336d5a7 
34c5ec46: folds
e8580b53: raises $0.3 to $0.4
f336d5a7: folds
692de524: calls $0.4
d254ce5: folds
Hero: folds
*** FLOP *** [Qs 8c 5h]
e8580b53: bets $0.72
692de524: folds
Uncalled bet ($0.72) returned to e8580b53
*** SHOWDOWN ***
e8580b53 collected $0.91 from pot
*** SUMMARY ***
Total pot $0.95 | Rake $0.04 | Jackpot $0 | Bingo $0 | Fortune $0
Board [Qs 8c 5h]
Seat 1: 692de524 (button) folded on the Flop
Seat 2: d254ce5 (small blind) folded before Flop
Seat 3: Hero (big blind) folded before Flop
Seat 4: 34c5ec46 folded before Flop (didn't bet)
Seat 5: e8580b53 won ($0.91)
Seat 6: f336d5a7 folded before Flop (didn't bet)


Poker Hand #RC1459912861: Hold'em No Limit  ($0.05/$0.1) - 2023/04/08 20:57:12
Table 'RushAndCash3778121' 6-max Seat #1 is the button
Seat 1: 2c1cb730 ($31.88 in chips)
Seat 2: Hero ($8.02 in chips)
Seat 3: 32767223 ($21.44 in chips)
Seat 4: 61fc2783 ($12.89 in chips)
Seat 5: 1196d30c ($10.33 in chips)
Seat 6: 157fc37b ($14.97 in chips)
Hero: posts small blind $0.05
32767223: posts big blind $0.1
*** HOLE CARDS ***
Dealt to 2c1cb730 
Dealt to Hero [Kh 8h]
Dealt to 32767223 
Dealt to 61fc2783 
Dealt to 1196d30c 
Dealt to 157fc37b 
61fc2783: raises $0.15 to $0.25
1196d30c: folds
157fc37b: raises $0.49 to $0.74
2c1cb730: folds
Hero: folds
32767223: folds
61fc2783: calls $0.49
*** FLOP *** [Jh Js Th]
61fc2783: checks
157fc37b: checks
*** TURN *** [Jh Js Th] [Qh]
61fc2783: checks
157fc37b: bets $0.82
61fc2783: calls $0.82
*** RIVER *** [Jh Js Th Qh] [9c]
61fc2783: checks
157fc37b: checks
61fc2783: shows [Ac Qc] (Pair of Queens and Pair of Jacks)
157fc37b: shows [4d 4c] (Pair of Jacks and Pair of Fours)
*** SHOWDOWN ***
61fc2783 collected $2.97 from pot
*** SUMMARY ***
Total pot $3.27 | Rake $0.15 | Jackpot $0.15 | Bingo $0 | Fortune $0
Board [Jh Js Th Qh 9c]
Seat 1: 2c1cb730 (button) folded before Flop (didn't bet)
Seat 2: Hero (small blind) folded before Flop
Seat 3: 32767223 (big blind) folded before Flop
Seat 4: 61fc2783 showed [Ac Qc] and won ($2.97) with Pair of Queens and Pair of Jacks
Seat 5: 1196d30c folded before Flop (didn't bet)
Seat 6: 157fc37b showed [4d 4c] and lost with Pair of Jacks and Pair of Fours


Poker Hand #RC1459912775: Hold'em No Limit  ($0.05/$0.1) - 2023/04/08 20:56:56
Table 'RushAndCash3778035' 6-max Seat #1 is the button
Seat 1: 3d16c2db ($48.74 in chips)
Seat 2: Hero ($8.07 in chips)
Seat 3: 4d5b0874 ($3.93 in chips)
Seat 4: 101ae7e ($12.75 in chips)
Seat 5: 2c1cb730 ($32.03 in chips)
Seat 6: dc78130f ($23.03 in chips)
Hero: posts small blind $0.05
4d5b0874: posts big blind $0.1
*** HOLE CARDS ***
Dealt to 3d16c2db 
Dealt to Hero [6c 3s]
Dealt to 4d5b0874 
Dealt to 101ae7e 
Dealt to 2c1cb730 
Dealt to dc78130f 
101ae7e: raises $0.14 to $0.24
2c1cb730: folds
dc78130f: calls $0.24
3d16c2db: folds
Hero: folds
4d5b0874: folds
*** FLOP *** [7h Ts Ad]
101ae7e: bets $0.32
dc78130f: calls $0.32
*** TURN *** [7h Ts Ad] [Jc]
101ae7e: bets $0.96
dc78130f: folds
Uncalled bet ($0.96) returned to 101ae7e
*** SHOWDOWN ***
101ae7e collected $1.21 from pot
*** SUMMARY ***
Total pot $1.27 | Rake $0.06 | Jackpot $0 | Bingo $0 | Fortune $0
Board [7h Ts Ad Jc]
Seat 1: 3d16c2db (button) folded before Flop (didn't bet)
Seat 2: Hero (small blind) folded before Flop
Seat 3: 4d5b0874 (big blind) folded before Flop
Seat 4: 101ae7e won ($1.21)
Seat 5: 2c1cb730 folded before Flop (didn't bet)
Seat 6: dc78130f folded on the Turn


Poker Hand #RC1459912726: Hold'em No Limit  ($0.05/$0.1) - 2023/04/08 20:56:47
Table 'RushAndCash3777986' 6-max Seat #1 is the button
Seat 1: Hero ($8.07 in chips)
Seat 2: 880937e1 ($18.93 in chips)
Seat 3: e790267c ($23.81 in chips)
Seat 4: fa54704d ($11.52 in chips)
Seat 5: 8ff246af ($10 in chips)
Seat 6: 6691e39a ($4.83 in chips)
880937e1: posts small blind $0.05
e790267c: posts big blind $0.1
*** HOLE CARDS ***
Dealt to Hero [Kh 9c]
Dealt to 880937e1 
Dealt to e790267c 
Dealt to fa54704d 
Dealt to 8ff246af 
Dealt to 6691e39a 
fa54704d: raises $0.1 to $0.2
8ff246af: folds
6691e39a: folds
Hero: folds
880937e1: folds
e790267c: folds
Uncalled bet ($0.1) returned to fa54704d
*** SHOWDOWN ***
fa54704d collected $0.25 from pot
*** SUMMARY ***
Total pot $0.25 | Rake $0 | Jackpot $0 | Bingo $0 | Fortune $0
Seat 1: Hero (button) folded before Flop (didn't bet)
Seat 2: 880937e1 (small blind) folded before Flop
Seat 3: e790267c (big blind) folded before Flop
Seat 4: fa54704d collected ($0.25)
Seat 5: 8ff246af folded before Flop (didn't bet)
Seat 6: 6691e39a folded before Flop (didn't bet)


Poker Hand #RC1459912670: Hold'em No Limit  ($0.05/$0.1) - 2023/04/08 20:56:36
Table 'RushAndCash3777930' 6-max Seat #1 is the button
Seat 1: 595d39ff ($14.32 in chips)
Seat 2: 16fb1715 ($11.88 in chips)
Seat 3: Hero ($8.17 in chips)
Seat 4: 8d5340db ($11.91 in chips)
Seat 5: b69132e4 ($10.73 in chips)
Seat 6: b86c8a85 ($15.33 in chips)
16fb1715: posts small blind $0.05
Hero: posts big blind $0.1
*** HOLE CARDS ***
Dealt to 595d39ff 
Dealt to 16fb1715 
Dealt to Hero [3h 7h]
Dealt to 8d5340db 
Dealt to b69132e4 
Dealt to b86c8a85 
8d5340db: folds
b69132e4: folds
b86c8a85: folds
595d39ff: folds
16fb1715: raises $0.2 to $0.3
Hero: folds
Uncalled bet ($0.2) returned to 16fb1715
*** SHOWDOWN ***
16fb1715 collected $0.2 from pot
*** SUMMARY ***
Total pot $0.2 | Rake $0 | Jackpot $0 | Bingo $0 | Fortune $0
Seat 1: 595d39ff (button) folded before Flop (didn't bet)
Seat 2: 16fb1715 (small blind) collected ($0.2)
Seat 3: Hero (big blind) folded before Flop
Seat 4: 8d5340db folded before Flop (didn't bet)
Seat 5: b69132e4 folded before Flop (didn't bet)
Seat 6: b86c8a85 folded before Flop (didn't bet)


Poker Hand #RC1459912644: Hold'em No Limit  ($0.05/$0.1) - 2023/04/08 20:56:31
Table 'RushAndCash3777904' 6-max Seat #1 is the button
Seat 1: c0546845 ($13.14 in chips)
Seat 2: 97cca5f4 ($15.18 in chips)
Seat 3: d0d6b27 ($16.13 in chips)
Seat 4: 6276705 ($10.59 in chips)
Seat 5: Hero ($8.17 in chips)
Seat 6: b69132e4 ($10.73 in chips)
97cca5f4: posts small blind $0.05
d0d6b27: posts big blind $0.1
*** HOLE CARDS ***
Dealt to c0546845 
Dealt to 97cca5f4 
Dealt to d0d6b27 
Dealt to 6276705 
Dealt to Hero [5s Qd]
Dealt to b69132e4 
6276705: folds
Hero: folds
b69132e4: folds
c0546845: raises $0.15 to $0.25
97cca5f4: folds
d0d6b27: calls $0.15
*** FLOP *** [6c Qh 5d]
d0d6b27: bets $0.75
c0546845: calls $0.75
*** TURN *** [6c Qh 5d] [8d]
d0d6b27: checks
c0546845: checks
*** RIVER *** [6c Qh 5d 8d] [2d]
d0d6b27: checks
c0546845: checks
d0d6b27: shows [4d 4c] (Pair of Fours)
c0546845: shows [Qs Td] (Pair of Queens)
*** SHOWDOWN ***
c0546845 collected $1.95 from pot
*** SUMMARY ***
Total pot $2.05 | Rake $0.1 | Jackpot $0 | Bingo $0 | Fortune $0
Board [6c Qh 5d 8d 2d]
Seat 1: c0546845 (button) showed [Qs Td] and won ($1.95) with Pair of Queens
Seat 2: 97cca5f4 (small blind) folded before Flop
Seat 3: d0d6b27 (big blind) showed [4d 4c] and lost with Pair of Fours
Seat 4: 6276705 folded before Flop (didn't bet)
Seat 5: Hero folded before Flop (didn't bet)
Seat 6: b69132e4 folded before Flop (didn't bet)


Poker Hand #RC1459912572: Hold'em No Limit  ($0.05/$0.1) - 2023/04/08 20:56:17
Table 'RushAndCash3777832' 6-max Seat #1 is the button
Seat 1: 9448719a ($20.29 in chips)
Seat 2: 8ea699cf ($11.79 in chips)
Seat 3: 8747e8cd ($10.1 in chips)
Seat 4: 4117f135 ($21.29 in chips)
Seat 5: ff0e0777 ($19.77 in chips)
Seat 6: Hero ($8.17 in chips)
8ea699cf: posts small blind $0.05
8747e8cd: posts big blind $0.1
*** HOLE CARDS ***
Dealt to 9448719a 
Dealt to 8ea699cf 
Dealt to 8747e8cd 
Dealt to 4117f135 
Dealt to ff0e0777 
Dealt to Hero [Ad 8c]
4117f135: folds
ff0e0777: folds
Hero: folds
9448719a: folds
8ea699cf: folds
Uncalled bet ($0.05) returned to 8747e8cd
*** SHOWDOWN ***
8747e8cd collected $0.1 from pot
*** SUMMARY ***
Total pot $0.1 | Rake $0 | Jackpot $0 | Bingo $0 | Fortune $0
Seat 1: 9448719a (button) folded before Flop (didn't bet)
Seat 2: 8ea699cf (small blind) folded before Flop
Seat 3: 8747e8cd (big blind) collected ($0.1)
Seat 4: 4117f135 folded before Flop (didn't bet)
Seat 5: ff0e0777 folded before Flop (didn't bet)
Seat 6: Hero folded before Flop (didn't bet)


Poker Hand #RC1459912457: Hold'em No Limit  ($0.05/$0.1) - 2023/04/08 20:55:57
Table 'RushAndCash3777717' 6-max Seat #1 is the button
Seat 1: Hero ($7.75 in chips)
Seat 2: 2f98635e ($10 in chips)
Seat 3: ff0e0777 ($19.87 in chips)
Seat 4: 46e9a690 ($10.57 in chips)
Seat 5: b1e0c6b6 ($10 in chips)
Seat 6: 8ea699cf ($12.09 in chips)
2f98635e: posts small blind $0.05
ff0e0777: posts big blind $0.1
*** HOLE CARDS ***
Dealt to Hero [Jh Js]
Dealt to 2f98635e 
Dealt to ff0e0777 
Dealt to 46e9a690 
Dealt to b1e0c6b6 
Dealt to 8ea699cf 
46e9a690: folds
b1e0c6b6: folds
8ea699cf: raises $0.2 to $0.3
Hero: raises $0.62 to $0.92
2f98635e: folds
ff0e0777: folds
8ea699cf: folds
Uncalled bet ($0.62) returned to Hero
*** SHOWDOWN ***
Hero collected $0.72 from pot
*** SUMMARY ***
Total pot $0.75 | Rake $0.03 | Jackpot $0 | Bingo $0 | Fortune $0
Seat 1: Hero (button) collected ($0.72)
Seat 2: 2f98635e (small blind) folded before Flop
Seat 3: ff0e0777 (big blind) folded before Flop
Seat 4: 46e9a690 folded before Flop (didn't bet)
Seat 5: b1e0c6b6 folded before Flop (didn't bet)
Seat 6: 8ea699cf folded before Flop


Poker Hand #RC1459912411: Hold'em No Limit  ($0.05/$0.1) - 2023/04/08 20:55:48
Table 'RushAndCash3777671' 6-max Seat #1 is the button
Seat 1: Hero ($7.75 in chips)
Seat 2: 3610c1a3 ($20.65 in chips)
Seat 3: f982bfe1 ($12.03 in chips)
Seat 4: e77be94e ($16.95 in chips)
Seat 5: 4b5309d ($12.19 in chips)
Seat 6: db15d716 ($27.8 in chips)
3610c1a3: posts small blind $0.05
f982bfe1: posts big blind $0.1
*** HOLE CARDS ***
Dealt to Hero [Ts 7c]
Dealt to 3610c1a3 
Dealt to f982bfe1 
Dealt to e77be94e 
Dealt to 4b5309d 
Dealt to db15d716 
e77be94e: raises $0.2 to $0.3
4b5309d: raises $0.7 to $1
db15d716: folds
Hero: folds
3610c1a3: folds
f982bfe1: folds
e77be94e: folds
Uncalled bet ($0.7) returned to 4b5309d
*** SHOWDOWN ***
4b5309d collected $0.72 from pot
*** SUMMARY ***
Total pot $0.75 | Rake $0.03 | Jackpot $0 | Bingo $0 | Fortune $0
Seat 1: Hero (button) folded before Flop (didn't bet)
Seat 2: 3610c1a3 (small blind) folded before Flop
Seat 3: f982bfe1 (big blind) folded before Flop
Seat 4: e77be94e folded before Flop
Seat 5: 4b5309d collected ($0.72)
Seat 6: db15d716 folded before Flop (didn't bet)


Poker Hand #RC1459912270: Hold'em No Limit  ($0.05/$0.1) - 2023/04/08 20:55:25
Table 'RushAndCash3777530' 6-max Seat #1 is the button
Seat 1: 3610c1a3 ($20.9 in chips)
Seat 2: Hero ($7.19 in chips)
Seat 3: 7954718f ($13.78 in chips)
Seat 4: 7a3e4c38 ($32.68 in chips)
Seat 5: 5489eecc ($22.52 in chips)
Seat 6: 38bd8899 ($28.87 in chips)
Hero: posts small blind $0.05
7954718f: posts big blind $0.1
*** HOLE CARDS ***
Dealt to 3610c1a3 
Dealt to Hero [Qd Ac]
Dealt to 7954718f 
Dealt to 7a3e4c38 
Dealt to 5489eecc 
Dealt to 38bd8899 
7a3e4c38: folds
5489eecc: raises $0.15 to $0.25
38bd8899: folds
3610c1a3: calls $0.25
Hero: raises $1.05 to $1.3
7954718f: folds
5489eecc: folds
3610c1a3: folds
Uncalled bet ($1.05) returned to Hero
*** SHOWDOWN ***
Hero collected $0.81 from pot
*** SUMMARY ***
Total pot $0.85 | Rake $0.04 | Jackpot $0 | Bingo $0 | Fortune $0
Seat 1: 3610c1a3 (button) folded before Flop
Seat 2: Hero (small blind) collected ($0.81)
Seat 3: 7954718f (big blind) folded before Flop
Seat 4: 7a3e4c38 folded before Flop (didn't bet)
Seat 5: 5489eecc folded before Flop
Seat 6: 38bd8899 folded before Flop (didn't bet)


Poker Hand #RC1459912074: Hold'em No Limit  ($0.05/$0.1) - 2023/04/08 20:54:51
Table 'RushAndCash3777334' 6-max Seat #1 is the button
Seat 1: caed7b6f ($17.06 in chips)
Seat 2: b6746050 ($77.29 in chips)
Seat 3: Hero ($6.72 in chips)
Seat 4: 82806f6 ($6.66 in chips)
Seat 5: 3610c1a3 ($21.26 in chips)
Seat 6: 8ea699cf ($12.24 in chips)
b6746050: posts small blind $0.05
Hero: posts big blind $0.1
*** HOLE CARDS ***
Dealt to caed7b6f 
Dealt to b6746050 
Dealt to Hero [Kd Qh]
Dealt to 82806f6 
Dealt to 3610c1a3 
Dealt to 8ea699cf 
82806f6: calls $0.1
3610c1a3: raises $0.26 to $0.36
8ea699cf: folds
caed7b6f: folds
b6746050: folds
Hero: raises $1.04 to $1.4
82806f6: folds
3610c1a3: folds
Uncalled bet ($1.04) returned to Hero
*** SHOWDOWN ***
Hero collected $0.83 from pot
*** SUMMARY ***
Total pot $0.87 | Rake $0.04 | Jackpot $0 | Bingo $0 | Fortune $0
Seat 1: caed7b6f (button) folded before Flop (didn't bet)
Seat 2: b6746050 (small blind) folded before Flop
Seat 3: Hero (big blind) collected ($0.83)
Seat 4: 82806f6 folded before Flop
Seat 5: 3610c1a3 folded before Flop
Seat 6: 8ea699cf folded before Flop (didn't bet)


Poker Hand #RC1459912050: Hold'em No Limit  ($0.05/$0.1) - 2023/04/08 20:54:46
Table 'RushAndCash3777310' 6-max Seat #1 is the button
Seat 1: 5279224c ($3.25 in chips)
Seat 2: d6708b52 ($10.61 in chips)
Seat 3: 18e279a4 ($68.53 in chips)
Seat 4: Hero ($6.72 in chips)
Seat 5: 82806f6 ($6.66 in chips)
Seat 6: 5644dbfa ($10.2 in chips)
d6708b52: posts small blind $0.05
18e279a4: posts big blind $0.1
*** HOLE CARDS ***
Dealt to 5279224c 
Dealt to d6708b52 
Dealt to 18e279a4 
Dealt to Hero [4c 6h]
Dealt to 82806f6 
Dealt to 5644dbfa 
Hero: folds
82806f6: folds
5644dbfa: folds
5279224c: raises $0.12 to $0.22
d6708b52: folds
18e279a4: folds
Uncalled bet ($0.12) returned to 5279224c
*** SHOWDOWN ***
5279224c collected $0.25 from pot
*** SUMMARY ***
Total pot $0.25 | Rake $0 | Jackpot $0 | Bingo $0 | Fortune $0
Seat 1: 5279224c (button) collected ($0.25)
Seat 2: d6708b52 (small blind) folded before Flop
Seat 3: 18e279a4 (big blind) folded before Flop
Seat 4: Hero folded before Flop (didn't bet)
Seat 5: 82806f6 folded before Flop (didn't bet)
Seat 6: 5644dbfa folded before Flop (didn't bet)


Poker Hand #RC1459912025: Hold'em No Limit  ($0.05/$0.1) - 2023/04/08 20:54:42
Table 'RushAndCash3777285' 6-max Seat #1 is the button
Seat 1: e414f212 ($30.71 in chips)
Seat 2: 9b6b9387 ($17.41 in chips)
Seat 3: ee266a57 ($10.79 in chips)
Seat 4: fd41e8da ($20.71 in chips)
Seat 5: Hero ($6.72 in chips)
Seat 6: 143e7da4 ($10.48 in chips)
9b6b9387: posts small blind $0.05
ee266a57: posts big blind $0.1
*** HOLE CARDS ***
Dealt to e414f212 
Dealt to 9b6b9387 
Dealt to ee266a57 
Dealt to fd41e8da 
Dealt to Hero [Jc 4d]
Dealt to 143e7da4 
fd41e8da: folds
Hero: folds
143e7da4: folds
e414f212: raises $0.15 to $0.25
9b6b9387: calls $0.2
ee266a57: folds
*** FLOP *** [8c 6d Ks]
9b6b9387: checks
e414f212: bets $0.3
9b6b9387: calls $0.3
*** TURN *** [8c 6d Ks] [4h]
9b6b9387: checks
e414f212: bets $0.9
9b6b9387: calls $0.9
*** RIVER *** [8c 6d Ks 4h] [Qd]
9b6b9387: checks
e414f212: checks
9b6b9387: shows [Ah 8h] (Pair of Eights)
e414f212: shows [9d 7d] (King-High)
*** SHOWDOWN ***
9b6b9387 collected $2.71 from pot
*** SUMMARY ***
Total pot $3 | Rake $0.14 | Jackpot $0.15 | Bingo $0 | Fortune $0
Board [8c 6d Ks 4h Qd]
Seat 1: e414f212 (button) showed [9d 7d] and lost with King-High
Seat 2: 9b6b9387 (small blind) showed [Ah 8h] and won ($2.71) with Pair of Eights
Seat 3: ee266a57 (big blind) folded before Flop
Seat 4: fd41e8da folded before Flop (didn't bet)
Seat 5: Hero folded before Flop (didn't bet)
Seat 6: 143e7da4 folded before Flop (didn't bet)


Poker Hand #RC1459911992: Hold'em No Limit  ($0.05/$0.1) - 2023/04/08 20:54:36
Table 'RushAndCash3777252' 6-max Seat #1 is the button
Seat 1: 9a4e419d ($10 in chips)
Seat 2: b0a8299d ($12.09 in chips)
Seat 3: 1353b9bd ($10.15 in chips)
Seat 4: ff98b220 ($18.19 in chips)
Seat 5: Hero ($6.72 in chips)
Seat 6: a438ad41 ($4.32 in chips)
b0a8299d: posts small blind $0.05
1353b9bd: posts big blind $0.1
*** HOLE CARDS ***
Dealt to 9a4e419d 
Dealt to b0a8299d 
Dealt to 1353b9bd 
Dealt to ff98b220 
Dealt to Hero [6c 2c]
Dealt to a438ad41 
ff98b220: folds
Hero: folds
a438ad41: raises $0.16 to $0.26
9a4e419d: folds
b0a8299d: folds
1353b9bd: folds
Uncalled bet ($0.16) returned to a438ad41
*** SHOWDOWN ***
a438ad41 collected $0.25 from pot
*** SUMMARY ***
Total pot $0.25 | Rake $0 | Jackpot $0 | Bingo $0 | Fortune $0
Seat 1: 9a4e419d (button) folded before Flop (didn't bet)
Seat 2: b0a8299d (small blind) folded before Flop
Seat 3: 1353b9bd (big blind) folded before Flop
Seat 4: ff98b220 folded before Flop (didn't bet)
Seat 5: Hero folded before Flop (didn't bet)
Seat 6: a438ad41 collected ($0.25)


Poker Hand #RC1459911960: Hold'em No Limit  ($0.05/$0.1) - 2023/04/08 20:54:31
Table 'RushAndCash3777220' 6-max Seat #1 is the button
Seat 1: ee5241c6 ($14.72 in chips)
Seat 2: 8d5340db ($12.41 in chips)
Seat 3: 85653a51 ($8.9 in chips)
Seat 4: Hero ($6.72 in chips)
Seat 5: f812ce14 ($12.91 in chips)
Seat 6: 4d2354fa ($15.77 in chips)
8d5340db: posts small blind $0.05
85653a51: posts big blind $0.1
*** HOLE CARDS ***
Dealt to ee5241c6 
Dealt to 8d5340db 
Dealt to 85653a51 
Dealt to Hero [4h 8c]
Dealt to f812ce14 
Dealt to 4d2354fa 
Hero: folds
f812ce14: folds
4d2354fa: folds
ee5241c6: raises $0.12 to $0.22
8d5340db: folds
85653a51: folds
Uncalled bet ($0.12) returned to ee5241c6
*** SHOWDOWN ***
ee5241c6 collected $0.25 from pot
*** SUMMARY ***
Total pot $0.25 | Rake $0 | Jackpot $0 | Bingo $0 | Fortune $0
Seat 1: ee5241c6 (button) collected ($0.25)
Seat 2: 8d5340db (small blind) folded before Flop
Seat 3: 85653a51 (big blind) folded before Flop
Seat 4: Hero folded before Flop (didn't bet)
Seat 5: f812ce14 folded before Flop (didn't bet)
Seat 6: 4d2354fa folded before Flop (didn't bet)


Poker Hand #RC1459911860: Hold'em No Limit  ($0.05/$0.1) - 2023/04/08 20:54:15
Table 'RushAndCash3777120' 6-max Seat #1 is the button
Seat 1: Hero ($6.57 in chips)
Seat 2: 47bd79f0 ($17.88 in chips)
Seat 3: dfe0f72a ($11.4 in chips)
Seat 4: 56fe61f7 ($15.2 in chips)
Seat 5: e33b6a9d ($2.25 in chips)
Seat 6: fe74b7c3 ($24.21 in chips)
47bd79f0: posts small blind $0.05
dfe0f72a: posts big blind $0.1
*** HOLE CARDS ***
Dealt to Hero [2c 2d]
Dealt to 47bd79f0 
Dealt to dfe0f72a 
Dealt to 56fe61f7 
Dealt to e33b6a9d 
Dealt to fe74b7c3 
56fe61f7: folds
e33b6a9d: folds
fe74b7c3: folds
Hero: raises $0.15 to $0.25
47bd79f0: folds
dfe0f72a: folds
Uncalled bet ($0.15) returned to Hero
*** SHOWDOWN ***
Hero collected $0.25 from pot
*** SUMMARY ***
Total pot $0.25 | Rake $0 | Jackpot $0 | Bingo $0 | Fortune $0
Seat 1: Hero (button) collected ($0.25)
Seat 2: 47bd79f0 (small blind) folded before Flop
Seat 3: dfe0f72a (big blind) folded before Flop
Seat 4: 56fe61f7 folded before Flop (didn't bet)
Seat 5: e33b6a9d folded before Flop (didn't bet)
Seat 6: fe74b7c3 folded before Flop (didn't bet)


Poker Hand #RC1459911833: Hold'em No Limit  ($0.05/$0.1) - 2023/04/08 20:54:10
Table 'RushAndCash3777093' 6-max Seat #1 is the button
Seat 1: 6a138b47 ($31.55 in chips)
Seat 2: 7faf8c75 ($32.25 in chips)
Seat 3: Hero ($6.67 in chips)
Seat 4: 8db4f8f6 ($8.12 in chips)
Seat 5: 94f887a ($11.65 in chips)
Seat 6: 31ee9606 ($32.96 in chips)
7faf8c75: posts small blind $0.05
Hero: posts big blind $0.1
*** HOLE CARDS ***
Dealt to 6a138b47 
Dealt to 7faf8c75 
Dealt to Hero [6d Jd]
Dealt to 8db4f8f6 
Dealt to 94f887a 
Dealt to 31ee9606 
8db4f8f6: folds
94f887a: raises $0.2 to $0.3
31ee9606: folds
6a138b47: folds
7faf8c75: folds
Hero: folds
Uncalled bet ($0.2) returned to 94f887a
*** SHOWDOWN ***
94f887a collected $0.25 from pot
*** SUMMARY ***
Total pot $0.25 | Rake $0 | Jackpot $0 | Bingo $0 | Fortune $0
Seat 1: 6a138b47 (button) folded before Flop (didn't bet)
Seat 2: 7faf8c75 (small blind) folded before Flop
Seat 3: Hero (big blind) folded before Flop
Seat 4: 8db4f8f6 folded before Flop (didn't bet)
Seat 5: 94f887a collected ($0.25)
Seat 6: 31ee9606 folded before Flop (didn't bet)


Poker Hand #RC1459911813: Hold'em No Limit  ($0.05/$0.1) - 2023/04/08 20:54:06
Table 'RushAndCash3777073' 6-max Seat #1 is the button
Seat 1: f72d1c42 ($10.09 in chips)
Seat 2: Hero ($6.72 in chips)
Seat 3: 3fdcb188 ($23.5 in chips)
Seat 4: 77194cea ($10 in chips)
Seat 5: 94f887a ($11.65 in chips)
Seat 6: f2724d93 ($11.11 in chips)
Hero: posts small blind $0.05
3fdcb188: posts big blind $0.1
*** HOLE CARDS ***
Dealt to f72d1c42 
Dealt to Hero [6d 4d]
Dealt to 3fdcb188 
Dealt to 77194cea 
Dealt to 94f887a 
Dealt to f2724d93 
77194cea: folds
94f887a: folds
f2724d93: folds
f72d1c42: raises $0.15 to $0.25
Hero: folds
3fdcb188: calls $0.15
*** FLOP *** [Kh Td Ac]
3fdcb188: checks
f72d1c42: bets $0.28
3fdcb188: folds
Uncalled bet ($0.28) returned to f72d1c42
*** SHOWDOWN ***
f72d1c42 collected $0.53 from pot
*** SUMMARY ***
Total pot $0.55 | Rake $0.02 | Jackpot $0 | Bingo $0 | Fortune $0
Board [Kh Td Ac]
Seat 1: f72d1c42 (button) won ($0.53)
Seat 2: Hero (small blind) folded before Flop
Seat 3: 3fdcb188 (big blind) folded on the Flop
Seat 4: 77194cea folded before Flop (didn't bet)
Seat 5: 94f887a folded before Flop (didn't bet)
Seat 6: f2724d93 folded before Flop (didn't bet)


Poker Hand #RC1459911792: Hold'em No Limit  ($0.05/$0.1) - 2023/04/08 20:54:02
Table 'RushAndCash3777052' 6-max Seat #1 is the button
Seat 1: d81ea08f ($23.34 in chips)
Seat 2: b69132e4 ($10.86 in chips)
Seat 3: Hero ($6.82 in chips)
Seat 4: 3077b607 ($11.96 in chips)
Seat 5: 3acdf15 ($28.74 in chips)
Seat 6: 4d2354fa ($15.82 in chips)
b69132e4: posts small blind $0.05
Hero: posts big blind $0.1
*** HOLE CARDS ***
Dealt to d81ea08f 
Dealt to b69132e4 
Dealt to Hero [3d Tc]
Dealt to 3077b607 
Dealt to 3acdf15 
Dealt to 4d2354fa 
3077b607: folds
3acdf15: folds
4d2354fa: folds
d81ea08f: raises $0.15 to $0.25
b69132e4: folds
Hero: folds
Uncalled bet ($0.15) returned to d81ea08f
*** SHOWDOWN ***
d81ea08f collected $0.25 from pot
*** SUMMARY ***
Total pot $0.25 | Rake $0 | Jackpot $0 | Bingo $0 | Fortune $0
Seat 1: d81ea08f (button) collected ($0.25)
Seat 2: b69132e4 (small blind) folded before Flop
Seat 3: Hero (big blind) folded before Flop
Seat 4: 3077b607 folded before Flop (didn't bet)
Seat 5: 3acdf15 folded before Flop (didn't bet)
Seat 6: 4d2354fa folded before Flop (didn't bet)


Poker Hand #RC1459911769: Hold'em No Limit  ($0.05/$0.1) - 2023/04/08 20:53:58
Table 'RushAndCash3777029' 6-max Seat #1 is the button
Seat 1: 80d1a4b2 ($45.38 in chips)
Seat 2: 4d7c3654 ($10.38 in chips)
Seat 3: 3cf396cc ($10 in chips)
Seat 4: Hero ($6.82 in chips)
Seat 5: 81206ee ($12.58 in chips)
Seat 6: d81ea08f ($23.34 in chips)
4d7c3654: posts small blind $0.05
3cf396cc: posts big blind $0.1
*** HOLE CARDS ***
Dealt to 80d1a4b2 
Dealt to 4d7c3654 
Dealt to 3cf396cc 
Dealt to Hero [Js 5s]
Dealt to 81206ee 
Dealt to d81ea08f 
Hero: folds
81206ee: folds
d81ea08f: folds
80d1a4b2: folds
4d7c3654: folds
Uncalled bet ($0.05) returned to 3cf396cc
*** SHOWDOWN ***
3cf396cc collected $0.1 from pot
*** SUMMARY ***
Total pot $0.1 | Rake $0 | Jackpot $0 | Bingo $0 | Fortune $0
Seat 1: 80d1a4b2 (button) folded before Flop (didn't bet)
Seat 2: 4d7c3654 (small blind) folded before Flop
Seat 3: 3cf396cc (big blind) collected ($0.1)
Seat 4: Hero folded before Flop (didn't bet)
Seat 5: 81206ee folded before Flop (didn't bet)
Seat 6: d81ea08f folded before Flop (didn't bet)


Poker Hand #RC1459911747: Hold'em No Limit  ($0.05/$0.1) - 2023/04/08 20:53:54
Table 'RushAndCash3777007' 6-max Seat #1 is the button
Seat 1: 4d7567a0 ($9.49 in chips)
Seat 2: Hero ($6.87 in chips)
Seat 3: 3a1e6474 ($11.58 in chips)
Seat 4: 89a660e7 ($9.32 in chips)
Seat 5: 500fa304 ($38.28 in chips)
Seat 6: a8745400 ($11.19 in chips)
Hero: posts small blind $0.05
3a1e6474: posts big blind $0.1
*** HOLE CARDS ***
Dealt to 4d7567a0 
Dealt to Hero [4h 3d]
Dealt to 3a1e6474 
Dealt to 89a660e7 
Dealt to 500fa304 
Dealt to a8745400 
89a660e7: folds
500fa304: folds
a8745400: folds
4d7567a0: folds
Hero: folds
Uncalled bet ($0.05) returned to 3a1e6474
*** SHOWDOWN ***
3a1e6474 collected $0.1 from pot
*** SUMMARY ***
Total pot $0.1 | Rake $0 | Jackpot $0 | Bingo $0 | Fortune $0
Seat 1: 4d7567a0 (button) folded before Flop (didn't bet)
Seat 2: Hero (small blind) folded before Flop
Seat 3: 3a1e6474 (big blind) collected ($0.1)
Seat 4: 89a660e7 folded before Flop (didn't bet)
Seat 5: 500fa304 folded before Flop (didn't bet)
Seat 6: a8745400 folded before Flop (didn't bet)


Poker Hand #RC1459911725: Hold'em No Limit  ($0.05/$0.1) - 2023/04/08 20:53:50
Table 'RushAndCash3776985' 6-max Seat #1 is the button
Seat 1: Hero ($6.87 in chips)
Seat 2: 773f7cb9 ($10.05 in chips)
Seat 3: 6ad16dc4 ($10.23 in chips)
Seat 4: 4ec6caba ($15.83 in chips)
Seat 5: a5ddf956 ($30.53 in chips)
Seat 6: b96d280 ($15.08 in chips)
773f7cb9: posts small blind $0.05
6ad16dc4: posts big blind $0.1
*** HOLE CARDS ***
Dealt to Hero [3h 2d]
Dealt to 773f7cb9 
Dealt to 6ad16dc4 
Dealt to 4ec6caba 
Dealt to a5ddf956 
Dealt to b96d280 
4ec6caba: folds
a5ddf956: calls $0.1
b96d280: folds
Hero: folds
773f7cb9: folds
6ad16dc4: checks
*** FLOP *** [7c 4c 8c]
6ad16dc4: checks
a5ddf956: checks
*** TURN *** [7c 4c 8c] [Th]
6ad16dc4: bets $0.19
a5ddf956: calls $0.19
*** RIVER *** [7c 4c 8c Th] [6c]
6ad16dc4: bets $0.36
a5ddf956: calls $0.36
6ad16dc4: shows [9s Ac] (Ace High Flush)
a5ddf956: shows [Ah Qc] (Queen High Flush)
*** SHOWDOWN ***
6ad16dc4 collected $1.29 from pot
*** SUMMARY ***
Total pot $1.35 | Rake $0.06 | Jackpot $0 | Bingo $0 | Fortune $0
Board [7c 4c 8c Th 6c]
Seat 1: Hero (button) folded before Flop (didn't bet)
Seat 2: 773f7cb9 (small blind) folded before Flop
Seat 3: 6ad16dc4 (big blind) showed [9s Ac] and won ($1.29) with Ace High Flush
Seat 4: 4ec6caba folded before Flop (didn't bet)
Seat 5: a5ddf956 showed [Ah Qc] and lost with Queen High Flush
Seat 6: b96d280 folded before Flop (didn't bet)


Poker Hand #RC1459911635: Hold'em No Limit  ($0.05/$0.1) - 2023/04/08 20:53:34
Table 'RushAndCash3776895' 6-max Seat #1 is the button
Seat 1: 66765bb7 ($1.86 in chips)
Seat 2: 55825302 ($12.3 in chips)
Seat 3: 82806f6 ($6.61 in chips)
Seat 4: 2165db3f ($10.15 in chips)
Seat 5: 8ff246af ($10 in chips)
Seat 6: Hero ($6.72 in chips)
55825302: posts small blind $0.05
82806f6: posts big blind $0.1
*** HOLE CARDS ***
Dealt to 66765bb7 
Dealt to 55825302 
Dealt to 82806f6 
Dealt to 2165db3f 
Dealt to 8ff246af 
Dealt to Hero [7h Ah]
2165db3f: folds
8ff246af: folds
Hero: raises $0.15 to $0.25
66765bb7: folds
55825302: folds
82806f6: folds
Uncalled bet ($0.15) returned to Hero
*** SHOWDOWN ***
Hero collected $0.25 from pot
*** SUMMARY ***
Total pot $0.25 | Rake $0 | Jackpot $0 | Bingo $0 | Fortune $0
Seat 1: 66765bb7 (button) folded before Flop (didn't bet)
Seat 2: 55825302 (small blind) folded before Flop
Seat 3: 82806f6 (big blind) folded before Flop
Seat 4: 2165db3f folded before Flop (didn't bet)
Seat 5: 8ff246af folded before Flop (didn't bet)
Seat 6: Hero collected ($0.25)


Poker Hand #RC1459911583: Hold'em No Limit  ($0.05/$0.1) - 2023/04/08 20:53:24
Table 'RushAndCash3776843' 6-max Seat #1 is the button
Seat 1: Hero ($6.72 in chips)
Seat 2: ec5f44e ($11.94 in chips)
Seat 3: f1433a12 ($4.61 in chips)
Seat 4: ada08ebe ($8.95 in chips)
Seat 5: cd49688f ($10.24 in chips)
Seat 6: f2620ac7 ($18.02 in chips)
ec5f44e: posts small blind $0.05
f1433a12: posts big blind $0.1
*** HOLE CARDS ***
Dealt to Hero [6c 4s]
Dealt to ec5f44e 
Dealt to f1433a12 
Dealt to ada08ebe 
Dealt to cd49688f 
Dealt to f2620ac7 
ada08ebe: folds
cd49688f: folds
f2620ac7: folds
Hero: folds
ec5f44e: folds
Uncalled bet ($0.05) returned to f1433a12
*** SHOWDOWN ***
f1433a12 collected $0.1 from pot
*** SUMMARY ***
Total pot $0.1 | Rake $0 | Jackpot $0 | Bingo $0 | Fortune $0
Seat 1: Hero (button) folded before Flop (didn't bet)
Seat 2: ec5f44e (small blind) folded before Flop
Seat 3: f1433a12 (big blind) collected ($0.1)
Seat 4: ada08ebe folded before Flop (didn't bet)
Seat 5: cd49688f folded before Flop (didn't bet)
Seat 6: f2620ac7 folded before Flop (didn't bet)


Poker Hand #RC1459911549: Hold'em No Limit  ($0.05/$0.1) - 2023/04/08 20:53:17
Table 'RushAndCash3776809' 6-max Seat #1 is the button
Seat 1: 46e9a690 ($10.37 in chips)
Seat 2: ce8eee04 ($9.13 in chips)
Seat 3: 732de4a8 ($10.71 in chips)
Seat 4: 95c94948 ($5.13 in chips)
Seat 5: c57a3d6 ($28.7 in chips)
Seat 6: Hero ($6.72 in chips)
ce8eee04: posts small blind $0.05
732de4a8: posts big blind $0.1
*** HOLE CARDS ***
Dealt to 46e9a690 
Dealt to ce8eee04 
Dealt to 732de4a8 
Dealt to 95c94948 
Dealt to c57a3d6 
Dealt to Hero [8c Qd]
95c94948: raises $0.2 to $0.3
c57a3d6: folds
Hero: folds
46e9a690: folds
ce8eee04: folds
732de4a8: folds
Uncalled bet ($0.2) returned to 95c94948
*** SHOWDOWN ***
95c94948 collected $0.25 from pot
*** SUMMARY ***
Total pot $0.25 | Rake $0 | Jackpot $0 | Bingo $0 | Fortune $0
Seat 1: 46e9a690 (button) folded before Flop (didn't bet)
Seat 2: ce8eee04 (small blind) folded before Flop
Seat 3: 732de4a8 (big blind) folded before Flop
Seat 4: 95c94948 collected ($0.25)
Seat 5: c57a3d6 folded before Flop (didn't bet)
Seat 6: Hero folded before Flop (didn't bet)


Poker Hand #RC1459911368: Hold'em No Limit  ($0.05/$0.1) - 2023/04/08 20:52:45
Table 'RushAndCash3776628' 6-max Seat #1 is the button
Seat 1: ee266a57 ($10.84 in chips)
Seat 2: Hero ($6.97 in chips)
Seat 3: 66765bb7 ($2.01 in chips)
Seat 4: d0d6b27 ($14.51 in chips)
Seat 5: dc004f81 ($9.68 in chips)
Seat 6: 732de4a8 ($10.39 in chips)
Hero: posts small blind $0.05
66765bb7: posts big blind $0.1
*** HOLE CARDS ***
Dealt to ee266a57 
Dealt to Hero [7c 7s]
Dealt to 66765bb7 
Dealt to d0d6b27 
Dealt to dc004f81 
Dealt to 732de4a8 
d0d6b27: folds
dc004f81: folds
732de4a8: raises $0.15 to $0.25
ee266a57: folds
Hero: calls $0.2
66765bb7: folds
*** FLOP *** [Ah Ks Qc]
Hero: checks
732de4a8: bets $0.75
Hero: folds
Uncalled bet ($0.75) returned to 732de4a8
*** SHOWDOWN ***
732de4a8 collected $0.57 from pot
*** SUMMARY ***
Total pot $0.6 | Rake $0.03 | Jackpot $0 | Bingo $0 | Fortune $0
Board [Ah Ks Qc]
Seat 1: ee266a57 (button) folded before Flop (didn't bet)
Seat 2: Hero (small blind) folded on the Flop
Seat 3: 66765bb7 (big blind) folded before Flop
Seat 4: d0d6b27 folded before Flop (didn't bet)
Seat 5: dc004f81 folded before Flop (didn't bet)
Seat 6: 732de4a8 won ($0.57)


Poker Hand #RC1459911318: Hold'em No Limit  ($0.05/$0.1) - 2023/04/08 20:52:37
Table 'RushAndCash3776578' 6-max Seat #1 is the button
Seat 1: 8967e899 ($30.9 in chips)
Seat 2: 60ffc5ca ($10 in chips)
Seat 3: 24bc78ed ($12.47 in chips)
Seat 4: b1e0c6b6 ($10 in chips)
Seat 5: Hero ($6.97 in chips)
Seat 6: 5489eecc ($23.63 in chips)
60ffc5ca: posts small blind $0.05
24bc78ed: posts big blind $0.1
*** HOLE CARDS ***
Dealt to 8967e899 
Dealt to 60ffc5ca 
Dealt to 24bc78ed 
Dealt to b1e0c6b6 
Dealt to Hero [5d Kd]
Dealt to 5489eecc 
b1e0c6b6: folds
Hero: folds
5489eecc: folds
8967e899: raises $0.13 to $0.23
60ffc5ca: raises $0.87 to $1.1
24bc78ed: folds
8967e899: folds
Uncalled bet ($0.87) returned to 60ffc5ca
*** SHOWDOWN ***
60ffc5ca collected $0.54 from pot
*** SUMMARY ***
Total pot $0.56 | Rake $0.02 | Jackpot $0 | Bingo $0 | Fortune $0
Seat 1: 8967e899 (button) folded before Flop
Seat 2: 60ffc5ca (small blind) collected ($0.54)
Seat 3: 24bc78ed (big blind) folded before Flop
Seat 4: b1e0c6b6 folded before Flop (didn't bet)
Seat 5: Hero folded before Flop (didn't bet)
Seat 6: 5489eecc folded before Flop (didn't bet)


Poker Hand #RC1459911245: Hold'em No Limit  ($0.05/$0.1) - 2023/04/08 20:52:24
Table 'RushAndCash3776505' 6-max Seat #1 is the button
Seat 1: e26a9316 ($5.42 in chips)
Seat 2: a438ad41 ($6.21 in chips)
Seat 3: 2e5a0969 ($8.31 in chips)
Seat 4: Hero ($6.97 in chips)
Seat 5: 2f98635e ($11.08 in chips)
Seat 6: 732de4a8 ($10.39 in chips)
a438ad41: posts small blind $0.05
2e5a0969: posts big blind $0.1
*** HOLE CARDS ***
Dealt to e26a9316 
Dealt to a438ad41 
Dealt to 2e5a0969 
Dealt to Hero [6d 2h]
Dealt to 2f98635e 
Dealt to 732de4a8 
Hero: folds
2f98635e: folds
732de4a8: folds
e26a9316: folds
a438ad41: folds
Uncalled bet ($0.05) returned to 2e5a0969
*** SHOWDOWN ***
2e5a0969 collected $0.1 from pot
*** SUMMARY ***
Total pot $0.1 | Rake $0 | Jackpot $0 | Bingo $0 | Fortune $0
Seat 1: e26a9316 (button) folded before Flop (didn't bet)
Seat 2: a438ad41 (small blind) folded before Flop
Seat 3: 2e5a0969 (big blind) collected ($0.1)
Seat 4: Hero folded before Flop (didn't bet)
Seat 5: 2f98635e folded before Flop (didn't bet)
Seat 6: 732de4a8 folded before Flop (didn't bet)


Poker Hand #RC1459911196: Hold'em No Limit  ($0.05/$0.1) - 2023/04/08 20:52:15
Table 'RushAndCash3776456' 6-max Seat #1 is the button
Seat 1: 9c7e0b10 ($10 in chips)
Seat 2: 3a725736 ($26.19 in chips)
Seat 3: Hero ($7.07 in chips)
Seat 4: d59033f9 ($11.05 in chips)
Seat 5: baddceb ($28.07 in chips)
Seat 6: 4a8c7660 ($69.03 in chips)
3a725736: posts small blind $0.05
Hero: posts big blind $0.1
*** HOLE CARDS ***
Dealt to 9c7e0b10 
Dealt to 3a725736 
Dealt to Hero [Qh 6s]
Dealt to d59033f9 
Dealt to baddceb 
Dealt to 4a8c7660 
d59033f9: folds
baddceb: folds
4a8c7660: folds
9c7e0b10: raises $0.15 to $0.25
3a725736: folds
Hero: folds
Uncalled bet ($0.15) returned to 9c7e0b10
*** SHOWDOWN ***
9c7e0b10 collected $0.25 from pot
*** SUMMARY ***
Total pot $0.25 | Rake $0 | Jackpot $0 | Bingo $0 | Fortune $0
Seat 1: 9c7e0b10 (button) collected ($0.25)
Seat 2: 3a725736 (small blind) folded before Flop
Seat 3: Hero (big blind) folded before Flop
Seat 4: d59033f9 folded before Flop (didn't bet)
Seat 5: baddceb folded before Flop (didn't bet)
Seat 6: 4a8c7660 folded before Flop (didn't bet)


Poker Hand #RC1459911166: Hold'em No Limit  ($0.05/$0.1) - 2023/04/08 20:52:11
Table 'RushAndCash3776426' 6-max Seat #1 is the button
Seat 1: cacd032a ($16.88 in chips)
Seat 2: 77194cea ($10 in chips)
Seat 3: 26081f26 ($10 in chips)
Seat 4: a438ad41 ($6.31 in chips)
Seat 5: Hero ($7.07 in chips)
Seat 6: 7052b8a0 ($10 in chips)
77194cea: posts small blind $0.05
26081f26: posts big blind $0.1
*** HOLE CARDS ***
Dealt to cacd032a 
Dealt to 77194cea 
Dealt to 26081f26 
Dealt to a438ad41 
Dealt to Hero [Td Ks]
Dealt to 7052b8a0 
a438ad41: folds
Hero: folds
7052b8a0: folds
cacd032a: folds
77194cea: folds
Uncalled bet ($0.05) returned to 26081f26
*** SHOWDOWN ***
26081f26 collected $0.1 from pot
*** SUMMARY ***
Total pot $0.1 | Rake $0 | Jackpot $0 | Bingo $0 | Fortune $0
Seat 1: cacd032a (button) folded before Flop (didn't bet)
Seat 2: 77194cea (small blind) folded before Flop
Seat 3: 26081f26 (big blind) collected ($0.1)
Seat 4: a438ad41 folded before Flop (didn't bet)
Seat 5: Hero folded before Flop (didn't bet)
Seat 6: 7052b8a0 folded before Flop (didn't bet)


Poker Hand #RC1459911144: Hold'em No Limit  ($0.05/$0.1) - 2023/04/08 20:52:06
Table 'RushAndCash3776404' 6-max Seat #1 is the button
Seat 1: Hero ($7.07 in chips)
Seat 2: e0cb9562 ($14.38 in chips)
Seat 3: 2261b544 ($10.32 in chips)
Seat 4: 7052b8a0 ($10 in chips)
Seat 5: 3610c1a3 ($21.12 in chips)
Seat 6: 77194cea ($10 in chips)
e0cb9562: posts small blind $0.05
2261b544: posts big blind $0.1
*** HOLE CARDS ***
Dealt to Hero [2h 5c]
Dealt to e0cb9562 
Dealt to 2261b544 
Dealt to 7052b8a0 
Dealt to 3610c1a3 
Dealt to 77194cea 
7052b8a0: folds
3610c1a3: folds
77194cea: folds
Hero: folds
e0cb9562: folds
Uncalled bet ($0.05) returned to 2261b544
*** SHOWDOWN ***
2261b544 collected $0.1 from pot
*** SUMMARY ***
Total pot $0.1 | Rake $0 | Jackpot $0 | Bingo $0 | Fortune $0
Seat 1: Hero (button) folded before Flop (didn't bet)
Seat 2: e0cb9562 (small blind) folded before Flop
Seat 3: 2261b544 (big blind) collected ($0.1)
Seat 4: 7052b8a0 folded before Flop (didn't bet)
Seat 5: 3610c1a3 folded before Flop (didn't bet)
Seat 6: 77194cea folded before Flop (didn't bet)


Poker Hand #RC1459911094: Hold'em No Limit  ($0.05/$0.1) - 2023/04/08 20:51:57
Table 'RushAndCash3776354' 6-max Seat #1 is the button
Seat 1: fa1722a8 ($13.31 in chips)
Seat 2: d33f9dd7 ($10.32 in chips)
Seat 3: Hero ($7.17 in chips)
Seat 4: 2101b7fa ($11.34 in chips)
Seat 5: 4bd29609 ($10 in chips)
Seat 6: 4d7567a0 ($9.07 in chips)
d33f9dd7: posts small blind $0.05
Hero: posts big blind $0.1
*** HOLE CARDS ***
Dealt to fa1722a8 
Dealt to d33f9dd7 
Dealt to Hero [Ah 4c]
Dealt to 2101b7fa 
Dealt to 4bd29609 
Dealt to 4d7567a0 
2101b7fa: folds
4bd29609: folds
4d7567a0: raises $0.2 to $0.3
fa1722a8: folds
d33f9dd7: calls $0.25
Hero: folds
*** FLOP *** [Qd Jd 4d]
d33f9dd7: checks
4d7567a0: bets $0.24
d33f9dd7: folds
Uncalled bet ($0.24) returned to 4d7567a0
*** SHOWDOWN ***
4d7567a0 collected $0.67 from pot
*** SUMMARY ***
Total pot $0.7 | Rake $0.03 | Jackpot $0 | Bingo $0 | Fortune $0
Board [Qd Jd 4d]
Seat 1: fa1722a8 (button) folded before Flop (didn't bet)
Seat 2: d33f9dd7 (small blind) folded on the Flop
Seat 3: Hero (big blind) folded before Flop
Seat 4: 2101b7fa folded before Flop (didn't bet)
Seat 5: 4bd29609 folded before Flop (didn't bet)
Seat 6: 4d7567a0 won ($0.67)


Poker Hand #RC1459910931: Hold'em No Limit  ($0.05/$0.1) - 2023/04/08 20:51:28
Table 'RushAndCash3776191' 6-max Seat #1 is the button
Seat 1: 19197d76 ($18.71 in chips)
Seat 2: 96987a94 ($19.01 in chips)
Seat 3: 1dd65d52 ($12.81 in chips)
Seat 4: 889f82b6 ($10 in chips)
Seat 5: Hero ($7.02 in chips)
Seat 6: a8e7c7bc ($12.85 in chips)
96987a94: posts small blind $0.05
1dd65d52: posts big blind $0.1
*** HOLE CARDS ***
Dealt to 19197d76 
Dealt to 96987a94 
Dealt to 1dd65d52 
Dealt to 889f82b6 
Dealt to Hero [Th Ts]
Dealt to a8e7c7bc 
889f82b6: folds
Hero: raises $0.15 to $0.25
a8e7c7bc: folds
19197d76: folds
96987a94: folds
1dd65d52: folds
Uncalled bet ($0.15) returned to Hero
*** SHOWDOWN ***
Hero collected $0.25 from pot
*** SUMMARY ***
Total pot $0.25 | Rake $0 | Jackpot $0 | Bingo $0 | Fortune $0
Seat 1: 19197d76 (button) folded before Flop (didn't bet)
Seat 2: 96987a94 (small blind) folded before Flop
Seat 3: 1dd65d52 (big blind) folded before Flop
Seat 4: 889f82b6 folded before Flop (didn't bet)
Seat 5: Hero collected ($0.25)
Seat 6: a8e7c7bc folded before Flop (didn't bet)


Poker Hand #RC1459910895: Hold'em No Limit  ($0.05/$0.1) - 2023/04/08 20:51:22
Table 'RushAndCash3776155' 6-max Seat #1 is the button
Seat 1: 8fcef37 ($8.69 in chips)
Seat 2: Hero ($7.07 in chips)
Seat 3: 21a9eb3 ($7.86 in chips)
Seat 4: 78961bb8 ($9.28 in chips)
Seat 5: 101ae7e ($12.53 in chips)
Seat 6: e414f212 ($25.26 in chips)
Hero: posts small blind $0.05
21a9eb3: posts big blind $0.1
*** HOLE CARDS ***
Dealt to 8fcef37 
Dealt to Hero [Qc 2h]
Dealt to 21a9eb3 
Dealt to 78961bb8 
Dealt to 101ae7e 
Dealt to e414f212 
78961bb8: folds
101ae7e: folds
e414f212: folds
8fcef37: folds
Hero: folds
Uncalled bet ($0.05) returned to 21a9eb3
*** SHOWDOWN ***
21a9eb3 collected $0.1 from pot
*** SUMMARY ***
Total pot $0.1 | Rake $0 | Jackpot $0 | Bingo $0 | Fortune $0
Seat 1: 8fcef37 (button) folded before Flop (didn't bet)
Seat 2: Hero (small blind) folded before Flop
Seat 3: 21a9eb3 (big blind) collected ($0.1)
Seat 4: 78961bb8 folded before Flop (didn't bet)
Seat 5: 101ae7e folded before Flop (didn't bet)
Seat 6: e414f212 folded before Flop (didn't bet)


Poker Hand #RC1459910870: Hold'em No Limit  ($0.05/$0.1) - 2023/04/08 20:51:18
Table 'RushAndCash3776130' 6-max Seat #1 is the button
Seat 1: 1196d30c ($10 in chips)
Seat 2: c86212cf ($10.13 in chips)
Seat 3: 3294ece5 ($53.04 in chips)
Seat 4: 3b57852c ($16.63 in chips)
Seat 5: e414f212 ($25.26 in chips)
Seat 6: Hero ($7.07 in chips)
c86212cf: posts small blind $0.05
3294ece5: posts big blind $0.1
*** HOLE CARDS ***
Dealt to 1196d30c 
Dealt to c86212cf 
Dealt to 3294ece5 
Dealt to 3b57852c 
Dealt to e414f212 
Dealt to Hero [Tc 3d]
3b57852c: folds
e414f212: folds
Hero: folds
1196d30c: folds
c86212cf: raises $0.15 to $0.25
3294ece5: folds
Uncalled bet ($0.15) returned to c86212cf
*** SHOWDOWN ***
c86212cf collected $0.2 from pot
*** SUMMARY ***
Total pot $0.2 | Rake $0 | Jackpot $0 | Bingo $0 | Fortune $0
Seat 1: 1196d30c (button) folded before Flop (didn't bet)
Seat 2: c86212cf (small blind) collected ($0.2)
Seat 3: 3294ece5 (big blind) folded before Flop
Seat 4: 3b57852c folded before Flop (didn't bet)
Seat 5: e414f212 folded before Flop (didn't bet)
Seat 6: Hero folded before Flop (didn't bet)


Poker Hand #RC1459910844: Hold'em No Limit  ($0.05/$0.1) - 2023/04/08 20:51:13
Table 'RushAndCash3776104' 6-max Seat #1 is the button
Seat 1: b022ac81 ($20.43 in chips)
Seat 2: dc525443 ($40.99 in chips)
Seat 3: 7a92f977 ($10 in chips)
Seat 4: 238ede5a ($14.74 in chips)
Seat 5: 692de524 ($10.11 in chips)
Seat 6: Hero ($7.07 in chips)
dc525443: posts small blind $0.05
7a92f977: posts big blind $0.1
*** HOLE CARDS ***
Dealt to b022ac81 
Dealt to dc525443 
Dealt to 7a92f977 
Dealt to 238ede5a 
Dealt to 692de524 
Dealt to Hero [Kc 3c]
238ede5a: raises $0.15 to $0.25
692de524: folds
Hero: folds
b022ac81: folds
dc525443: folds
7a92f977: folds
Uncalled bet ($0.15) returned to 238ede5a
*** SHOWDOWN ***
238ede5a collected $0.25 from pot
*** SUMMARY ***
Total pot $0.25 | Rake $0 | Jackpot $0 | Bingo $0 | Fortune $0
Seat 1: b022ac81 (button) folded before Flop (didn't bet)
Seat 2: dc525443 (small blind) folded before Flop
Seat 3: 7a92f977 (big blind) folded before Flop
Seat 4: 238ede5a collected ($0.25)
Seat 5: 692de524 folded before Flop (didn't bet)
Seat 6: Hero folded before Flop (didn't bet)


Poker Hand #RC1459910807: Hold'em No Limit  ($0.05/$0.1) - 2023/04/08 20:51:08
Table 'RushAndCash3776067' 6-max Seat #1 is the button
Seat 1: 7f8ad2db ($10.03 in chips)
Seat 2: 31acca90 ($22.28 in chips)
Seat 3: b6746050 ($77.33 in chips)
Seat 4: 2e5a0969 ($7.98 in chips)
Seat 5: 9b6b9387 ($16.99 in chips)
Seat 6: Hero ($7.07 in chips)
31acca90: posts small blind $0.05
b6746050: posts big blind $0.1
*** HOLE CARDS ***
Dealt to 7f8ad2db 
Dealt to 31acca90 
Dealt to b6746050 
Dealt to 2e5a0969 
Dealt to 9b6b9387 
Dealt to Hero [Ad 3d]
2e5a0969: folds
9b6b9387: folds
Hero: folds
7f8ad2db: folds
31acca90: raises $0.2 to $0.3
b6746050: raises $0.8 to $1.1
31acca90: calls $0.8
*** FLOP *** [Ac 2s 9h]
31acca90: checks
b6746050: bets $0.73
31acca90: calls $0.73
*** TURN *** [Ac 2s 9h] [9d]
31acca90: checks
b6746050: checks
*** RIVER *** [Ac 2s 9h 9d] [2c]
31acca90: checks
b6746050: checks
31acca90: shows [8h Ah] (Pair of Aces and Pair of Nines)
b6746050: shows [Qh Jh] (Pair of Nines and Pair of Twos)
*** SHOWDOWN ***
31acca90 collected $3.34 from pot
*** SUMMARY ***
Total pot $3.66 | Rake $0.17 | Jackpot $0.15 | Bingo $0 | Fortune $0
Board [Ac 2s 9h 9d 2c]
Seat 1: 7f8ad2db (button) folded before Flop (didn't bet)
Seat 2: 31acca90 (small blind) showed [8h Ah] and won ($3.34) with Pair of Aces and Pair of Nines
Seat 3: b6746050 (big blind) showed [Qh Jh] and lost with Pair of Nines and Pair of Twos
Seat 4: 2e5a0969 folded before Flop (didn't bet)
Seat 5: 9b6b9387 folded before Flop (didn't bet)
Seat 6: Hero folded before Flop (didn't bet)


Poker Hand #RC1459910786: Hold'em No Limit  ($0.05/$0.1) - 2023/04/08 20:51:04
Table 'RushAndCash3776046' 6-max Seat #1 is the button
Seat 1: 81b571a ($19.06 in chips)
Seat 2: a438ad41 ($5.9 in chips)
Seat 3: 7bfc260f ($10.37 in chips)
Seat 4: 5f642286 ($17.36 in chips)
Seat 5: Hero ($7.07 in chips)
Seat 6: 972b1dd9 ($7.8 in chips)
a438ad41: posts small blind $0.05
7bfc260f: posts big blind $0.1
*** HOLE CARDS ***
Dealt to 81b571a 
Dealt to a438ad41 
Dealt to 7bfc260f 
Dealt to 5f642286 
Dealt to Hero [4d 9d]
Dealt to 972b1dd9 
5f642286: folds
Hero: folds
972b1dd9: folds
81b571a: folds
a438ad41: folds
Uncalled bet ($0.05) returned to 7bfc260f
*** SHOWDOWN ***
7bfc260f collected $0.1 from pot
*** SUMMARY ***
Total pot $0.1 | Rake $0 | Jackpot $0 | Bingo $0 | Fortune $0
Seat 1: 81b571a (button) folded before Flop (didn't bet)
Seat 2: a438ad41 (small blind) folded before Flop
Seat 3: 7bfc260f (big blind) collected ($0.1)
Seat 4: 5f642286 folded before Flop (didn't bet)
Seat 5: Hero folded before Flop (didn't bet)
Seat 6: 972b1dd9 folded before Flop (didn't bet)


Poker Hand #RC1459910764: Hold'em No Limit  ($0.05/$0.1) - 2023/04/08 20:51:00
Table 'RushAndCash3776024' 6-max Seat #1 is the button
Seat 1: 7800aeef ($10.45 in chips)
Seat 2: Hero ($7.12 in chips)
Seat 3: 9448719a ($11.05 in chips)
Seat 4: 81b571a ($19.06 in chips)
Seat 5: ee266a57 ($10.25 in chips)
Seat 6: 47bd79f0 ($16.57 in chips)
Hero: posts small blind $0.05
9448719a: posts big blind $0.1
*** HOLE CARDS ***
Dealt to 7800aeef 
Dealt to Hero [3c Tc]
Dealt to 9448719a 
Dealt to 81b571a 
Dealt to ee266a57 
Dealt to 47bd79f0 
81b571a: folds
ee266a57: folds
47bd79f0: raises $0.13 to $0.23
7800aeef: folds
Hero: folds
9448719a: raises $0.97 to $1.2
47bd79f0: folds
Uncalled bet ($0.97) returned to 9448719a
*** SHOWDOWN ***
9448719a collected $0.49 from pot
*** SUMMARY ***
Total pot $0.51 | Rake $0.02 | Jackpot $0 | Bingo $0 | Fortune $0
Seat 1: 7800aeef (button) folded before Flop (didn't bet)
Seat 2: Hero (small blind) folded before Flop
Seat 3: 9448719a (big blind) collected ($0.49)
Seat 4: 81b571a folded before Flop (didn't bet)
Seat 5: ee266a57 folded before Flop (didn't bet)
Seat 6: 47bd79f0 folded before Flop


Poker Hand #RC1459910743: Hold'em No Limit  ($0.05/$0.1) - 2023/04/08 20:50:55
Table 'RushAndCash3776003' 6-max Seat #1 is the button
Seat 1: 3acdf15 ($29.29 in chips)
Seat 2: dc78130f ($20.22 in chips)
Seat 3: 77194cea ($10 in chips)
Seat 4: f18ec573 ($32.57 in chips)
Seat 5: Hero ($7.12 in chips)
Seat 6: ada08ebe ($9.75 in chips)
dc78130f: posts small blind $0.05
77194cea: posts big blind $0.1
*** HOLE CARDS ***
Dealt to 3acdf15 
Dealt to dc78130f 
Dealt to 77194cea 
Dealt to f18ec573 
Dealt to Hero [Ah 3s]
Dealt to ada08ebe 
f18ec573: folds
Hero: folds
ada08ebe: folds
3acdf15: folds
dc78130f: raises $0.15 to $0.25
77194cea: folds
Uncalled bet ($0.15) returned to dc78130f
*** SHOWDOWN ***
dc78130f collected $0.2 from pot
*** SUMMARY ***
Total pot $0.2 | Rake $0 | Jackpot $0 | Bingo $0 | Fortune $0
Seat 1: 3acdf15 (button) folded before Flop (didn't bet)
Seat 2: dc78130f (small blind) collected ($0.2)
Seat 3: 77194cea (big blind) folded before Flop
Seat 4: f18ec573 folded before Flop (didn't bet)
Seat 5: Hero folded before Flop (didn't bet)
Seat 6: ada08ebe folded before Flop (didn't bet)


Poker Hand #RC1459910664: Hold'em No Limit  ($0.05/$0.1) - 2023/04/08 20:50:41
Table 'RushAndCash3775924' 6-max Seat #1 is the button
Seat 1: 38bd8899 ($36.21 in chips)
Seat 2: 92a48d51 ($10.81 in chips)
Seat 3: Hero ($7.22 in chips)
Seat 4: 5e48a168 ($13.65 in chips)
Seat 5: f18ec573 ($32.67 in chips)
Seat 6: e4c53d38 ($28.82 in chips)
92a48d51: posts small blind $0.05
Hero: posts big blind $0.1
*** HOLE CARDS ***
Dealt to 38bd8899 
Dealt to 92a48d51 
Dealt to Hero [6h Kh]
Dealt to 5e48a168 
Dealt to f18ec573 
Dealt to e4c53d38 
5e48a168: raises $0.15 to $0.25
f18ec573: folds
e4c53d38: folds
38bd8899: folds
92a48d51: folds
Hero: folds
Uncalled bet ($0.15) returned to 5e48a168
*** SHOWDOWN ***
5e48a168 collected $0.25 from pot
*** SUMMARY ***
Total pot $0.25 | Rake $0 | Jackpot $0 | Bingo $0 | Fortune $0
Seat 1: 38bd8899 (button) folded before Flop (didn't bet)
Seat 2: 92a48d51 (small blind) folded before Flop
Seat 3: Hero (big blind) folded before Flop
Seat 4: 5e48a168 collected ($0.25)
Seat 5: f18ec573 folded before Flop (didn't bet)
Seat 6: e4c53d38 folded before Flop (didn't bet)


Poker Hand #RC1459910638: Hold'em No Limit  ($0.05/$0.1) - 2023/04/08 20:50:37
Table 'RushAndCash3775898' 6-max Seat #1 is the button
Seat 1: 3858da2d ($11.94 in chips)
Seat 2: e414f212 ($25.21 in chips)
Seat 3: f2620ac7 ($16.38 in chips)
Seat 4: e7de0df5 ($5.93 in chips)
Seat 5: Hero ($7.22 in chips)
Seat 6: 79257cf5 ($8.48 in chips)
e414f212: posts small blind $0.05
f2620ac7: posts big blind $0.1
*** HOLE CARDS ***
Dealt to 3858da2d 
Dealt to e414f212 
Dealt to f2620ac7 
Dealt to e7de0df5 
Dealt to Hero [7s 8d]
Dealt to 79257cf5 
e7de0df5: folds
Hero: folds
79257cf5: folds
3858da2d: folds
e414f212: folds
Uncalled bet ($0.05) returned to f2620ac7
*** SHOWDOWN ***
f2620ac7 collected $0.1 from pot
*** SUMMARY ***
Total pot $0.1 | Rake $0 | Jackpot $0 | Bingo $0 | Fortune $0
Seat 1: 3858da2d (button) folded before Flop (didn't bet)
Seat 2: e414f212 (small blind) folded before Flop
Seat 3: f2620ac7 (big blind) collected ($0.1)
Seat 4: e7de0df5 folded before Flop (didn't bet)
Seat 5: Hero folded before Flop (didn't bet)
Seat 6: 79257cf5 folded before Flop (didn't bet)


Poker Hand #RC1459910225: Hold'em No Limit  ($0.05/$0.1) - 2023/04/08 20:49:26
Table 'RushAndCash3775485' 6-max Seat #1 is the button
Seat 1: Hero ($6.26 in chips)
Seat 2: 6fc0179c ($10 in chips)
Seat 3: dc525443 ($40.24 in chips)
Seat 4: 82806f6 ($6.22 in chips)
Seat 5: 27089392 ($36.2 in chips)
Seat 6: e7de0df5 ($6.83 in chips)
6fc0179c: posts small blind $0.05
dc525443: posts big blind $0.1
*** HOLE CARDS ***
Dealt to Hero [Ac Kc]
Dealt to 6fc0179c 
Dealt to dc525443 
Dealt to 82806f6 
Dealt to 27089392 
Dealt to e7de0df5 
82806f6: folds
27089392: folds
e7de0df5: raises $0.2 to $0.3
Hero: raises $0.6 to $0.9
6fc0179c: folds
dc525443: folds
e7de0df5: calls $0.6
*** FLOP *** [5c Ts 4d]
e7de0df5: checks
Hero: checks
*** TURN *** [5c Ts 4d] [4c]
e7de0df5: checks
Hero: checks
*** RIVER *** [5c Ts 4d 4c] [6s]
e7de0df5: checks
Hero: checks
e7de0df5: shows [Qh Ks] (Pair of Fours)
Hero: shows [Ac Kc] (Pair of Fours)
*** SHOWDOWN ***
Hero collected $1.86 from pot
*** SUMMARY ***
Total pot $1.95 | Rake $0.09 | Jackpot $0 | Bingo $0 | Fortune $0
Board [5c Ts 4d 4c 6s]
Seat 1: Hero (button) showed [Ac Kc] and won ($1.86) with Pair of Fours
Seat 2: 6fc0179c (small blind) folded before Flop
Seat 3: dc525443 (big blind) folded before Flop
Seat 4: 82806f6 folded before Flop (didn't bet)
Seat 5: 27089392 folded before Flop (didn't bet)
Seat 6: e7de0df5 showed [Qh Ks] and lost with Pair of Fours


Poker Hand #RC1459910154: Hold'em No Limit  ($0.05/$0.1) - 2023/04/08 20:49:15
Table 'RushAndCash3775414' 6-max Seat #1 is the button
Seat 1: c8452cef ($16.93 in chips)
Seat 2: Hero ($6.16 in chips)
Seat 3: 81bf7bca ($15.81 in chips)
Seat 4: 89d24b76 ($25.36 in chips)
Seat 5: 6b6b5b7d ($3.35 in chips)
Seat 6: 16fb1715 ($9.85 in chips)
Hero: posts small blind $0.05
81bf7bca: posts big blind $0.1
*** HOLE CARDS ***
Dealt to c8452cef 
Dealt to Hero [9h Tc]
Dealt to 81bf7bca 
Dealt to 89d24b76 
Dealt to 6b6b5b7d 
Dealt to 16fb1715 
89d24b76: folds
6b6b5b7d: folds
16fb1715: folds
c8452cef: raises $0.13 to $0.23
Hero: folds
81bf7bca: calls $0.13
*** FLOP *** [Ks 7c Th]
81bf7bca: checks
c8452cef: bets $0.18
81bf7bca: calls $0.18
*** TURN *** [Ks 7c Th] [9c]
81bf7bca: checks
c8452cef: checks
*** RIVER *** [Ks 7c Th 9c] [2s]
81bf7bca: checks
c8452cef: bets $0.44
81bf7bca: calls $0.44
c8452cef: shows [Ad Kh] (Pair of Kings)
81bf7bca: shows [6c Ts] (Pair of Tens)
*** SHOWDOWN ***
c8452cef collected $1.67 from pot
*** SUMMARY ***
Total pot $1.75 | Rake $0.08 | Jackpot $0 | Bingo $0 | Fortune $0
Board [Ks 7c Th 9c 2s]
Seat 1: c8452cef (button) showed [Ad Kh] and won ($1.67) with Pair of Kings
Seat 2: Hero (small blind) folded before Flop
Seat 3: 81bf7bca (big blind) showed [6c Ts] and lost with Pair of Tens
Seat 4: 89d24b76 folded before Flop (didn't bet)
Seat 5: 6b6b5b7d folded before Flop (didn't bet)
Seat 6: 16fb1715 folded before Flop (didn't bet)


Poker Hand #RC1459910121: Hold'em No Limit  ($0.05/$0.1) - 2023/04/08 20:49:11
Table 'RushAndCash3775381' 6-max Seat #1 is the button
Seat 1: 66765bb7 ($3.75 in chips)
Seat 2: 6691e39a ($3.75 in chips)
Seat 3: Hero ($6.26 in chips)
Seat 4: 8e4121e2 ($10.62 in chips)
Seat 5: 8a8bce3 ($36.89 in chips)
Seat 6: 3610c1a3 ($22.88 in chips)
6691e39a: posts small blind $0.05
Hero: posts big blind $0.1
*** HOLE CARDS ***
Dealt to 66765bb7 
Dealt to 6691e39a 
Dealt to Hero [9h 6s]
Dealt to 8e4121e2 
Dealt to 8a8bce3 
Dealt to 3610c1a3 
8e4121e2: folds
8a8bce3: folds
3610c1a3: folds
66765bb7: folds
6691e39a: folds
Uncalled bet ($0.05) returned to Hero
*** SHOWDOWN ***
Hero collected $0.1 from pot
*** SUMMARY ***
Total pot $0.1 | Rake $0 | Jackpot $0 | Bingo $0 | Fortune $0
Seat 1: 66765bb7 (button) folded before Flop (didn't bet)
Seat 2: 6691e39a (small blind) folded before Flop
Seat 3: Hero (big blind) collected ($0.1)
Seat 4: 8e4121e2 folded before Flop (didn't bet)
Seat 5: 8a8bce3 folded before Flop (didn't bet)
Seat 6: 3610c1a3 folded before Flop (didn't bet)


Poker Hand #RC1459910084: Hold'em No Limit  ($0.05/$0.1) - 2023/04/08 20:49:04
Table 'RushAndCash3775344' 6-max Seat #1 is the button
Seat 1: f4b5f867 ($10 in chips)
Seat 2: 83fce378 ($51.34 in chips)
Seat 3: a7288e4 ($14.29 in chips)
Seat 4: Hero ($6.26 in chips)
Seat 5: a113d701 ($12.11 in chips)
Seat 6: 4d5b0874 ($5.22 in chips)
83fce378: posts small blind $0.05
a7288e4: posts big blind $0.1
*** HOLE CARDS ***
Dealt to f4b5f867 
Dealt to 83fce378 
Dealt to a7288e4 
Dealt to Hero [3h Kh]
Dealt to a113d701 
Dealt to 4d5b0874 
Hero: folds
a113d701: folds
4d5b0874: folds
f4b5f867: raises $0.15 to $0.25
83fce378: folds
a7288e4: folds
Uncalled bet ($0.15) returned to f4b5f867
*** SHOWDOWN ***
f4b5f867 collected $0.25 from pot
*** SUMMARY ***
Total pot $0.25 | Rake $0 | Jackpot $0 | Bingo $0 | Fortune $0
Seat 1: f4b5f867 (button) collected ($0.25)
Seat 2: 83fce378 (small blind) folded before Flop
Seat 3: a7288e4 (big blind) folded before Flop
Seat 4: Hero folded before Flop (didn't bet)
Seat 5: a113d701 folded before Flop (didn't bet)
Seat 6: 4d5b0874 folded before Flop (didn't bet)


Poker Hand #RC1459910010: Hold'em No Limit  ($0.05/$0.1) - 2023/04/08 20:48:52
Table 'RushAndCash3775270' 6-max Seat #1 is the button
Seat 1: ad685734 ($15.29 in chips)
Seat 2: 1a384da3 ($26.18 in chips)
Seat 3: 9046d9c0 ($10.57 in chips)
Seat 4: Hero ($6.11 in chips)
Seat 5: 1dd65d52 ($14.63 in chips)
Seat 6: dc78130f ($19.42 in chips)
1a384da3: posts small blind $0.05
9046d9c0: posts big blind $0.1
*** HOLE CARDS ***
Dealt to ad685734 
Dealt to 1a384da3 
Dealt to 9046d9c0 
Dealt to Hero [Tc Td]
Dealt to 1dd65d52 
Dealt to dc78130f 
Hero: raises $0.15 to $0.25
1dd65d52: folds
dc78130f: folds
ad685734: folds
1a384da3: folds
9046d9c0: folds
Uncalled bet ($0.15) returned to Hero
*** SHOWDOWN ***
Hero collected $0.25 from pot
*** SUMMARY ***
Total pot $0.25 | Rake $0 | Jackpot $0 | Bingo $0 | Fortune $0
Seat 1: ad685734 (button) folded before Flop (didn't bet)
Seat 2: 1a384da3 (small blind) folded before Flop
Seat 3: 9046d9c0 (big blind) folded before Flop
Seat 4: Hero collected ($0.25)
Seat 5: 1dd65d52 folded before Flop (didn't bet)
Seat 6: dc78130f folded before Flop (didn't bet)


Poker Hand #RC1459909916: Hold'em No Limit  ($0.05/$0.1) - 2023/04/08 20:48:37
Table 'RushAndCash3775176' 6-max Seat #1 is the button
Seat 1: Hero ($6.11 in chips)
Seat 2: b808e640 ($11.02 in chips)
Seat 3: e19f4a02 ($11.05 in chips)
Seat 4: c57a3d6 ($29.65 in chips)
Seat 5: 3d16c2db ($41.4 in chips)
Seat 6: 318bf4b0 ($23.05 in chips)
b808e640: posts small blind $0.05
e19f4a02: posts big blind $0.1
*** HOLE CARDS ***
Dealt to Hero [3h Ah]
Dealt to b808e640 
Dealt to e19f4a02 
Dealt to c57a3d6 
Dealt to 3d16c2db 
Dealt to 318bf4b0 
c57a3d6: folds
3d16c2db: folds
318bf4b0: raises $0.15 to $0.25
Hero: folds
b808e640: folds
e19f4a02: folds
Uncalled bet ($0.15) returned to 318bf4b0
*** SHOWDOWN ***
318bf4b0 collected $0.25 from pot
*** SUMMARY ***
Total pot $0.25 | Rake $0 | Jackpot $0 | Bingo $0 | Fortune $0
Seat 1: Hero (button) folded before Flop (didn't bet)
Seat 2: b808e640 (small blind) folded before Flop
Seat 3: e19f4a02 (big blind) folded before Flop
Seat 4: c57a3d6 folded before Flop (didn't bet)
Seat 5: 3d16c2db folded before Flop (didn't bet)
Seat 6: 318bf4b0 collected ($0.25)


Poker Hand #RC1459909890: Hold'em No Limit  ($0.05/$0.1) - 2023/04/08 20:48:33
Table 'RushAndCash3775150' 6-max Seat #1 is the button
Seat 1: 47699031 ($11.06 in chips)
Seat 2: b03e9cca ($6.68 in chips)
Seat 3: 8d5340db ($13.64 in chips)
Seat 4: Hero ($6.11 in chips)
Seat 5: 68d58f0b ($10.18 in chips)
Seat 6: 7954718f ($12.51 in chips)
b03e9cca: posts small blind $0.05
8d5340db: posts big blind $0.1
*** HOLE CARDS ***
Dealt to 47699031 
Dealt to b03e9cca 
Dealt to 8d5340db 
Dealt to Hero [2d 6c]
Dealt to 68d58f0b 
Dealt to 7954718f 
Hero: folds
68d58f0b: folds
7954718f: folds
47699031: raises $0.1 to $0.2
b03e9cca: folds
8d5340db: calls $0.1
*** FLOP *** [3d 4s 8c]
8d5340db: checks
47699031: bets $0.14
8d5340db: calls $0.14
*** TURN *** [3d 4s 8c] [7c]
8d5340db: checks
47699031: bets $0.92
8d5340db: folds
Uncalled bet ($0.92) returned to 47699031
*** SHOWDOWN ***
47699031 collected $0.7 from pot
*** SUMMARY ***
Total pot $0.73 | Rake $0.03 | Jackpot $0 | Bingo $0 | Fortune $0
Board [3d 4s 8c 7c]
Seat 1: 47699031 (button) won ($0.7)
Seat 2: b03e9cca (small blind) folded before Flop
Seat 3: 8d5340db (big blind) folded on the Turn
Seat 4: Hero folded before Flop (didn't bet)
Seat 5: 68d58f0b folded before Flop (didn't bet)
Seat 6: 7954718f folded before Flop (didn't bet)


Poker Hand #RC1459909868: Hold'em No Limit  ($0.05/$0.1) - 2023/04/08 20:48:28
Table 'RushAndCash3775128' 6-max Seat #1 is the button
Seat 1: 55ac3cd6 ($12.52 in chips)
Seat 2: 67c53cfa ($11.32 in chips)
Seat 3: 89d24b76 ($25.23 in chips)
Seat 4: 7f57e0f9 ($145.82 in chips)
Seat 5: e3e4b226 ($10.37 in chips)
Seat 6: Hero ($6.11 in chips)
67c53cfa: posts small blind $0.05
89d24b76: posts big blind $0.1
*** HOLE CARDS ***
Dealt to 55ac3cd6 
Dealt to 67c53cfa 
Dealt to 89d24b76 
Dealt to 7f57e0f9 
Dealt to e3e4b226 
Dealt to Hero [8s 4d]
7f57e0f9: folds
e3e4b226: folds
Hero: folds
55ac3cd6: folds
67c53cfa: calls $0.05
89d24b76: checks
*** FLOP *** [6s 7h 2c]
67c53cfa: checks
89d24b76: bets $0.15
67c53cfa: calls $0.15
*** TURN *** [6s 7h 2c] [6c]
67c53cfa: checks
89d24b76: bets $0.38
67c53cfa: folds
Uncalled bet ($0.38) returned to 89d24b76
*** SHOWDOWN ***
89d24b76 collected $0.48 from pot
*** SUMMARY ***
Total pot $0.5 | Rake $0.02 | Jackpot $0 | Bingo $0 | Fortune $0
Board [6s 7h 2c 6c]
Seat 1: 55ac3cd6 (button) folded before Flop (didn't bet)
Seat 2: 67c53cfa (small blind) folded on the Turn
Seat 3: 89d24b76 (big blind) won ($0.48)
Seat 4: 7f57e0f9 folded before Flop (didn't bet)
Seat 5: e3e4b226 folded before Flop (didn't bet)
Seat 6: Hero folded before Flop (didn't bet)


Poker Hand #RC1459909821: Hold'em No Limit  ($0.05/$0.1) - 2023/04/08 20:48:20
Table 'RushAndCash3775081' 6-max Seat #1 is the button
Seat 1: 59cb8ca8 ($15.31 in chips)
Seat 2: 18c7270a ($10 in chips)
Seat 3: Hero ($6.21 in chips)
Seat 4: 5489eecc ($24.83 in chips)
Seat 5: 83034386 ($31.57 in chips)
Seat 6: e99a6164 ($10.61 in chips)
18c7270a: posts small blind $0.05
Hero: posts big blind $0.1
*** HOLE CARDS ***
Dealt to 59cb8ca8 
Dealt to 18c7270a 
Dealt to Hero [Jh Td]
Dealt to 5489eecc 
Dealt to 83034386 
Dealt to e99a6164 
5489eecc: folds
83034386: folds
e99a6164: folds
59cb8ca8: raises $0.11 to $0.21
18c7270a: folds
Hero: folds
Uncalled bet ($0.11) returned to 59cb8ca8
*** SHOWDOWN ***
59cb8ca8 collected $0.25 from pot
*** SUMMARY ***
Total pot $0.25 | Rake $0 | Jackpot $0 | Bingo $0 | Fortune $0
Seat 1: 59cb8ca8 (button) collected ($0.25)
Seat 2: 18c7270a (small blind) folded before Flop
Seat 3: Hero (big blind) folded before Flop
Seat 4: 5489eecc folded before Flop (didn't bet)
Seat 5: 83034386 folded before Flop (didn't bet)
Seat 6: e99a6164 folded before Flop (didn't bet)


Poker Hand #RC1459909797: Hold'em No Limit  ($0.05/$0.1) - 2023/04/08 20:48:15
Table 'RushAndCash3775057' 6-max Seat #1 is the button
Seat 1: 472bcca7 ($11.57 in chips)
Seat 2: 2eccbc3e ($20.21 in chips)
Seat 3: 91f5be8d ($17.39 in chips)
Seat 4: f4047310 ($11.65 in chips)
Seat 5: Hero ($6.21 in chips)
Seat 6: 93e8500 ($11.31 in chips)
2eccbc3e: posts small blind $0.05
91f5be8d: posts big blind $0.1
*** HOLE CARDS ***
Dealt to 472bcca7 
Dealt to 2eccbc3e 
Dealt to 91f5be8d 
Dealt to f4047310 
Dealt to Hero [3s Qd]
Dealt to 93e8500 
f4047310: folds
Hero: folds
93e8500: folds
472bcca7: raises $0.15 to $0.25
2eccbc3e: raises $0.85 to $1.1
91f5be8d: folds
472bcca7: folds
Uncalled bet ($0.85) returned to 2eccbc3e
*** SHOWDOWN ***
2eccbc3e collected $0.57 from pot
*** SUMMARY ***
Total pot $0.6 | Rake $0.03 | Jackpot $0 | Bingo $0 | Fortune $0
Seat 1: 472bcca7 (button) folded before Flop
Seat 2: 2eccbc3e (small blind) collected ($0.57)
Seat 3: 91f5be8d (big blind) folded before Flop
Seat 4: f4047310 folded before Flop (didn't bet)
Seat 5: Hero folded before Flop (didn't bet)
Seat 6: 93e8500 folded before Flop (didn't bet)


Poker Hand #RC1459909638: Hold'em No Limit  ($0.05/$0.1) - 2023/04/08 20:47:48
Table 'RushAndCash3774898' 6-max Seat #1 is the button
Seat 1: Hero ($6.46 in chips)
Seat 2: 93e8500 ($10.84 in chips)
Seat 3: c100b725 ($12.45 in chips)
Seat 4: 5644dbfa ($10 in chips)
Seat 5: a8e7c7bc ($10.51 in chips)
Seat 6: c89af454 ($20.99 in chips)
93e8500: posts small blind $0.05
c100b725: posts big blind $0.1
*** HOLE CARDS ***
Dealt to Hero [3d Ac]
Dealt to 93e8500 
Dealt to c100b725 
Dealt to 5644dbfa 
Dealt to a8e7c7bc 
Dealt to c89af454 
5644dbfa: folds
a8e7c7bc: folds
c89af454: folds
Hero: raises $0.15 to $0.25
93e8500: raises $0.75 to $1
c100b725: folds
Hero: folds
Uncalled bet ($0.75) returned to 93e8500
*** SHOWDOWN ***
93e8500 collected $0.57 from pot
*** SUMMARY ***
Total pot $0.6 | Rake $0.03 | Jackpot $0 | Bingo $0 | Fortune $0
Seat 1: Hero (button) folded before Flop
Seat 2: 93e8500 (small blind) collected ($0.57)
Seat 3: c100b725 (big blind) folded before Flop
Seat 4: 5644dbfa folded before Flop (didn't bet)
Seat 5: a8e7c7bc folded before Flop (didn't bet)
Seat 6: c89af454 folded before Flop (didn't bet)


Poker Hand #RC1459909579: Hold'em No Limit  ($0.05/$0.1) - 2023/04/08 20:47:39
Table 'RushAndCash3774839' 6-max Seat #1 is the button
Seat 1: 39c1fa2c ($18.18 in chips)
Seat 2: Hero ($6.51 in chips)
Seat 3: 53bb487b ($12.07 in chips)
Seat 4: 9ad1a53e ($10.15 in chips)
Seat 5: 63257d79 ($11.6 in chips)
Seat 6: df76427d ($10 in chips)
Hero: posts small blind $0.05
53bb487b: posts big blind $0.1
*** HOLE CARDS ***
Dealt to 39c1fa2c 
Dealt to Hero [8s 6c]
Dealt to 53bb487b 
Dealt to 9ad1a53e 
Dealt to 63257d79 
Dealt to df76427d 
9ad1a53e: folds
63257d79: folds
df76427d: folds
39c1fa2c: raises $0.15 to $0.25
Hero: folds
53bb487b: calls $0.15
*** FLOP *** [5h Ts 6h]
53bb487b: checks
39c1fa2c: checks
*** TURN *** [5h Ts 6h] [Jd]
53bb487b: checks
39c1fa2c: bets $0.42
53bb487b: folds
Uncalled bet ($0.42) returned to 39c1fa2c
*** SHOWDOWN ***
39c1fa2c collected $0.53 from pot
*** SUMMARY ***
Total pot $0.55 | Rake $0.02 | Jackpot $0 | Bingo $0 | Fortune $0
Board [5h Ts 6h Jd]
Seat 1: 39c1fa2c (button) won ($0.53)
Seat 2: Hero (small blind) folded before Flop
Seat 3: 53bb487b (big blind) folded on the Turn
Seat 4: 9ad1a53e folded before Flop (didn't bet)
Seat 5: 63257d79 folded before Flop (didn't bet)
Seat 6: df76427d folded before Flop (didn't bet)


Poker Hand #RC1459909510: Hold'em No Limit  ($0.05/$0.1) - 2023/04/08 20:47:28
Table 'RushAndCash3774770' 6-max Seat #1 is the button
Seat 1: 8a46d84c ($10.2 in chips)
Seat 2: 616a92d4 ($14.72 in chips)
Seat 3: 97b4f97a ($45.91 in chips)
Seat 4: 64d75dc3 ($11.63 in chips)
Seat 5: 399ab01a ($10 in chips)
Seat 6: Hero ($6.51 in chips)
616a92d4: posts small blind $0.05
97b4f97a: posts big blind $0.1
*** HOLE CARDS ***
Dealt to 8a46d84c 
Dealt to 616a92d4 
Dealt to 97b4f97a 
Dealt to 64d75dc3 
Dealt to 399ab01a 
Dealt to Hero [Qh Th]
64d75dc3: folds
399ab01a: raises $0.15 to $0.25
Hero: folds
8a46d84c: folds
616a92d4: folds
97b4f97a: folds
Uncalled bet ($0.15) returned to 399ab01a
*** SHOWDOWN ***
399ab01a collected $0.25 from pot
*** SUMMARY ***
Total pot $0.25 | Rake $0 | Jackpot $0 | Bingo $0 | Fortune $0
Seat 1: 8a46d84c (button) folded before Flop (didn't bet)
Seat 2: 616a92d4 (small blind) folded before Flop
Seat 3: 97b4f97a (big blind) folded before Flop
Seat 4: 64d75dc3 folded before Flop (didn't bet)
Seat 5: 399ab01a collected ($0.25)
Seat 6: Hero folded before Flop (didn't bet)


Poker Hand #RC1459909465: Hold'em No Limit  ($0.05/$0.1) - 2023/04/08 20:47:21
Table 'RushAndCash3774725' 6-max Seat #1 is the button
Seat 1: 967fc2b9 ($11.88 in chips)
Seat 2: Hero ($6.56 in chips)
Seat 3: 4117f135 ($21.77 in chips)
Seat 4: 77194cea ($10.15 in chips)
Seat 5: ce8eee04 ($17.55 in chips)
Seat 6: 43663618 ($18.52 in chips)
Hero: posts small blind $0.05
4117f135: posts big blind $0.1
*** HOLE CARDS ***
Dealt to 967fc2b9 
Dealt to Hero [2d 8s]
Dealt to 4117f135 
Dealt to 77194cea 
Dealt to ce8eee04 
Dealt to 43663618 
77194cea: folds
ce8eee04: folds
43663618: raises $0.14 to $0.24
967fc2b9: folds
Hero: folds
4117f135: folds
Uncalled bet ($0.14) returned to 43663618
*** SHOWDOWN ***
43663618 collected $0.25 from pot
*** SUMMARY ***
Total pot $0.25 | Rake $0 | Jackpot $0 | Bingo $0 | Fortune $0
Seat 1: 967fc2b9 (button) folded before Flop (didn't bet)
Seat 2: Hero (small blind) folded before Flop
Seat 3: 4117f135 (big blind) folded before Flop
Seat 4: 77194cea folded before Flop (didn't bet)
Seat 5: ce8eee04 folded before Flop (didn't bet)
Seat 6: 43663618 collected ($0.25)


Poker Hand #RC1459909130: Hold'em No Limit  ($0.05/$0.1) - 2023/04/08 20:46:25
Table 'RushAndCash3774390' 6-max Seat #1 is the button
Seat 1: b96d280 ($13.41 in chips)
Seat 2: a32d35d6 ($10.41 in chips)
Seat 3: Hero ($5.35 in chips)
Seat 4: 9a83057 ($10.1 in chips)
Seat 5: 1cf38f48 ($21.87 in chips)
Seat 6: 4117f135 ($22.91 in chips)
a32d35d6: posts small blind $0.05
Hero: posts big blind $0.1
*** HOLE CARDS ***
Dealt to b96d280 
Dealt to a32d35d6 
Dealt to Hero [4h Ah]
Dealt to 9a83057 
Dealt to 1cf38f48 
Dealt to 4117f135 
9a83057: folds
1cf38f48: folds
4117f135: raises $0.1 to $0.2
b96d280: folds
a32d35d6: folds
Hero: calls $0.1
*** FLOP *** [Js Ad 4s]
Hero: checks
4117f135: checks
*** TURN *** [Js Ad 4s] [2c]
Hero: bets $0.34
4117f135: calls $0.34
*** RIVER *** [Js Ad 4s 2c] [3d]
Hero: bets $0.75
4117f135: calls $0.75
Hero: shows [4h Ah] (Pair of Aces and Pair of Fours)
4117f135: shows [9c Jc] (Pair of Jacks)
*** SHOWDOWN ***
Hero collected $2.5 from pot
*** SUMMARY ***
Total pot $2.63 | Rake $0.13 | Jackpot $0 | Bingo $0 | Fortune $0
Board [Js Ad 4s 2c 3d]
Seat 1: b96d280 (button) folded before Flop (didn't bet)
Seat 2: a32d35d6 (small blind) folded before Flop
Seat 3: Hero (big blind) showed [4h Ah] and won ($2.5) with Pair of Aces and Pair of Fours
Seat 4: 9a83057 folded before Flop (didn't bet)
Seat 5: 1cf38f48 folded before Flop (didn't bet)
Seat 6: 4117f135 showed [9c Jc] and lost with Pair of Jacks


Poker Hand #RC1459909109: Hold'em No Limit  ($0.05/$0.1) - 2023/04/08 20:46:21
Table 'RushAndCash3774369' 6-max Seat #1 is the button
Seat 1: 7340f470 ($60.53 in chips)
Seat 2: 5606876c ($11.24 in chips)
Seat 3: 93e8500 ($10.32 in chips)
Seat 4: d3f64a2e ($32.25 in chips)
Seat 5: Hero ($5.35 in chips)
Seat 6: 1cf38f48 ($21.87 in chips)
5606876c: posts small blind $0.05
93e8500: posts big blind $0.1
*** HOLE CARDS ***
Dealt to 7340f470 
Dealt to 5606876c 
Dealt to 93e8500 
Dealt to d3f64a2e 
Dealt to Hero [4h 9s]
Dealt to 1cf38f48 
d3f64a2e: raises $0.12 to $0.22
Hero: folds
1cf38f48: folds
7340f470: folds
5606876c: folds
93e8500: folds
Uncalled bet ($0.12) returned to d3f64a2e
*** SHOWDOWN ***
d3f64a2e collected $0.25 from pot
*** SUMMARY ***
Total pot $0.25 | Rake $0 | Jackpot $0 | Bingo $0 | Fortune $0
Seat 1: 7340f470 (button) folded before Flop (didn't bet)
Seat 2: 5606876c (small blind) folded before Flop
Seat 3: 93e8500 (big blind) folded before Flop
Seat 4: d3f64a2e collected ($0.25)
Seat 5: Hero folded before Flop (didn't bet)
Seat 6: 1cf38f48 folded before Flop (didn't bet)


Poker Hand #RC1459909078: Hold'em No Limit  ($0.05/$0.1) - 2023/04/08 20:46:15
Table 'RushAndCash3774338' 6-max Seat #1 is the button
Seat 1: 5786b1cd ($10 in chips)
Seat 2: da6980d ($10.76 in chips)
Seat 3: e26a9316 ($2.33 in chips)
Seat 4: 3d16c2db ($39.17 in chips)
Seat 5: 148ef8a0 ($18.05 in chips)
Seat 6: Hero ($5.35 in chips)
da6980d: posts small blind $0.05
e26a9316: posts big blind $0.1
*** HOLE CARDS ***
Dealt to 5786b1cd 
Dealt to da6980d 
Dealt to e26a9316 
Dealt to 3d16c2db 
Dealt to 148ef8a0 
Dealt to Hero [4d 7s]
3d16c2db: folds
148ef8a0: folds
Hero: folds
5786b1cd: folds
da6980d: calls $0.05
e26a9316: raises $0.2 to $0.3
da6980d: calls $0.2
*** FLOP *** [Kd Jh 6d]
da6980d: checks
e26a9316: bets $0.3
da6980d: folds
Uncalled bet ($0.3) returned to e26a9316
*** SHOWDOWN ***
e26a9316 collected $0.57 from pot
*** SUMMARY ***
Total pot $0.6 | Rake $0.03 | Jackpot $0 | Bingo $0 | Fortune $0
Board [Kd Jh 6d]
Seat 1: 5786b1cd (button) folded before Flop (didn't bet)
Seat 2: da6980d (small blind) folded on the Flop
Seat 3: e26a9316 (big blind) won ($0.57)
Seat 4: 3d16c2db folded before Flop (didn't bet)
Seat 5: 148ef8a0 folded before Flop (didn't bet)
Seat 6: Hero folded before Flop (didn't bet)


Poker Hand #RC1459909049: Hold'em No Limit  ($0.05/$0.1) - 2023/04/08 20:46:10
Table 'RushAndCash3774309' 6-max Seat #1 is the button
Seat 1: Hero ($5.35 in chips)
Seat 2: a8e7c7bc ($10.81 in chips)
Seat 3: 19054d3d ($9.27 in chips)
Seat 4: eecda565 ($10.8 in chips)
Seat 5: 2f7d31ea ($10 in chips)
Seat 6: f513fe95 ($10.2 in chips)
a8e7c7bc: posts small blind $0.05
19054d3d: posts big blind $0.1
*** HOLE CARDS ***
Dealt to Hero [8d 3c]
Dealt to a8e7c7bc 
Dealt to 19054d3d 
Dealt to eecda565 
Dealt to 2f7d31ea 
Dealt to f513fe95 
eecda565: folds
2f7d31ea: folds
f513fe95: folds
Hero: folds
a8e7c7bc: folds
Uncalled bet ($0.05) returned to 19054d3d
*** SHOWDOWN ***
19054d3d collected $0.1 from pot
*** SUMMARY ***
Total pot $0.1 | Rake $0 | Jackpot $0 | Bingo $0 | Fortune $0
Seat 1: Hero (button) folded before Flop (didn't bet)
Seat 2: a8e7c7bc (small blind) folded before Flop
Seat 3: 19054d3d (big blind) collected ($0.1)
Seat 4: eecda565 folded before Flop (didn't bet)
Seat 5: 2f7d31ea folded before Flop (didn't bet)
Seat 6: f513fe95 folded before Flop (didn't bet)


Poker Hand #RC1459908957: Hold'em No Limit  ($0.05/$0.1) - 2023/04/08 20:45:56
Table 'RushAndCash3774217' 6-max Seat #1 is the button
Seat 1: 157fc37b ($10.1 in chips)
Seat 2: eecda565 ($10.85 in chips)
Seat 3: dda64973 ($10 in chips)
Seat 4: d728232d ($12.81 in chips)
Seat 5: 1054b93b ($10.15 in chips)
Seat 6: Hero ($5.2 in chips)
eecda565: posts small blind $0.05
dda64973: posts big blind $0.1
*** HOLE CARDS ***
Dealt to 157fc37b 
Dealt to eecda565 
Dealt to dda64973 
Dealt to d728232d 
Dealt to 1054b93b 
Dealt to Hero [Kc Ad]
d728232d: folds
1054b93b: folds
Hero: raises $0.15 to $0.25
157fc37b: folds
eecda565: folds
dda64973: folds
Uncalled bet ($0.15) returned to Hero
*** SHOWDOWN ***
Hero collected $0.25 from pot
*** SUMMARY ***
Total pot $0.25 | Rake $0 | Jackpot $0 | Bingo $0 | Fortune $0
Seat 1: 157fc37b (button) folded before Flop (didn't bet)
Seat 2: eecda565 (small blind) folded before Flop
Seat 3: dda64973 (big blind) folded before Flop
Seat 4: d728232d folded before Flop (didn't bet)
Seat 5: 1054b93b folded before Flop (didn't bet)
Seat 6: Hero collected ($0.25)


Poker Hand #RC1459908918: Hold'em No Limit  ($0.05/$0.1) - 2023/04/08 20:45:49
Table 'RushAndCash3774178' 6-max Seat #1 is the button
Seat 1: ff0e0777 ($10 in chips)
Seat 2: f181dc91 ($77.1 in chips)
Seat 3: 9ea6cc1 ($15.83 in chips)
Seat 4: 318bf4b0 ($22.72 in chips)
Seat 5: Hero ($5.2 in chips)
Seat 6: 97cca5f4 ($10 in chips)
f181dc91: posts small blind $0.05
9ea6cc1: posts big blind $0.1
*** HOLE CARDS ***
Dealt to ff0e0777 
Dealt to f181dc91 
Dealt to 9ea6cc1 
Dealt to 318bf4b0 
Dealt to Hero [Ah 9c]
Dealt to 97cca5f4 
318bf4b0: raises $0.15 to $0.25
Hero: folds
97cca5f4: folds
ff0e0777: folds
f181dc91: folds
9ea6cc1: folds
Uncalled bet ($0.15) returned to 318bf4b0
*** SHOWDOWN ***
318bf4b0 collected $0.25 from pot
*** SUMMARY ***
Total pot $0.25 | Rake $0 | Jackpot $0 | Bingo $0 | Fortune $0
Seat 1: ff0e0777 (button) folded before Flop (didn't bet)
Seat 2: f181dc91 (small blind) folded before Flop
Seat 3: 9ea6cc1 (big blind) folded before Flop
Seat 4: 318bf4b0 collected ($0.25)
Seat 5: Hero folded before Flop (didn't bet)
Seat 6: 97cca5f4 folded before Flop (didn't bet)


Poker Hand #RC1459908893: Hold'em No Limit  ($0.05/$0.1) - 2023/04/08 20:45:44
Table 'RushAndCash3774153' 6-max Seat #1 is the button
Seat 1: d0bb49b9 ($4.26 in chips)
Seat 2: 4b5309d ($10.15 in chips)
Seat 3: 4c996243 ($11.2 in chips)
Seat 4: 7d679fa8 ($8.32 in chips)
Seat 5: 8f834bd5 ($30.42 in chips)
Seat 6: Hero ($5.2 in chips)
4b5309d: posts small blind $0.05
4c996243: posts big blind $0.1
*** HOLE CARDS ***
Dealt to d0bb49b9 
Dealt to 4b5309d 
Dealt to 4c996243 
Dealt to 7d679fa8 
Dealt to 8f834bd5 
Dealt to Hero [Jh 3c]
7d679fa8: folds
8f834bd5: folds
Hero: folds
d0bb49b9: raises $0.13 to $0.23
4b5309d: calls $0.18
4c996243: folds
*** FLOP *** [9h As 4c]
4b5309d: checks
d0bb49b9: bets $0.19
4b5309d: calls $0.19
*** TURN *** [9h As 4c] [Kd]
4b5309d: checks
d0bb49b9: checks
*** RIVER *** [9h As 4c Kd] [8h]
4b5309d: checks
d0bb49b9: bets $0.71
4b5309d: folds
Uncalled bet ($0.71) returned to d0bb49b9
*** SHOWDOWN ***
d0bb49b9 collected $0.9 from pot
*** SUMMARY ***
Total pot $0.94 | Rake $0.04 | Jackpot $0 | Bingo $0 | Fortune $0
Board [9h As 4c Kd 8h]
Seat 1: d0bb49b9 (button) won ($0.9)
Seat 2: 4b5309d (small blind) folded on the River
Seat 3: 4c996243 (big blind) folded before Flop
Seat 4: 7d679fa8 folded before Flop (didn't bet)
Seat 5: 8f834bd5 folded before Flop (didn't bet)
Seat 6: Hero folded before Flop (didn't bet)


Poker Hand #RC1459908843: Hold'em No Limit  ($0.05/$0.1) - 2023/04/08 20:45:37
Table 'RushAndCash3774103' 6-max Seat #1 is the button
Seat 1: 81bf7bca ($13.53 in chips)
Seat 2: Hero ($5.25 in chips)
Seat 3: 18857b9c ($10.08 in chips)
Seat 4: 845cd800 ($13.12 in chips)
Seat 5: 895de881 ($7.35 in chips)
Seat 6: 12f5bf4f ($8.68 in chips)
Hero: posts small blind $0.05
18857b9c: posts big blind $0.1
*** HOLE CARDS ***
Dealt to 81bf7bca 
Dealt to Hero [5s Jh]
Dealt to 18857b9c 
Dealt to 845cd800 
Dealt to 895de881 
Dealt to 12f5bf4f 
845cd800: folds
895de881: folds
12f5bf4f: raises $0.15 to $0.25
81bf7bca: folds
Hero: folds
18857b9c: folds
Uncalled bet ($0.15) returned to 12f5bf4f
*** SHOWDOWN ***
12f5bf4f collected $0.25 from pot
*** SUMMARY ***
Total pot $0.25 | Rake $0 | Jackpot $0 | Bingo $0 | Fortune $0
Seat 1: 81bf7bca (button) folded before Flop (didn't bet)
Seat 2: Hero (small blind) folded before Flop
Seat 3: 18857b9c (big blind) folded before Flop
Seat 4: 845cd800 folded before Flop (didn't bet)
Seat 5: 895de881 folded before Flop (didn't bet)
Seat 6: 12f5bf4f collected ($0.25)


Poker Hand #RC1459908648: Hold'em No Limit  ($0.05/$0.1) - 2023/04/08 20:45:00
Table 'RushAndCash3773908' 6-max Seat #1 is the button
Seat 1: Hero ($6.17 in chips)
Seat 2: 845cd800 ($11.32 in chips)
Seat 3: aaa179e5 ($9.56 in chips)
Seat 4: 867e0a9c ($10 in chips)
Seat 5: 4bcea642 ($6.2 in chips)
Seat 6: 7ffbdfa1 ($5.23 in chips)
845cd800: posts small blind $0.05
aaa179e5: posts big blind $0.1
*** HOLE CARDS ***
Dealt to Hero [Kc Qs]
Dealt to 845cd800 
Dealt to aaa179e5 
Dealt to 867e0a9c 
Dealt to 4bcea642 
Dealt to 7ffbdfa1 
867e0a9c: folds
4bcea642: folds
7ffbdfa1: raises $0.2 to $0.3
Hero: raises $0.62 to $0.92
845cd800: calls $0.87
aaa179e5: folds
7ffbdfa1: calls $0.62
*** FLOP *** [6c Ac 7h]
845cd800: bets $0.95
7ffbdfa1: folds
Hero: folds
Uncalled bet ($0.95) returned to 845cd800
*** SHOWDOWN ***
845cd800 collected $2.72 from pot
*** SUMMARY ***
Total pot $2.86 | Rake $0.14 | Jackpot $0 | Bingo $0 | Fortune $0
Board [6c Ac 7h]
Seat 1: Hero (button) folded on the Flop
Seat 2: 845cd800 (small blind) won ($2.72)
Seat 3: aaa179e5 (big blind) folded before Flop
Seat 4: 867e0a9c folded before Flop (didn't bet)
Seat 5: 4bcea642 folded before Flop (didn't bet)
Seat 6: 7ffbdfa1 folded on the Flop


Poker Hand #RC1459908613: Hold'em No Limit  ($0.05/$0.1) - 2023/04/08 20:44:51
Table 'RushAndCash3773873' 6-max Seat #1 is the button
Seat 1: 616a92d4 ($9.6 in chips)
Seat 2: Hero ($6.22 in chips)
Seat 3: ad685734 ($14.46 in chips)
Seat 4: 60a8f8e3 ($10.68 in chips)
Seat 5: edcaa5e3 ($13.54 in chips)
Seat 6: 3294ece5 ($56.13 in chips)
Hero: posts small blind $0.05
ad685734: posts big blind $0.1
*** HOLE CARDS ***
Dealt to 616a92d4 
Dealt to Hero [6d 3h]
Dealt to ad685734 
Dealt to 60a8f8e3 
Dealt to edcaa5e3 
Dealt to 3294ece5 
60a8f8e3: folds
edcaa5e3: folds
3294ece5: raises $0.15 to $0.25
616a92d4: calls $0.25
Hero: folds
ad685734: calls $0.15
*** FLOP *** [3s 8d 8h]
ad685734: checks
3294ece5: bets $0.24
616a92d4: folds
ad685734: folds
Uncalled bet ($0.24) returned to 3294ece5
*** SHOWDOWN ***
3294ece5 collected $0.76 from pot
*** SUMMARY ***
Total pot $0.8 | Rake $0.04 | Jackpot $0 | Bingo $0 | Fortune $0
Board [3s 8d 8h]
Seat 1: 616a92d4 (button) folded on the Flop
Seat 2: Hero (small blind) folded before Flop
Seat 3: ad685734 (big blind) folded on the Flop
Seat 4: 60a8f8e3 folded before Flop (didn't bet)
Seat 5: edcaa5e3 folded before Flop (didn't bet)
Seat 6: 3294ece5 won ($0.76)


Poker Hand #RC1459908568: Hold'em No Limit  ($0.05/$0.1) - 2023/04/08 20:44:43
Table 'RushAndCash3773828' 6-max Seat #1 is the button
Seat 1: 46e9a690 ($10 in chips)
Seat 2: 5658ebb1 ($6.41 in chips)
Seat 3: Hero ($6.32 in chips)
Seat 4: 17397d22 ($10 in chips)
Seat 5: 93c20dae ($11.15 in chips)
Seat 6: 7d698839 ($10.11 in chips)
5658ebb1: posts small blind $0.05
Hero: posts big blind $0.1
*** HOLE CARDS ***
Dealt to 46e9a690 
Dealt to 5658ebb1 
Dealt to Hero [5s Qc]
Dealt to 17397d22 
Dealt to 93c20dae 
Dealt to 7d698839 
17397d22: folds
93c20dae: folds
7d698839: folds
46e9a690: raises $0.15 to $0.25
5658ebb1: calls $0.2
Hero: folds
*** FLOP *** [2s Ac As]
5658ebb1: checks
46e9a690: checks
*** TURN *** [2s Ac As] [Ts]
5658ebb1: bets $0.3
46e9a690: folds
Uncalled bet ($0.3) returned to 5658ebb1
*** SHOWDOWN ***
5658ebb1 collected $0.57 from pot
*** SUMMARY ***
Total pot $0.6 | Rake $0.03 | Jackpot $0 | Bingo $0 | Fortune $0
Board [2s Ac As Ts]
Seat 1: 46e9a690 (button) folded on the Turn
Seat 2: 5658ebb1 (small blind) won ($0.57)
Seat 3: Hero (big blind) folded before Flop
Seat 4: 17397d22 folded before Flop (didn't bet)
Seat 5: 93c20dae folded before Flop (didn't bet)
Seat 6: 7d698839 folded before Flop (didn't bet)


Poker Hand #RC1459908528: Hold'em No Limit  ($0.05/$0.1) - 2023/04/08 20:44:34
Table 'RushAndCash3773788' 6-max Seat #1 is the button
Seat 1: 50f2bcd ($10 in chips)
Seat 2: 73b2000b ($10.27 in chips)
Seat 3: ec5f44e ($11.49 in chips)
Seat 4: d26b42b7 ($11.34 in chips)
Seat 5: Hero ($6.32 in chips)
Seat 6: 43663618 ($18.81 in chips)
73b2000b: posts small blind $0.05
ec5f44e: posts big blind $0.1
*** HOLE CARDS ***
Dealt to 50f2bcd 
Dealt to 73b2000b 
Dealt to ec5f44e 
Dealt to d26b42b7 
Dealt to Hero [8c 9d]
Dealt to 43663618 
d26b42b7: raises $0.15 to $0.25
Hero: folds
43663618: folds
50f2bcd: folds
73b2000b: folds
ec5f44e: folds
Uncalled bet ($0.15) returned to d26b42b7
*** SHOWDOWN ***
d26b42b7 collected $0.25 from pot
*** SUMMARY ***
Total pot $0.25 | Rake $0 | Jackpot $0 | Bingo $0 | Fortune $0
Seat 1: 50f2bcd (button) folded before Flop (didn't bet)
Seat 2: 73b2000b (small blind) folded before Flop
Seat 3: ec5f44e (big blind) folded before Flop
Seat 4: d26b42b7 collected ($0.25)
Seat 5: Hero folded before Flop (didn't bet)
Seat 6: 43663618 folded before Flop (didn't bet)


Poker Hand #RC1459908508: Hold'em No Limit  ($0.05/$0.1) - 2023/04/08 20:44:30
Table 'RushAndCash3773768' 6-max Seat #1 is the button
Seat 1: e4c53d38 ($28.92 in chips)
Seat 2: bc774360 ($10 in chips)
Seat 3: fb71a257 ($14.55 in chips)
Seat 4: Hero ($6.32 in chips)
Seat 5: 97b4f97a ($40.5 in chips)
Seat 6: 556685d2 ($46.28 in chips)
bc774360: posts small blind $0.05
fb71a257: posts big blind $0.1
*** HOLE CARDS ***
Dealt to e4c53d38 
Dealt to bc774360 
Dealt to fb71a257 
Dealt to Hero [Ks 7s]
Dealt to 97b4f97a 
Dealt to 556685d2 
Hero: folds
97b4f97a: folds
556685d2: folds
e4c53d38: folds
bc774360: raises $0.2 to $0.3
fb71a257: folds
Uncalled bet ($0.2) returned to bc774360
*** SHOWDOWN ***
bc774360 collected $0.2 from pot
*** SUMMARY ***
Total pot $0.2 | Rake $0 | Jackpot $0 | Bingo $0 | Fortune $0
Seat 1: e4c53d38 (button) folded before Flop (didn't bet)
Seat 2: bc774360 (small blind) collected ($0.2)
Seat 3: fb71a257 (big blind) folded before Flop
Seat 4: Hero folded before Flop (didn't bet)
Seat 5: 97b4f97a folded before Flop (didn't bet)
Seat 6: 556685d2 folded before Flop (didn't bet)


Poker Hand #RC1459908490: Hold'em No Limit  ($0.05/$0.1) - 2023/04/08 20:44:26
Table 'RushAndCash3773750' 6-max Seat #1 is the button
Seat 1: 604f40ce ($12.68 in chips)
Seat 2: d4c4ec99 ($17.79 in chips)
Seat 3: Hero ($6.42 in chips)
Seat 4: 9f65c8a ($13.42 in chips)
Seat 5: caed7b6f ($10.38 in chips)
Seat 6: 867e0a9c ($10 in chips)
d4c4ec99: posts small blind $0.05
Hero: posts big blind $0.1
*** HOLE CARDS ***
Dealt to 604f40ce 
Dealt to d4c4ec99 
Dealt to Hero [Jd 8c]
Dealt to 9f65c8a 
Dealt to caed7b6f 
Dealt to 867e0a9c 
9f65c8a: folds
caed7b6f: folds
867e0a9c: raises $0.15 to $0.25
604f40ce: raises $0.49 to $0.74
d4c4ec99: folds
Hero: folds
867e0a9c: folds
Uncalled bet ($0.49) returned to 604f40ce
*** SHOWDOWN ***
604f40ce collected $0.62 from pot
*** SUMMARY ***
Total pot $0.65 | Rake $0.03 | Jackpot $0 | Bingo $0 | Fortune $0
Seat 1: 604f40ce (button) collected ($0.62)
Seat 2: d4c4ec99 (small blind) folded before Flop
Seat 3: Hero (big blind) folded before Flop
Seat 4: 9f65c8a folded before Flop (didn't bet)
Seat 5: caed7b6f folded before Flop (didn't bet)
Seat 6: 867e0a9c folded before Flop


Poker Hand #RC1459908470: Hold'em No Limit  ($0.05/$0.1) - 2023/04/08 20:44:22
Table 'RushAndCash3773730' 6-max Seat #1 is the button
Seat 1: Hero ($6.42 in chips)
Seat 2: 14bda94c ($10 in chips)
Seat 3: 277af015 ($10 in chips)
Seat 4: 2e2255e7 ($18.92 in chips)
Seat 5: f4047310 ($11.74 in chips)
Seat 6: aaa179e5 ($9.46 in chips)
14bda94c: posts small blind $0.05
277af015: posts big blind $0.1
*** HOLE CARDS ***
Dealt to Hero [Jd 8c]
Dealt to 14bda94c 
Dealt to 277af015 
Dealt to 2e2255e7 
Dealt to f4047310 
Dealt to aaa179e5 
2e2255e7: raises $0.14 to $0.24
f4047310: folds
aaa179e5: folds
Hero: folds
14bda94c: folds
277af015: folds
Uncalled bet ($0.14) returned to 2e2255e7
*** SHOWDOWN ***
2e2255e7 collected $0.25 from pot
*** SUMMARY ***
Total pot $0.25 | Rake $0 | Jackpot $0 | Bingo $0 | Fortune $0
Seat 1: Hero (button) folded before Flop (didn't bet)
Seat 2: 14bda94c (small blind) folded before Flop
Seat 3: 277af015 (big blind) folded before Flop
Seat 4: 2e2255e7 collected ($0.25)
Seat 5: f4047310 folded before Flop (didn't bet)
Seat 6: aaa179e5 folded before Flop (didn't bet)


Poker Hand #RC1459908313: Hold'em No Limit  ($0.05/$0.1) - 2023/04/08 20:43:52
Table 'RushAndCash3773573' 6-max Seat #1 is the button
Seat 1: 94f1a56a ($9.53 in chips)
Seat 2: 80783716 ($10 in chips)
Seat 3: caed7b6f ($10.2 in chips)
Seat 4: 29278a24 ($29.39 in chips)
Seat 5: 72dd4b8 ($20.46 in chips)
Seat 6: Hero ($6.67 in chips)
80783716: posts small blind $0.05
caed7b6f: posts big blind $0.1
*** HOLE CARDS ***
Dealt to 94f1a56a 
Dealt to 80783716 
Dealt to caed7b6f 
Dealt to 29278a24 
Dealt to 72dd4b8 
Dealt to Hero [7s Ad]
29278a24: folds
72dd4b8: folds
Hero: raises $0.15 to $0.25
94f1a56a: folds
80783716: folds
caed7b6f: calls $0.15
*** FLOP *** [7h 9d 8d]
caed7b6f: checks
Hero: checks
*** TURN *** [7h 9d 8d] [Th]
caed7b6f: checks
Hero: checks
*** RIVER *** [7h 9d 8d Th] [Qd]
caed7b6f: bets $0.42
Hero: folds
Uncalled bet ($0.42) returned to caed7b6f
*** SHOWDOWN ***
caed7b6f collected $0.53 from pot
*** SUMMARY ***
Total pot $0.55 | Rake $0.02 | Jackpot $0 | Bingo $0 | Fortune $0
Board [7h 9d 8d Th Qd]
Seat 1: 94f1a56a (button) folded before Flop (didn't bet)
Seat 2: 80783716 (small blind) folded before Flop
Seat 3: caed7b6f (big blind) won ($0.53)
Seat 4: 29278a24 folded before Flop (didn't bet)
Seat 5: 72dd4b8 folded before Flop (didn't bet)
Seat 6: Hero folded on the River


Poker Hand #RC1459908293: Hold'em No Limit  ($0.05/$0.1) - 2023/04/08 20:43:48
Table 'RushAndCash3773553' 6-max Seat #1 is the button
Seat 1: c1960272 ($11.1 in chips)
Seat 2: 5a721ebb ($9.85 in chips)
Seat 3: 297591e6 ($8.17 in chips)
Seat 4: Hero ($6.67 in chips)
Seat 5: f2c7ee7c ($10 in chips)
Seat 6: 2101b7fa ($12.29 in chips)
5a721ebb: posts small blind $0.05
297591e6: posts big blind $0.1
*** HOLE CARDS ***
Dealt to c1960272 
Dealt to 5a721ebb 
Dealt to 297591e6 
Dealt to Hero [Kc 6s]
Dealt to f2c7ee7c 
Dealt to 2101b7fa 
Hero: folds
f2c7ee7c: folds
2101b7fa: raises $0.15 to $0.25
c1960272: folds
5a721ebb: folds
297591e6: calls $0.15
*** FLOP *** [5c 8h 4s]
297591e6: bets $0.37
2101b7fa: calls $0.37
*** TURN *** [5c 8h 4s] [Tc]
297591e6: bets $1
2101b7fa: calls $1
*** RIVER *** [5c 8h 4s Tc] [Kh]
297591e6: bets $2.21
2101b7fa: folds
Uncalled bet ($2.21) returned to 297591e6
*** SHOWDOWN ***
297591e6 collected $2.99 from pot
*** SUMMARY ***
Total pot $3.29 | Rake $0.15 | Jackpot $0.15 | Bingo $0 | Fortune $0
Board [5c 8h 4s Tc Kh]
Seat 1: c1960272 (button) folded before Flop (didn't bet)
Seat 2: 5a721ebb (small blind) folded before Flop
Seat 3: 297591e6 (big blind) won ($2.99)
Seat 4: Hero folded before Flop (didn't bet)
Seat 5: f2c7ee7c folded before Flop (didn't bet)
Seat 6: 2101b7fa folded on the River


Poker Hand #RC1459908269: Hold'em No Limit  ($0.05/$0.1) - 2023/04/08 20:43:44
Table 'RushAndCash3773529' 6-max Seat #1 is the button
Seat 1: c89af454 ($21.29 in chips)
Seat 2: ce8eee04 ($16.34 in chips)
Seat 3: 7eed5c57 ($18.68 in chips)
Seat 4: bb68e4fe ($8.33 in chips)
Seat 5: Hero ($6.67 in chips)
Seat 6: 9369fe84 ($6.8 in chips)
ce8eee04: posts small blind $0.05
7eed5c57: posts big blind $0.1
*** HOLE CARDS ***
Dealt to c89af454 
Dealt to ce8eee04 
Dealt to 7eed5c57 
Dealt to bb68e4fe 
Dealt to Hero [Jc Tc]
Dealt to 9369fe84 
bb68e4fe: folds
Hero: folds
9369fe84: folds
c89af454: raises $0.15 to $0.25
ce8eee04: folds
7eed5c57: folds
Uncalled bet ($0.15) returned to c89af454
*** SHOWDOWN ***
c89af454 collected $0.25 from pot
*** SUMMARY ***
Total pot $0.25 | Rake $0 | Jackpot $0 | Bingo $0 | Fortune $0
Seat 1: c89af454 (button) collected ($0.25)
Seat 2: ce8eee04 (small blind) folded before Flop
Seat 3: 7eed5c57 (big blind) folded before Flop
Seat 4: bb68e4fe folded before Flop (didn't bet)
Seat 5: Hero folded before Flop (didn't bet)
Seat 6: 9369fe84 folded before Flop (didn't bet)


Poker Hand #RC1459908202: Hold'em No Limit  ($0.05/$0.1) - 2023/04/08 20:43:31
Table 'RushAndCash3773462' 6-max Seat #1 is the button
Seat 1: Hero ($6.52 in chips)
Seat 2: a7d462f5 ($20.63 in chips)
Seat 3: 46e9a690 ($10.3 in chips)
Seat 4: 7f958c6d ($21.1 in chips)
Seat 5: c89af454 ($21.29 in chips)
Seat 6: ce8eee04 ($16.34 in chips)
a7d462f5: posts small blind $0.05
46e9a690: posts big blind $0.1
*** HOLE CARDS ***
Dealt to Hero [Kc Js]
Dealt to a7d462f5 
Dealt to 46e9a690 
Dealt to 7f958c6d 
Dealt to c89af454 
Dealt to ce8eee04 
7f958c6d: folds
c89af454: folds
ce8eee04: folds
Hero: raises $0.15 to $0.25
a7d462f5: folds
46e9a690: folds
Uncalled bet ($0.15) returned to Hero
*** SHOWDOWN ***
Hero collected $0.25 from pot
*** SUMMARY ***
Total pot $0.25 | Rake $0 | Jackpot $0 | Bingo $0 | Fortune $0
Seat 1: Hero (button) collected ($0.25)
Seat 2: a7d462f5 (small blind) folded before Flop
Seat 3: 46e9a690 (big blind) folded before Flop
Seat 4: 7f958c6d folded before Flop (didn't bet)
Seat 5: c89af454 folded before Flop (didn't bet)
Seat 6: ce8eee04 folded before Flop (didn't bet)


Poker Hand #RC1459908157: Hold'em No Limit  ($0.05/$0.1) - 2023/04/08 20:43:22
Table 'RushAndCash3773417' 6-max Seat #1 is the button
Seat 1: f9cc9468 ($16.54 in chips)
Seat 2: 8a38d99 ($22.94 in chips)
Seat 3: Hero ($6.47 in chips)
Seat 4: f9461174 ($11.62 in chips)
Seat 5: 2b717329 ($20.02 in chips)
Seat 6: d318a3f7 ($22.56 in chips)
8a38d99: posts small blind $0.05
Hero: posts big blind $0.1
*** HOLE CARDS ***
Dealt to f9cc9468 
Dealt to 8a38d99 
Dealt to Hero [Th 7c]
Dealt to f9461174 
Dealt to 2b717329 
Dealt to d318a3f7 
f9461174: folds
2b717329: folds
d318a3f7: folds
f9cc9468: folds
8a38d99: folds
Uncalled bet ($0.05) returned to Hero
*** SHOWDOWN ***
Hero collected $0.1 from pot
*** SUMMARY ***
Total pot $0.1 | Rake $0 | Jackpot $0 | Bingo $0 | Fortune $0
Seat 1: f9cc9468 (button) folded before Flop (didn't bet)
Seat 2: 8a38d99 (small blind) folded before Flop
Seat 3: Hero (big blind) collected ($0.1)
Seat 4: f9461174 folded before Flop (didn't bet)
Seat 5: 2b717329 folded before Flop (didn't bet)
Seat 6: d318a3f7 folded before Flop (didn't bet)


Poker Hand #RC1459908078: Hold'em No Limit  ($0.05/$0.1) - 2023/04/08 20:43:09
Table 'RushAndCash3773338' 6-max Seat #1 is the button
Seat 1: e3e4b226 ($10.62 in chips)
Seat 2: Hero ($6.52 in chips)
Seat 3: d318a3f7 ($22.71 in chips)
Seat 4: 85c0deea ($4.47 in chips)
Seat 5: f18ec573 ($29.55 in chips)
Seat 6: d0d6b27 ($6.57 in chips)
Hero: posts small blind $0.05
d318a3f7: posts big blind $0.1
*** HOLE CARDS ***
Dealt to e3e4b226 
Dealt to Hero [5s 2c]
Dealt to d318a3f7 
Dealt to 85c0deea 
Dealt to f18ec573 
Dealt to d0d6b27 
85c0deea: raises $0.1 to $0.2
f18ec573: raises $0.55 to $0.75
d0d6b27: folds
e3e4b226: folds
Hero: folds
d318a3f7: folds
85c0deea: calls $0.55
*** FLOP *** [8d As 8h]
85c0deea: checks
f18ec573: checks
*** TURN *** [8d As 8h] [Ts]
85c0deea: bets $1.24
f18ec573: raises $4.16 to $5.4
85c0deea: calls $2.48 and is all-in
Uncalled bet ($1.68) returned to f18ec573
f18ec573: shows [Ah 3h] (Pair of Aces and Pair of Eights)
85c0deea: shows [Kh Th] (Pair of Tens and Pair of Eights)
*** RIVER *** [8d As 8h Ts] [2h]
*** SHOWDOWN ***
f18ec573 collected $8.64 from pot
*** SUMMARY ***
Total pot $9.09 | Rake $0.3 | Jackpot $0.15 | Bingo $0 | Fortune $0
Board [8d As 8h Ts 2h]
Seat 1: e3e4b226 (button) folded before Flop (didn't bet)
Seat 2: Hero (small blind) folded before Flop
Seat 3: d318a3f7 (big blind) folded before Flop
Seat 4: 85c0deea showed [Kh Th] and lost with Pair of Tens and Pair of Eights
Seat 5: f18ec573 showed [Ah 3h] and won ($8.64) with Pair of Aces and Pair of Eights
Seat 6: d0d6b27 folded before Flop (didn't bet)


Poker Hand #RC1459908046: Hold'em No Limit  ($0.05/$0.1) - 2023/04/08 20:43:04
Table 'RushAndCash3773306' 6-max Seat #1 is the button
Seat 1: 880937e1 ($21.31 in chips)
Seat 2: 1b43f364 ($11.12 in chips)
Seat 3: Hero ($6.62 in chips)
Seat 4: ad402a2 ($17.25 in chips)
Seat 5: 70cd5c03 ($12.21 in chips)
Seat 6: cc8b02b8 ($4.08 in chips)
1b43f364: posts small blind $0.05
Hero: posts big blind $0.1
*** HOLE CARDS ***
Dealt to 880937e1 
Dealt to 1b43f364 
Dealt to Hero [5d Ks]
Dealt to ad402a2 
Dealt to 70cd5c03 
Dealt to cc8b02b8 
ad402a2: raises $0.1 to $0.2
70cd5c03: raises $0.42 to $0.62
cc8b02b8: folds
880937e1: folds
1b43f364: folds
Hero: folds
ad402a2: raises $1.23 to $1.85
70cd5c03: calls $1.23
*** FLOP *** [5s Jc Jh]
ad402a2: bets $1.45
70cd5c03: calls $1.45
*** TURN *** [5s Jc Jh] [8h]
ad402a2: bets $2.5
70cd5c03: folds
Uncalled bet ($2.5) returned to ad402a2
*** SHOWDOWN ***
ad402a2 collected $6.3 from pot
*** SUMMARY ***
Total pot $6.75 | Rake $0.3 | Jackpot $0.15 | Bingo $0 | Fortune $0
Board [5s Jc Jh 8h]
Seat 1: 880937e1 (button) folded before Flop (didn't bet)
Seat 2: 1b43f364 (small blind) folded before Flop
Seat 3: Hero (big blind) folded before Flop
Seat 4: ad402a2 won ($6.3)
Seat 5: 70cd5c03 folded on the Turn
Seat 6: cc8b02b8 folded before Flop (didn't bet)


Poker Hand #RC1459907984: Hold'em No Limit  ($0.05/$0.1) - 2023/04/08 20:42:54
Table 'RushAndCash3773244' 6-max Seat #1 is the button
Seat 1: df76427d ($11.1 in chips)
Seat 2: 51bfaab4 ($11.37 in chips)
Seat 3: 8b84b27b ($10 in chips)
Seat 4: 55ac3cd6 ($12.01 in chips)
Seat 5: 69f90ce5 ($19.85 in chips)
Seat 6: Hero ($6.62 in chips)
51bfaab4: posts small blind $0.05
8b84b27b: posts big blind $0.1
*** HOLE CARDS ***
Dealt to df76427d 
Dealt to 51bfaab4 
Dealt to 8b84b27b 
Dealt to 55ac3cd6 
Dealt to 69f90ce5 
Dealt to Hero [7c 3s]
55ac3cd6: raises $0.2 to $0.3
69f90ce5: folds
Hero: folds
df76427d: folds
51bfaab4: calls $0.25
8b84b27b: folds
*** FLOP *** [8c Tc 8h]
51bfaab4: checks
55ac3cd6: checks
*** TURN *** [8c Tc 8h] [Ts]
51bfaab4: checks
55ac3cd6: checks
*** RIVER *** [8c Tc 8h Ts] [5s]
51bfaab4: checks
55ac3cd6: checks
51bfaab4: shows [6d Kd] (Pair of Tens and Pair of Eights)
55ac3cd6: shows [Kh Ah] (Pair of Tens and Pair of Eights)
*** SHOWDOWN ***
55ac3cd6 collected $0.67 from pot
*** SUMMARY ***
Total pot $0.7 | Rake $0.03 | Jackpot $0 | Bingo $0 | Fortune $0
Board [8c Tc 8h Ts 5s]
Seat 1: df76427d (button) folded before Flop (didn't bet)
Seat 2: 51bfaab4 (small blind) showed [6d Kd] and lost with Pair of Tens and Pair of Eights
Seat 3: 8b84b27b (big blind) folded before Flop
Seat 4: 55ac3cd6 showed [Kh Ah] and won ($0.67) with Pair of Tens and Pair of Eights
Seat 5: 69f90ce5 folded before Flop (didn't bet)
Seat 6: Hero folded before Flop (didn't bet)


Poker Hand #RC1459907956: Hold'em No Limit  ($0.05/$0.1) - 2023/04/08 20:42:49
Table 'RushAndCash3773216' 6-max Seat #1 is the button
Seat 1: 4bcea642 ($17.52 in chips)
Seat 2: 9cdbefab ($8.25 in chips)
Seat 3: b4d78cbd ($12.89 in chips)
Seat 4: Hero ($6.62 in chips)
Seat 5: 29278a24 ($29.39 in chips)
Seat 6: 3fdcb188 ($11.83 in chips)
9cdbefab: posts small blind $0.05
b4d78cbd: posts big blind $0.1
*** HOLE CARDS ***
Dealt to 4bcea642 
Dealt to 9cdbefab 
Dealt to b4d78cbd 
Dealt to Hero [Kh 9s]
Dealt to 29278a24 
Dealt to 3fdcb188 
Hero: folds
29278a24: folds
3fdcb188: folds
4bcea642: folds
9cdbefab: folds
Uncalled bet ($0.05) returned to b4d78cbd
*** SHOWDOWN ***
b4d78cbd collected $0.1 from pot
*** SUMMARY ***
Total pot $0.1 | Rake $0 | Jackpot $0 | Bingo $0 | Fortune $0
Seat 1: 4bcea642 (button) folded before Flop (didn't bet)
Seat 2: 9cdbefab (small blind) folded before Flop
Seat 3: b4d78cbd (big blind) collected ($0.1)
Seat 4: Hero folded before Flop (didn't bet)
Seat 5: 29278a24 folded before Flop (didn't bet)
Seat 6: 3fdcb188 folded before Flop (didn't bet)


Poker Hand #RC1459907905: Hold'em No Limit  ($0.05/$0.1) - 2023/04/08 20:42:40
Table 'RushAndCash3773165' 6-max Seat #1 is the button
Seat 1: 59cb8ca8 ($15.04 in chips)
Seat 2: 8a8bce3 ($36.18 in chips)
Seat 3: 6276705 ($10 in chips)
Seat 4: Hero ($6.62 in chips)
Seat 5: 636721ef ($13.37 in chips)
Seat 6: b69132e4 ($10.57 in chips)
8a8bce3: posts small blind $0.05
6276705: posts big blind $0.1
*** HOLE CARDS ***
Dealt to 59cb8ca8 
Dealt to 8a8bce3 
Dealt to 6276705 
Dealt to Hero [3c 8h]
Dealt to 636721ef 
Dealt to b69132e4 
Hero: folds
636721ef: raises $0.15 to $0.25
b69132e4: folds
59cb8ca8: folds
8a8bce3: folds
6276705: calls $0.15
*** FLOP *** [Ks 8c 7c]
6276705: checks
636721ef: bets $0.3
6276705: calls $0.3
*** TURN *** [Ks 8c 7c] [6h]
6276705: checks
636721ef: checks
*** RIVER *** [Ks 8c 7c 6h] [3h]
6276705: bets $0.65
636721ef: calls $0.65
6276705: shows [8d 7d] (Pair of Eights and Pair of Sevens)
636721ef: shows [Tc Ts] (Pair of Tens)
*** SHOWDOWN ***
6276705 collected $2.33 from pot
*** SUMMARY ***
Total pot $2.45 | Rake $0.12 | Jackpot $0 | Bingo $0 | Fortune $0
Board [Ks 8c 7c 6h 3h]
Seat 1: 59cb8ca8 (button) folded before Flop (didn't bet)
Seat 2: 8a8bce3 (small blind) folded before Flop
Seat 3: 6276705 (big blind) showed [8d 7d] and won ($2.33) with Pair of Eights and Pair of Sevens
Seat 4: Hero folded before Flop (didn't bet)
Seat 5: 636721ef showed [Tc Ts] and lost with Pair of Tens
Seat 6: b69132e4 folded before Flop (didn't bet)


Poker Hand #RC1459907871: Hold'em No Limit  ($0.05/$0.1) - 2023/04/08 20:42:35
Table 'RushAndCash3773131' 6-max Seat #1 is the button
Seat 1: Hero ($6.62 in chips)
Seat 2: 80783716 ($10.45 in chips)
Seat 3: 1e2ad5b2 ($10.91 in chips)
Seat 4: 9448719a ($10 in chips)
Seat 5: edd695a8 ($12.29 in chips)
Seat 6: f2def8dc ($33.46 in chips)
80783716: posts small blind $0.05
1e2ad5b2: posts big blind $0.1
*** HOLE CARDS ***
Dealt to Hero [8h 3c]
Dealt to 80783716 
Dealt to 1e2ad5b2 
Dealt to 9448719a 
Dealt to edd695a8 
Dealt to f2def8dc 
9448719a: folds
edd695a8: folds
f2def8dc: folds
Hero: folds
80783716: raises $0.1 to $0.2
1e2ad5b2: folds
Uncalled bet ($0.1) returned to 80783716
*** SHOWDOWN ***
80783716 collected $0.2 from pot
*** SUMMARY ***
Total pot $0.2 | Rake $0 | Jackpot $0 | Bingo $0 | Fortune $0
Seat 1: Hero (button) folded before Flop (didn't bet)
Seat 2: 80783716 (small blind) collected ($0.2)
Seat 3: 1e2ad5b2 (big blind) folded before Flop
Seat 4: 9448719a folded before Flop (didn't bet)
Seat 5: edd695a8 folded before Flop (didn't bet)
Seat 6: f2def8dc folded before Flop (didn't bet)


Poker Hand #RC1459907837: Hold'em No Limit  ($0.05/$0.1) - 2023/04/08 20:42:29
Table 'RushAndCash3773097' 6-max Seat #1 is the button
Seat 1: b808e640 ($11.77 in chips)
Seat 2: b3ba48a4 ($10.33 in chips)
Seat 3: 2c26b728 ($11.27 in chips)
Seat 4: Hero ($6.62 in chips)
Seat 5: 2143eb6c ($11.4 in chips)
Seat 6: 3a725736 ($24.32 in chips)
b3ba48a4: posts small blind $0.05
2c26b728: posts big blind $0.1
*** HOLE CARDS ***
Dealt to b808e640 
Dealt to b3ba48a4 
Dealt to 2c26b728 
Dealt to Hero [Jd 6d]
Dealt to 2143eb6c 
Dealt to 3a725736 
Hero: folds
2143eb6c: folds
3a725736: folds
b808e640: raises $0.15 to $0.25
b3ba48a4: folds
2c26b728: folds
Uncalled bet ($0.15) returned to b808e640
*** SHOWDOWN ***
b808e640 collected $0.25 from pot
*** SUMMARY ***
Total pot $0.25 | Rake $0 | Jackpot $0 | Bingo $0 | Fortune $0
Seat 1: b808e640 (button) collected ($0.25)
Seat 2: b3ba48a4 (small blind) folded before Flop
Seat 3: 2c26b728 (big blind) folded before Flop
Seat 4: Hero folded before Flop (didn't bet)
Seat 5: 2143eb6c folded before Flop (didn't bet)
Seat 6: 3a725736 folded before Flop (didn't bet)


Poker Hand #RC1459907808: Hold'em No Limit  ($0.05/$0.1) - 2023/04/08 20:42:23
Table 'RushAndCash3773068' 6-max Seat #1 is the button
Seat 1: 7036d465 ($19.57 in chips)
Seat 2: Hero ($6.67 in chips)
Seat 3: 4c996243 ($10 in chips)
Seat 4: d7cf9b00 ($11.49 in chips)
Seat 5: 10cb5d98 ($8.2 in chips)
Seat 6: 807d11fd ($10.22 in chips)
Hero: posts small blind $0.05
4c996243: posts big blind $0.1
*** HOLE CARDS ***
Dealt to 7036d465 
Dealt to Hero [9d Jh]
Dealt to 4c996243 
Dealt to d7cf9b00 
Dealt to 10cb5d98 
Dealt to 807d11fd 
d7cf9b00: folds
10cb5d98: raises $0.15 to $0.25
807d11fd: raises $0.75 to $1
7036d465: folds
Hero: folds
4c996243: folds
10cb5d98: calls $0.75
*** FLOP *** [Ts Kh Td]
10cb5d98: checks
807d11fd: bets $0.8
10cb5d98: calls $0.8
*** TURN *** [Ts Kh Td] [6c]
10cb5d98: checks
807d11fd: bets $1.8
10cb5d98: folds
Uncalled bet ($1.8) returned to 807d11fd
*** SHOWDOWN ***
807d11fd collected $3.42 from pot
*** SUMMARY ***
Total pot $3.75 | Rake $0.18 | Jackpot $0.15 | Bingo $0 | Fortune $0
Board [Ts Kh Td 6c]
Seat 1: 7036d465 (button) folded before Flop (didn't bet)
Seat 2: Hero (small blind) folded before Flop
Seat 3: 4c996243 (big blind) folded before Flop
Seat 4: d7cf9b00 folded before Flop (didn't bet)
Seat 5: 10cb5d98 folded on the Turn
Seat 6: 807d11fd won ($3.42)


Poker Hand #RC1459907774: Hold'em No Limit  ($0.05/$0.1) - 2023/04/08 20:42:17
Table 'RushAndCash3773034' 6-max Seat #1 is the button
Seat 1: 17afc875 ($10.27 in chips)
Seat 2: edd695a8 ($12.34 in chips)
Seat 3: 5ef07beb ($38.91 in chips)
Seat 4: 97b4f97a ($40.65 in chips)
Seat 5: ebdcdf3d ($18.26 in chips)
Seat 6: Hero ($6.67 in chips)
edd695a8: posts small blind $0.05
5ef07beb: posts big blind $0.1
*** HOLE CARDS ***
Dealt to 17afc875 
Dealt to edd695a8 
Dealt to 5ef07beb 
Dealt to 97b4f97a 
Dealt to ebdcdf3d 
Dealt to Hero [2d 7h]
97b4f97a: folds
ebdcdf3d: folds
Hero: folds
17afc875: raises $0.15 to $0.25
edd695a8: folds
5ef07beb: folds
Uncalled bet ($0.15) returned to 17afc875
*** SHOWDOWN ***
17afc875 collected $0.25 from pot
*** SUMMARY ***
Total pot $0.25 | Rake $0 | Jackpot $0 | Bingo $0 | Fortune $0
Seat 1: 17afc875 (button) collected ($0.25)
Seat 2: edd695a8 (small blind) folded before Flop
Seat 3: 5ef07beb (big blind) folded before Flop
Seat 4: 97b4f97a folded before Flop (didn't bet)
Seat 5: ebdcdf3d folded before Flop (didn't bet)
Seat 6: Hero folded before Flop (didn't bet)


Poker Hand #RC1459907561: Hold'em No Limit  ($0.05/$0.1) - 2023/04/08 20:41:42
Table 'RushAndCash3772821' 6-max Seat #1 is the button
Seat 1: 69b20187 ($11 in chips)
Seat 2: Hero ($6.97 in chips)
Seat 3: 3237ce2 ($14.79 in chips)
Seat 4: f6b84b5c ($10.95 in chips)
Seat 5: b69132e4 ($10.57 in chips)
Seat 6: 80783716 ($10 in chips)
Hero: posts small blind $0.05
3237ce2: posts big blind $0.1
*** HOLE CARDS ***
Dealt to 69b20187 
Dealt to Hero [Tc Kc]
Dealt to 3237ce2 
Dealt to f6b84b5c 
Dealt to b69132e4 
Dealt to 80783716 
f6b84b5c: folds
b69132e4: folds
80783716: folds
69b20187: folds
Hero: raises $0.2 to $0.3
3237ce2: calls $0.2
*** FLOP *** [Jh 2s 6d]
Hero: checks
3237ce2: bets $0.2
Hero: folds
Uncalled bet ($0.2) returned to 3237ce2
*** SHOWDOWN ***
3237ce2 collected $0.57 from pot
*** SUMMARY ***
Total pot $0.6 | Rake $0.03 | Jackpot $0 | Bingo $0 | Fortune $0
Board [Jh 2s 6d]
Seat 1: 69b20187 (button) folded before Flop (didn't bet)
Seat 2: Hero (small blind) folded on the Flop
Seat 3: 3237ce2 (big blind) won ($0.57)
Seat 4: f6b84b5c folded before Flop (didn't bet)
Seat 5: b69132e4 folded before Flop (didn't bet)
Seat 6: 80783716 folded before Flop (didn't bet)


Poker Hand #RC1459907535: Hold'em No Limit  ($0.05/$0.1) - 2023/04/08 20:41:37
Table 'RushAndCash3772795' 6-max Seat #1 is the button
Seat 1: 87bc60ab ($20.41 in chips)
Seat 2: 92006799 ($10.41 in chips)
Seat 3: baddceb ($22.8 in chips)
Seat 4: Hero ($6.97 in chips)
Seat 5: 8f834bd5 ($30.48 in chips)
Seat 6: c7af190b ($13.18 in chips)
92006799: posts small blind $0.05
baddceb: posts big blind $0.1
*** HOLE CARDS ***
Dealt to 87bc60ab 
Dealt to 92006799 
Dealt to baddceb 
Dealt to Hero [4s Qc]
Dealt to 8f834bd5 
Dealt to c7af190b 
Hero: folds
8f834bd5: folds
c7af190b: folds
87bc60ab: folds
92006799: folds
Uncalled bet ($0.05) returned to baddceb
*** SHOWDOWN ***
baddceb collected $0.1 from pot
*** SUMMARY ***
Total pot $0.1 | Rake $0 | Jackpot $0 | Bingo $0 | Fortune $0
Seat 1: 87bc60ab (button) folded before Flop (didn't bet)
Seat 2: 92006799 (small blind) folded before Flop
Seat 3: baddceb (big blind) collected ($0.1)
Seat 4: Hero folded before Flop (didn't bet)
Seat 5: 8f834bd5 folded before Flop (didn't bet)
Seat 6: c7af190b folded before Flop (didn't bet)


Poker Hand #RC1459907497: Hold'em No Limit  ($0.05/$0.1) - 2023/04/08 20:41:30
Table 'RushAndCash3772757' 6-max Seat #1 is the button
Seat 1: f2def8dc ($33.39 in chips)
Seat 2: 8c7692c1 ($10.12 in chips)
Seat 3: d318a3f7 ($21.74 in chips)
Seat 4: 8ea699cf ($10.24 in chips)
Seat 5: Hero ($6.97 in chips)
Seat 6: c57a3d6 ($23.53 in chips)
8c7692c1: posts small blind $0.05
d318a3f7: posts big blind $0.1
*** HOLE CARDS ***
Dealt to f2def8dc 
Dealt to 8c7692c1 
Dealt to d318a3f7 
Dealt to 8ea699cf 
Dealt to Hero [9h Ac]
Dealt to c57a3d6 
8ea699cf: raises $0.2 to $0.3
Hero: folds
c57a3d6: folds
f2def8dc: folds
8c7692c1: folds
d318a3f7: folds
Uncalled bet ($0.2) returned to 8ea699cf
*** SHOWDOWN ***
8ea699cf collected $0.25 from pot
*** SUMMARY ***
Total pot $0.25 | Rake $0 | Jackpot $0 | Bingo $0 | Fortune $0
Seat 1: f2def8dc (button) folded before Flop (didn't bet)
Seat 2: 8c7692c1 (small blind) folded before Flop
Seat 3: d318a3f7 (big blind) folded before Flop
Seat 4: 8ea699cf collected ($0.25)
Seat 5: Hero folded before Flop (didn't bet)
Seat 6: c57a3d6 folded before Flop (didn't bet)


Poker Hand #RC1459907471: Hold'em No Limit  ($0.05/$0.1) - 2023/04/08 20:41:26
Table 'RushAndCash3772731' 6-max Seat #1 is the button
Seat 1: 5ad9ed91 ($10.68 in chips)
Seat 2: 18857b9c ($10 in chips)
Seat 3: Hero ($7.07 in chips)
Seat 4: c57a3d6 ($23.53 in chips)
Seat 5: 9ffadf7e ($3.6 in chips)
Seat 6: 97b4f97a ($40.75 in chips)
18857b9c: posts small blind $0.05
Hero: posts big blind $0.1
*** HOLE CARDS ***
Dealt to 5ad9ed91 
Dealt to 18857b9c 
Dealt to Hero [Th 8c]
Dealt to c57a3d6 
Dealt to 9ffadf7e 
Dealt to 97b4f97a 
c57a3d6: folds
9ffadf7e: folds
97b4f97a: folds
5ad9ed91: raises $0.16 to $0.26
18857b9c: folds
Hero: folds
Uncalled bet ($0.16) returned to 5ad9ed91
*** SHOWDOWN ***
5ad9ed91 collected $0.25 from pot
*** SUMMARY ***
Total pot $0.25 | Rake $0 | Jackpot $0 | Bingo $0 | Fortune $0
Seat 1: 5ad9ed91 (button) collected ($0.25)
Seat 2: 18857b9c (small blind) folded before Flop
Seat 3: Hero (big blind) folded before Flop
Seat 4: c57a3d6 folded before Flop (didn't bet)
Seat 5: 9ffadf7e folded before Flop (didn't bet)
Seat 6: 97b4f97a folded before Flop (didn't bet)


Poker Hand #RC1459907388: Hold'em No Limit  ($0.05/$0.1) - 2023/04/08 20:41:11
Table 'RushAndCash3772648' 6-max Seat #1 is the button
Seat 1: Hero ($7.07 in chips)
Seat 2: 1b11e8a6 ($10 in chips)
Seat 3: c3c0fb7f ($10.56 in chips)
Seat 4: e26a9316 ($3.6 in chips)
Seat 5: 5ff297d1 ($9.15 in chips)
Seat 6: 2c1cb730 ($10.15 in chips)
1b11e8a6: posts small blind $0.05
c3c0fb7f: posts big blind $0.1
*** HOLE CARDS ***
Dealt to Hero [Ac 4h]
Dealt to 1b11e8a6 
Dealt to c3c0fb7f 
Dealt to e26a9316 
Dealt to 5ff297d1 
Dealt to 2c1cb730 
e26a9316: folds
5ff297d1: raises $0.25 to $0.35
2c1cb730: folds
Hero: folds
1b11e8a6: folds
c3c0fb7f: folds
Uncalled bet ($0.25) returned to 5ff297d1
*** SHOWDOWN ***
5ff297d1 collected $0.25 from pot
*** SUMMARY ***
Total pot $0.25 | Rake $0 | Jackpot $0 | Bingo $0 | Fortune $0
Seat 1: Hero (button) folded before Flop (didn't bet)
Seat 2: 1b11e8a6 (small blind) folded before Flop
Seat 3: c3c0fb7f (big blind) folded before Flop
Seat 4: e26a9316 folded before Flop (didn't bet)
Seat 5: 5ff297d1 collected ($0.25)
Seat 6: 2c1cb730 folded before Flop (didn't bet)


Poker Hand #RC1459907360: Hold'em No Limit  ($0.05/$0.1) - 2023/04/08 20:41:07
Table 'RushAndCash3772620' 6-max Seat #1 is the button
Seat 1: Hero ($7.07 in chips)
Seat 2: a3c3dc0f ($10.25 in chips)
Seat 3: 47bd79f0 ($18.47 in chips)
Seat 4: fe74b7c3 ($23.31 in chips)
Seat 5: ed2461d3 ($27.14 in chips)
Seat 6: c3c0fb7f ($10.56 in chips)
a3c3dc0f: posts small blind $0.05
47bd79f0: posts big blind $0.1
*** HOLE CARDS ***
Dealt to Hero [2s 5d]
Dealt to a3c3dc0f 
Dealt to 47bd79f0 
Dealt to fe74b7c3 
Dealt to ed2461d3 
Dealt to c3c0fb7f 
fe74b7c3: folds
ed2461d3: folds
c3c0fb7f: folds
Hero: folds
a3c3dc0f: calls $0.05
47bd79f0: checks
*** FLOP *** [2d 8c Th]
a3c3dc0f: bets $0.1
47bd79f0: folds
Uncalled bet ($0.1) returned to a3c3dc0f
*** SHOWDOWN ***
a3c3dc0f collected $0.19 from pot
*** SUMMARY ***
Total pot $0.2 | Rake $0.01 | Jackpot $0 | Bingo $0 | Fortune $0
Board [2d 8c Th]
Seat 1: Hero (button) folded before Flop (didn't bet)
Seat 2: a3c3dc0f (small blind) won ($0.19)
Seat 3: 47bd79f0 (big blind) folded on the Flop
Seat 4: fe74b7c3 folded before Flop (didn't bet)
Seat 5: ed2461d3 folded before Flop (didn't bet)
Seat 6: c3c0fb7f folded before Flop (didn't bet)


Poker Hand #RC1459907338: Hold'em No Limit  ($0.05/$0.1) - 2023/04/08 20:41:03
Table 'RushAndCash3772598' 6-max Seat #1 is the button
Seat 1: 86e1ee3f ($10 in chips)
Seat 2: Hero ($7.12 in chips)
Seat 3: 29278a24 ($29.79 in chips)
Seat 4: ee266a57 ($11.12 in chips)
Seat 5: c3c0fb7f ($10.56 in chips)
Seat 6: aff25f2b ($23.58 in chips)
Hero: posts small blind $0.05
29278a24: posts big blind $0.1
*** HOLE CARDS ***
Dealt to 86e1ee3f 
Dealt to Hero [Qs 5c]
Dealt to 29278a24 
Dealt to ee266a57 
Dealt to c3c0fb7f 
Dealt to aff25f2b 
ee266a57: raises $0.1 to $0.2
c3c0fb7f: folds
aff25f2b: calls $0.2
86e1ee3f: calls $0.2
Hero: folds
29278a24: folds
*** FLOP *** [8d Ac 7s]
ee266a57: checks
aff25f2b: checks
86e1ee3f: bets $0.25
ee266a57: folds
aff25f2b: folds
Uncalled bet ($0.25) returned to 86e1ee3f
*** SHOWDOWN ***
86e1ee3f collected $0.72 from pot
*** SUMMARY ***
Total pot $0.75 | Rake $0.03 | Jackpot $0 | Bingo $0 | Fortune $0
Board [8d Ac 7s]
Seat 1: 86e1ee3f (button) won ($0.72)
Seat 2: Hero (small blind) folded before Flop
Seat 3: 29278a24 (big blind) folded before Flop
Seat 4: ee266a57 folded on the Flop
Seat 5: c3c0fb7f folded before Flop (didn't bet)
Seat 6: aff25f2b folded on the Flop


Poker Hand #RC1459907318: Hold'em No Limit  ($0.05/$0.1) - 2023/04/08 20:40:59
Table 'RushAndCash3772578' 6-max Seat #1 is the button
Seat 1: da6980d ($10.41 in chips)
Seat 2: fb71a257 ($10 in chips)
Seat 3: f05ce810 ($14.22 in chips)
Seat 4: e33b6a9d ($8.1 in chips)
Seat 5: Hero ($7.12 in chips)
Seat 6: 87bc60ab ($20.71 in chips)
fb71a257: posts small blind $0.05
f05ce810: posts big blind $0.1
*** HOLE CARDS ***
Dealt to da6980d 
Dealt to fb71a257 
Dealt to f05ce810 
Dealt to e33b6a9d 
Dealt to Hero [Jh Td]
Dealt to 87bc60ab 
e33b6a9d: folds
Hero: folds
87bc60ab: folds
da6980d: raises $0.15 to $0.25
fb71a257: folds
f05ce810: folds
Uncalled bet ($0.15) returned to da6980d
*** SHOWDOWN ***
da6980d collected $0.25 from pot
*** SUMMARY ***
Total pot $0.25 | Rake $0 | Jackpot $0 | Bingo $0 | Fortune $0
Seat 1: da6980d (button) collected ($0.25)
Seat 2: fb71a257 (small blind) folded before Flop
Seat 3: f05ce810 (big blind) folded before Flop
Seat 4: e33b6a9d folded before Flop (didn't bet)
Seat 5: Hero folded before Flop (didn't bet)
Seat 6: 87bc60ab folded before Flop (didn't bet)


Poker Hand #RC1459907289: Hold'em No Limit  ($0.05/$0.1) - 2023/04/08 20:40:55
Table 'RushAndCash3772549' 6-max Seat #1 is the button
Seat 1: 7dcc6c82 ($10.87 in chips)
Seat 2: a02f13bb ($31.1 in chips)
Seat 3: Hero ($7.22 in chips)
Seat 4: 49da03d9 ($31.72 in chips)
Seat 5: 587a017c ($101.61 in chips)
Seat 6: 17e4c517 ($20.5 in chips)
a02f13bb: posts small blind $0.05
Hero: posts big blind $0.1
*** HOLE CARDS ***
Dealt to 7dcc6c82 
Dealt to a02f13bb 
Dealt to Hero [6c 9s]
Dealt to 49da03d9 
Dealt to 587a017c 
Dealt to 17e4c517 
49da03d9: folds
587a017c: folds
17e4c517: folds
7dcc6c82: raises $0.15 to $0.25
a02f13bb: folds
Hero: folds
Uncalled bet ($0.15) returned to 7dcc6c82
*** SHOWDOWN ***
7dcc6c82 collected $0.25 from pot
*** SUMMARY ***
Total pot $0.25 | Rake $0 | Jackpot $0 | Bingo $0 | Fortune $0
Seat 1: 7dcc6c82 (button) collected ($0.25)
Seat 2: a02f13bb (small blind) folded before Flop
Seat 3: Hero (big blind) folded before Flop
Seat 4: 49da03d9 folded before Flop (didn't bet)
Seat 5: 587a017c folded before Flop (didn't bet)
Seat 6: 17e4c517 folded before Flop (didn't bet)


Poker Hand #RC1459907264: Hold'em No Limit  ($0.05/$0.1) - 2023/04/08 20:40:50
Table 'RushAndCash3772524' 6-max Seat #1 is the button
Seat 1: Hero ($7.22 in chips)
Seat 2: 7dcc6c82 ($10.92 in chips)
Seat 3: f7d69424 ($6.78 in chips)
Seat 4: 3fdcb188 ($11.85 in chips)
Seat 5: dfe0f72a ($10.25 in chips)
Seat 6: 587a017c ($101.61 in chips)
7dcc6c82: posts small blind $0.05
f7d69424: posts big blind $0.1
*** HOLE CARDS ***
Dealt to Hero [9s 2s]
Dealt to 7dcc6c82 
Dealt to f7d69424 
Dealt to 3fdcb188 
Dealt to dfe0f72a 
Dealt to 587a017c 
3fdcb188: folds
dfe0f72a: folds
587a017c: folds
Hero: folds
7dcc6c82: folds
Uncalled bet ($0.05) returned to f7d69424
*** SHOWDOWN ***
f7d69424 collected $0.1 from pot
*** SUMMARY ***
Total pot $0.1 | Rake $0 | Jackpot $0 | Bingo $0 | Fortune $0
Seat 1: Hero (button) folded before Flop (didn't bet)
Seat 2: 7dcc6c82 (small blind) folded before Flop
Seat 3: f7d69424 (big blind) collected ($0.1)
Seat 4: 3fdcb188 folded before Flop (didn't bet)
Seat 5: dfe0f72a folded before Flop (didn't bet)
Seat 6: 587a017c folded before Flop (didn't bet)


Poker Hand #RC1459907238: Hold'em No Limit  ($0.05/$0.1) - 2023/04/08 20:40:46
Table 'RushAndCash3772498' 6-max Seat #1 is the button
Seat 1: f05ce810 ($14.22 in chips)
Seat 2: 91f5be8d ($14.47 in chips)
Seat 3: 68ef8f13 ($10.06 in chips)
Seat 4: Hero ($7.22 in chips)
Seat 5: 95d2128f ($46.96 in chips)
Seat 6: 1b43f364 ($11.4 in chips)
91f5be8d: posts small blind $0.05
68ef8f13: posts big blind $0.1
*** HOLE CARDS ***
Dealt to f05ce810 
Dealt to 91f5be8d 
Dealt to 68ef8f13 
Dealt to Hero [Qh 2s]
Dealt to 95d2128f 
Dealt to 1b43f364 
Hero: folds
95d2128f: folds
1b43f364: folds
f05ce810: folds
91f5be8d: folds
Uncalled bet ($0.05) returned to 68ef8f13
*** SHOWDOWN ***
68ef8f13 collected $0.1 from pot
*** SUMMARY ***
Total pot $0.1 | Rake $0 | Jackpot $0 | Bingo $0 | Fortune $0
Seat 1: f05ce810 (button) folded before Flop (didn't bet)
Seat 2: 91f5be8d (small blind) folded before Flop
Seat 3: 68ef8f13 (big blind) collected ($0.1)
Seat 4: Hero folded before Flop (didn't bet)
Seat 5: 95d2128f folded before Flop (didn't bet)
Seat 6: 1b43f364 folded before Flop (didn't bet)


Poker Hand #RC1459907212: Hold'em No Limit  ($0.05/$0.1) - 2023/04/08 20:40:41
Table 'RushAndCash3772472' 6-max Seat #1 is the button
Seat 1: 5b1b87a6 ($19.75 in chips)
Seat 2: 6ba28c84 ($14.31 in chips)
Seat 3: cd80bf76 ($10.1 in chips)
Seat 4: 89d24b76 ($26.69 in chips)
Seat 5: Hero ($7.22 in chips)
Seat 6: f7d69424 ($6.78 in chips)
6ba28c84: posts small blind $0.05
cd80bf76: posts big blind $0.1
*** HOLE CARDS ***
Dealt to 5b1b87a6 
Dealt to 6ba28c84 
Dealt to cd80bf76 
Dealt to 89d24b76 
Dealt to Hero [2d 7s]
Dealt to f7d69424 
89d24b76: folds
Hero: folds
f7d69424: folds
5b1b87a6: raises $0.13 to $0.23
6ba28c84: calls $0.18
cd80bf76: folds
*** FLOP *** [Tc Kh 6c]
6ba28c84: checks
5b1b87a6: bets $0.19
6ba28c84: folds
Uncalled bet ($0.19) returned to 5b1b87a6
*** SHOWDOWN ***
5b1b87a6 collected $0.54 from pot
*** SUMMARY ***
Total pot $0.56 | Rake $0.02 | Jackpot $0 | Bingo $0 | Fortune $0
Board [Tc Kh 6c]
Seat 1: 5b1b87a6 (button) won ($0.54)
Seat 2: 6ba28c84 (small blind) folded on the Flop
Seat 3: cd80bf76 (big blind) folded before Flop
Seat 4: 89d24b76 folded before Flop (didn't bet)
Seat 5: Hero folded before Flop (didn't bet)
Seat 6: f7d69424 folded before Flop (didn't bet)


Poker Hand #RC1459907192: Hold'em No Limit  ($0.05/$0.1) - 2023/04/08 20:40:37
Table 'RushAndCash3772452' 6-max Seat #1 is the button
Seat 1: ad685734 ($14.22 in chips)
Seat 2: db15d716 ($24.81 in chips)
Seat 3: 1e2ad5b2 ($11.35 in chips)
Seat 4: Hero ($7.22 in chips)
Seat 5: baddceb ($23 in chips)
Seat 6: 845cd800 ($11.87 in chips)
db15d716: posts small blind $0.05
1e2ad5b2: posts big blind $0.1
*** HOLE CARDS ***
Dealt to ad685734 
Dealt to db15d716 
Dealt to 1e2ad5b2 
Dealt to Hero [3h 4h]
Dealt to baddceb 
Dealt to 845cd800 
Hero: folds
baddceb: folds
845cd800: folds
ad685734: folds
db15d716: folds
Uncalled bet ($0.05) returned to 1e2ad5b2
*** SHOWDOWN ***
1e2ad5b2 collected $0.1 from pot
*** SUMMARY ***
Total pot $0.1 | Rake $0 | Jackpot $0 | Bingo $0 | Fortune $0
Seat 1: ad685734 (button) folded before Flop (didn't bet)
Seat 2: db15d716 (small blind) folded before Flop
Seat 3: 1e2ad5b2 (big blind) collected ($0.1)
Seat 4: Hero folded before Flop (didn't bet)
Seat 5: baddceb folded before Flop (didn't bet)
Seat 6: 845cd800 folded before Flop (didn't bet)


Poker Hand #RC1459907145: Hold'em No Limit  ($0.05/$0.1) - 2023/04/08 20:40:30
Table 'RushAndCash3772405' 6-max Seat #1 is the button
Seat 1: fa2c2cc3 ($17.56 in chips)
Seat 2: 5e20bab2 ($13.94 in chips)
Seat 3: Hero ($7.17 in chips)
Seat 4: c9a078f8 ($8.39 in chips)
Seat 5: 95c94948 ($7.36 in chips)
Seat 6: e8dad1c8 ($34.5 in chips)
5e20bab2: posts small blind $0.05
Hero: posts big blind $0.1
*** HOLE CARDS ***
Dealt to fa2c2cc3 
Dealt to 5e20bab2 
Dealt to Hero [Kc 4h]
Dealt to c9a078f8 
Dealt to 95c94948 
Dealt to e8dad1c8 
c9a078f8: folds
95c94948: folds
e8dad1c8: folds
fa2c2cc3: folds
5e20bab2: folds
Uncalled bet ($0.05) returned to Hero
*** SHOWDOWN ***
Hero collected $0.1 from pot
*** SUMMARY ***
Total pot $0.1 | Rake $0 | Jackpot $0 | Bingo $0 | Fortune $0
Seat 1: fa2c2cc3 (button) folded before Flop (didn't bet)
Seat 2: 5e20bab2 (small blind) folded before Flop
Seat 3: Hero (big blind) collected ($0.1)
Seat 4: c9a078f8 folded before Flop (didn't bet)
Seat 5: 95c94948 folded before Flop (didn't bet)
Seat 6: e8dad1c8 folded before Flop (didn't bet)


Poker Hand #RC1459907087: Hold'em No Limit  ($0.05/$0.1) - 2023/04/08 20:40:20
Table 'RushAndCash3772347' 6-max Seat #1 is the button
Seat 1: db71bbd3 ($13.9 in chips)
Seat 2: Hero ($7.22 in chips)
Seat 3: a9b318dc ($9.13 in chips)
Seat 4: fff78e2 ($13.93 in chips)
Seat 5: f305844b ($10 in chips)
Seat 6: d7cf9b00 ($11.94 in chips)
Hero: posts small blind $0.05
a9b318dc: posts big blind $0.1
*** HOLE CARDS ***
Dealt to db71bbd3 
Dealt to Hero [8d 3h]
Dealt to a9b318dc 
Dealt to fff78e2 
Dealt to f305844b 
Dealt to d7cf9b00 
fff78e2: folds
f305844b: folds
d7cf9b00: folds
db71bbd3: raises $0.15 to $0.25
Hero: folds
a9b318dc: calls $0.15
*** FLOP *** [2h 9s 6d]
a9b318dc: checks
db71bbd3: bets $0.19
a9b318dc: folds
Uncalled bet ($0.19) returned to db71bbd3
*** SHOWDOWN ***
db71bbd3 collected $0.53 from pot
*** SUMMARY ***
Total pot $0.55 | Rake $0.02 | Jackpot $0 | Bingo $0 | Fortune $0
Board [2h 9s 6d]
Seat 1: db71bbd3 (button) won ($0.53)
Seat 2: Hero (small blind) folded before Flop
Seat 3: a9b318dc (big blind) folded on the Flop
Seat 4: fff78e2 folded before Flop (didn't bet)
Seat 5: f305844b folded before Flop (didn't bet)
Seat 6: d7cf9b00 folded before Flop (didn't bet)


Poker Hand #RC1459906822: Hold'em No Limit  ($0.05/$0.1) - 2023/04/08 20:39:33
Table 'RushAndCash3772082' 6-max Seat #1 is the button
Seat 1: 9dc43da9 ($12.94 in chips)
Seat 2: a113d701 ($10 in chips)
Seat 3: 5994ee06 ($11.95 in chips)
Seat 4: Hero ($8.67 in chips)
Seat 5: 1d14bbd1 ($5.25 in chips)
Seat 6: 4bcea642 ($16.9 in chips)
a113d701: posts small blind $0.05
5994ee06: posts big blind $0.1
*** HOLE CARDS ***
Dealt to 9dc43da9 
Dealt to a113d701 
Dealt to 5994ee06 
Dealt to Hero [Ts Tc]
Dealt to 1d14bbd1 
Dealt to 4bcea642 
Hero: raises $0.15 to $0.25
1d14bbd1: calls $0.25
4bcea642: folds
9dc43da9: calls $0.25
a113d701: folds
5994ee06: folds
*** FLOP *** [3s 4s 6d]
Hero: bets $0.45
1d14bbd1: folds
9dc43da9: calls $0.45
*** TURN *** [3s 4s 6d] [4h]
Hero: checks
9dc43da9: checks
*** RIVER *** [3s 4s 6d 4h] [3h]
Hero: bets $0.75
9dc43da9: calls $0.75
Hero: shows [Ts Tc] (Pair of Tens and Pair of Fours)
9dc43da9: shows [Qd Qs] (Pair of Queens and Pair of Fours)
*** SHOWDOWN ***
9dc43da9 collected $3 from pot
*** SUMMARY ***
Total pot $3.3 | Rake $0.15 | Jackpot $0.15 | Bingo $0 | Fortune $0
Board [3s 4s 6d 4h 3h]
Seat 1: 9dc43da9 (button) showed [Qd Qs] and won ($3) with Pair of Queens and Pair of Fours
Seat 2: a113d701 (small blind) folded before Flop
Seat 3: 5994ee06 (big blind) folded before Flop
Seat 4: Hero showed [Ts Tc] and lost with Pair of Tens and Pair of Fours
Seat 5: 1d14bbd1 folded on the Flop
Seat 6: 4bcea642 folded before Flop (didn't bet)


Poker Hand #RC1459906798: Hold'em No Limit  ($0.05/$0.1) - 2023/04/08 20:39:28
Table 'RushAndCash3772058' 6-max Seat #1 is the button
Seat 1: 5994ee06 ($11.95 in chips)
Seat 2: 1eb53111 ($9.33 in chips)
Seat 3: 39c1fa2c ($15.77 in chips)
Seat 4: 867e0a9c ($13.77 in chips)
Seat 5: Hero ($8.67 in chips)
Seat 6: 264b4dc3 ($11.68 in chips)
1eb53111: posts small blind $0.05
39c1fa2c: posts big blind $0.1
*** HOLE CARDS ***
Dealt to 5994ee06 
Dealt to 1eb53111 
Dealt to 39c1fa2c 
Dealt to 867e0a9c 
Dealt to Hero [8c Tc]
Dealt to 264b4dc3 
867e0a9c: raises $0.15 to $0.25
Hero: folds
264b4dc3: folds
5994ee06: folds
1eb53111: folds
39c1fa2c: raises $0.75 to $1
867e0a9c: calls $0.75
*** FLOP *** [Th 5s 9s]
39c1fa2c: bets $1.03
867e0a9c: folds
Uncalled bet ($1.03) returned to 39c1fa2c
*** SHOWDOWN ***
39c1fa2c collected $1.95 from pot
*** SUMMARY ***
Total pot $2.05 | Rake $0.1 | Jackpot $0 | Bingo $0 | Fortune $0
Board [Th 5s 9s]
Seat 1: 5994ee06 (button) folded before Flop (didn't bet)
Seat 2: 1eb53111 (small blind) folded before Flop
Seat 3: 39c1fa2c (big blind) won ($1.95)
Seat 4: 867e0a9c folded on the Flop
Seat 5: Hero folded before Flop (didn't bet)
Seat 6: 264b4dc3 folded before Flop (didn't bet)


Poker Hand #RC1459906777: Hold'em No Limit  ($0.05/$0.1) - 2023/04/08 20:39:24
Table 'RushAndCash3772037' 6-max Seat #1 is the button
Seat 1: 556685d2 ($43.32 in chips)
Seat 2: 423ab6ff ($9.85 in chips)
Seat 3: fa1722a8 ($14.49 in chips)
Seat 4: 67c53cfa ($10 in chips)
Seat 5: 867e0a9c ($13.77 in chips)
Seat 6: Hero ($8.67 in chips)
423ab6ff: posts small blind $0.05
fa1722a8: posts big blind $0.1
*** HOLE CARDS ***
Dealt to 556685d2 
Dealt to 423ab6ff 
Dealt to fa1722a8 
Dealt to 67c53cfa 
Dealt to 867e0a9c 
Dealt to Hero [7c 4d]
67c53cfa: folds
867e0a9c: folds
Hero: folds
556685d2: raises $0.15 to $0.25
423ab6ff: folds
fa1722a8: folds
Uncalled bet ($0.15) returned to 556685d2
*** SHOWDOWN ***
556685d2 collected $0.25 from pot
*** SUMMARY ***
Total pot $0.25 | Rake $0 | Jackpot $0 | Bingo $0 | Fortune $0
Seat 1: 556685d2 (button) collected ($0.25)
Seat 2: 423ab6ff (small blind) folded before Flop
Seat 3: fa1722a8 (big blind) folded before Flop
Seat 4: 67c53cfa folded before Flop (didn't bet)
Seat 5: 867e0a9c folded before Flop (didn't bet)
Seat 6: Hero folded before Flop (didn't bet)


Poker Hand #RC1459906751: Hold'em No Limit  ($0.05/$0.1) - 2023/04/08 20:39:19
Table 'RushAndCash3772011' 6-max Seat #1 is the button
Seat 1: f024b49e ($10.24 in chips)
Seat 2: 43663618 ($17.86 in chips)
Seat 3: 18e279a4 ($57.73 in chips)
Seat 4: d5e86f77 ($12.49 in chips)
Seat 5: 3edd334f ($31.27 in chips)
Seat 6: Hero ($8.67 in chips)
43663618: posts small blind $0.05
18e279a4: posts big blind $0.1
*** HOLE CARDS ***
Dealt to f024b49e 
Dealt to 43663618 
Dealt to 18e279a4 
Dealt to d5e86f77 
Dealt to 3edd334f 
Dealt to Hero [4s 5d]
d5e86f77: calls $0.1
3edd334f: folds
Hero: folds
f024b49e: folds
43663618: folds
18e279a4: checks
*** FLOP *** [7d 6s 6d]
18e279a4: checks
d5e86f77: checks
*** TURN *** [7d 6s 6d] [3h]
18e279a4: checks
d5e86f77: checks
*** RIVER *** [7d 6s 6d 3h] [4d]
18e279a4: checks
d5e86f77: checks
18e279a4: shows [4c Qs] (Pair of Sixes and Pair of Fours)
d5e86f77: shows [2h 2c] (Pair of Sixes and Pair of Twos)
*** SHOWDOWN ***
18e279a4 collected $0.24 from pot
*** SUMMARY ***
Total pot $0.25 | Rake $0.01 | Jackpot $0 | Bingo $0 | Fortune $0
Board [7d 6s 6d 3h 4d]
Seat 1: f024b49e (button) folded before Flop (didn't bet)
Seat 2: 43663618 (small blind) folded before Flop
Seat 3: 18e279a4 (big blind) showed [4c Qs] and won ($0.24) with Pair of Sixes and Pair of Fours
Seat 4: d5e86f77 showed [2h 2c] and lost with Pair of Sixes and Pair of Twos
Seat 5: 3edd334f folded before Flop (didn't bet)
Seat 6: Hero folded before Flop (didn't bet)


Poker Hand #RC1459906525: Hold'em No Limit  ($0.05/$0.1) - 2023/04/08 20:38:36
Table 'RushAndCash3771785' 6-max Seat #1 is the button
Seat 1: 68ef8f13 ($9.76 in chips)
Seat 2: Hero ($7.85 in chips)
Seat 3: 7a3e4c38 ($41.32 in chips)
Seat 4: 39c1fa2c ($15.54 in chips)
Seat 5: 63ba99da ($10 in chips)
Seat 6: 7faf8c75 ($50.12 in chips)
Hero: posts small blind $0.05
7a3e4c38: posts big blind $0.1
*** HOLE CARDS ***
Dealt to 68ef8f13 
Dealt to Hero [Jh Kh]
Dealt to 7a3e4c38 
Dealt to 39c1fa2c 
Dealt to 63ba99da 
Dealt to 7faf8c75 
39c1fa2c: folds
63ba99da: raises $0.1 to $0.2
7faf8c75: folds
68ef8f13: folds
Hero: raises $0.6 to $0.8
7a3e4c38: folds
63ba99da: calls $0.6
*** FLOP *** [Ah 3s Qs]
Hero: bets $0.85
63ba99da: folds
Uncalled bet ($0.85) returned to Hero
*** SHOWDOWN ***
Hero collected $1.62 from pot
*** SUMMARY ***
Total pot $1.7 | Rake $0.08 | Jackpot $0 | Bingo $0 | Fortune $0
Board [Ah 3s Qs]
Seat 1: 68ef8f13 (button) folded before Flop (didn't bet)
Seat 2: Hero (small blind) won ($1.62)
Seat 3: 7a3e4c38 (big blind) folded before Flop
Seat 4: 39c1fa2c folded before Flop (didn't bet)
Seat 5: 63ba99da folded on the Flop
Seat 6: 7faf8c75 folded before Flop (didn't bet)


Poker Hand #RC1459906374: Hold'em No Limit  ($0.05/$0.1) - 2023/04/08 20:38:08
Table 'RushAndCash3771634' 6-max Seat #1 is the button
Seat 1: d318a3f7 ($23 in chips)
Seat 2: d3f64a2e ($29.56 in chips)
Seat 3: Hero ($7.95 in chips)
Seat 4: 8ad93cef ($11.66 in chips)
Seat 5: 7340f470 ($58.39 in chips)
Seat 6: 31782351 ($8.42 in chips)
d3f64a2e: posts small blind $0.05
Hero: posts big blind $0.1
*** HOLE CARDS ***
Dealt to d318a3f7 
Dealt to d3f64a2e 
Dealt to Hero [7h Qc]
Dealt to 8ad93cef 
Dealt to 7340f470 
Dealt to 31782351 
8ad93cef: folds
7340f470: folds
31782351: raises $0.1 to $0.2
d318a3f7: folds
d3f64a2e: calls $0.15
Hero: folds
*** FLOP *** [5c Kh 5h]
d3f64a2e: checks
31782351: bets $0.23
d3f64a2e: folds
Uncalled bet ($0.23) returned to 31782351
*** SHOWDOWN ***
31782351 collected $0.48 from pot
*** SUMMARY ***
Total pot $0.5 | Rake $0.02 | Jackpot $0 | Bingo $0 | Fortune $0
Board [5c Kh 5h]
Seat 1: d318a3f7 (button) folded before Flop (didn't bet)
Seat 2: d3f64a2e (small blind) folded on the Flop
Seat 3: Hero (big blind) folded before Flop
Seat 4: 8ad93cef folded before Flop (didn't bet)
Seat 5: 7340f470 folded before Flop (didn't bet)
Seat 6: 31782351 won ($0.48)


Poker Hand #RC1459906292: Hold'em No Limit  ($0.05/$0.1) - 2023/04/08 20:37:53
Table 'RushAndCash3771552' 6-max Seat #1 is the button
Seat 1: 70cd5c03 ($13.78 in chips)
Seat 2: 81206ee ($9.89 in chips)
Seat 3: 99557150 ($16.68 in chips)
Seat 4: Hero ($7.8 in chips)
Seat 5: ffe9bf5a ($10.49 in chips)
Seat 6: 166da242 ($10.26 in chips)
81206ee: posts small blind $0.05
99557150: posts big blind $0.1
*** HOLE CARDS ***
Dealt to 70cd5c03 
Dealt to 81206ee 
Dealt to 99557150 
Dealt to Hero [Qs Jd]
Dealt to ffe9bf5a 
Dealt to 166da242 
Hero: raises $0.15 to $0.25
ffe9bf5a: folds
166da242: folds
70cd5c03: folds
81206ee: folds
99557150: folds
Uncalled bet ($0.15) returned to Hero
*** SHOWDOWN ***
Hero collected $0.25 from pot
*** SUMMARY ***
Total pot $0.25 | Rake $0 | Jackpot $0 | Bingo $0 | Fortune $0
Seat 1: 70cd5c03 (button) folded before Flop (didn't bet)
Seat 2: 81206ee (small blind) folded before Flop
Seat 3: 99557150 (big blind) folded before Flop
Seat 4: Hero collected ($0.25)
Seat 5: ffe9bf5a folded before Flop (didn't bet)
Seat 6: 166da242 folded before Flop (didn't bet)


Poker Hand #RC1459906269: Hold'em No Limit  ($0.05/$0.1) - 2023/04/08 20:37:48
Table 'RushAndCash3771529' 6-max Seat #1 is the button
Seat 1: 3acdf15 ($29.14 in chips)
Seat 2: 8a38d99 ($24.36 in chips)
Seat 3: f4b5f867 ($10.23 in chips)
Seat 4: cf0fd6d6 ($10 in chips)
Seat 5: 72e6df6b ($6.76 in chips)
Seat 6: Hero ($7.8 in chips)
8a38d99: posts small blind $0.05
f4b5f867: posts big blind $0.1
*** HOLE CARDS ***
Dealt to 3acdf15 
Dealt to 8a38d99 
Dealt to f4b5f867 
Dealt to cf0fd6d6 
Dealt to 72e6df6b 
Dealt to Hero [3c 2c]
cf0fd6d6: folds
72e6df6b: folds
Hero: folds
3acdf15: folds
8a38d99: folds
Uncalled bet ($0.05) returned to f4b5f867
*** SHOWDOWN ***
f4b5f867 collected $0.1 from pot
*** SUMMARY ***
Total pot $0.1 | Rake $0 | Jackpot $0 | Bingo $0 | Fortune $0
Seat 1: 3acdf15 (button) folded before Flop (didn't bet)
Seat 2: 8a38d99 (small blind) folded before Flop
Seat 3: f4b5f867 (big blind) collected ($0.1)
Seat 4: cf0fd6d6 folded before Flop (didn't bet)
Seat 5: 72e6df6b folded before Flop (didn't bet)
Seat 6: Hero folded before Flop (didn't bet)


Poker Hand #RC1459906218: Hold'em No Limit  ($0.05/$0.1) - 2023/04/08 20:37:39
Table 'RushAndCash3771478' 6-max Seat #1 is the button
Seat 1: 6389c836 ($19.99 in chips)
Seat 2: bea7486e ($10.12 in chips)
Seat 3: Hero ($7.75 in chips)
Seat 4: ab6313d2 ($11.09 in chips)
Seat 5: 692de524 ($14.24 in chips)
Seat 6: ad685734 ($13 in chips)
bea7486e: posts small blind $0.05
Hero: posts big blind $0.1
*** HOLE CARDS ***
Dealt to 6389c836 
Dealt to bea7486e 
Dealt to Hero [Jh Kh]
Dealt to ab6313d2 
Dealt to 692de524 
Dealt to ad685734 
ab6313d2: folds
692de524: folds
ad685734: folds
6389c836: folds
bea7486e: folds
Uncalled bet ($0.05) returned to Hero
*** SHOWDOWN ***
Hero collected $0.1 from pot
*** SUMMARY ***
Total pot $0.1 | Rake $0 | Jackpot $0 | Bingo $0 | Fortune $0
Seat 1: 6389c836 (button) folded before Flop (didn't bet)
Seat 2: bea7486e (small blind) folded before Flop
Seat 3: Hero (big blind) collected ($0.1)
Seat 4: ab6313d2 folded before Flop (didn't bet)
Seat 5: 692de524 folded before Flop (didn't bet)
Seat 6: ad685734 folded before Flop (didn't bet)


Poker Hand #RC1459906194: Hold'em No Limit  ($0.05/$0.1) - 2023/04/08 20:37:35
Table 'RushAndCash3771454' 6-max Seat #1 is the button
Seat 1: fd41e8da ($19.36 in chips)
Seat 2: e1f119ce ($19.01 in chips)
Seat 3: 467f13c7 ($10.55 in chips)
Seat 4: 4c855208 ($10.1 in chips)
Seat 5: 83fce378 ($45.85 in chips)
Seat 6: Hero ($7.75 in chips)
e1f119ce: posts small blind $0.05
467f13c7: posts big blind $0.1
*** HOLE CARDS ***
Dealt to fd41e8da 
Dealt to e1f119ce 
Dealt to 467f13c7 
Dealt to 4c855208 
Dealt to 83fce378 
Dealt to Hero [2s 7c]
4c855208: raises $0.13 to $0.23
83fce378: folds
Hero: folds
fd41e8da: folds
e1f119ce: folds
467f13c7: calls $0.13
*** FLOP *** [8s 7h As]
467f13c7: checks
4c855208: bets $0.17
467f13c7: folds
Uncalled bet ($0.17) returned to 4c855208
*** SHOWDOWN ***
4c855208 collected $0.49 from pot
*** SUMMARY ***
Total pot $0.51 | Rake $0.02 | Jackpot $0 | Bingo $0 | Fortune $0
Board [8s 7h As]
Seat 1: fd41e8da (button) folded before Flop (didn't bet)
Seat 2: e1f119ce (small blind) folded before Flop
Seat 3: 467f13c7 (big blind) folded on the Flop
Seat 4: 4c855208 won ($0.49)
Seat 5: 83fce378 folded before Flop (didn't bet)
Seat 6: Hero folded before Flop (didn't bet)


Poker Hand #RC1459906087: Hold'em No Limit  ($0.05/$0.1) - 2023/04/08 20:37:15
Table 'RushAndCash3771347' 6-max Seat #1 is the button
Seat 1: Hero ($7.6 in chips)
Seat 2: e3e4b226 ($10.13 in chips)
Seat 3: 9f65c8a ($12.51 in chips)
Seat 4: 3237ce2 ($14.45 in chips)
Seat 5: 6389c836 ($19.99 in chips)
Seat 6: b342ae3f ($10.05 in chips)
e3e4b226: posts small blind $0.05
9f65c8a: posts big blind $0.1
*** HOLE CARDS ***
Dealt to Hero [Jc Ts]
Dealt to e3e4b226 
Dealt to 9f65c8a 
Dealt to 3237ce2 
Dealt to 6389c836 
Dealt to b342ae3f 
3237ce2: folds
6389c836: folds
b342ae3f: folds
Hero: raises $0.15 to $0.25
e3e4b226: folds
9f65c8a: folds
Uncalled bet ($0.15) returned to Hero
*** SHOWDOWN ***
Hero collected $0.25 from pot
*** SUMMARY ***
Total pot $0.25 | Rake $0 | Jackpot $0 | Bingo $0 | Fortune $0
Seat 1: Hero (button) collected ($0.25)
Seat 2: e3e4b226 (small blind) folded before Flop
Seat 3: 9f65c8a (big blind) folded before Flop
Seat 4: 3237ce2 folded before Flop (didn't bet)
Seat 5: 6389c836 folded before Flop (didn't bet)
Seat 6: b342ae3f folded before Flop (didn't bet)


Poker Hand #RC1459906034: Hold'em No Limit  ($0.05/$0.1) - 2023/04/08 20:37:06
Table 'RushAndCash3771294' 6-max Seat #1 is the button
Seat 1: Hero ($7.6 in chips)
Seat 2: ed2461d3 ($27.94 in chips)
Seat 3: c89af454 ($19.85 in chips)
Seat 4: 68888d2b ($54.54 in chips)
Seat 5: f4362c8f ($11.31 in chips)
Seat 6: bea7486e ($10.27 in chips)
ed2461d3: posts small blind $0.05
c89af454: posts big blind $0.1
*** HOLE CARDS ***
Dealt to Hero [Qs 9c]
Dealt to ed2461d3 
Dealt to c89af454 
Dealt to 68888d2b 
Dealt to f4362c8f 
Dealt to bea7486e 
68888d2b: folds
f4362c8f: folds
bea7486e: folds
Hero: folds
ed2461d3: raises $0.1 to $0.2
c89af454: folds
Uncalled bet ($0.1) returned to ed2461d3
*** SHOWDOWN ***
ed2461d3 collected $0.2 from pot
*** SUMMARY ***
Total pot $0.2 | Rake $0 | Jackpot $0 | Bingo $0 | Fortune $0
Seat 1: Hero (button) folded before Flop (didn't bet)
Seat 2: ed2461d3 (small blind) collected ($0.2)
Seat 3: c89af454 (big blind) folded before Flop
Seat 4: 68888d2b folded before Flop (didn't bet)
Seat 5: f4362c8f folded before Flop (didn't bet)
Seat 6: bea7486e folded before Flop (didn't bet)


Poker Hand #RC1459905917: Hold'em No Limit  ($0.05/$0.1) - 2023/04/08 20:36:46
Table 'RushAndCash3771177' 6-max Seat #1 is the button
Seat 1: 9ffadf7e ($4.14 in chips)
Seat 2: Hero ($7.65 in chips)
Seat 3: 6276705 ($9.01 in chips)
Seat 4: cacd032a ($14.11 in chips)
Seat 5: 87bc60ab ($20.55 in chips)
Seat 6: 3862da35 ($16.84 in chips)
Hero: posts small blind $0.05
6276705: posts big blind $0.1
*** HOLE CARDS ***
Dealt to 9ffadf7e 
Dealt to Hero [3c 3h]
Dealt to 6276705 
Dealt to cacd032a 
Dealt to 87bc60ab 
Dealt to 3862da35 
cacd032a: raises $0.2 to $0.3
87bc60ab: folds
3862da35: folds
9ffadf7e: folds
Hero: folds
6276705: folds
Uncalled bet ($0.2) returned to cacd032a
*** SHOWDOWN ***
cacd032a collected $0.25 from pot
*** SUMMARY ***
Total pot $0.25 | Rake $0 | Jackpot $0 | Bingo $0 | Fortune $0
Seat 1: 9ffadf7e (button) folded before Flop (didn't bet)
Seat 2: Hero (small blind) folded before Flop
Seat 3: 6276705 (big blind) folded before Flop
Seat 4: cacd032a collected ($0.25)
Seat 5: 87bc60ab folded before Flop (didn't bet)
Seat 6: 3862da35 folded before Flop (didn't bet)


Poker Hand #RC1459905850: Hold'em No Limit  ($0.05/$0.1) - 2023/04/08 20:36:35
Table 'RushAndCash3771110' 6-max Seat #1 is the button
Seat 1: 51bfaab4 ($11.95 in chips)
Seat 2: 4a8c7660 ($67.9 in chips)
Seat 3: 6e40213d ($10.83 in chips)
Seat 4: 616a92d4 ($9.74 in chips)
Seat 5: f6b84b5c ($8.44 in chips)
Seat 6: Hero ($7.65 in chips)
4a8c7660: posts small blind $0.05
6e40213d: posts big blind $0.1
*** HOLE CARDS ***
Dealt to 51bfaab4 
Dealt to 4a8c7660 
Dealt to 6e40213d 
Dealt to 616a92d4 
Dealt to f6b84b5c 
Dealt to Hero [7h 4d]
616a92d4: folds
f6b84b5c: folds
Hero: folds
51bfaab4: folds
4a8c7660: folds
Uncalled bet ($0.05) returned to 6e40213d
*** SHOWDOWN ***
6e40213d collected $0.1 from pot
*** SUMMARY ***
Total pot $0.1 | Rake $0 | Jackpot $0 | Bingo $0 | Fortune $0
Seat 1: 51bfaab4 (button) folded before Flop (didn't bet)
Seat 2: 4a8c7660 (small blind) folded before Flop
Seat 3: 6e40213d (big blind) collected ($0.1)
Seat 4: 616a92d4 folded before Flop (didn't bet)
Seat 5: f6b84b5c folded before Flop (didn't bet)
Seat 6: Hero folded before Flop (didn't bet)


Poker Hand #RC1459905625: Hold'em No Limit  ($0.05/$0.1) - 2023/04/08 20:35:54
Table 'RushAndCash3770885' 6-max Seat #1 is the button
Seat 1: ad402a2 ($19 in chips)
Seat 2: 732de4a8 ($13.38 in chips)
Seat 3: 4a8c7660 ($68.15 in chips)
Seat 4: 39c1fa2c ($17.31 in chips)
Seat 5: 8e4121e2 ($10.68 in chips)
Seat 6: Hero ($7.37 in chips)
732de4a8: posts small blind $0.05
4a8c7660: posts big blind $0.1
*** HOLE CARDS ***
Dealt to ad402a2 
Dealt to 732de4a8 
Dealt to 4a8c7660 
Dealt to 39c1fa2c 
Dealt to 8e4121e2 
Dealt to Hero [Jc Ah]
39c1fa2c: folds
8e4121e2: folds
Hero: raises $0.15 to $0.25
ad402a2: folds
732de4a8: folds
4a8c7660: calls $0.15
*** FLOP *** [Kd 5c Js]
4a8c7660: checks
Hero: checks
*** TURN *** [Kd 5c Js] [7s]
4a8c7660: checks
Hero: bets $0.28
4a8c7660: folds
Uncalled bet ($0.28) returned to Hero
*** SHOWDOWN ***
Hero collected $0.53 from pot
*** SUMMARY ***
Total pot $0.55 | Rake $0.02 | Jackpot $0 | Bingo $0 | Fortune $0
Board [Kd 5c Js 7s]
Seat 1: ad402a2 (button) folded before Flop (didn't bet)
Seat 2: 732de4a8 (small blind) folded before Flop
Seat 3: 4a8c7660 (big blind) folded on the Turn
Seat 4: 39c1fa2c folded before Flop (didn't bet)
Seat 5: 8e4121e2 folded before Flop (didn't bet)
Seat 6: Hero won ($0.53)


Poker Hand #RC1459905550: Hold'em No Limit  ($0.05/$0.1) - 2023/04/08 20:35:41
Table 'RushAndCash3770810' 6-max Seat #1 is the button
Seat 1: 618d2af9 ($10.2 in chips)
Seat 2: 7aa1a89b ($10.34 in chips)
Seat 3: 70cd5c03 ($14.27 in chips)
Seat 4: c0442f11 ($11.16 in chips)
Seat 5: Hero ($7.37 in chips)
Seat 6: 36b95207 ($4.54 in chips)
7aa1a89b: posts small blind $0.05
70cd5c03: posts big blind $0.1
*** HOLE CARDS ***
Dealt to 618d2af9 
Dealt to 7aa1a89b 
Dealt to 70cd5c03 
Dealt to c0442f11 
Dealt to Hero [Kd Tc]
Dealt to 36b95207 
c0442f11: folds
Hero: folds
36b95207: raises $0.2 to $0.3
618d2af9: folds
7aa1a89b: folds
70cd5c03: folds
Uncalled bet ($0.2) returned to 36b95207
*** SHOWDOWN ***
36b95207 collected $0.25 from pot
*** SUMMARY ***
Total pot $0.25 | Rake $0 | Jackpot $0 | Bingo $0 | Fortune $0
Seat 1: 618d2af9 (button) folded before Flop (didn't bet)
Seat 2: 7aa1a89b (small blind) folded before Flop
Seat 3: 70cd5c03 (big blind) folded before Flop
Seat 4: c0442f11 folded before Flop (didn't bet)
Seat 5: Hero folded before Flop (didn't bet)
Seat 6: 36b95207 collected ($0.25)


Poker Hand #RC1459905496: Hold'em No Limit  ($0.05/$0.1) - 2023/04/08 20:35:32
Table 'RushAndCash3770756' 6-max Seat #1 is the button
Seat 1: 7eed5c57 ($10.32 in chips)
Seat 2: e33b6a9d ($4.77 in chips)
Seat 3: 28631210 ($11.26 in chips)
Seat 4: a416c295 ($10.22 in chips)
Seat 5: Hero ($7.37 in chips)
Seat 6: eda2be39 ($13.41 in chips)
e33b6a9d: posts small blind $0.05
28631210: posts big blind $0.1
*** HOLE CARDS ***
Dealt to 7eed5c57 
Dealt to e33b6a9d 
Dealt to 28631210 
Dealt to a416c295 
Dealt to Hero [8d 3s]
Dealt to eda2be39 
a416c295: folds
Hero: folds
eda2be39: raises $0.15 to $0.25
7eed5c57: folds
e33b6a9d: folds
28631210: folds
Uncalled bet ($0.15) returned to eda2be39
*** SHOWDOWN ***
eda2be39 collected $0.25 from pot
*** SUMMARY ***
Total pot $0.25 | Rake $0 | Jackpot $0 | Bingo $0 | Fortune $0
Seat 1: 7eed5c57 (button) folded before Flop (didn't bet)
Seat 2: e33b6a9d (small blind) folded before Flop
Seat 3: 28631210 (big blind) folded before Flop
Seat 4: a416c295 folded before Flop (didn't bet)
Seat 5: Hero folded before Flop (didn't bet)
Seat 6: eda2be39 collected ($0.25)


Poker Hand #RC1459905401: Hold'em No Limit  ($0.05/$0.1) - 2023/04/08 20:35:16
Table 'RushAndCash3770661' 6-max Seat #1 is the button
Seat 1: 880937e1 ($19.77 in chips)
Seat 2: Hero ($7.27 in chips)
Seat 3: f2724d93 ($11.17 in chips)
Seat 4: 9448719a ($10.32 in chips)
Seat 5: 49da03d9 ($33.63 in chips)
Seat 6: 81b571a ($8.3 in chips)
Hero: posts small blind $0.05
f2724d93: posts big blind $0.1
*** HOLE CARDS ***
Dealt to 880937e1 
Dealt to Hero [As 4h]
Dealt to f2724d93 
Dealt to 9448719a 
Dealt to 49da03d9 
Dealt to 81b571a 
9448719a: folds
49da03d9: folds
81b571a: folds
880937e1: folds
Hero: raises $0.2 to $0.3
f2724d93: folds
Uncalled bet ($0.2) returned to Hero
*** SHOWDOWN ***
Hero collected $0.2 from pot
*** SUMMARY ***
Total pot $0.2 | Rake $0 | Jackpot $0 | Bingo $0 | Fortune $0
Seat 1: 880937e1 (button) folded before Flop (didn't bet)
Seat 2: Hero (small blind) collected ($0.2)
Seat 3: f2724d93 (big blind) folded before Flop
Seat 4: 9448719a folded before Flop (didn't bet)
Seat 5: 49da03d9 folded before Flop (didn't bet)
Seat 6: 81b571a folded before Flop (didn't bet)


Poker Hand #RC1459905349: Hold'em No Limit  ($0.05/$0.1) - 2023/04/08 20:35:06
Table 'RushAndCash3770609' 6-max Seat #1 is the button
Seat 1: Hero ($7.27 in chips)
Seat 2: cb7073f6 ($9.9 in chips)
Seat 3: 3acdf15 ($30.89 in chips)
Seat 4: e05d2035 ($4.06 in chips)
Seat 5: 9f65c8a ($12.38 in chips)
Seat 6: 14bda94c ($10.42 in chips)
cb7073f6: posts small blind $0.05
3acdf15: posts big blind $0.1
*** HOLE CARDS ***
Dealt to Hero [Qs 9d]
Dealt to cb7073f6 
Dealt to 3acdf15 
Dealt to e05d2035 
Dealt to 9f65c8a 
Dealt to 14bda94c 
e05d2035: raises $0.2 to $0.3
9f65c8a: folds
14bda94c: folds
Hero: folds
cb7073f6: folds
3acdf15: folds
Uncalled bet ($0.2) returned to e05d2035
*** SHOWDOWN ***
e05d2035 collected $0.25 from pot
*** SUMMARY ***
Total pot $0.25 | Rake $0 | Jackpot $0 | Bingo $0 | Fortune $0
Seat 1: Hero (button) folded before Flop (didn't bet)
Seat 2: cb7073f6 (small blind) folded before Flop
Seat 3: 3acdf15 (big blind) folded before Flop
Seat 4: e05d2035 collected ($0.25)
Seat 5: 9f65c8a folded before Flop (didn't bet)
Seat 6: 14bda94c folded before Flop (didn't bet)


Poker Hand #RC1459905267: Hold'em No Limit  ($0.05/$0.1) - 2023/04/08 20:34:52
Table 'RushAndCash3770527' 6-max Seat #1 is the button
Seat 1: 1b11e8a6 ($10.43 in chips)
Seat 2: f53cdad ($45.28 in chips)
Seat 3: Hero ($7.37 in chips)
Seat 4: 609aa77c ($13.91 in chips)
Seat 5: c7af190b ($13 in chips)
Seat 6: 11ef0c8 ($20.82 in chips)
f53cdad: posts small blind $0.05
Hero: posts big blind $0.1
*** HOLE CARDS ***
Dealt to 1b11e8a6 
Dealt to f53cdad 
Dealt to Hero [8h 5c]
Dealt to 609aa77c 
Dealt to c7af190b 
Dealt to 11ef0c8 
609aa77c: folds
c7af190b: raises $0.15 to $0.25
11ef0c8: folds
1b11e8a6: folds
f53cdad: folds
Hero: folds
Uncalled bet ($0.15) returned to c7af190b
*** SHOWDOWN ***
c7af190b collected $0.25 from pot
*** SUMMARY ***
Total pot $0.25 | Rake $0 | Jackpot $0 | Bingo $0 | Fortune $0
Seat 1: 1b11e8a6 (button) folded before Flop (didn't bet)
Seat 2: f53cdad (small blind) folded before Flop
Seat 3: Hero (big blind) folded before Flop
Seat 4: 609aa77c folded before Flop (didn't bet)
Seat 5: c7af190b collected ($0.25)
Seat 6: 11ef0c8 folded before Flop (didn't bet)


Poker Hand #RC1459905190: Hold'em No Limit  ($0.05/$0.1) - 2023/04/08 20:34:39
Table 'RushAndCash3770450' 6-max Seat #1 is the button
Seat 1: 1f3c5644 ($32.1 in chips)
Seat 2: 457142b5 ($14.68 in chips)
Seat 3: 69b20187 ($9.29 in chips)
Seat 4: 2fe03fd0 ($5.13 in chips)
Seat 5: c57a3d6 ($20.07 in chips)
Seat 6: Hero ($7.37 in chips)
457142b5: posts small blind $0.05
69b20187: posts big blind $0.1
*** HOLE CARDS ***
Dealt to 1f3c5644 
Dealt to 457142b5 
Dealt to 69b20187 
Dealt to 2fe03fd0 
Dealt to c57a3d6 
Dealt to Hero [3d Ac]
2fe03fd0: folds
c57a3d6: folds
Hero: folds
1f3c5644: folds
457142b5: folds
Uncalled bet ($0.05) returned to 69b20187
*** SHOWDOWN ***
69b20187 collected $0.1 from pot
*** SUMMARY ***
Total pot $0.1 | Rake $0 | Jackpot $0 | Bingo $0 | Fortune $0
Seat 1: 1f3c5644 (button) folded before Flop (didn't bet)
Seat 2: 457142b5 (small blind) folded before Flop
Seat 3: 69b20187 (big blind) collected ($0.1)
Seat 4: 2fe03fd0 folded before Flop (didn't bet)
Seat 5: c57a3d6 folded before Flop (didn't bet)
Seat 6: Hero folded before Flop (didn't bet)


Poker Hand #RC1459904889: Hold'em No Limit  ($0.05/$0.1) - 2023/04/08 20:33:44
Table 'RushAndCash3770149' 6-max Seat #1 is the button
Seat 1: ee266a57 ($11.58 in chips)
Seat 2: 4691fa1e ($18.5 in chips)
Seat 3: 1f3c5644 ($32.39 in chips)
Seat 4: fa2c2cc3 ($13.97 in chips)
Seat 5: 2fe03fd0 ($4.55 in chips)
Seat 6: Hero ($7.66 in chips)
4691fa1e: posts small blind $0.05
1f3c5644: posts big blind $0.1
*** HOLE CARDS ***
Dealt to ee266a57 
Dealt to 4691fa1e 
Dealt to 1f3c5644 
Dealt to fa2c2cc3 
Dealt to 2fe03fd0 
Dealt to Hero [Ah 9h]
fa2c2cc3: folds
2fe03fd0: raises $0.19 to $0.29
Hero: calls $0.29
ee266a57: folds
4691fa1e: folds
1f3c5644: calls $0.19
*** FLOP *** [4c Jd 5s]
1f3c5644: checks
2fe03fd0: checks
Hero: checks
*** TURN *** [4c Jd 5s] [8d]
1f3c5644: checks
2fe03fd0: bets $0.46
Hero: folds
1f3c5644: folds
Uncalled bet ($0.46) returned to 2fe03fd0
*** SHOWDOWN ***
2fe03fd0 collected $0.87 from pot
*** SUMMARY ***
Total pot $0.92 | Rake $0.05 | Jackpot $0 | Bingo $0 | Fortune $0
Board [4c Jd 5s 8d]
Seat 1: ee266a57 (button) folded before Flop (didn't bet)
Seat 2: 4691fa1e (small blind) folded before Flop
Seat 3: 1f3c5644 (big blind) folded on the Turn
Seat 4: fa2c2cc3 folded before Flop (didn't bet)
Seat 5: 2fe03fd0 won ($0.87)
Seat 6: Hero folded on the Turn


Poker Hand #RC1459904827: Hold'em No Limit  ($0.05/$0.1) - 2023/04/08 20:33:33
Table 'RushAndCash3770087' 6-max Seat #1 is the button
Seat 1: 5f642286 ($10.15 in chips)
Seat 2: e34f410c ($10.05 in chips)
Seat 3: f7d69424 ($9.66 in chips)
Seat 4: 7f1c678c ($9.27 in chips)
Seat 5: 9d2ad470 ($11.7 in chips)
Seat 6: Hero ($7.51 in chips)
e34f410c: posts small blind $0.05
f7d69424: posts big blind $0.1
*** HOLE CARDS ***
Dealt to 5f642286 
Dealt to e34f410c 
Dealt to f7d69424 
Dealt to 7f1c678c 
Dealt to 9d2ad470 
Dealt to Hero [9c 9s]
7f1c678c: folds
9d2ad470: folds
Hero: raises $0.15 to $0.25
5f642286: folds
e34f410c: folds
f7d69424: folds
Uncalled bet ($0.15) returned to Hero
*** SHOWDOWN ***
Hero collected $0.25 from pot
*** SUMMARY ***
Total pot $0.25 | Rake $0 | Jackpot $0 | Bingo $0 | Fortune $0
Seat 1: 5f642286 (button) folded before Flop (didn't bet)
Seat 2: e34f410c (small blind) folded before Flop
Seat 3: f7d69424 (big blind) folded before Flop
Seat 4: 7f1c678c folded before Flop (didn't bet)
Seat 5: 9d2ad470 folded before Flop (didn't bet)
Seat 6: Hero collected ($0.25)


Poker Hand #RC1459904758: Hold'em No Limit  ($0.05/$0.1) - 2023/04/08 20:33:19
Table 'RushAndCash3770018' 6-max Seat #1 is the button
Seat 1: e8dad1c8 ($32.69 in chips)
Seat 2: ac0ed7cb ($10.15 in chips)
Seat 3: 5fb0cb47 ($10 in chips)
Seat 4: a416c295 ($10.24 in chips)
Seat 5: Hero ($7.51 in chips)
Seat 6: 6dbca9dd ($10 in chips)
ac0ed7cb: posts small blind $0.05
5fb0cb47: posts big blind $0.1
*** HOLE CARDS ***
Dealt to e8dad1c8 
Dealt to ac0ed7cb 
Dealt to 5fb0cb47 
Dealt to a416c295 
Dealt to Hero [Kd 3h]
Dealt to 6dbca9dd 
a416c295: folds
Hero: folds
6dbca9dd: folds
e8dad1c8: folds
ac0ed7cb: folds
Uncalled bet ($0.05) returned to 5fb0cb47
*** SHOWDOWN ***
5fb0cb47 collected $0.1 from pot
*** SUMMARY ***
Total pot $0.1 | Rake $0 | Jackpot $0 | Bingo $0 | Fortune $0
Seat 1: e8dad1c8 (button) folded before Flop (didn't bet)
Seat 2: ac0ed7cb (small blind) folded before Flop
Seat 3: 5fb0cb47 (big blind) collected ($0.1)
Seat 4: a416c295 folded before Flop (didn't bet)
Seat 5: Hero folded before Flop (didn't bet)
Seat 6: 6dbca9dd folded before Flop (didn't bet)


Poker Hand #RC1459874668: Hold'em No Limit  ($0.05/$0.1) - 2023/04/08 20:33:05
Table 'RushAndCash3769928' 6-max Seat #1 is the button
Seat 1: 3a1e6474 ($10 in chips)
Seat 2: e8dad1c8 ($32.74 in chips)
Seat 3: Hero ($7.61 in chips)
Seat 4: 5ad9ed91 ($10.22 in chips)
Seat 5: 7ffbdfa1 ($4.55 in chips)
Seat 6: 81b571a ($4.45 in chips)
e8dad1c8: posts small blind $0.05
Hero: posts big blind $0.1
*** HOLE CARDS ***
Dealt to 3a1e6474 
Dealt to e8dad1c8 
Dealt to Hero [7h Jh]
Dealt to 5ad9ed91 
Dealt to 7ffbdfa1 
Dealt to 81b571a 
5ad9ed91: folds
7ffbdfa1: folds
81b571a: raises $0.15 to $0.25
3a1e6474: folds
e8dad1c8: folds
Hero: folds
Uncalled bet ($0.15) returned to 81b571a
*** SHOWDOWN ***
81b571a collected $0.25 from pot
*** SUMMARY ***
Total pot $0.25 | Rake $0 | Jackpot $0 | Bingo $0 | Fortune $0
Seat 1: 3a1e6474 (button) folded before Flop (didn't bet)
Seat 2: e8dad1c8 (small blind) folded before Flop
Seat 3: Hero (big blind) folded before Flop
Seat 4: 5ad9ed91 folded before Flop (didn't bet)
Seat 5: 7ffbdfa1 folded before Flop (didn't bet)
Seat 6: 81b571a collected ($0.25)


Poker Hand #RC1459874616: Hold'em No Limit  ($0.05/$0.1) - 2023/04/08 20:32:55
Table 'RushAndCash3769876' 6-max Seat #1 is the button
Seat 1: 7a92f977 ($10 in chips)
Seat 2: Hero ($7.66 in chips)
Seat 3: 500fa304 ($38.02 in chips)
Seat 4: 804e4011 ($10 in chips)
Seat 5: b1e0c6b6 ($13.26 in chips)
Seat 6: 636721ef ($15.84 in chips)
Hero: posts small blind $0.05
500fa304: posts big blind $0.1
*** HOLE CARDS ***
Dealt to 7a92f977 
Dealt to Hero [2c Jd]
Dealt to 500fa304 
Dealt to 804e4011 
Dealt to b1e0c6b6 
Dealt to 636721ef 
804e4011: folds
b1e0c6b6: raises $0.1 to $0.2
636721ef: folds
7a92f977: folds
Hero: folds
500fa304: folds
Uncalled bet ($0.1) returned to b1e0c6b6
*** SHOWDOWN ***
b1e0c6b6 collected $0.25 from pot
*** SUMMARY ***
Total pot $0.25 | Rake $0 | Jackpot $0 | Bingo $0 | Fortune $0
Seat 1: 7a92f977 (button) folded before Flop (didn't bet)
Seat 2: Hero (small blind) folded before Flop
Seat 3: 500fa304 (big blind) folded before Flop
Seat 4: 804e4011 folded before Flop (didn't bet)
Seat 5: b1e0c6b6 collected ($0.25)
Seat 6: 636721ef folded before Flop (didn't bet)


Poker Hand #RC1459874582: Hold'em No Limit  ($0.05/$0.1) - 2023/04/08 20:32:49
Table 'RushAndCash3769842' 6-max Seat #1 is the button
Seat 1: Hero ($7.66 in chips)
Seat 2: f2def8dc ($19.5 in chips)
Seat 3: c4bd7832 ($10 in chips)
Seat 4: 16009f73 ($13.84 in chips)
Seat 5: 31782351 ($9.84 in chips)
Seat 6: 6389c836 ($20.44 in chips)
f2def8dc: posts small blind $0.05
c4bd7832: posts big blind $0.1
*** HOLE CARDS ***
Dealt to Hero [9c 6h]
Dealt to f2def8dc 
Dealt to c4bd7832 
Dealt to 16009f73 
Dealt to 31782351 
Dealt to 6389c836 
16009f73: folds
31782351: folds
6389c836: folds
Hero: folds
f2def8dc: folds
Uncalled bet ($0.05) returned to c4bd7832
*** SHOWDOWN ***
c4bd7832 collected $0.1 from pot
*** SUMMARY ***
Total pot $0.1 | Rake $0 | Jackpot $0 | Bingo $0 | Fortune $0
Seat 1: Hero (button) folded before Flop (didn't bet)
Seat 2: f2def8dc (small blind) folded before Flop
Seat 3: c4bd7832 (big blind) collected ($0.1)
Seat 4: 16009f73 folded before Flop (didn't bet)
Seat 5: 31782351 folded before Flop (didn't bet)
Seat 6: 6389c836 folded before Flop (didn't bet)


Poker Hand #RC1459874551: Hold'em No Limit  ($0.05/$0.1) - 2023/04/08 20:32:44
Table 'RushAndCash3769811' 6-max Seat #1 is the button
Seat 1: d0b73ea6 ($9.57 in chips)
Seat 2: 4f65eaa3 ($16.47 in chips)
Seat 3: 31acca90 ($10.28 in chips)
Seat 4: Hero ($7.66 in chips)
Seat 5: e115cf1e ($11.49 in chips)
Seat 6: e33b6a9d ($3.81 in chips)
4f65eaa3: posts small blind $0.05
31acca90: posts big blind $0.1
*** HOLE CARDS ***
Dealt to d0b73ea6 
Dealt to 4f65eaa3 
Dealt to 31acca90 
Dealt to Hero [Td 4h]
Dealt to e115cf1e 
Dealt to e33b6a9d 
Hero: folds
e115cf1e: folds
e33b6a9d: folds
d0b73ea6: folds
4f65eaa3: calls $0.05
31acca90: checks
*** FLOP *** [Qd 3d Jd]
4f65eaa3: checks
31acca90: checks
*** TURN *** [Qd 3d Jd] [Qc]
4f65eaa3: bets $0.1
31acca90: folds
Uncalled bet ($0.1) returned to 4f65eaa3
*** SHOWDOWN ***
4f65eaa3 collected $0.19 from pot
*** SUMMARY ***
Total pot $0.2 | Rake $0.01 | Jackpot $0 | Bingo $0 | Fortune $0
Board [Qd 3d Jd Qc]
Seat 1: d0b73ea6 (button) folded before Flop (didn't bet)
Seat 2: 4f65eaa3 (small blind) won ($0.19)
Seat 3: 31acca90 (big blind) folded on the Turn
Seat 4: Hero folded before Flop (didn't bet)
Seat 5: e115cf1e folded before Flop (didn't bet)
Seat 6: e33b6a9d folded before Flop (didn't bet)


Poker Hand #RC1459874522: Hold'em No Limit  ($0.05/$0.1) - 2023/04/08 20:32:39
Table 'RushAndCash3769782' 6-max Seat #1 is the button
Seat 1: 4ce13ecd ($8.63 in chips)
Seat 2: e4228515 ($10.83 in chips)
Seat 3: 11ef0c8 ($21.32 in chips)
Seat 4: Hero ($7.66 in chips)
Seat 5: e414f212 ($29.06 in chips)
Seat 6: 1b79f37c ($20.58 in chips)
e4228515: posts small blind $0.05
11ef0c8: posts big blind $0.1
*** HOLE CARDS ***
Dealt to 4ce13ecd 
Dealt to e4228515 
Dealt to 11ef0c8 
Dealt to Hero [4c Ks]
Dealt to e414f212 
Dealt to 1b79f37c 
Hero: folds
e414f212: folds
1b79f37c: folds
4ce13ecd: folds
e4228515: raises $0.3 to $0.4
11ef0c8: folds
Uncalled bet ($0.3) returned to e4228515
*** SHOWDOWN ***
e4228515 collected $0.2 from pot
*** SUMMARY ***
Total pot $0.2 | Rake $0 | Jackpot $0 | Bingo $0 | Fortune $0
Seat 1: 4ce13ecd (button) folded before Flop (didn't bet)
Seat 2: e4228515 (small blind) collected ($0.2)
Seat 3: 11ef0c8 (big blind) folded before Flop
Seat 4: Hero folded before Flop (didn't bet)
Seat 5: e414f212 folded before Flop (didn't bet)
Seat 6: 1b79f37c folded before Flop (didn't bet)


Poker Hand #RC1459874205: Hold'em No Limit  ($0.05/$0.1) - 2023/04/08 20:31:44
Table 'RushAndCash3769465' 6-max Seat #1 is the button
Seat 1: 7036d465 ($12.07 in chips)
Seat 2: e7de0df5 ($11.38 in chips)
Seat 3: b808e640 ($8.11 in chips)
Seat 4: fde40c61 ($17.4 in chips)
Seat 5: 6d86a9c5 ($5.02 in chips)
Seat 6: Hero ($9.47 in chips)
e7de0df5: posts small blind $0.05
b808e640: posts big blind $0.1
*** HOLE CARDS ***
Dealt to 7036d465 
Dealt to e7de0df5 
Dealt to b808e640 
Dealt to fde40c61 
Dealt to 6d86a9c5 
Dealt to Hero [Jd As]
fde40c61: raises $0.13 to $0.23
6d86a9c5: calls $0.23
Hero: raises $0.78 to $1.01
7036d465: folds
e7de0df5: folds
b808e640: folds
fde40c61: calls $0.78
6d86a9c5: folds
*** FLOP *** [Ks 6d 8c]
fde40c61: checks
Hero: bets $0.8
fde40c61: raises $1.05 to $1.85
Hero: folds
Uncalled bet ($1.05) returned to fde40c61
*** SHOWDOWN ***
fde40c61 collected $3.66 from pot
*** SUMMARY ***
Total pot $4 | Rake $0.19 | Jackpot $0.15 | Bingo $0 | Fortune $0
Board [Ks 6d 8c]
Seat 1: 7036d465 (button) folded before Flop (didn't bet)
Seat 2: e7de0df5 (small blind) folded before Flop
Seat 3: b808e640 (big blind) folded before Flop
Seat 4: fde40c61 won ($3.66)
Seat 5: 6d86a9c5 folded before Flop
Seat 6: Hero folded on the Flop


Poker Hand #RC1459873777: Hold'em No Limit  ($0.05/$0.1) - 2023/04/08 20:30:28
Table 'RushAndCash3769037' 6-max Seat #1 is the button
Seat 1: 551d9a48 ($13 in chips)
Seat 2: fec53cb4 ($6.23 in chips)
Seat 3: Hero ($10.22 in chips)
Seat 4: fde40c61 ($16.5 in chips)
Seat 5: 2261b544 ($10 in chips)
Seat 6: 5e1effd ($10.19 in chips)
fec53cb4: posts small blind $0.05
Hero: posts big blind $0.1
*** HOLE CARDS ***
Dealt to 551d9a48 
Dealt to fec53cb4 
Dealt to Hero [Tc Ad]
Dealt to fde40c61 
Dealt to 2261b544 
Dealt to 5e1effd 
fde40c61: raises $0.13 to $0.23
2261b544: folds
5e1effd: folds
551d9a48: folds
fec53cb4: calls $0.18
Hero: calls $0.13
*** FLOP *** [Td 9d 4d]
fec53cb4: checks
Hero: bets $0.52
fde40c61: calls $0.52
fec53cb4: folds
*** TURN *** [Td 9d 4d] [Qs]
Hero: checks
fde40c61: bets $2.6
Hero: folds
Uncalled bet ($2.6) returned to fde40c61
*** SHOWDOWN ***
fde40c61 collected $1.65 from pot
*** SUMMARY ***
Total pot $1.73 | Rake $0.08 | Jackpot $0 | Bingo $0 | Fortune $0
Board [Td 9d 4d Qs]
Seat 1: 551d9a48 (button) folded before Flop (didn't bet)
Seat 2: fec53cb4 (small blind) folded on the Flop
Seat 3: Hero (big blind) folded on the Turn
Seat 4: fde40c61 won ($1.65)
Seat 5: 2261b544 folded before Flop (didn't bet)
Seat 6: 5e1effd folded before Flop (didn't bet)


Poker Hand #RC1459871441: Hold'em No Limit  ($0.05/$0.1) - 2023/04/08 20:23:53
Table 'RushAndCash3766701' 6-max Seat #1 is the button
Seat 1: Hero ($10.44 in chips)
Seat 2: df76427d ($10.77 in chips)
Seat 3: ebda8c0 ($17.78 in chips)
Seat 4: 3fdcb188 ($10.67 in chips)
Seat 5: 716dad3 ($11.5 in chips)
Seat 6: 5a0d0450 ($9.47 in chips)
df76427d: posts small blind $0.05
ebda8c0: posts big blind $0.1
*** HOLE CARDS ***
Dealt to Hero [3h 3s]
Dealt to df76427d 
Dealt to ebda8c0 
Dealt to 3fdcb188 
Dealt to 716dad3 
Dealt to 5a0d0450 
3fdcb188: folds
716dad3: folds
5a0d0450: raises $0.12 to $0.22
Hero: calls $0.22
df76427d: folds
ebda8c0: folds
*** FLOP *** [7s Qc Ks]
5a0d0450: bets $0.3
Hero: folds
Uncalled bet ($0.3) returned to 5a0d0450
*** SHOWDOWN ***
5a0d0450 collected $0.56 from pot
*** SUMMARY ***
Total pot $0.59 | Rake $0.03 | Jackpot $0 | Bingo $0 | Fortune $0
Board [7s Qc Ks]
Seat 1: Hero (button) folded on the Flop
Seat 2: df76427d (small blind) folded before Flop
Seat 3: ebda8c0 (big blind) folded before Flop
Seat 4: 3fdcb188 folded before Flop (didn't bet)
Seat 5: 716dad3 folded before Flop (didn't bet)
Seat 6: 5a0d0450 won ($0.56)


Poker Hand #RC1459871381: Hold'em No Limit  ($0.05/$0.1) - 2023/04/08 20:23:43
Table 'RushAndCash3766641' 6-max Seat #1 is the button
Seat 1: 875bd886 ($10 in chips)
Seat 2: Hero ($10.49 in chips)
Seat 3: bf9dc4c2 ($37.83 in chips)
Seat 4: fd41e8da ($21.31 in chips)
Seat 5: 3615e748 ($11.62 in chips)
Seat 6: b579d5c8 ($23.42 in chips)
Hero: posts small blind $0.05
bf9dc4c2: posts big blind $0.1
*** HOLE CARDS ***
Dealt to 875bd886 
Dealt to Hero [Ac 7h]
Dealt to bf9dc4c2 
Dealt to fd41e8da 
Dealt to 3615e748 
Dealt to b579d5c8 
fd41e8da: folds
3615e748: folds
b579d5c8: raises $0.2 to $0.3
875bd886: folds
Hero: folds
bf9dc4c2: folds
Uncalled bet ($0.2) returned to b579d5c8
*** SHOWDOWN ***
b579d5c8 collected $0.25 from pot
*** SUMMARY ***
Total pot $0.25 | Rake $0 | Jackpot $0 | Bingo $0 | Fortune $0
Seat 1: 875bd886 (button) folded before Flop (didn't bet)
Seat 2: Hero (small blind) folded before Flop
Seat 3: bf9dc4c2 (big blind) folded before Flop
Seat 4: fd41e8da folded before Flop (didn't bet)
Seat 5: 3615e748 folded before Flop (didn't bet)
Seat 6: b579d5c8 collected ($0.25)


Poker Hand #RC1459870962: Hold'em No Limit  ($0.05/$0.1) - 2023/04/08 20:22:21
Table 'RushAndCash3766222' 6-max Seat #1 is the button
Seat 1: 31782351 ($9.85 in chips)
Seat 2: Hero ($9.9 in chips)
Seat 3: 2f7d31ea ($35.01 in chips)
Seat 4: ac8e6dde ($37.89 in chips)
Seat 5: fd41e8da ($21.86 in chips)
Seat 6: 2a44e667 ($10.2 in chips)
Hero: posts small blind $0.05
2f7d31ea: posts big blind $0.1
*** HOLE CARDS ***
Dealt to 31782351 
Dealt to Hero [Ac 9c]
Dealt to 2f7d31ea 
Dealt to ac8e6dde 
Dealt to fd41e8da 
Dealt to 2a44e667 
ac8e6dde: folds
fd41e8da: raises $0.15 to $0.25
2a44e667: folds
31782351: folds
Hero: calls $0.2
2f7d31ea: folds
*** FLOP *** [9d As 9h]
Hero: checks
fd41e8da: bets $0.3
Hero: calls $0.3
*** TURN *** [9d As 9h] [4d]
Hero: checks
fd41e8da: checks
*** RIVER *** [9d As 9h 4d] [6d]
Hero: bets $0.6
fd41e8da: folds
Uncalled bet ($0.6) returned to Hero
*** SHOWDOWN ***
Hero collected $1.14 from pot
*** SUMMARY ***
Total pot $1.2 | Rake $0.06 | Jackpot $0 | Bingo $0 | Fortune $0
Board [9d As 9h 4d 6d]
Seat 1: 31782351 (button) folded before Flop (didn't bet)
Seat 2: Hero (small blind) won ($1.14)
Seat 3: 2f7d31ea (big blind) folded before Flop
Seat 4: ac8e6dde folded before Flop (didn't bet)
Seat 5: fd41e8da folded on the River
Seat 6: 2a44e667 folded before Flop (didn't bet)


Poker Hand #RC1459870922: Hold'em No Limit  ($0.05/$0.1) - 2023/04/08 20:22:13
Table 'RushAndCash3766182' 6-max Seat #1 is the button
Seat 1: 6c98edc ($10.15 in chips)
Seat 2: 81bf7bca ($8.36 in chips)
Seat 3: 22db0f49 ($19.44 in chips)
Seat 4: Hero ($9.9 in chips)
Seat 5: b82fd860 ($13.5 in chips)
Seat 6: a8745400 ($20.36 in chips)
81bf7bca: posts small blind $0.05
22db0f49: posts big blind $0.1
*** HOLE CARDS ***
Dealt to 6c98edc 
Dealt to 81bf7bca 
Dealt to 22db0f49 
Dealt to Hero [7d 9d]
Dealt to b82fd860 
Dealt to a8745400 
Hero: folds
b82fd860: raises $0.1 to $0.2
a8745400: folds
6c98edc: folds
81bf7bca: folds
22db0f49: calls $0.1
*** FLOP *** [Qs 6h As]
22db0f49: checks
b82fd860: bets $0.3
22db0f49: calls $0.3
*** TURN *** [Qs 6h As] [Th]
22db0f49: checks
b82fd860: bets $0.8
22db0f49: calls $0.8
*** RIVER *** [Qs 6h As Th] [Jd]
22db0f49: checks
b82fd860: bets $0.75
22db0f49: folds
Uncalled bet ($0.75) returned to b82fd860
*** SHOWDOWN ***
b82fd860 collected $2.52 from pot
*** SUMMARY ***
Total pot $2.65 | Rake $0.13 | Jackpot $0 | Bingo $0 | Fortune $0
Board [Qs 6h As Th Jd]
Seat 1: 6c98edc (button) folded before Flop (didn't bet)
Seat 2: 81bf7bca (small blind) folded before Flop
Seat 3: 22db0f49 (big blind) folded on the River
Seat 4: Hero folded before Flop (didn't bet)
Seat 5: b82fd860 won ($2.52)
Seat 6: a8745400 folded before Flop (didn't bet)


Poker Hand #RC1459870848: Hold'em No Limit  ($0.05/$0.1) - 2023/04/08 20:22:00
Table 'RushAndCash3766108' 6-max Seat #1 is the button
Seat 1: Hero ($9.75 in chips)
Seat 2: 732de4a8 ($11.37 in chips)
Seat 3: f181dc91 ($68.78 in chips)
Seat 4: fff78e2 ($13.84 in chips)
Seat 5: 67cc6d0e ($3.35 in chips)
Seat 6: 66ead1e9 ($15.84 in chips)
732de4a8: posts small blind $0.05
f181dc91: posts big blind $0.1
*** HOLE CARDS ***
Dealt to Hero [Qd Js]
Dealt to 732de4a8 
Dealt to f181dc91 
Dealt to fff78e2 
Dealt to 67cc6d0e 
Dealt to 66ead1e9 
fff78e2: folds
67cc6d0e: folds
66ead1e9: folds
Hero: raises $0.15 to $0.25
732de4a8: folds
f181dc91: folds
Uncalled bet ($0.15) returned to Hero
*** SHOWDOWN ***
Hero collected $0.25 from pot
*** SUMMARY ***
Total pot $0.25 | Rake $0 | Jackpot $0 | Bingo $0 | Fortune $0
Seat 1: Hero (button) collected ($0.25)
Seat 2: 732de4a8 (small blind) folded before Flop
Seat 3: f181dc91 (big blind) folded before Flop
Seat 4: fff78e2 folded before Flop (didn't bet)
Seat 5: 67cc6d0e folded before Flop (didn't bet)
Seat 6: 66ead1e9 folded before Flop (didn't bet)


Poker Hand #RC1459870742: Hold'em No Limit  ($0.05/$0.1) - 2023/04/08 20:21:39
Table 'RushAndCash3766002' 6-max Seat #1 is the button
Seat 1: 18e279a4 ($57.58 in chips)
Seat 2: fff78e2 ($13.89 in chips)
Seat 3: Hero ($9.85 in chips)
Seat 4: 88ee8fcc ($10 in chips)
Seat 5: ed2461d3 ($26.25 in chips)
Seat 6: 38bd8899 ($25.55 in chips)
fff78e2: posts small blind $0.05
Hero: posts big blind $0.1
*** HOLE CARDS ***
Dealt to 18e279a4 
Dealt to fff78e2 
Dealt to Hero [7h Ts]
Dealt to 88ee8fcc 
Dealt to ed2461d3 
Dealt to 38bd8899 
88ee8fcc: folds
ed2461d3: raises $0.15 to $0.25
38bd8899: folds
18e279a4: folds
fff78e2: folds
Hero: folds
Uncalled bet ($0.15) returned to ed2461d3
*** SHOWDOWN ***
ed2461d3 collected $0.25 from pot
*** SUMMARY ***
Total pot $0.25 | Rake $0 | Jackpot $0 | Bingo $0 | Fortune $0
Seat 1: 18e279a4 (button) folded before Flop (didn't bet)
Seat 2: fff78e2 (small blind) folded before Flop
Seat 3: Hero (big blind) folded before Flop
Seat 4: 88ee8fcc folded before Flop (didn't bet)
Seat 5: ed2461d3 collected ($0.25)
Seat 6: 38bd8899 folded before Flop (didn't bet)


Poker Hand #RC1459870676: Hold'em No Limit  ($0.05/$0.1) - 2023/04/08 20:21:26
Table 'RushAndCash3765936' 6-max Seat #1 is the button
Seat 1: 660756cd ($10 in chips)
Seat 2: 8f834bd5 ($9.58 in chips)
Seat 3: e53d5717 ($11.4 in chips)
Seat 4: 5663e5da ($18.29 in chips)
Seat 5: f05ce810 ($12.16 in chips)
Seat 6: Hero ($9.85 in chips)
8f834bd5: posts small blind $0.05
e53d5717: posts big blind $0.1
*** HOLE CARDS ***
Dealt to 660756cd 
Dealt to 8f834bd5 
Dealt to e53d5717 
Dealt to 5663e5da 
Dealt to f05ce810 
Dealt to Hero [Qc Ts]
5663e5da: raises $0.12 to $0.22
f05ce810: folds
Hero: folds
660756cd: folds
8f834bd5: folds
e53d5717: folds
Uncalled bet ($0.12) returned to 5663e5da
*** SHOWDOWN ***
5663e5da collected $0.25 from pot
*** SUMMARY ***
Total pot $0.25 | Rake $0 | Jackpot $0 | Bingo $0 | Fortune $0
Seat 1: 660756cd (button) folded before Flop (didn't bet)
Seat 2: 8f834bd5 (small blind) folded before Flop
Seat 3: e53d5717 (big blind) folded before Flop
Seat 4: 5663e5da collected ($0.25)
Seat 5: f05ce810 folded before Flop (didn't bet)
Seat 6: Hero folded before Flop (didn't bet)


Poker Hand #RC1459870609: Hold'em No Limit  ($0.05/$0.1) - 2023/04/08 20:21:14
Table 'RushAndCash3765869' 6-max Seat #1 is the button
Seat 1: efa37a1d ($9.7 in chips)
Seat 2: Hero ($9.9 in chips)
Seat 3: f7312c09 ($11.96 in chips)
Seat 4: 9a4e419d ($10.15 in chips)
Seat 5: 875bd886 ($10.5 in chips)
Seat 6: 23d1bcf4 ($10.06 in chips)
Hero: posts small blind $0.05
f7312c09: posts big blind $0.1
*** HOLE CARDS ***
Dealt to efa37a1d 
Dealt to Hero [Tc 5h]
Dealt to f7312c09 
Dealt to 9a4e419d 
Dealt to 875bd886 
Dealt to 23d1bcf4 
9a4e419d: folds
875bd886: raises $0.13 to $0.23
23d1bcf4: folds
efa37a1d: folds
Hero: folds
f7312c09: calls $0.13
*** FLOP *** [2d 2h 5d]
f7312c09: checks
875bd886: checks
*** TURN *** [2d 2h 5d] [6s]
f7312c09: bets $0.31
875bd886: folds
Uncalled bet ($0.31) returned to f7312c09
*** SHOWDOWN ***
f7312c09 collected $0.49 from pot
*** SUMMARY ***
Total pot $0.51 | Rake $0.02 | Jackpot $0 | Bingo $0 | Fortune $0
Board [2d 2h 5d 6s]
Seat 1: efa37a1d (button) folded before Flop (didn't bet)
Seat 2: Hero (small blind) folded before Flop
Seat 3: f7312c09 (big blind) won ($0.49)
Seat 4: 9a4e419d folded before Flop (didn't bet)
Seat 5: 875bd886 folded on the Turn
Seat 6: 23d1bcf4 folded before Flop (didn't bet)


Poker Hand #RC1459870493: Hold'em No Limit  ($0.05/$0.1) - 2023/04/08 20:20:51
Table 'RushAndCash3765753' 6-max Seat #1 is the button
Seat 1: e115cf1e ($6.8 in chips)
Seat 2: d3f64a2e ($27.44 in chips)
Seat 3: e6f28e1b ($8.64 in chips)
Seat 4: Hero ($9.9 in chips)
Seat 5: 545c097e ($10 in chips)
Seat 6: b5be15a0 ($11.76 in chips)
d3f64a2e: posts small blind $0.05
e6f28e1b: posts big blind $0.1
*** HOLE CARDS ***
Dealt to e115cf1e 
Dealt to d3f64a2e 
Dealt to e6f28e1b 
Dealt to Hero [7c 6d]
Dealt to 545c097e 
Dealt to b5be15a0 
Hero: folds
545c097e: folds
b5be15a0: raises $0.15 to $0.25
e115cf1e: folds
d3f64a2e: calls $0.2
e6f28e1b: folds
*** FLOP *** [Ah 6h 3d]
d3f64a2e: checks
b5be15a0: checks
*** TURN *** [Ah 6h 3d] [Tc]
d3f64a2e: checks
b5be15a0: bets $0.4
d3f64a2e: folds
Uncalled bet ($0.4) returned to b5be15a0
*** SHOWDOWN ***
b5be15a0 collected $0.57 from pot
*** SUMMARY ***
Total pot $0.6 | Rake $0.03 | Jackpot $0 | Bingo $0 | Fortune $0
Board [Ah 6h 3d Tc]
Seat 1: e115cf1e (button) folded before Flop (didn't bet)
Seat 2: d3f64a2e (small blind) folded on the Turn
Seat 3: e6f28e1b (big blind) folded before Flop
Seat 4: Hero folded before Flop (didn't bet)
Seat 5: 545c097e folded before Flop (didn't bet)
Seat 6: b5be15a0 won ($0.57)


Poker Hand #RC1459870420: Hold'em No Limit  ($0.05/$0.1) - 2023/04/08 20:20:37
Table 'RushAndCash3765680' 6-max Seat #1 is the button
Seat 1: 80361c9f ($10.27 in chips)
Seat 2: 34bdb0c8 ($22.93 in chips)
Seat 3: Hero ($10 in chips)
Seat 4: 7a3e4c38 ($18.96 in chips)
Seat 5: 62dc1925 ($10.05 in chips)
Seat 6: 5e48a168 ($8.36 in chips)
34bdb0c8: posts small blind $0.05
Hero: posts big blind $0.1
*** HOLE CARDS ***
Dealt to 80361c9f 
Dealt to 34bdb0c8 
Dealt to Hero [Kc 4c]
Dealt to 7a3e4c38 
Dealt to 62dc1925 
Dealt to 5e48a168 
7a3e4c38: folds
62dc1925: folds
5e48a168: folds
80361c9f: raises $0.15 to $0.25
34bdb0c8: folds
Hero: folds
Uncalled bet ($0.15) returned to 80361c9f
*** SHOWDOWN ***
80361c9f collected $0.25 from pot
*** SUMMARY ***
Total pot $0.25 | Rake $0 | Jackpot $0 | Bingo $0 | Fortune $0
Seat 1: 80361c9f (button) collected ($0.25)
Seat 2: 34bdb0c8 (small blind) folded before Flop
Seat 3: Hero (big blind) folded before Flop
Seat 4: 7a3e4c38 folded before Flop (didn't bet)
Seat 5: 62dc1925 folded before Flop (didn't bet)
Seat 6: 5e48a168 folded before Flop (didn't bet)


Poker Hand #RC1459870352: Hold'em No Limit  ($0.05/$0.1) - 2023/04/08 20:20:24
Table 'RushAndCash3765612' 6-max Seat #1 is the button
Seat 1: Hero ($10 in chips)
Seat 2: 351bb63a ($29.96 in chips)
Seat 3: 6c98edc ($10.55 in chips)
Seat 4: 5489eecc ($25.61 in chips)
Seat 5: 3368ae52 ($10 in chips)
Seat 6: b793dede ($17.19 in chips)
351bb63a: posts small blind $0.05
6c98edc: posts big blind $0.1
*** HOLE CARDS ***
Dealt to Hero [2d 6h]
Dealt to 351bb63a 
Dealt to 6c98edc 
Dealt to 5489eecc 
Dealt to 3368ae52 
Dealt to b793dede 
5489eecc: folds
3368ae52: folds
b793dede: folds
Hero: folds
351bb63a: folds
Uncalled bet ($0.05) returned to 6c98edc
*** SHOWDOWN ***
6c98edc collected $0.1 from pot
*** SUMMARY ***
Total pot $0.1 | Rake $0 | Jackpot $0 | Bingo $0 | Fortune $0
Seat 1: Hero (button) folded before Flop (didn't bet)
Seat 2: 351bb63a (small blind) folded before Flop
Seat 3: 6c98edc (big blind) collected ($0.1)
Seat 4: 5489eecc folded before Flop (didn't bet)
Seat 5: 3368ae52 folded before Flop (didn't bet)
Seat 6: b793dede folded before Flop (didn't bet)


Poker Hand #RC1459870308: Hold'em No Limit  ($0.05/$0.1) - 2023/04/08 20:20:16
Table 'RushAndCash3765568' 6-max Seat #1 is the button
Seat 1: 31f2a64d ($5.08 in chips)
Seat 2: 116d5b6a ($10.94 in chips)
Seat 3: f2724d93 ($14.57 in chips)
Seat 4: 5ea648b1 ($10 in chips)
Seat 5: Hero ($2.82 in chips)
Seat 6: c09dbfbc ($14.58 in chips)
116d5b6a: posts small blind $0.05
f2724d93: posts big blind $0.1
*** HOLE CARDS ***
Dealt to 31f2a64d 
Dealt to 116d5b6a 
Dealt to f2724d93 
Dealt to 5ea648b1 
Dealt to Hero [5s 2d]
Dealt to c09dbfbc 
5ea648b1: folds
Hero: folds
c09dbfbc: folds
31f2a64d: folds
116d5b6a: raises $0.2 to $0.3
f2724d93: calls $0.2
*** FLOP *** [8s 9d 2c]
116d5b6a: bets $0.2
f2724d93: calls $0.2
*** TURN *** [8s 9d 2c] [4c]
116d5b6a: bets $0.75
f2724d93: calls $0.75
*** RIVER *** [8s 9d 2c 4c] [5h]
116d5b6a: bets $1.88
f2724d93: folds
Uncalled bet ($1.88) returned to 116d5b6a
*** SHOWDOWN ***
116d5b6a collected $2.38 from pot
*** SUMMARY ***
Total pot $2.5 | Rake $0.12 | Jackpot $0 | Bingo $0 | Fortune $0
Board [8s 9d 2c 4c 5h]
Seat 1: 31f2a64d (button) folded before Flop (didn't bet)
Seat 2: 116d5b6a (small blind) won ($2.38)
Seat 3: f2724d93 (big blind) folded on the River
Seat 4: 5ea648b1 folded before Flop (didn't bet)
Seat 5: Hero folded before Flop (didn't bet)
Seat 6: c09dbfbc folded before Flop (didn't bet)


Poker Hand #RC1459870258: Hold'em No Limit  ($0.05/$0.1) - 2023/04/08 20:20:08
Table 'RushAndCash3765518' 6-max Seat #1 is the button
Seat 1: 67cf03f3 ($21.51 in chips)
Seat 2: fe74b7c3 ($19.75 in chips)
Seat 3: c09dbfbc ($14.68 in chips)
Seat 4: 5cddb095 ($16.43 in chips)
Seat 5: 6bf4bfde ($6.52 in chips)
Seat 6: Hero ($2.82 in chips)
fe74b7c3: posts small blind $0.05
c09dbfbc: posts big blind $0.1
*** HOLE CARDS ***
Dealt to 67cf03f3 
Dealt to fe74b7c3 
Dealt to c09dbfbc 
Dealt to 5cddb095 
Dealt to 6bf4bfde 
Dealt to Hero [3c Jc]
5cddb095: folds
6bf4bfde: raises $0.2 to $0.3
Hero: folds
67cf03f3: folds
fe74b7c3: calls $0.25
c09dbfbc: folds
*** FLOP *** [Qs 5d 9s]
fe74b7c3: checks
6bf4bfde: checks
*** TURN *** [Qs 5d 9s] [7c]
fe74b7c3: checks
6bf4bfde: checks
*** RIVER *** [Qs 5d 9s 7c] [Qc]
fe74b7c3: bets $0.53
6bf4bfde: calls $0.53
fe74b7c3: shows [Jh Th] (Pair of Queens)
6bf4bfde: shows [Ac Kd] (Pair of Queens)
*** SHOWDOWN ***
6bf4bfde collected $1.68 from pot
*** SUMMARY ***
Total pot $1.76 | Rake $0.08 | Jackpot $0 | Bingo $0 | Fortune $0
Board [Qs 5d 9s 7c Qc]
Seat 1: 67cf03f3 (button) folded before Flop (didn't bet)
Seat 2: fe74b7c3 (small blind) showed [Jh Th] and lost with Pair of Queens
Seat 3: c09dbfbc (big blind) folded before Flop
Seat 4: 5cddb095 folded before Flop (didn't bet)
Seat 5: 6bf4bfde showed [Ac Kd] and won ($1.68) with Pair of Queens
Seat 6: Hero folded before Flop (didn't bet)


Poker Hand #RC1459870230: Hold'em No Limit  ($0.05/$0.1) - 2023/04/08 20:20:03
Table 'RushAndCash3765490' 6-max Seat #1 is the button
Seat 1: ffe9bf5a ($10 in chips)
Seat 2: 54f59ada ($13.78 in chips)
Seat 3: ebef8ed1 ($9.34 in chips)
Seat 4: dfc7c90a ($8.28 in chips)
Seat 5: Hero ($2.82 in chips)
Seat 6: f21a5649 ($3.94 in chips)
54f59ada: posts small blind $0.05
ebef8ed1: posts big blind $0.1
*** HOLE CARDS ***
Dealt to ffe9bf5a 
Dealt to 54f59ada 
Dealt to ebef8ed1 
Dealt to dfc7c90a 
Dealt to Hero [6d 9d]
Dealt to f21a5649 
dfc7c90a: folds
Hero: folds
f21a5649: raises $0.13 to $0.23
ffe9bf5a: folds
54f59ada: folds
ebef8ed1: folds
Uncalled bet ($0.13) returned to f21a5649
*** SHOWDOWN ***
f21a5649 collected $0.25 from pot
*** SUMMARY ***
Total pot $0.25 | Rake $0 | Jackpot $0 | Bingo $0 | Fortune $0
Seat 1: ffe9bf5a (button) folded before Flop (didn't bet)
Seat 2: 54f59ada (small blind) folded before Flop
Seat 3: ebef8ed1 (big blind) folded before Flop
Seat 4: dfc7c90a folded before Flop (didn't bet)
Seat 5: Hero folded before Flop (didn't bet)
Seat 6: f21a5649 collected ($0.25)


Poker Hand #RC1459869658: Hold'em No Limit  ($0.05/$0.1) - 2023/04/08 20:18:20
Table 'RushAndCash3764918' 6-max Seat #1 is the button
Seat 1: 4e81b0c7 ($11.08 in chips)
Seat 2: 3054a0bf ($11.32 in chips)
Seat 3: bc99aab9 ($10 in chips)
Seat 4: a89f9b32 ($10.32 in chips)
Seat 5: 68888d2b ($53.22 in chips)
Seat 6: Hero ($5.51 in chips)
3054a0bf: posts small blind $0.05
bc99aab9: posts big blind $0.1
*** HOLE CARDS ***
Dealt to 4e81b0c7 
Dealt to 3054a0bf 
Dealt to bc99aab9 
Dealt to a89f9b32 
Dealt to 68888d2b 
Dealt to Hero [9d 9s]
a89f9b32: raises $0.17 to $0.27
68888d2b: folds
Hero: raises $0.57 to $0.84
4e81b0c7: folds
3054a0bf: folds
bc99aab9: calls $0.74
a89f9b32: calls $0.57
*** FLOP *** [Ad 2h 5d]
bc99aab9: checks
a89f9b32: checks
Hero: checks
*** TURN *** [Ad 2h 5d] [Ac]
bc99aab9: bets $0.85
a89f9b32: calls $0.85
Hero: calls $0.85
*** RIVER *** [Ad 2h 5d Ac] [2d]
bc99aab9: checks
a89f9b32: bets $1
Hero: calls $1
bc99aab9: folds
a89f9b32: shows [Jd Td] (Ace High Flush)
Hero: shows [9d 9s] (Pair of Aces and Pair of Nines)
*** SHOWDOWN ***
a89f9b32 collected $6.67 from pot
*** SUMMARY ***
Total pot $7.12 | Rake $0.3 | Jackpot $0.15 | Bingo $0 | Fortune $0
Board [Ad 2h 5d Ac 2d]
Seat 1: 4e81b0c7 (button) folded before Flop (didn't bet)
Seat 2: 3054a0bf (small blind) folded before Flop
Seat 3: bc99aab9 (big blind) folded on the River
Seat 4: a89f9b32 showed [Jd Td] and won ($6.67) with Ace High Flush
Seat 5: 68888d2b folded before Flop (didn't bet)
Seat 6: Hero showed [9d 9s] and lost with Pair of Aces and Pair of Nines


Poker Hand #RC1459869621: Hold'em No Limit  ($0.05/$0.1) - 2023/04/08 20:18:14
Table 'RushAndCash3764881' 6-max Seat #1 is the button
Seat 1: 42ad43e ($10.18 in chips)
Seat 2: 99ca95f3 ($10.05 in chips)
Seat 3: 96c7183a ($16.97 in chips)
Seat 4: 23d1bcf4 ($4.85 in chips)
Seat 5: 85d9c84a ($10.28 in chips)
Seat 6: Hero ($5.51 in chips)
99ca95f3: posts small blind $0.05
96c7183a: posts big blind $0.1
*** HOLE CARDS ***
Dealt to 42ad43e 
Dealt to 99ca95f3 
Dealt to 96c7183a 
Dealt to 23d1bcf4 
Dealt to 85d9c84a 
Dealt to Hero [8c 2d]
23d1bcf4: raises $0.15 to $0.25
85d9c84a: folds
Hero: folds
42ad43e: folds
99ca95f3: folds
96c7183a: calls $0.15
*** FLOP *** [Js 2c 9h]
96c7183a: checks
23d1bcf4: bets $0.3
96c7183a: calls $0.3
*** TURN *** [Js 2c 9h] [7d]
96c7183a: checks
23d1bcf4: checks
*** RIVER *** [Js 2c 9h 7d] [Qd]
96c7183a: checks
23d1bcf4: bets $0.4
96c7183a: calls $0.4
23d1bcf4: shows [Qh As] (Pair of Queens)
96c7183a: shows [Jd Td] (Pair of Jacks)
*** SHOWDOWN ***
23d1bcf4 collected $1.86 from pot
*** SUMMARY ***
Total pot $1.95 | Rake $0.09 | Jackpot $0 | Bingo $0 | Fortune $0
Board [Js 2c 9h 7d Qd]
Seat 1: 42ad43e (button) folded before Flop (didn't bet)
Seat 2: 99ca95f3 (small blind) folded before Flop
Seat 3: 96c7183a (big blind) showed [Jd Td] and lost with Pair of Jacks
Seat 4: 23d1bcf4 showed [Qh As] and won ($1.86) with Pair of Queens
Seat 5: 85d9c84a folded before Flop (didn't bet)
Seat 6: Hero folded before Flop (didn't bet)


Poker Hand #RC1459869596: Hold'em No Limit  ($0.05/$0.1) - 2023/04/08 20:18:09
Table 'RushAndCash3764856' 6-max Seat #1 is the button
Seat 1: Hero ($5.51 in chips)
Seat 2: 98ef47e9 ($13.86 in chips)
Seat 3: 5a721ebb ($9.9 in chips)
Seat 4: f7312c09 ($12.34 in chips)
Seat 5: eda2be39 ($20.1 in chips)
Seat 6: e8dad1c8 ($33.54 in chips)
98ef47e9: posts small blind $0.05
5a721ebb: posts big blind $0.1
*** HOLE CARDS ***
Dealt to Hero [9d 3c]
Dealt to 98ef47e9 
Dealt to 5a721ebb 
Dealt to f7312c09 
Dealt to eda2be39 
Dealt to e8dad1c8 
f7312c09: folds
eda2be39: raises $0.15 to $0.25
e8dad1c8: folds
Hero: folds
98ef47e9: calls $0.2
5a721ebb: folds
*** FLOP *** [Ts 3s 6h]
98ef47e9: checks
eda2be39: bets $0.3
98ef47e9: folds
Uncalled bet ($0.3) returned to eda2be39
*** SHOWDOWN ***
eda2be39 collected $0.57 from pot
*** SUMMARY ***
Total pot $0.6 | Rake $0.03 | Jackpot $0 | Bingo $0 | Fortune $0
Board [Ts 3s 6h]
Seat 1: Hero (button) folded before Flop (didn't bet)
Seat 2: 98ef47e9 (small blind) folded on the Flop
Seat 3: 5a721ebb (big blind) folded before Flop
Seat 4: f7312c09 folded before Flop (didn't bet)
Seat 5: eda2be39 won ($0.57)
Seat 6: e8dad1c8 folded before Flop (didn't bet)


Poker Hand #RC1459869571: Hold'em No Limit  ($0.05/$0.1) - 2023/04/08 20:18:05
Table 'RushAndCash3764831' 6-max Seat #1 is the button
Seat 1: 5cddb095 ($15.83 in chips)
Seat 2: Hero ($5.56 in chips)
Seat 3: 7faf8c75 ($49.13 in chips)
Seat 4: 9ea751ea ($10.03 in chips)
Seat 5: 58a553d0 ($16.79 in chips)
Seat 6: b7c5ed84 ($14.27 in chips)
Hero: posts small blind $0.05
7faf8c75: posts big blind $0.1
*** HOLE CARDS ***
Dealt to 5cddb095 
Dealt to Hero [Qh 9s]
Dealt to 7faf8c75 
Dealt to 9ea751ea 
Dealt to 58a553d0 
Dealt to b7c5ed84 
9ea751ea: folds
58a553d0: folds
b7c5ed84: folds
5cddb095: raises $0.15 to $0.25
Hero: folds
7faf8c75: folds
Uncalled bet ($0.15) returned to 5cddb095
*** SHOWDOWN ***
5cddb095 collected $0.25 from pot
*** SUMMARY ***
Total pot $0.25 | Rake $0 | Jackpot $0 | Bingo $0 | Fortune $0
Seat 1: 5cddb095 (button) collected ($0.25)
Seat 2: Hero (small blind) folded before Flop
Seat 3: 7faf8c75 (big blind) folded before Flop
Seat 4: 9ea751ea folded before Flop (didn't bet)
Seat 5: 58a553d0 folded before Flop (didn't bet)
Seat 6: b7c5ed84 folded before Flop (didn't bet)


Poker Hand #RC1459869519: Hold'em No Limit  ($0.05/$0.1) - 2023/04/08 20:17:56
Table 'RushAndCash3764779' 6-max Seat #1 is the button
Seat 1: 2c26b728 ($10.05 in chips)
Seat 2: dfc7c90a ($8.63 in chips)
Seat 3: Hero ($5.51 in chips)
Seat 4: f80efe5f ($10.15 in chips)
Seat 5: f0bb503d ($8.01 in chips)
Seat 6: fbee46f4 ($11.99 in chips)
dfc7c90a: posts small blind $0.05
Hero: posts big blind $0.1
*** HOLE CARDS ***
Dealt to 2c26b728 
Dealt to dfc7c90a 
Dealt to Hero [As 9s]
Dealt to f80efe5f 
Dealt to f0bb503d 
Dealt to fbee46f4 
f80efe5f: folds
f0bb503d: folds
fbee46f4: folds
2c26b728: folds
dfc7c90a: folds
Uncalled bet ($0.05) returned to Hero
*** SHOWDOWN ***
Hero collected $0.1 from pot
*** SUMMARY ***
Total pot $0.1 | Rake $0 | Jackpot $0 | Bingo $0 | Fortune $0
Seat 1: 2c26b728 (button) folded before Flop (didn't bet)
Seat 2: dfc7c90a (small blind) folded before Flop
Seat 3: Hero (big blind) collected ($0.1)
Seat 4: f80efe5f folded before Flop (didn't bet)
Seat 5: f0bb503d folded before Flop (didn't bet)
Seat 6: fbee46f4 folded before Flop (didn't bet)


Poker Hand #RC1459869494: Hold'em No Limit  ($0.05/$0.1) - 2023/04/08 20:17:51
Table 'RushAndCash3764754' 6-max Seat #1 is the button
Seat 1: 9f65c8a ($9.87 in chips)
Seat 2: 2164d54c ($32.36 in chips)
Seat 3: 2590fb03 ($10.93 in chips)
Seat 4: a02f13bb ($31.07 in chips)
Seat 5: Hero ($5.51 in chips)
Seat 6: fec53cb4 ($3.7 in chips)
2164d54c: posts small blind $0.05
2590fb03: posts big blind $0.1
*** HOLE CARDS ***
Dealt to 9f65c8a 
Dealt to 2164d54c 
Dealt to 2590fb03 
Dealt to a02f13bb 
Dealt to Hero [8d 2c]
Dealt to fec53cb4 
a02f13bb: raises $0.14 to $0.24
Hero: folds
fec53cb4: folds
9f65c8a: folds
2164d54c: folds
2590fb03: folds
Uncalled bet ($0.14) returned to a02f13bb
*** SHOWDOWN ***
a02f13bb collected $0.25 from pot
*** SUMMARY ***
Total pot $0.25 | Rake $0 | Jackpot $0 | Bingo $0 | Fortune $0
Seat 1: 9f65c8a (button) folded before Flop (didn't bet)
Seat 2: 2164d54c (small blind) folded before Flop
Seat 3: 2590fb03 (big blind) folded before Flop
Seat 4: a02f13bb collected ($0.25)
Seat 5: Hero folded before Flop (didn't bet)
Seat 6: fec53cb4 folded before Flop (didn't bet)


Poker Hand #RC1459869452: Hold'em No Limit  ($0.05/$0.1) - 2023/04/08 20:17:44
Table 'RushAndCash3764712' 6-max Seat #1 is the button
Seat 1: 2e9a8f64 ($10.1 in chips)
Seat 2: f4fbd3ee ($28.18 in chips)
Seat 3: 110937af ($11.31 in chips)
Seat 4: 36fb0e91 ($12.11 in chips)
Seat 5: Hero ($5.51 in chips)
Seat 6: dc525443 ($35.63 in chips)
f4fbd3ee: posts small blind $0.05
110937af: posts big blind $0.1
*** HOLE CARDS ***
Dealt to 2e9a8f64 
Dealt to f4fbd3ee 
Dealt to 110937af 
Dealt to 36fb0e91 
Dealt to Hero [Js 2c]
Dealt to dc525443 
36fb0e91: folds
Hero: folds
dc525443: raises $0.15 to $0.25
2e9a8f64: folds
f4fbd3ee: folds
110937af: folds
Uncalled bet ($0.15) returned to dc525443
*** SHOWDOWN ***
dc525443 collected $0.25 from pot
*** SUMMARY ***
Total pot $0.25 | Rake $0 | Jackpot $0 | Bingo $0 | Fortune $0
Seat 1: 2e9a8f64 (button) folded before Flop (didn't bet)
Seat 2: f4fbd3ee (small blind) folded before Flop
Seat 3: 110937af (big blind) folded before Flop
Seat 4: 36fb0e91 folded before Flop (didn't bet)
Seat 5: Hero folded before Flop (didn't bet)
Seat 6: dc525443 collected ($0.25)


Poker Hand #RC1459869405: Hold'em No Limit  ($0.05/$0.1) - 2023/04/08 20:17:36
Table 'RushAndCash3764665' 6-max Seat #1 is the button
Seat 1: f4362c8f ($10 in chips)
Seat 2: ff075683 ($10.96 in chips)
Seat 3: 76069ee8 ($15.79 in chips)
Seat 4: 32eaf87d ($15.13 in chips)
Seat 5: adb4e172 ($11.03 in chips)
Seat 6: Hero ($5.51 in chips)
ff075683: posts small blind $0.05
76069ee8: posts big blind $0.1
*** HOLE CARDS ***
Dealt to f4362c8f 
Dealt to ff075683 
Dealt to 76069ee8 
Dealt to 32eaf87d 
Dealt to adb4e172 
Dealt to Hero [7s 3c]
32eaf87d: folds
adb4e172: folds
Hero: folds
f4362c8f: folds
ff075683: folds
Uncalled bet ($0.05) returned to 76069ee8
*** SHOWDOWN ***
76069ee8 collected $0.1 from pot
*** SUMMARY ***
Total pot $0.1 | Rake $0 | Jackpot $0 | Bingo $0 | Fortune $0
Seat 1: f4362c8f (button) folded before Flop (didn't bet)
Seat 2: ff075683 (small blind) folded before Flop
Seat 3: 76069ee8 (big blind) collected ($0.1)
Seat 4: 32eaf87d folded before Flop (didn't bet)
Seat 5: adb4e172 folded before Flop (didn't bet)
Seat 6: Hero folded before Flop (didn't bet)


Poker Hand #RC1459869311: Hold'em No Limit  ($0.05/$0.1) - 2023/04/08 20:17:19
Table 'RushAndCash3764571' 6-max Seat #1 is the button
Seat 1: 82971aeb ($10.15 in chips)
Seat 2: cd80bf76 ($22.27 in chips)
Seat 3: Hero ($5.61 in chips)
Seat 4: 27089392 ($35.16 in chips)
Seat 5: 3d16c2db ($41.49 in chips)
Seat 6: f4d194a2 ($14.14 in chips)
cd80bf76: posts small blind $0.05
Hero: posts big blind $0.1
*** HOLE CARDS ***
Dealt to 82971aeb 
Dealt to cd80bf76 
Dealt to Hero [2d 5h]
Dealt to 27089392 
Dealt to 3d16c2db 
Dealt to f4d194a2 
27089392: folds
3d16c2db: folds
f4d194a2: folds
82971aeb: raises $0.17 to $0.27
cd80bf76: folds
Hero: folds
Uncalled bet ($0.17) returned to 82971aeb
*** SHOWDOWN ***
82971aeb collected $0.25 from pot
*** SUMMARY ***
Total pot $0.25 | Rake $0 | Jackpot $0 | Bingo $0 | Fortune $0
Seat 1: 82971aeb (button) collected ($0.25)
Seat 2: cd80bf76 (small blind) folded before Flop
Seat 3: Hero (big blind) folded before Flop
Seat 4: 27089392 folded before Flop (didn't bet)
Seat 5: 3d16c2db folded before Flop (didn't bet)
Seat 6: f4d194a2 folded before Flop (didn't bet)


Poker Hand #RC1459869234: Hold'em No Limit  ($0.05/$0.1) - 2023/04/08 20:17:06
Table 'RushAndCash3764494' 6-max Seat #1 is the button
Seat 1: 917f3b91 ($9.56 in chips)
Seat 2: Hero ($5.66 in chips)
Seat 3: cc9732f3 ($10.62 in chips)
Seat 4: 624ba201 ($10 in chips)
Seat 5: f4d194a2 ($14.14 in chips)
Seat 6: b2d3d1b9 ($28.82 in chips)
Hero: posts small blind $0.05
cc9732f3: posts big blind $0.1
*** HOLE CARDS ***
Dealt to 917f3b91 
Dealt to Hero [Qs Kc]
Dealt to cc9732f3 
Dealt to 624ba201 
Dealt to f4d194a2 
Dealt to b2d3d1b9 
624ba201: raises $0.15 to $0.25
f4d194a2: folds
b2d3d1b9: folds
917f3b91: raises $0.55 to $0.8
Hero: folds
cc9732f3: folds
624ba201: raises $1.2 to $2
917f3b91: folds
Uncalled bet ($1.2) returned to 624ba201
*** SHOWDOWN ***
624ba201 collected $1.67 from pot
*** SUMMARY ***
Total pot $1.75 | Rake $0.08 | Jackpot $0 | Bingo $0 | Fortune $0
Seat 1: 917f3b91 (button) folded before Flop
Seat 2: Hero (small blind) folded before Flop
Seat 3: cc9732f3 (big blind) folded before Flop
Seat 4: 624ba201 collected ($1.67)
Seat 5: f4d194a2 folded before Flop (didn't bet)
Seat 6: b2d3d1b9 folded before Flop (didn't bet)


Poker Hand #RC1459869207: Hold'em No Limit  ($0.05/$0.1) - 2023/04/08 20:17:02
Table 'RushAndCash3764467' 6-max Seat #1 is the button
Seat 1: Hero ($5.66 in chips)
Seat 2: ec8b1b3c ($10.01 in chips)
Seat 3: 31f2a64d ($8.83 in chips)
Seat 4: 262c23d ($3.7 in chips)
Seat 5: 4ec6caba ($11.27 in chips)
Seat 6: 277af015 ($10.33 in chips)
ec8b1b3c: posts small blind $0.05
31f2a64d: posts big blind $0.1
*** HOLE CARDS ***
Dealt to Hero [6s 2d]
Dealt to ec8b1b3c 
Dealt to 31f2a64d 
Dealt to 262c23d 
Dealt to 4ec6caba 
Dealt to 277af015 
262c23d: folds
4ec6caba: folds
277af015: raises $0.15 to $0.25
Hero: folds
ec8b1b3c: folds
31f2a64d: folds
Uncalled bet ($0.15) returned to 277af015
*** SHOWDOWN ***
277af015 collected $0.25 from pot
*** SUMMARY ***
Total pot $0.25 | Rake $0 | Jackpot $0 | Bingo $0 | Fortune $0
Seat 1: Hero (button) folded before Flop (didn't bet)
Seat 2: ec8b1b3c (small blind) folded before Flop
Seat 3: 31f2a64d (big blind) folded before Flop
Seat 4: 262c23d folded before Flop (didn't bet)
Seat 5: 4ec6caba folded before Flop (didn't bet)
Seat 6: 277af015 collected ($0.25)


Poker Hand #RC1459869178: Hold'em No Limit  ($0.05/$0.1) - 2023/04/08 20:16:57
Table 'RushAndCash3764438' 6-max Seat #1 is the button
Seat 1: 6a138b47 ($22.38 in chips)
Seat 2: a4f17ab8 ($12.79 in chips)
Seat 3: 8d2b1c55 ($19.29 in chips)
Seat 4: 92a48d51 ($14.51 in chips)
Seat 5: Hero ($5.66 in chips)
Seat 6: 32767223 ($12.88 in chips)
a4f17ab8: posts small blind $0.05
8d2b1c55: posts big blind $0.1
*** HOLE CARDS ***
Dealt to 6a138b47 
Dealt to a4f17ab8 
Dealt to 8d2b1c55 
Dealt to 92a48d51 
Dealt to Hero [Kd 6c]
Dealt to 32767223 
92a48d51: folds
Hero: folds
32767223: raises $0.14 to $0.24
6a138b47: folds
a4f17ab8: folds
8d2b1c55: calls $0.14
*** FLOP *** [9s 3d 7h]
8d2b1c55: bets $0.27
32767223: raises $0.54 to $0.81
8d2b1c55: calls $0.54
*** TURN *** [9s 3d 7h] [3c]
8d2b1c55: bets $2.15
32767223: calls $2.15
*** RIVER *** [9s 3d 7h 3c] [3h]
8d2b1c55: bets $6.45
32767223: raises $3.23 to $9.68 and is all-in
8d2b1c55: calls $3.23
32767223: shows [As Ah] (Treys Full over Aces)
8d2b1c55: shows [3s Jh] (Four Treys)
*** SHOWDOWN ***
8d2b1c55 collected $25.36 from pot
*** SUMMARY ***
Total pot $25.81 | Rake $0.3 | Jackpot $0.15 | Bingo $0 | Fortune $0
Board [9s 3d 7h 3c 3h]
Seat 1: 6a138b47 (button) folded before Flop (didn't bet)
Seat 2: a4f17ab8 (small blind) folded before Flop
Seat 3: 8d2b1c55 (big blind) showed [3s Jh] and won ($25.36) with Four Treys
Seat 4: 92a48d51 folded before Flop (didn't bet)
Seat 5: Hero folded before Flop (didn't bet)
Seat 6: 32767223 showed [As Ah] and lost with Treys Full over Aces


Poker Hand #RC1459869144: Hold'em No Limit  ($0.05/$0.1) - 2023/04/08 20:16:51
Table 'RushAndCash3764404' 6-max Seat #1 is the button
Seat 1: 475fe736 ($33.9 in chips)
Seat 2: ec6ca311 ($17.15 in chips)
Seat 3: 7981963d ($10.5 in chips)
Seat 4: 3471027 ($10.7 in chips)
Seat 5: 48082eba ($10.51 in chips)
Seat 6: Hero ($5.66 in chips)
ec6ca311: posts small blind $0.05
7981963d: posts big blind $0.1
*** HOLE CARDS ***
Dealt to 475fe736 
Dealt to ec6ca311 
Dealt to 7981963d 
Dealt to 3471027 
Dealt to 48082eba 
Dealt to Hero [9d 3h]
3471027: raises $0.12 to $0.22
48082eba: folds
Hero: folds
475fe736: folds
ec6ca311: folds
7981963d: folds
Uncalled bet ($0.12) returned to 3471027
*** SHOWDOWN ***
3471027 collected $0.25 from pot
*** SUMMARY ***
Total pot $0.25 | Rake $0 | Jackpot $0 | Bingo $0 | Fortune $0
Seat 1: 475fe736 (button) folded before Flop (didn't bet)
Seat 2: ec6ca311 (small blind) folded before Flop
Seat 3: 7981963d (big blind) folded before Flop
Seat 4: 3471027 collected ($0.25)
Seat 5: 48082eba folded before Flop (didn't bet)
Seat 6: Hero folded before Flop (didn't bet)


Poker Hand #RC1459869091: Hold'em No Limit  ($0.05/$0.1) - 2023/04/08 20:16:42
Table 'RushAndCash3764351' 6-max Seat #1 is the button
Seat 1: 56fe61f7 ($12.31 in chips)
Seat 2: Hero ($5.71 in chips)
Seat 3: 845fb6fd ($24.01 in chips)
Seat 4: dfc7c90a ($8.88 in chips)
Seat 5: ca47437 ($10.23 in chips)
Seat 6: 4d7c3654 ($11.45 in chips)
Hero: posts small blind $0.05
845fb6fd: posts big blind $0.1
*** HOLE CARDS ***
Dealt to 56fe61f7 
Dealt to Hero [4s 5h]
Dealt to 845fb6fd 
Dealt to dfc7c90a 
Dealt to ca47437 
Dealt to 4d7c3654 
dfc7c90a: folds
ca47437: folds
4d7c3654: raises $0.15 to $0.25
56fe61f7: folds
Hero: folds
845fb6fd: folds
Uncalled bet ($0.15) returned to 4d7c3654
*** SHOWDOWN ***
4d7c3654 collected $0.25 from pot
*** SUMMARY ***
Total pot $0.25 | Rake $0 | Jackpot $0 | Bingo $0 | Fortune $0
Seat 1: 56fe61f7 (button) folded before Flop (didn't bet)
Seat 2: Hero (small blind) folded before Flop
Seat 3: 845fb6fd (big blind) folded before Flop
Seat 4: dfc7c90a folded before Flop (didn't bet)
Seat 5: ca47437 folded before Flop (didn't bet)
Seat 6: 4d7c3654 collected ($0.25)


Poker Hand #RC1459868979: Hold'em No Limit  ($0.05/$0.1) - 2023/04/08 20:16:22
Table 'RushAndCash3764239' 6-max Seat #1 is the button
Seat 1: ec6ca311 ($17.25 in chips)
Seat 2: f7d69424 ($8.31 in chips)
Seat 3: 5355a1a2 ($22.91 in chips)
Seat 4: 2fe03fd0 ($13.11 in chips)
Seat 5: 2c26b728 ($10.55 in chips)
Seat 6: Hero ($5.96 in chips)
f7d69424: posts small blind $0.05
5355a1a2: posts big blind $0.1
*** HOLE CARDS ***
Dealt to ec6ca311 
Dealt to f7d69424 
Dealt to 5355a1a2 
Dealt to 2fe03fd0 
Dealt to 2c26b728 
Dealt to Hero [5s 4s]
2fe03fd0: folds
2c26b728: folds
Hero: raises $0.15 to $0.25
ec6ca311: folds
f7d69424: folds
5355a1a2: raises $0.79 to $1.04
Hero: folds
Uncalled bet ($0.79) returned to 5355a1a2
*** SHOWDOWN ***
5355a1a2 collected $0.53 from pot
*** SUMMARY ***
Total pot $0.55 | Rake $0.02 | Jackpot $0 | Bingo $0 | Fortune $0
Seat 1: ec6ca311 (button) folded before Flop (didn't bet)
Seat 2: f7d69424 (small blind) folded before Flop
Seat 3: 5355a1a2 (big blind) collected ($0.53)
Seat 4: 2fe03fd0 folded before Flop (didn't bet)
Seat 5: 2c26b728 folded before Flop (didn't bet)
Seat 6: Hero folded before Flop


Poker Hand #RC1459868850: Hold'em No Limit  ($0.05/$0.1) - 2023/04/08 20:16:01
Table 'RushAndCash3764110' 6-max Seat #1 is the button
Seat 1: 551d9a48 ($11.42 in chips)
Seat 2: 6ad16dc4 ($10.05 in chips)
Seat 3: Hero ($5.91 in chips)
Seat 4: bf9dc4c2 ($38.6 in chips)
Seat 5: 4988181b ($11.17 in chips)
Seat 6: b579d5c8 ($22.51 in chips)
6ad16dc4: posts small blind $0.05
Hero: posts big blind $0.1
*** HOLE CARDS ***
Dealt to 551d9a48 
Dealt to 6ad16dc4 
Dealt to Hero [5h 9s]
Dealt to bf9dc4c2 
Dealt to 4988181b 
Dealt to b579d5c8 
bf9dc4c2: folds
4988181b: folds
b579d5c8: folds
551d9a48: folds
6ad16dc4: folds
Uncalled bet ($0.05) returned to Hero
*** SHOWDOWN ***
Hero collected $0.1 from pot
*** SUMMARY ***
Total pot $0.1 | Rake $0 | Jackpot $0 | Bingo $0 | Fortune $0
Seat 1: 551d9a48 (button) folded before Flop (didn't bet)
Seat 2: 6ad16dc4 (small blind) folded before Flop
Seat 3: Hero (big blind) collected ($0.1)
Seat 4: bf9dc4c2 folded before Flop (didn't bet)
Seat 5: 4988181b folded before Flop (didn't bet)
Seat 6: b579d5c8 folded before Flop (didn't bet)


Poker Hand #RC1459868818: Hold'em No Limit  ($0.05/$0.1) - 2023/04/08 20:15:56
Table 'RushAndCash3764078' 6-max Seat #1 is the button
Seat 1: a4f17ab8 ($12.14 in chips)
Seat 2: 7565f2ab ($10.17 in chips)
Seat 3: f982bfe1 ($11.73 in chips)
Seat 4: 875bd886 ($10.21 in chips)
Seat 5: Hero ($5.91 in chips)
Seat 6: ed2461d3 ($27.05 in chips)
7565f2ab: posts small blind $0.05
f982bfe1: posts big blind $0.1
*** HOLE CARDS ***
Dealt to a4f17ab8 
Dealt to 7565f2ab 
Dealt to f982bfe1 
Dealt to 875bd886 
Dealt to Hero [7c 2c]
Dealt to ed2461d3 
875bd886: folds
Hero: folds
ed2461d3: folds
a4f17ab8: raises $0.1 to $0.2
7565f2ab: folds
f982bfe1: folds
Uncalled bet ($0.1) returned to a4f17ab8
*** SHOWDOWN ***
a4f17ab8 collected $0.25 from pot
*** SUMMARY ***
Total pot $0.25 | Rake $0 | Jackpot $0 | Bingo $0 | Fortune $0
Seat 1: a4f17ab8 (button) collected ($0.25)
Seat 2: 7565f2ab (small blind) folded before Flop
Seat 3: f982bfe1 (big blind) folded before Flop
Seat 4: 875bd886 folded before Flop (didn't bet)
Seat 5: Hero folded before Flop (didn't bet)
Seat 6: ed2461d3 folded before Flop (didn't bet)


Poker Hand #RC1459868796: Hold'em No Limit  ($0.05/$0.1) - 2023/04/08 20:15:51
Table 'RushAndCash3764056' 6-max Seat #1 is the button
Seat 1: Hero ($5.91 in chips)
Seat 2: fff78e2 ($13.09 in chips)
Seat 3: 583bb900 ($22.95 in chips)
Seat 4: f53cdad ($34.24 in chips)
Seat 5: b79a8f2a ($14.94 in chips)
Seat 6: 10cb5d98 ($2.65 in chips)
fff78e2: posts small blind $0.05
583bb900: posts big blind $0.1
*** HOLE CARDS ***
Dealt to Hero [6h Ks]
Dealt to fff78e2 
Dealt to 583bb900 
Dealt to f53cdad 
Dealt to b79a8f2a 
Dealt to 10cb5d98 
f53cdad: folds
b79a8f2a: folds
10cb5d98: raises $0.15 to $0.25
Hero: folds
fff78e2: folds
583bb900: folds
Uncalled bet ($0.15) returned to 10cb5d98
*** SHOWDOWN ***
10cb5d98 collected $0.25 from pot
*** SUMMARY ***
Total pot $0.25 | Rake $0 | Jackpot $0 | Bingo $0 | Fortune $0
Seat 1: Hero (button) folded before Flop (didn't bet)
Seat 2: fff78e2 (small blind) folded before Flop
Seat 3: 583bb900 (big blind) folded before Flop
Seat 4: f53cdad folded before Flop (didn't bet)
Seat 5: b79a8f2a folded before Flop (didn't bet)
Seat 6: 10cb5d98 collected ($0.25)


Poker Hand #RC1459868767: Hold'em No Limit  ($0.05/$0.1) - 2023/04/08 20:15:46
Table 'RushAndCash3764027' 6-max Seat #1 is the button
Seat 1: 80d1a4b2 ($17.67 in chips)
Seat 2: 3368ae52 ($10.28 in chips)
Seat 3: 1abb994b ($11.04 in chips)
Seat 4: 845fb6fd ($23.01 in chips)
Seat 5: Hero ($5.91 in chips)
Seat 6: 732de4a8 ($10.15 in chips)
3368ae52: posts small blind $0.05
1abb994b: posts big blind $0.1
*** HOLE CARDS ***
Dealt to 80d1a4b2 
Dealt to 3368ae52 
Dealt to 1abb994b 
Dealt to 845fb6fd 
Dealt to Hero [Kd 7c]
Dealt to 732de4a8 
845fb6fd: folds
Hero: folds
732de4a8: raises $0.15 to $0.25
80d1a4b2: folds
3368ae52: folds
1abb994b: folds
Uncalled bet ($0.15) returned to 732de4a8
*** SHOWDOWN ***
732de4a8 collected $0.25 from pot
*** SUMMARY ***
Total pot $0.25 | Rake $0 | Jackpot $0 | Bingo $0 | Fortune $0
Seat 1: 80d1a4b2 (button) folded before Flop (didn't bet)
Seat 2: 3368ae52 (small blind) folded before Flop
Seat 3: 1abb994b (big blind) folded before Flop
Seat 4: 845fb6fd folded before Flop (didn't bet)
Seat 5: Hero folded before Flop (didn't bet)
Seat 6: 732de4a8 collected ($0.25)


Poker Hand #RC1459868741: Hold'em No Limit  ($0.05/$0.1) - 2023/04/08 20:15:41
Table 'RushAndCash3764001' 6-max Seat #1 is the button
Seat 1: 666a6bfc ($19.65 in chips)
Seat 2: fbee46f4 ($12.57 in chips)
Seat 3: Hero ($6.01 in chips)
Seat 4: 29a17827 ($10.39 in chips)
Seat 5: f7d69424 ($8.46 in chips)
Seat 6: 2f7d31ea ($34.74 in chips)
fbee46f4: posts small blind $0.05
Hero: posts big blind $0.1
*** HOLE CARDS ***
Dealt to 666a6bfc 
Dealt to fbee46f4 
Dealt to Hero [6h 3h]
Dealt to 29a17827 
Dealt to f7d69424 
Dealt to 2f7d31ea 
29a17827: raises $0.2 to $0.3
f7d69424: folds
2f7d31ea: folds
666a6bfc: folds
fbee46f4: calls $0.25
Hero: folds
*** FLOP *** [2d 5c 5s]
fbee46f4: checks
29a17827: bets $0.35
fbee46f4: calls $0.35
*** TURN *** [2d 5c 5s] [6c]
fbee46f4: checks
29a17827: checks
*** RIVER *** [2d 5c 5s 6c] [Ts]
fbee46f4: checks
29a17827: checks
fbee46f4: shows [Qh Ah] (Pair of Fives)
29a17827: shows [Kc As] (Pair of Fives)
*** SHOWDOWN ***
29a17827 collected $1.33 from pot
*** SUMMARY ***
Total pot $1.4 | Rake $0.07 | Jackpot $0 | Bingo $0 | Fortune $0
Board [2d 5c 5s 6c Ts]
Seat 1: 666a6bfc (button) folded before Flop (didn't bet)
Seat 2: fbee46f4 (small blind) showed [Qh Ah] and lost with Pair of Fives
Seat 3: Hero (big blind) folded before Flop
Seat 4: 29a17827 showed [Kc As] and won ($1.33) with Pair of Fives
Seat 5: f7d69424 folded before Flop (didn't bet)
Seat 6: 2f7d31ea folded before Flop (didn't bet)


Poker Hand #RC1459868716: Hold'em No Limit  ($0.05/$0.1) - 2023/04/08 20:15:37
Table 'RushAndCash3763976' 6-max Seat #1 is the button
Seat 1: Hero ($6.01 in chips)
Seat 2: e0b3c9ec ($10.79 in chips)
Seat 3: 403e5430 ($14.47 in chips)
Seat 4: c3c0fb7f ($11.45 in chips)
Seat 5: 163b9118 ($12.75 in chips)
Seat 6: 87bc60ab ($18.92 in chips)
e0b3c9ec: posts small blind $0.05
403e5430: posts big blind $0.1
*** HOLE CARDS ***
Dealt to Hero [8d 3s]
Dealt to e0b3c9ec 
Dealt to 403e5430 
Dealt to c3c0fb7f 
Dealt to 163b9118 
Dealt to 87bc60ab 
c3c0fb7f: folds
163b9118: folds
87bc60ab: folds
Hero: folds
e0b3c9ec: raises $0.2 to $0.3
403e5430: raises $0.2 to $0.5
e0b3c9ec: raises $1 to $1.5
403e5430: calls $1
*** FLOP *** [Qs Ah 5s]
e0b3c9ec: checks
403e5430: bets $1.5
e0b3c9ec: raises $3 to $4.5
403e5430: calls $3
*** TURN *** [Qs Ah 5s] [4s]
e0b3c9ec: bets $4.79 and is all-in
403e5430: calls $4.79
e0b3c9ec: shows [Ac Ad] (Three Aces)
403e5430: shows [Qc As] (Pair of Aces and Pair of Queens)
*** RIVER *** [Qs Ah 5s 4s] [Tc]
*** SHOWDOWN ***
e0b3c9ec collected $21.13 from pot
*** SUMMARY ***
Total pot $21.58 | Rake $0.3 | Jackpot $0.15 | Bingo $0 | Fortune $0
Board [Qs Ah 5s 4s Tc]
Seat 1: Hero (button) folded before Flop (didn't bet)
Seat 2: e0b3c9ec (small blind) showed [Ac Ad] and won ($21.13) with Three Aces
Seat 3: 403e5430 (big blind) showed [Qc As] and lost with Pair of Aces and Pair of Queens
Seat 4: c3c0fb7f folded before Flop (didn't bet)
Seat 5: 163b9118 folded before Flop (didn't bet)
Seat 6: 87bc60ab folded before Flop (didn't bet)


Poker Hand #RC1459868685: Hold'em No Limit  ($0.05/$0.1) - 2023/04/08 20:15:31
Table 'RushAndCash3763945' 6-max Seat #1 is the button
Seat 1: 867e0a9c ($13.7 in chips)
Seat 2: 5297cb95 ($11.7 in chips)
Seat 3: 84bb602d ($12.28 in chips)
Seat 4: adb4e172 ($12.45 in chips)
Seat 5: Hero ($6.01 in chips)
Seat 6: 20e4e3ed ($17.54 in chips)
5297cb95: posts small blind $0.05
84bb602d: posts big blind $0.1
*** HOLE CARDS ***
Dealt to 867e0a9c 
Dealt to 5297cb95 
Dealt to 84bb602d 
Dealt to adb4e172 
Dealt to Hero [Ad 3h]
Dealt to 20e4e3ed 
adb4e172: folds
Hero: folds
20e4e3ed: raises $0.15 to $0.25
867e0a9c: folds
5297cb95: raises $0.75 to $1
84bb602d: folds
20e4e3ed: calls $0.75
*** FLOP *** [6c Jc Js]
5297cb95: bets $0.7
20e4e3ed: calls $0.7
*** TURN *** [6c Jc Js] [9s]
5297cb95: bets $2.63
20e4e3ed: folds
Uncalled bet ($2.63) returned to 5297cb95
*** SHOWDOWN ***
5297cb95 collected $3.19 from pot
*** SUMMARY ***
Total pot $3.5 | Rake $0.16 | Jackpot $0.15 | Bingo $0 | Fortune $0
Board [6c Jc Js 9s]
Seat 1: 867e0a9c (button) folded before Flop (didn't bet)
Seat 2: 5297cb95 (small blind) won ($3.19)
Seat 3: 84bb602d (big blind) folded before Flop
Seat 4: adb4e172 folded before Flop (didn't bet)
Seat 5: Hero folded before Flop (didn't bet)
Seat 6: 20e4e3ed folded on the Turn


Poker Hand #RC1459868624: Hold'em No Limit  ($0.05/$0.1) - 2023/04/08 20:15:20
Table 'RushAndCash3763884' 6-max Seat #1 is the button
Seat 1: ef3bd8db ($10.15 in chips)
Seat 2: Hero ($6.06 in chips)
Seat 3: 88006615 ($11.73 in chips)
Seat 4: f452404a ($10.81 in chips)
Seat 5: 17e4c517 ($18.78 in chips)
Seat 6: 5ef07beb ($9.78 in chips)
Hero: posts small blind $0.05
88006615: posts big blind $0.1
*** HOLE CARDS ***
Dealt to ef3bd8db 
Dealt to Hero [Qs 9c]
Dealt to 88006615 
Dealt to f452404a 
Dealt to 17e4c517 
Dealt to 5ef07beb 
f452404a: raises $0.15 to $0.25
17e4c517: raises $0.5 to $0.75
5ef07beb: folds
ef3bd8db: folds
Hero: folds
88006615: folds
f452404a: folds
Uncalled bet ($0.5) returned to 17e4c517
*** SHOWDOWN ***
17e4c517 collected $0.62 from pot
*** SUMMARY ***
Total pot $0.65 | Rake $0.03 | Jackpot $0 | Bingo $0 | Fortune $0
Seat 1: ef3bd8db (button) folded before Flop (didn't bet)
Seat 2: Hero (small blind) folded before Flop
Seat 3: 88006615 (big blind) folded before Flop
Seat 4: f452404a folded before Flop
Seat 5: 17e4c517 collected ($0.62)
Seat 6: 5ef07beb folded before Flop (didn't bet)


Poker Hand #RC1459868418: Hold'em No Limit  ($0.05/$0.1) - 2023/04/08 20:14:45
Table 'RushAndCash3763678' 6-max Seat #1 is the button
Seat 1: f452404a ($10 in chips)
Seat 2: 6bf4bfde ($4.45 in chips)
Seat 3: 83b2c8f1 ($10.19 in chips)
Seat 4: Hero ($6.8 in chips)
Seat 5: 6dd8c518 ($11.84 in chips)
Seat 6: f18ec573 ($30.61 in chips)
6bf4bfde: posts small blind $0.05
83b2c8f1: posts big blind $0.1
*** HOLE CARDS ***
Dealt to f452404a 
Dealt to 6bf4bfde 
Dealt to 83b2c8f1 
Dealt to Hero [Kh Qd]
Dealt to 6dd8c518 
Dealt to f18ec573 
Hero: raises $0.15 to $0.25
6dd8c518: folds
f18ec573: folds
f452404a: raises $0.49 to $0.74
6bf4bfde: folds
83b2c8f1: folds
Hero: calls $0.49
*** FLOP *** [Th 7h Ts]
Hero: checks
f452404a: bets $0.54
Hero: folds
Uncalled bet ($0.54) returned to f452404a
*** SHOWDOWN ***
f452404a collected $1.55 from pot
*** SUMMARY ***
Total pot $1.63 | Rake $0.08 | Jackpot $0 | Bingo $0 | Fortune $0
Board [Th 7h Ts]
Seat 1: f452404a (button) won ($1.55)
Seat 2: 6bf4bfde (small blind) folded before Flop
Seat 3: 83b2c8f1 (big blind) folded before Flop
Seat 4: Hero folded on the Flop
Seat 5: 6dd8c518 folded before Flop (didn't bet)
Seat 6: f18ec573 folded before Flop (didn't bet)


Poker Hand #RC1459868367: Hold'em No Limit  ($0.05/$0.1) - 2023/04/08 20:14:37
Table 'RushAndCash3763627' 6-max Seat #1 is the button
Seat 1: 18e279a4 ($56.41 in chips)
Seat 2: Hero ($6.85 in chips)
Seat 3: 6d5b11f0 ($10 in chips)
Seat 4: 3cc996d4 ($10 in chips)
Seat 5: 83b2c8f1 ($10.19 in chips)
Seat 6: aad9256b ($10.05 in chips)
Hero: posts small blind $0.05
6d5b11f0: posts big blind $0.1
*** HOLE CARDS ***
Dealt to 18e279a4 
Dealt to Hero [8h 5s]
Dealt to 6d5b11f0 
Dealt to 3cc996d4 
Dealt to 83b2c8f1 
Dealt to aad9256b 
3cc996d4: folds
83b2c8f1: folds
aad9256b: folds
18e279a4: raises $0.15 to $0.25
Hero: folds
6d5b11f0: folds
Uncalled bet ($0.15) returned to 18e279a4
*** SHOWDOWN ***
18e279a4 collected $0.25 from pot
*** SUMMARY ***
Total pot $0.25 | Rake $0 | Jackpot $0 | Bingo $0 | Fortune $0
Seat 1: 18e279a4 (button) collected ($0.25)
Seat 2: Hero (small blind) folded before Flop
Seat 3: 6d5b11f0 (big blind) folded before Flop
Seat 4: 3cc996d4 folded before Flop (didn't bet)
Seat 5: 83b2c8f1 folded before Flop (didn't bet)
Seat 6: aad9256b folded before Flop (didn't bet)


Poker Hand #RC1459868323: Hold'em No Limit  ($0.05/$0.1) - 2023/04/08 20:14:28
Table 'RushAndCash3763583' 6-max Seat #1 is the button
Seat 1: Hero ($6.85 in chips)
Seat 2: fa1722a8 ($14.97 in chips)
Seat 3: a5829bf8 ($9.16 in chips)
Seat 4: ba360497 ($10.27 in chips)
Seat 5: 99aef936 ($6.26 in chips)
Seat 6: 76069ee8 ($15.04 in chips)
fa1722a8: posts small blind $0.05
a5829bf8: posts big blind $0.1
*** HOLE CARDS ***
Dealt to Hero [Td 2d]
Dealt to fa1722a8 
Dealt to a5829bf8 
Dealt to ba360497 
Dealt to 99aef936 
Dealt to 76069ee8 
ba360497: folds
99aef936: folds
76069ee8: raises $0.15 to $0.25
Hero: folds
fa1722a8: raises $0.47 to $0.72
a5829bf8: folds
76069ee8: folds
Uncalled bet ($0.47) returned to fa1722a8
*** SHOWDOWN ***
fa1722a8 collected $0.57 from pot
*** SUMMARY ***
Total pot $0.6 | Rake $0.03 | Jackpot $0 | Bingo $0 | Fortune $0
Seat 1: Hero (button) folded before Flop (didn't bet)
Seat 2: fa1722a8 (small blind) collected ($0.57)
Seat 3: a5829bf8 (big blind) folded before Flop
Seat 4: ba360497 folded before Flop (didn't bet)
Seat 5: 99aef936 folded before Flop (didn't bet)
Seat 6: 76069ee8 folded before Flop


Poker Hand #RC1459868290: Hold'em No Limit  ($0.05/$0.1) - 2023/04/08 20:14:23
Table 'RushAndCash3763550' 6-max Seat #1 is the button
Seat 1: 859eb237 ($23.68 in chips)
Seat 2: 3acdf15 ($10 in chips)
Seat 3: Hero ($6.95 in chips)
Seat 4: 457142b5 ($13.94 in chips)
Seat 5: 5f8acb5f ($10 in chips)
Seat 6: fff78e2 ($13.34 in chips)
3acdf15: posts small blind $0.05
Hero: posts big blind $0.1
*** HOLE CARDS ***
Dealt to 859eb237 
Dealt to 3acdf15 
Dealt to Hero [4d 8c]
Dealt to 457142b5 
Dealt to 5f8acb5f 
Dealt to fff78e2 
457142b5: raises $0.14 to $0.24
5f8acb5f: folds
fff78e2: folds
859eb237: folds
3acdf15: folds
Hero: folds
Uncalled bet ($0.14) returned to 457142b5
*** SHOWDOWN ***
457142b5 collected $0.25 from pot
*** SUMMARY ***
Total pot $0.25 | Rake $0 | Jackpot $0 | Bingo $0 | Fortune $0
Seat 1: 859eb237 (button) folded before Flop (didn't bet)
Seat 2: 3acdf15 (small blind) folded before Flop
Seat 3: Hero (big blind) folded before Flop
Seat 4: 457142b5 collected ($0.25)
Seat 5: 5f8acb5f folded before Flop (didn't bet)
Seat 6: fff78e2 folded before Flop (didn't bet)


Poker Hand #RC1459868259: Hold'em No Limit  ($0.05/$0.1) - 2023/04/08 20:14:17
Table 'RushAndCash3763519' 6-max Seat #1 is the button
Seat 1: ef3bd8db ($10 in chips)
Seat 2: 2e2255e7 ($10.52 in chips)
Seat 3: 457142b5 ($14.04 in chips)
Seat 4: fe74b7c3 ($11.74 in chips)
Seat 5: Hero ($6.95 in chips)
Seat 6: d81ea08f ($20.88 in chips)
2e2255e7: posts small blind $0.05
457142b5: posts big blind $0.1
*** HOLE CARDS ***
Dealt to ef3bd8db 
Dealt to 2e2255e7 
Dealt to 457142b5 
Dealt to fe74b7c3 
Dealt to Hero [Ts 5s]
Dealt to d81ea08f 
fe74b7c3: raises $0.2 to $0.3
Hero: folds
d81ea08f: folds
ef3bd8db: calls $0.3
2e2255e7: folds
457142b5: folds
*** FLOP *** [8s Ks 7h]
fe74b7c3: bets $0.38
ef3bd8db: folds
Uncalled bet ($0.38) returned to fe74b7c3
*** SHOWDOWN ***
fe74b7c3 collected $0.72 from pot
*** SUMMARY ***
Total pot $0.75 | Rake $0.03 | Jackpot $0 | Bingo $0 | Fortune $0
Board [8s Ks 7h]
Seat 1: ef3bd8db (button) folded on the Flop
Seat 2: 2e2255e7 (small blind) folded before Flop
Seat 3: 457142b5 (big blind) folded before Flop
Seat 4: fe74b7c3 won ($0.72)
Seat 5: Hero folded before Flop (didn't bet)
Seat 6: d81ea08f folded before Flop (didn't bet)


Poker Hand #RC1459868220: Hold'em No Limit  ($0.05/$0.1) - 2023/04/08 20:14:10
Table 'RushAndCash3763480' 6-max Seat #1 is the button
Seat 1: f7d69424 ($8.21 in chips)
Seat 2: 54f59ada ($12.87 in chips)
Seat 3: dce49951 ($19.64 in chips)
Seat 4: a89f9b32 ($10.18 in chips)
Seat 5: Hero ($6.95 in chips)
Seat 6: a951861a ($27.5 in chips)
54f59ada: posts small blind $0.05
dce49951: posts big blind $0.1
*** HOLE CARDS ***
Dealt to f7d69424 
Dealt to 54f59ada 
Dealt to dce49951 
Dealt to a89f9b32 
Dealt to Hero [Kc 4c]
Dealt to a951861a 
a89f9b32: folds
Hero: folds
a951861a: raises $0.17 to $0.27
f7d69424: calls $0.27
54f59ada: folds
dce49951: calls $0.17
*** FLOP *** [Jc 3c 5d]
dce49951: checks
a951861a: checks
f7d69424: bets $0.43
dce49951: folds
a951861a: folds
Uncalled bet ($0.43) returned to f7d69424
*** SHOWDOWN ***
f7d69424 collected $0.82 from pot
*** SUMMARY ***
Total pot $0.86 | Rake $0.04 | Jackpot $0 | Bingo $0 | Fortune $0
Board [Jc 3c 5d]
Seat 1: f7d69424 (button) won ($0.82)
Seat 2: 54f59ada (small blind) folded before Flop
Seat 3: dce49951 (big blind) folded on the Flop
Seat 4: a89f9b32 folded before Flop (didn't bet)
Seat 5: Hero folded before Flop (didn't bet)
Seat 6: a951861a folded on the Flop


Poker Hand #RC1459868189: Hold'em No Limit  ($0.05/$0.1) - 2023/04/08 20:14:05
Table 'RushAndCash3763449' 6-max Seat #1 is the button
Seat 1: 3acdf15 ($10 in chips)
Seat 2: ad402a2 ($6.83 in chips)
Seat 3: 5d1fdaa2 ($10.98 in chips)
Seat 4: Hero ($6.95 in chips)
Seat 5: c7f92a51 ($18.28 in chips)
Seat 6: 31f2a64d ($9.78 in chips)
ad402a2: posts small blind $0.05
5d1fdaa2: posts big blind $0.1
*** HOLE CARDS ***
Dealt to 3acdf15 
Dealt to ad402a2 
Dealt to 5d1fdaa2 
Dealt to Hero [2c 9s]
Dealt to c7f92a51 
Dealt to 31f2a64d 
Hero: folds
c7f92a51: raises $0.15 to $0.25
31f2a64d: folds
3acdf15: folds
ad402a2: folds
5d1fdaa2: folds
Uncalled bet ($0.15) returned to c7f92a51
*** SHOWDOWN ***
c7f92a51 collected $0.25 from pot
*** SUMMARY ***
Total pot $0.25 | Rake $0 | Jackpot $0 | Bingo $0 | Fortune $0
Seat 1: 3acdf15 (button) folded before Flop (didn't bet)
Seat 2: ad402a2 (small blind) folded before Flop
Seat 3: 5d1fdaa2 (big blind) folded before Flop
Seat 4: Hero folded before Flop (didn't bet)
Seat 5: c7f92a51 collected ($0.25)
Seat 6: 31f2a64d folded before Flop (didn't bet)


Poker Hand #RC1459868158: Hold'em No Limit  ($0.05/$0.1) - 2023/04/08 20:14:00
Table 'RushAndCash3763418' 6-max Seat #1 is the button
Seat 1: a32d35d6 ($11 in chips)
Seat 2: 70be4eb ($10 in chips)
Seat 3: 84bb602d ($12.28 in chips)
Seat 4: ce8eee04 ($5.41 in chips)
Seat 5: Hero ($6.95 in chips)
Seat 6: d8910378 ($8.63 in chips)
70be4eb: posts small blind $0.05
84bb602d: posts big blind $0.1
*** HOLE CARDS ***
Dealt to a32d35d6 
Dealt to 70be4eb 
Dealt to 84bb602d 
Dealt to ce8eee04 
Dealt to Hero [3s 8s]
Dealt to d8910378 
ce8eee04: folds
Hero: folds
d8910378: folds
a32d35d6: folds
70be4eb: folds
Uncalled bet ($0.05) returned to 84bb602d
*** SHOWDOWN ***
84bb602d collected $0.1 from pot
*** SUMMARY ***
Total pot $0.1 | Rake $0 | Jackpot $0 | Bingo $0 | Fortune $0
Seat 1: a32d35d6 (button) folded before Flop (didn't bet)
Seat 2: 70be4eb (small blind) folded before Flop
Seat 3: 84bb602d (big blind) collected ($0.1)
Seat 4: ce8eee04 folded before Flop (didn't bet)
Seat 5: Hero folded before Flop (didn't bet)
Seat 6: d8910378 folded before Flop (didn't bet)


Poker Hand #RC1459868133: Hold'em No Limit  ($0.05/$0.1) - 2023/04/08 20:13:56
Table 'RushAndCash3763393' 6-max Seat #1 is the button
Seat 1: 851d66df ($8.19 in chips)
Seat 2: 233f552d ($24.38 in chips)
Seat 3: e6f8b112 ($18.07 in chips)
Seat 4: f7d69424 ($8.21 in chips)
Seat 5: ce8eee04 ($5.41 in chips)
Seat 6: Hero ($6.95 in chips)
233f552d: posts small blind $0.05
e6f8b112: posts big blind $0.1
*** HOLE CARDS ***
Dealt to 851d66df 
Dealt to 233f552d 
Dealt to e6f8b112 
Dealt to f7d69424 
Dealt to ce8eee04 
Dealt to Hero [4h Jc]
f7d69424: folds
ce8eee04: folds
Hero: folds
851d66df: raises $0.12 to $0.22
233f552d: folds
e6f8b112: raises $0.98 to $1.2
851d66df: calls $0.98
*** FLOP *** [4d 9c Qd]
e6f8b112: checks
851d66df: checks
*** TURN *** [4d 9c Qd] [3d]
e6f8b112: checks
851d66df: checks
*** RIVER *** [4d 9c Qd 3d] [2h]
e6f8b112: checks
851d66df: checks
e6f8b112: shows [5s 7s] (Queen-High)
851d66df: shows [Th Ah] (Ace-High)
*** SHOWDOWN ***
851d66df collected $2.33 from pot
*** SUMMARY ***
Total pot $2.45 | Rake $0.12 | Jackpot $0 | Bingo $0 | Fortune $0
Board [4d 9c Qd 3d 2h]
Seat 1: 851d66df (button) showed [Th Ah] and won ($2.33) with Ace-High
Seat 2: 233f552d (small blind) folded before Flop
Seat 3: e6f8b112 (big blind) showed [5s 7s] and lost with Queen-High
Seat 4: f7d69424 folded before Flop (didn't bet)
Seat 5: ce8eee04 folded before Flop (didn't bet)
Seat 6: Hero folded before Flop (didn't bet)


Poker Hand #RC1459868043: Hold'em No Limit  ($0.05/$0.1) - 2023/04/08 20:13:40
Table 'RushAndCash3763303' 6-max Seat #1 is the button
Seat 1: e0bfbef3 ($11.89 in chips)
Seat 2: 87bc60ab ($19.72 in chips)
Seat 3: 6dd8c518 ($11.71 in chips)
Seat 4: 5663e5da ($10 in chips)
Seat 5: Hero ($6.95 in chips)
Seat 6: 5f8acb5f ($10 in chips)
87bc60ab: posts small blind $0.05
6dd8c518: posts big blind $0.1
*** HOLE CARDS ***
Dealt to e0bfbef3 
Dealt to 87bc60ab 
Dealt to 6dd8c518 
Dealt to 5663e5da 
Dealt to Hero [Kd Tc]
Dealt to 5f8acb5f 
5663e5da: folds
Hero: folds
5f8acb5f: raises $0.15 to $0.25
e0bfbef3: raises $0.65 to $0.9
87bc60ab: folds
6dd8c518: folds
5f8acb5f: folds
Uncalled bet ($0.65) returned to e0bfbef3
*** SHOWDOWN ***
e0bfbef3 collected $0.62 from pot
*** SUMMARY ***
Total pot $0.65 | Rake $0.03 | Jackpot $0 | Bingo $0 | Fortune $0
Seat 1: e0bfbef3 (button) collected ($0.62)
Seat 2: 87bc60ab (small blind) folded before Flop
Seat 3: 6dd8c518 (big blind) folded before Flop
Seat 4: 5663e5da folded before Flop (didn't bet)
Seat 5: Hero folded before Flop (didn't bet)
Seat 6: 5f8acb5f folded before Flop


Poker Hand #RC1459867973: Hold'em No Limit  ($0.05/$0.1) - 2023/04/08 20:13:27
Table 'RushAndCash3763233' 6-max Seat #1 is the button
Seat 1: Hero ($6.8 in chips)
Seat 2: dfc7c90a ($9.14 in chips)
Seat 3: f7d69424 ($8.51 in chips)
Seat 4: 62dc1925 ($10.1 in chips)
Seat 5: 60a2c7ea ($21.78 in chips)
Seat 6: 3368ae52 ($10 in chips)
dfc7c90a: posts small blind $0.05
f7d69424: posts big blind $0.1
*** HOLE CARDS ***
Dealt to Hero [3h Ah]
Dealt to dfc7c90a 
Dealt to f7d69424 
Dealt to 62dc1925 
Dealt to 60a2c7ea 
Dealt to 3368ae52 
62dc1925: folds
60a2c7ea: folds
3368ae52: folds
Hero: raises $0.15 to $0.25
dfc7c90a: folds
f7d69424: folds
Uncalled bet ($0.15) returned to Hero
*** SHOWDOWN ***
Hero collected $0.25 from pot
*** SUMMARY ***
Total pot $0.25 | Rake $0 | Jackpot $0 | Bingo $0 | Fortune $0
Seat 1: Hero (button) collected ($0.25)
Seat 2: dfc7c90a (small blind) folded before Flop
Seat 3: f7d69424 (big blind) folded before Flop
Seat 4: 62dc1925 folded before Flop (didn't bet)
Seat 5: 60a2c7ea folded before Flop (didn't bet)
Seat 6: 3368ae52 folded before Flop (didn't bet)


Poker Hand #RC1459867908: Hold'em No Limit  ($0.05/$0.1) - 2023/04/08 20:13:15
Table 'RushAndCash3763168' 6-max Seat #1 is the button
Seat 1: 500fa304 ($46.12 in chips)
Seat 2: ad9785 ($27.75 in chips)
Seat 3: Hero ($6.75 in chips)
Seat 4: 8eafc83b ($10 in chips)
Seat 5: d81ea08f ($20.93 in chips)
Seat 6: 90d93d63 ($10 in chips)
ad9785: posts small blind $0.05
Hero: posts big blind $0.1
*** HOLE CARDS ***
Dealt to 500fa304 
Dealt to ad9785 
Dealt to Hero [Qd 5s]
Dealt to 8eafc83b 
Dealt to d81ea08f 
Dealt to 90d93d63 
8eafc83b: folds
d81ea08f: folds
90d93d63: folds
500fa304: folds
ad9785: folds
Uncalled bet ($0.05) returned to Hero
*** SHOWDOWN ***
Hero collected $0.1 from pot
*** SUMMARY ***
Total pot $0.1 | Rake $0 | Jackpot $0 | Bingo $0 | Fortune $0
Seat 1: 500fa304 (button) folded before Flop (didn't bet)
Seat 2: ad9785 (small blind) folded before Flop
Seat 3: Hero (big blind) collected ($0.1)
Seat 4: 8eafc83b folded before Flop (didn't bet)
Seat 5: d81ea08f folded before Flop (didn't bet)
Seat 6: 90d93d63 folded before Flop (didn't bet)


Poker Hand #RC1459867750: Hold'em No Limit  ($0.05/$0.1) - 2023/04/08 20:12:44
Table 'RushAndCash3763010' 6-max Seat #1 is the button
Seat 1: d81ea08f ($19.75 in chips)
Seat 2: Hero ($7.95 in chips)
Seat 3: dc78130f ($25.74 in chips)
Seat 4: 8eafc83b ($10 in chips)
Seat 5: f067e67b ($29.92 in chips)
Seat 6: 99aef936 ($14.14 in chips)
Hero: posts small blind $0.05
dc78130f: posts big blind $0.1
*** HOLE CARDS ***
Dealt to d81ea08f 
Dealt to Hero [Ad Qc]
Dealt to dc78130f 
Dealt to 8eafc83b 
Dealt to f067e67b 
Dealt to 99aef936 
8eafc83b: folds
f067e67b: folds
99aef936: folds
d81ea08f: raises $0.2 to $0.3
Hero: raises $0.9 to $1.2
dc78130f: folds
d81ea08f: raises $18.55 to $19.75 and is all-in
Hero: folds
Uncalled bet ($18.55) returned to d81ea08f
*** SHOWDOWN ***
d81ea08f collected $2.38 from pot
*** SUMMARY ***
Total pot $2.5 | Rake $0.12 | Jackpot $0 | Bingo $0 | Fortune $0
Seat 1: d81ea08f (button) collected ($2.38)
Seat 2: Hero (small blind) folded before Flop
Seat 3: dc78130f (big blind) folded before Flop
Seat 4: 8eafc83b folded before Flop (didn't bet)
Seat 5: f067e67b folded before Flop (didn't bet)
Seat 6: 99aef936 folded before Flop (didn't bet)


Poker Hand #RC1459867710: Hold'em No Limit  ($0.05/$0.1) - 2023/04/08 20:12:37
Table 'RushAndCash3762970' 6-max Seat #1 is the button
Seat 1: cd80bf76 ($22.94 in chips)
Seat 2: d0b73ea6 ($14 in chips)
Seat 3: 1b79f37c ($11.19 in chips)
Seat 4: 8967e899 ($10.3 in chips)
Seat 5: Hero ($7.95 in chips)
Seat 6: b311bb8e ($10.04 in chips)
d0b73ea6: posts small blind $0.05
1b79f37c: posts big blind $0.1
*** HOLE CARDS ***
Dealt to cd80bf76 
Dealt to d0b73ea6 
Dealt to 1b79f37c 
Dealt to 8967e899 
Dealt to Hero [2d 3h]
Dealt to b311bb8e 
8967e899: folds
Hero: folds
b311bb8e: folds
cd80bf76: folds
d0b73ea6: folds
Uncalled bet ($0.05) returned to 1b79f37c
*** SHOWDOWN ***
1b79f37c collected $0.1 from pot
*** SUMMARY ***
Total pot $0.1 | Rake $0 | Jackpot $0 | Bingo $0 | Fortune $0
Seat 1: cd80bf76 (button) folded before Flop (didn't bet)
Seat 2: d0b73ea6 (small blind) folded before Flop
Seat 3: 1b79f37c (big blind) collected ($0.1)
Seat 4: 8967e899 folded before Flop (didn't bet)
Seat 5: Hero folded before Flop (didn't bet)
Seat 6: b311bb8e folded before Flop (didn't bet)


Poker Hand #RC1459867604: Hold'em No Limit  ($0.05/$0.1) - 2023/04/08 20:12:18
Table 'RushAndCash3762864' 6-max Seat #1 is the button
Seat 1: b342ae3f ($13.81 in chips)
Seat 2: f05ce810 ($10 in chips)
Seat 3: 4691fa1e ($10.65 in chips)
Seat 4: 34bdb0c8 ($10.9 in chips)
Seat 5: 5b07b7ed ($10 in chips)
Seat 6: Hero ($7.58 in chips)
f05ce810: posts small blind $0.05
4691fa1e: posts big blind $0.1
*** HOLE CARDS ***
Dealt to b342ae3f 
Dealt to f05ce810 
Dealt to 4691fa1e 
Dealt to 34bdb0c8 
Dealt to 5b07b7ed 
Dealt to Hero [8h 8c]
34bdb0c8: folds
5b07b7ed: raises $0.15 to $0.25
Hero: raises $0.55 to $0.8
b342ae3f: folds
f05ce810: folds
4691fa1e: folds
5b07b7ed: folds
Uncalled bet ($0.55) returned to Hero
*** SHOWDOWN ***
Hero collected $0.62 from pot
*** SUMMARY ***
Total pot $0.65 | Rake $0.03 | Jackpot $0 | Bingo $0 | Fortune $0
Seat 1: b342ae3f (button) folded before Flop (didn't bet)
Seat 2: f05ce810 (small blind) folded before Flop
Seat 3: 4691fa1e (big blind) folded before Flop
Seat 4: 34bdb0c8 folded before Flop (didn't bet)
Seat 5: 5b07b7ed folded before Flop
Seat 6: Hero collected ($0.62)


Poker Hand #RC1459867493: Hold'em No Limit  ($0.05/$0.1) - 2023/04/08 20:11:57
Table 'RushAndCash3762753' 6-max Seat #1 is the button
Seat 1: Hero ($7.43 in chips)
Seat 2: 851d66df ($8.77 in chips)
Seat 3: 29278a24 ($23.97 in chips)
Seat 4: 52d59703 ($13.21 in chips)
Seat 5: 8113ce85 ($10 in chips)
Seat 6: 4bcea642 ($5.18 in chips)
851d66df: posts small blind $0.05
29278a24: posts big blind $0.1
*** HOLE CARDS ***
Dealt to Hero [6d 5d]
Dealt to 851d66df 
Dealt to 29278a24 
Dealt to 52d59703 
Dealt to 8113ce85 
Dealt to 4bcea642 
52d59703: folds
8113ce85: folds
4bcea642: folds
Hero: raises $0.15 to $0.25
851d66df: folds
29278a24: folds
Uncalled bet ($0.15) returned to Hero
*** SHOWDOWN ***
Hero collected $0.25 from pot
*** SUMMARY ***
Total pot $0.25 | Rake $0 | Jackpot $0 | Bingo $0 | Fortune $0
Seat 1: Hero (button) collected ($0.25)
Seat 2: 851d66df (small blind) folded before Flop
Seat 3: 29278a24 (big blind) folded before Flop
Seat 4: 52d59703 folded before Flop (didn't bet)
Seat 5: 8113ce85 folded before Flop (didn't bet)
Seat 6: 4bcea642 folded before Flop (didn't bet)


Poker Hand #RC1459867411: Hold'em No Limit  ($0.05/$0.1) - 2023/04/08 20:11:42
Table 'RushAndCash3762671' 6-max Seat #1 is the button
Seat 1: 7f57e0f9 ($150.06 in chips)
Seat 2: 2f7d31ea ($33.42 in chips)
Seat 3: Hero ($7.53 in chips)
Seat 4: a6064f96 ($10.51 in chips)
Seat 5: 2590fb03 ($10 in chips)
Seat 6: 95ad258d ($12.41 in chips)
2f7d31ea: posts small blind $0.05
Hero: posts big blind $0.1
*** HOLE CARDS ***
Dealt to 7f57e0f9 
Dealt to 2f7d31ea 
Dealt to Hero [Qd 5d]
Dealt to a6064f96 
Dealt to 2590fb03 
Dealt to 95ad258d 
a6064f96: folds
2590fb03: folds
95ad258d: raises $0.15 to $0.25
7f57e0f9: folds
2f7d31ea: folds
Hero: folds
Uncalled bet ($0.15) returned to 95ad258d
*** SHOWDOWN ***
95ad258d collected $0.25 from pot
*** SUMMARY ***
Total pot $0.25 | Rake $0 | Jackpot $0 | Bingo $0 | Fortune $0
Seat 1: 7f57e0f9 (button) folded before Flop (didn't bet)
Seat 2: 2f7d31ea (small blind) folded before Flop
Seat 3: Hero (big blind) folded before Flop
Seat 4: a6064f96 folded before Flop (didn't bet)
Seat 5: 2590fb03 folded before Flop (didn't bet)
Seat 6: 95ad258d collected ($0.25)


Poker Hand #RC1459866797: Hold'em No Limit  ($0.05/$0.1) - 2023/04/08 20:09:55
Table 'RushAndCash3762057' 6-max Seat #1 is the button
Seat 1: f369b709 ($18.68 in chips)
Seat 2: Hero ($16.88 in chips)
Seat 3: 10cb5d98 ($4.95 in chips)
Seat 4: 238ede5a ($12.39 in chips)
Seat 5: f1bae32 ($20 in chips)
Seat 6: eaf57a38 ($31.67 in chips)
Hero: posts small blind $0.05
10cb5d98: posts big blind $0.1
*** HOLE CARDS ***
Dealt to f369b709 
Dealt to Hero [As Js]
Dealt to 10cb5d98 
Dealt to 238ede5a 
Dealt to f1bae32 
Dealt to eaf57a38 
238ede5a: folds
f1bae32: folds
eaf57a38: raises $0.1 to $0.2
f369b709: folds
Hero: raises $0.6 to $0.8
10cb5d98: folds
eaf57a38: calls $0.6
*** FLOP *** [Ts 2d Jh]
Hero: bets $0.85
eaf57a38: calls $0.85
*** TURN *** [Ts 2d Jh] [8d]
Hero: bets $1.7
eaf57a38: calls $1.7
*** RIVER *** [Ts 2d Jh 8d] [5c]
Hero: bets $2
eaf57a38: raises $4 to $6
Hero: calls $4
eaf57a38: shows [2s 2c] (Three Twos)
Hero: shows [As Js] (Pair of Jacks)
*** SHOWDOWN ***
eaf57a38 collected $18.35 from pot
*** SUMMARY ***
Total pot $18.8 | Rake $0.3 | Jackpot $0.15 | Bingo $0 | Fortune $0
Board [Ts 2d Jh 8d 5c]
Seat 1: f369b709 (button) folded before Flop (didn't bet)
Seat 2: Hero (small blind) showed [As Js] and lost with Pair of Jacks
Seat 3: 10cb5d98 (big blind) folded before Flop
Seat 4: 238ede5a folded before Flop (didn't bet)
Seat 5: f1bae32 folded before Flop (didn't bet)
Seat 6: eaf57a38 showed [2s 2c] and won ($18.35) with Three Twos


Poker Hand #RC1459866712: Hold'em No Limit  ($0.05/$0.1) - 2023/04/08 20:09:40
Table 'RushAndCash3761972' 6-max Seat #1 is the button
Seat 1: ab1b4f5c ($14.35 in chips)
Seat 2: ebe6df25 ($10.05 in chips)
Seat 3: 58568431 ($37.63 in chips)
Seat 4: Hero ($16.88 in chips)
Seat 5: 702ae42e ($13.1 in chips)
Seat 6: c0442f11 ($15.49 in chips)
ebe6df25: posts small blind $0.05
58568431: posts big blind $0.1
*** HOLE CARDS ***
Dealt to ab1b4f5c 
Dealt to ebe6df25 
Dealt to 58568431 
Dealt to Hero [Qh 7d]
Dealt to 702ae42e 
Dealt to c0442f11 
Hero: folds
702ae42e: folds
c0442f11: folds
ab1b4f5c: folds
ebe6df25: folds
Uncalled bet ($0.05) returned to 58568431
*** SHOWDOWN ***
58568431 collected $0.1 from pot
*** SUMMARY ***
Total pot $0.1 | Rake $0 | Jackpot $0 | Bingo $0 | Fortune $0
Seat 1: ab1b4f5c (button) folded before Flop (didn't bet)
Seat 2: ebe6df25 (small blind) folded before Flop
Seat 3: 58568431 (big blind) collected ($0.1)
Seat 4: Hero folded before Flop (didn't bet)
Seat 5: 702ae42e folded before Flop (didn't bet)
Seat 6: c0442f11 folded before Flop (didn't bet)


Poker Hand #RC1459866637: Hold'em No Limit  ($0.05/$0.1) - 2023/04/08 20:09:28
Table 'RushAndCash3761897' 6-max Seat #1 is the button
Seat 1: 4988181b ($10.1 in chips)
Seat 2: 657904b6 ($4.91 in chips)
Seat 3: be2592f5 ($10.84 in chips)
Seat 4: 39acc71d ($12.41 in chips)
Seat 5: eaf57a38 ($31.52 in chips)
Seat 6: Hero ($16.73 in chips)
657904b6: posts small blind $0.05
be2592f5: posts big blind $0.1
*** HOLE CARDS ***
Dealt to 4988181b 
Dealt to 657904b6 
Dealt to be2592f5 
Dealt to 39acc71d 
Dealt to eaf57a38 
Dealt to Hero [As Qc]
39acc71d: folds
eaf57a38: folds
Hero: raises $0.15 to $0.25
4988181b: folds
657904b6: folds
be2592f5: folds
Uncalled bet ($0.15) returned to Hero
*** SHOWDOWN ***
Hero collected $0.25 from pot
*** SUMMARY ***
Total pot $0.25 | Rake $0 | Jackpot $0 | Bingo $0 | Fortune $0
Seat 1: 4988181b (button) folded before Flop (didn't bet)
Seat 2: 657904b6 (small blind) folded before Flop
Seat 3: be2592f5 (big blind) folded before Flop
Seat 4: 39acc71d folded before Flop (didn't bet)
Seat 5: eaf57a38 folded before Flop (didn't bet)
Seat 6: Hero collected ($0.25)


Poker Hand #RC1459866596: Hold'em No Limit  ($0.05/$0.1) - 2023/04/08 20:09:21
Table 'RushAndCash3761856' 6-max Seat #1 is the button
Seat 1: d0e9527b ($10 in chips)
Seat 2: dce49951 ($19.69 in chips)
Seat 3: adb4e172 ($13.84 in chips)
Seat 4: 6a138b47 ($23.26 in chips)
Seat 5: 81206ee ($9.89 in chips)
Seat 6: Hero ($16.73 in chips)
dce49951: posts small blind $0.05
adb4e172: posts big blind $0.1
*** HOLE CARDS ***
Dealt to d0e9527b 
Dealt to dce49951 
Dealt to adb4e172 
Dealt to 6a138b47 
Dealt to 81206ee 
Dealt to Hero [Ah 5c]
6a138b47: raises $0.1 to $0.2
81206ee: folds
Hero: folds
d0e9527b: folds
dce49951: folds
adb4e172: calls $0.1
*** FLOP *** [Qh 7h 8c]
adb4e172: checks
6a138b47: bets $0.2
adb4e172: folds
Uncalled bet ($0.2) returned to 6a138b47
*** SHOWDOWN ***
6a138b47 collected $0.43 from pot
*** SUMMARY ***
Total pot $0.45 | Rake $0.02 | Jackpot $0 | Bingo $0 | Fortune $0
Board [Qh 7h 8c]
Seat 1: d0e9527b (button) folded before Flop (didn't bet)
Seat 2: dce49951 (small blind) folded before Flop
Seat 3: adb4e172 (big blind) folded on the Flop
Seat 4: 6a138b47 won ($0.43)
Seat 5: 81206ee folded before Flop (didn't bet)
Seat 6: Hero folded before Flop (didn't bet)


Poker Hand #RC1459866573: Hold'em No Limit  ($0.05/$0.1) - 2023/04/08 20:09:17
Table 'RushAndCash3761833' 6-max Seat #1 is the button
Seat 1: fa2c2cc3 ($10 in chips)
Seat 2: d2e1c7ab ($13.05 in chips)
Seat 3: f7d69424 ($9.47 in chips)
Seat 4: Hero ($16.73 in chips)
Seat 5: 7f57e0f9 ($149.68 in chips)
Seat 6: e489763f ($9.8 in chips)
d2e1c7ab: posts small blind $0.05
f7d69424: posts big blind $0.1
*** HOLE CARDS ***
Dealt to fa2c2cc3 
Dealt to d2e1c7ab 
Dealt to f7d69424 
Dealt to Hero [Qc 3s]
Dealt to 7f57e0f9 
Dealt to e489763f 
Hero: folds
7f57e0f9: folds
e489763f: raises $0.1 to $0.2
fa2c2cc3: folds
d2e1c7ab: folds
f7d69424: folds
Uncalled bet ($0.1) returned to e489763f
*** SHOWDOWN ***
e489763f collected $0.25 from pot
*** SUMMARY ***
Total pot $0.25 | Rake $0 | Jackpot $0 | Bingo $0 | Fortune $0
Seat 1: fa2c2cc3 (button) folded before Flop (didn't bet)
Seat 2: d2e1c7ab (small blind) folded before Flop
Seat 3: f7d69424 (big blind) folded before Flop
Seat 4: Hero folded before Flop (didn't bet)
Seat 5: 7f57e0f9 folded before Flop (didn't bet)
Seat 6: e489763f collected ($0.25)


Poker Hand #RC1459866539: Hold'em No Limit  ($0.05/$0.1) - 2023/04/08 20:09:11
Table 'RushAndCash3761799' 6-max Seat #1 is the button
Seat 1: 4ce13ecd ($7.07 in chips)
Seat 2: b8f000db ($10 in chips)
Seat 3: b96d280 ($10.8 in chips)
Seat 4: Hero ($16.73 in chips)
Seat 5: 17e4c517 ($6.53 in chips)
Seat 6: 1b2691d2 ($14.54 in chips)
b8f000db: posts small blind $0.05
b96d280: posts big blind $0.1
*** HOLE CARDS ***
Dealt to 4ce13ecd 
Dealt to b8f000db 
Dealt to b96d280 
Dealt to Hero [Qd Th]
Dealt to 17e4c517 
Dealt to 1b2691d2 
Hero: folds
17e4c517: raises $0.2 to $0.3
1b2691d2: folds
4ce13ecd: folds
b8f000db: calls $0.25
b96d280: calls $0.2
*** FLOP *** [6s 4s Ac]
b8f000db: checks
b96d280: checks
17e4c517: checks
*** TURN *** [6s 4s Ac] [9h]
b8f000db: bets $0.45
b96d280: raises $0.8 to $1.25
17e4c517: folds
b8f000db: calls $0.8
*** RIVER *** [6s 4s Ac 9h] [8c]
b8f000db: checks
b96d280: bets $2.25
b8f000db: raises $6.2 to $8.45 and is all-in
b96d280: folds
Uncalled bet ($6.2) returned to b8f000db
*** SHOWDOWN ***
b8f000db collected $7.45 from pot
*** SUMMARY ***
Total pot $7.9 | Rake $0.3 | Jackpot $0.15 | Bingo $0 | Fortune $0
Board [6s 4s Ac 9h 8c]
Seat 1: 4ce13ecd (button) folded before Flop (didn't bet)
Seat 2: b8f000db (small blind) won ($7.45)
Seat 3: b96d280 (big blind) folded on the River
Seat 4: Hero folded before Flop (didn't bet)
Seat 5: 17e4c517 folded on the Turn
Seat 6: 1b2691d2 folded before Flop (didn't bet)


Poker Hand #RC1459866513: Hold'em No Limit  ($0.05/$0.1) - 2023/04/08 20:09:07
Table 'RushAndCash3761773' 6-max Seat #1 is the button
Seat 1: 3054a0bf ($10.42 in chips)
Seat 2: 193f4d25 ($12.02 in chips)
Seat 3: Hero ($16.83 in chips)
Seat 4: 4278ea69 ($10.34 in chips)
Seat 5: f9c0e377 ($27.45 in chips)
Seat 6: 2a44e667 ($10.07 in chips)
193f4d25: posts small blind $0.05
Hero: posts big blind $0.1
*** HOLE CARDS ***
Dealt to 3054a0bf 
Dealt to 193f4d25 
Dealt to Hero [Qh 2s]
Dealt to 4278ea69 
Dealt to f9c0e377 
Dealt to 2a44e667 
4278ea69: folds
f9c0e377: folds
2a44e667: raises $0.2 to $0.3
3054a0bf: calls $0.3
193f4d25: folds
Hero: folds
*** FLOP *** [8h 7d Jh]
2a44e667: checks
3054a0bf: bets $0.6
2a44e667: folds
Uncalled bet ($0.6) returned to 3054a0bf
*** SHOWDOWN ***
3054a0bf collected $0.72 from pot
*** SUMMARY ***
Total pot $0.75 | Rake $0.03 | Jackpot $0 | Bingo $0 | Fortune $0
Board [8h 7d Jh]
Seat 1: 3054a0bf (button) won ($0.72)
Seat 2: 193f4d25 (small blind) folded before Flop
Seat 3: Hero (big blind) folded before Flop
Seat 4: 4278ea69 folded before Flop (didn't bet)
Seat 5: f9c0e377 folded before Flop (didn't bet)
Seat 6: 2a44e667 folded on the Flop


Poker Hand #RC1459866292: Hold'em No Limit  ($0.05/$0.1) - 2023/04/08 20:08:34
Table 'RushAndCash3761552' 6-max Seat #1 is the button
Seat 1: e3f695fc ($12.87 in chips)
Seat 2: Hero ($16.29 in chips)
Seat 3: 4d7c3654 ($10 in chips)
Seat 4: 45152e70 ($16.29 in chips)
Seat 5: bb0e2d3 ($10 in chips)
Seat 6: 4278ea69 ($10.49 in chips)
Hero: posts small blind $0.05
4d7c3654: posts big blind $0.1
*** HOLE CARDS ***
Dealt to e3f695fc 
Dealt to Hero [6c 4c]
Dealt to 4d7c3654 
Dealt to 45152e70 
Dealt to bb0e2d3 
Dealt to 4278ea69 
45152e70: folds
bb0e2d3: folds
4278ea69: folds
e3f695fc: folds
Hero: raises $0.2 to $0.3
4d7c3654: calls $0.2
*** FLOP *** [9s 6s 6d]
Hero: checks
4d7c3654: bets $0.3
Hero: raises $0.6 to $0.9
4d7c3654: folds
Uncalled bet ($0.6) returned to Hero
*** SHOWDOWN ***
Hero collected $1.14 from pot
*** SUMMARY ***
Total pot $1.2 | Rake $0.06 | Jackpot $0 | Bingo $0 | Fortune $0
Board [9s 6s 6d]
Seat 1: e3f695fc (button) folded before Flop (didn't bet)
Seat 2: Hero (small blind) won ($1.14)
Seat 3: 4d7c3654 (big blind) folded on the Flop
Seat 4: 45152e70 folded before Flop (didn't bet)
Seat 5: bb0e2d3 folded before Flop (didn't bet)
Seat 6: 4278ea69 folded before Flop (didn't bet)


Poker Hand #RC1459866243: Hold'em No Limit  ($0.05/$0.1) - 2023/04/08 20:08:25
Table 'RushAndCash3761503' 6-max Seat #1 is the button
Seat 1: ad685734 ($11.21 in chips)
Seat 2: 7a3e4c38 ($11.04 in chips)
Seat 3: cacd032a ($15.42 in chips)
Seat 4: Hero ($16.29 in chips)
Seat 5: 3054a0bf ($10 in chips)
Seat 6: 373964a6 ($10.34 in chips)
7a3e4c38: posts small blind $0.05
cacd032a: posts big blind $0.1
*** HOLE CARDS ***
Dealt to ad685734 
Dealt to 7a3e4c38 
Dealt to cacd032a 
Dealt to Hero [Ad 5s]
Dealt to 3054a0bf 
Dealt to 373964a6 
Hero: folds
3054a0bf: folds
373964a6: folds
ad685734: raises $0.14 to $0.24
7a3e4c38: folds
cacd032a: folds
Uncalled bet ($0.14) returned to ad685734
*** SHOWDOWN ***
ad685734 collected $0.25 from pot
*** SUMMARY ***
Total pot $0.25 | Rake $0 | Jackpot $0 | Bingo $0 | Fortune $0
Seat 1: ad685734 (button) collected ($0.25)
Seat 2: 7a3e4c38 (small blind) folded before Flop
Seat 3: cacd032a (big blind) folded before Flop
Seat 4: Hero folded before Flop (didn't bet)
Seat 5: 3054a0bf folded before Flop (didn't bet)
Seat 6: 373964a6 folded before Flop (didn't bet)


Poker Hand #RC1459866216: Hold'em No Limit  ($0.05/$0.1) - 2023/04/08 20:08:19
Table 'RushAndCash3761476' 6-max Seat #1 is the button
Seat 1: 800d12f4 ($13.63 in chips)
Seat 2: 80361c9f ($10.48 in chips)
Seat 3: f0bb503d ($9.01 in chips)
Seat 4: Hero ($16.29 in chips)
Seat 5: 5ef92a1f ($10.27 in chips)
Seat 6: 62eb6051 ($23.17 in chips)
80361c9f: posts small blind $0.05
f0bb503d: posts big blind $0.1
*** HOLE CARDS ***
Dealt to 800d12f4 
Dealt to 80361c9f 
Dealt to f0bb503d 
Dealt to Hero [Ts 6h]
Dealt to 5ef92a1f 
Dealt to 62eb6051 
Hero: folds
5ef92a1f: raises $0.15 to $0.25
62eb6051: folds
800d12f4: folds
80361c9f: folds
f0bb503d: folds
Uncalled bet ($0.15) returned to 5ef92a1f
*** SHOWDOWN ***
5ef92a1f collected $0.25 from pot
*** SUMMARY ***
Total pot $0.25 | Rake $0 | Jackpot $0 | Bingo $0 | Fortune $0
Seat 1: 800d12f4 (button) folded before Flop (didn't bet)
Seat 2: 80361c9f (small blind) folded before Flop
Seat 3: f0bb503d (big blind) folded before Flop
Seat 4: Hero folded before Flop (didn't bet)
Seat 5: 5ef92a1f collected ($0.25)
Seat 6: 62eb6051 folded before Flop (didn't bet)


Poker Hand #RC1459866053: Hold'em No Limit  ($0.05/$0.1) - 2023/04/08 20:07:50
Table 'RushAndCash3761313' 6-max Seat #1 is the button
Seat 1: b6746050 ($73.59 in chips)
Seat 2: Hero ($16.54 in chips)
Seat 3: 800d12f4 ($13.4 in chips)
Seat 4: f7d69424 ($9.62 in chips)
Seat 5: 1a0a123c ($33.19 in chips)
Seat 6: 545c097e ($10.7 in chips)
Hero: posts small blind $0.05
800d12f4: posts big blind $0.1
*** HOLE CARDS ***
Dealt to b6746050 
Dealt to Hero [2s Qh]
Dealt to 800d12f4 
Dealt to f7d69424 
Dealt to 1a0a123c 
Dealt to 545c097e 
f7d69424: folds
1a0a123c: folds
545c097e: folds
b6746050: folds
Hero: raises $0.15 to $0.25
800d12f4: raises $0.75 to $1
Hero: folds
Uncalled bet ($0.75) returned to 800d12f4
*** SHOWDOWN ***
800d12f4 collected $0.48 from pot
*** SUMMARY ***
Total pot $0.5 | Rake $0.02 | Jackpot $0 | Bingo $0 | Fortune $0
Seat 1: b6746050 (button) folded before Flop (didn't bet)
Seat 2: Hero (small blind) folded before Flop
Seat 3: 800d12f4 (big blind) collected ($0.48)
Seat 4: f7d69424 folded before Flop (didn't bet)
Seat 5: 1a0a123c folded before Flop (didn't bet)
Seat 6: 545c097e folded before Flop (didn't bet)


Poker Hand #RC1459865964: Hold'em No Limit  ($0.05/$0.1) - 2023/04/08 20:07:37
Table 'RushAndCash3761224' 6-max Seat #1 is the button
Seat 1: db15d716 ($19.24 in chips)
Seat 2: ca5cf018 ($13.24 in chips)
Seat 3: Hero ($16.64 in chips)
Seat 4: 2261b544 ($10.99 in chips)
Seat 5: e489763f ($10.1 in chips)
Seat 6: 7bfc260f ($10.15 in chips)
ca5cf018: posts small blind $0.05
Hero: posts big blind $0.1
*** HOLE CARDS ***
Dealt to db15d716 
Dealt to ca5cf018 
Dealt to Hero [Qs 7h]
Dealt to 2261b544 
Dealt to e489763f 
Dealt to 7bfc260f 
2261b544: raises $0.15 to $0.25
e489763f: folds
7bfc260f: folds
db15d716: folds
ca5cf018: folds
Hero: folds
Uncalled bet ($0.15) returned to 2261b544
*** SHOWDOWN ***
2261b544 collected $0.25 from pot
*** SUMMARY ***
Total pot $0.25 | Rake $0 | Jackpot $0 | Bingo $0 | Fortune $0
Seat 1: db15d716 (button) folded before Flop (didn't bet)
Seat 2: ca5cf018 (small blind) folded before Flop
Seat 3: Hero (big blind) folded before Flop
Seat 4: 2261b544 collected ($0.25)
Seat 5: e489763f folded before Flop (didn't bet)
Seat 6: 7bfc260f folded before Flop (didn't bet)


Poker Hand #RC1459865907: Hold'em No Limit  ($0.05/$0.1) - 2023/04/08 20:07:29
Table 'RushAndCash3761167' 6-max Seat #1 is the button
Seat 1: Hero ($16.64 in chips)
Seat 2: 9b0fff42 ($14.88 in chips)
Seat 3: 2e2255e7 ($10.15 in chips)
Seat 4: e489763f ($10.2 in chips)
Seat 5: 2de4dd1f ($10 in chips)
Seat 6: b311bb8e ($11.37 in chips)
9b0fff42: posts small blind $0.05
2e2255e7: posts big blind $0.1
*** HOLE CARDS ***
Dealt to Hero [7h Jh]
Dealt to 9b0fff42 
Dealt to 2e2255e7 
Dealt to e489763f 
Dealt to 2de4dd1f 
Dealt to b311bb8e 
e489763f: folds
2de4dd1f: folds
b311bb8e: raises $0.2 to $0.3
Hero: folds
9b0fff42: folds
2e2255e7: folds
Uncalled bet ($0.2) returned to b311bb8e
*** SHOWDOWN ***
b311bb8e collected $0.25 from pot
*** SUMMARY ***
Total pot $0.25 | Rake $0 | Jackpot $0 | Bingo $0 | Fortune $0
Seat 1: Hero (button) folded before Flop (didn't bet)
Seat 2: 9b0fff42 (small blind) folded before Flop
Seat 3: 2e2255e7 (big blind) folded before Flop
Seat 4: e489763f folded before Flop (didn't bet)
Seat 5: 2de4dd1f folded before Flop (didn't bet)
Seat 6: b311bb8e collected ($0.25)


Poker Hand #RC1459865844: Hold'em No Limit  ($0.05/$0.1) - 2023/04/08 20:07:20
Table 'RushAndCash3761104' 6-max Seat #1 is the button
Seat 1: Hero ($16.64 in chips)
Seat 2: 1eb53111 ($7.72 in chips)
Seat 3: b579d5c8 ($23.81 in chips)
Seat 4: b1e0c6b6 ($10.02 in chips)
Seat 5: a8fbf7f7 ($6.66 in chips)
Seat 6: 85d9c84a ($10 in chips)
1eb53111: posts small blind $0.05
b579d5c8: posts big blind $0.1
*** HOLE CARDS ***
Dealt to Hero [5d 7s]
Dealt to 1eb53111 
Dealt to b579d5c8 
Dealt to b1e0c6b6 
Dealt to a8fbf7f7 
Dealt to 85d9c84a 
b1e0c6b6: folds
a8fbf7f7: raises $0.15 to $0.25
85d9c84a: raises $0.55 to $0.8
Hero: folds
1eb53111: folds
b579d5c8: folds
a8fbf7f7: calls $0.55
*** FLOP *** [7c Jh Ah]
a8fbf7f7: checks
85d9c84a: bets $0.58
a8fbf7f7: folds
Uncalled bet ($0.58) returned to 85d9c84a
*** SHOWDOWN ***
85d9c84a collected $1.67 from pot
*** SUMMARY ***
Total pot $1.75 | Rake $0.08 | Jackpot $0 | Bingo $0 | Fortune $0
Board [7c Jh Ah]
Seat 1: Hero (button) folded before Flop (didn't bet)
Seat 2: 1eb53111 (small blind) folded before Flop
Seat 3: b579d5c8 (big blind) folded before Flop
Seat 4: b1e0c6b6 folded before Flop (didn't bet)
Seat 5: a8fbf7f7 folded on the Flop
Seat 6: 85d9c84a won ($1.67)


Poker Hand #RC1459865701: Hold'em No Limit  ($0.05/$0.1) - 2023/04/08 20:06:58
Table 'RushAndCash3760961' 6-max Seat #1 is the button
Seat 1: 20e4e3ed ($17.24 in chips)
Seat 2: ad3b4285 ($12.29 in chips)
Seat 3: d0e9527b ($10.95 in chips)
Seat 4: 9ec053d2 ($40.99 in chips)
Seat 5: a8fbf7f7 ($6.81 in chips)
Seat 6: Hero ($16.49 in chips)
ad3b4285: posts small blind $0.05
d0e9527b: posts big blind $0.1
*** HOLE CARDS ***
Dealt to 20e4e3ed 
Dealt to ad3b4285 
Dealt to d0e9527b 
Dealt to 9ec053d2 
Dealt to a8fbf7f7 
Dealt to Hero [7d 6d]
9ec053d2: folds
a8fbf7f7: folds
Hero: raises $0.15 to $0.25
20e4e3ed: folds
ad3b4285: folds
d0e9527b: folds
Uncalled bet ($0.15) returned to Hero
*** SHOWDOWN ***
Hero collected $0.25 from pot
*** SUMMARY ***
Total pot $0.25 | Rake $0 | Jackpot $0 | Bingo $0 | Fortune $0
Seat 1: 20e4e3ed (button) folded before Flop (didn't bet)
Seat 2: ad3b4285 (small blind) folded before Flop
Seat 3: d0e9527b (big blind) folded before Flop
Seat 4: 9ec053d2 folded before Flop (didn't bet)
Seat 5: a8fbf7f7 folded before Flop (didn't bet)
Seat 6: Hero collected ($0.25)


Poker Hand #RC1459865262: Hold'em No Limit  ($0.05/$0.1) - 2023/04/08 20:05:46
Table 'RushAndCash3760522' 6-max Seat #1 is the button
Seat 1: 545c097e ($10.32 in chips)
Seat 2: 40125b6a ($8.96 in chips)
Seat 3: 1eb53111 ($8.6 in chips)
Seat 4: Hero ($13.82 in chips)
Seat 5: ba360497 ($10.15 in chips)
Seat 6: fe74b7c3 ($17.96 in chips)
40125b6a: posts small blind $0.05
1eb53111: posts big blind $0.1
*** HOLE CARDS ***
Dealt to 545c097e 
Dealt to 40125b6a 
Dealt to 1eb53111 
Dealt to Hero [Kd Ad]
Dealt to ba360497 
Dealt to fe74b7c3 
Hero: raises $0.15 to $0.25
ba360497: folds
fe74b7c3: calls $0.25
545c097e: folds
40125b6a: folds
1eb53111: folds
*** FLOP *** [Tc 8c Kh]
Hero: bets $0.43
fe74b7c3: calls $0.43
*** TURN *** [Tc 8c Kh] [3s]
Hero: bets $0.76
fe74b7c3: raises $1.52 to $2.28
Hero: calls $1.52
*** RIVER *** [Tc 8c Kh 3s] [3h]
Hero: checks
fe74b7c3: checks
Hero: shows [Kd Ad] (Pair of Kings and Pair of Treys)
fe74b7c3: shows [4c Kc] (Pair of Kings and Pair of Treys)
*** SHOWDOWN ***
Hero collected $5.63 from pot
*** SUMMARY ***
Total pot $6.07 | Rake $0.29 | Jackpot $0.15 | Bingo $0 | Fortune $0
Board [Tc 8c Kh 3s 3h]
Seat 1: 545c097e (button) folded before Flop (didn't bet)
Seat 2: 40125b6a (small blind) folded before Flop
Seat 3: 1eb53111 (big blind) folded before Flop
Seat 4: Hero showed [Kd Ad] and won ($5.63) with Pair of Kings and Pair of Treys
Seat 5: ba360497 folded before Flop (didn't bet)
Seat 6: fe74b7c3 showed [4c Kc] and lost with Pair of Kings and Pair of Treys


Poker Hand #RC1459865137: Hold'em No Limit  ($0.05/$0.1) - 2023/04/08 20:05:26
Table 'RushAndCash3760397' 6-max Seat #1 is the button
Seat 1: Hero ($14.07 in chips)
Seat 2: 545c097e ($10 in chips)
Seat 3: a5ddf956 ($24.81 in chips)
Seat 4: 8967e899 ($10.5 in chips)
Seat 5: 76069ee8 ($10 in chips)
Seat 6: 54d5ab2 ($12.61 in chips)
545c097e: posts small blind $0.05
a5ddf956: posts big blind $0.1
*** HOLE CARDS ***
Dealt to Hero [5s Ac]
Dealt to 545c097e 
Dealt to a5ddf956 
Dealt to 8967e899 
Dealt to 76069ee8 
Dealt to 54d5ab2 
8967e899: folds
76069ee8: folds
54d5ab2: folds
Hero: raises $0.15 to $0.25
545c097e: raises $0.75 to $1
a5ddf956: folds
Hero: folds
Uncalled bet ($0.75) returned to 545c097e
*** SHOWDOWN ***
545c097e collected $0.57 from pot
*** SUMMARY ***
Total pot $0.6 | Rake $0.03 | Jackpot $0 | Bingo $0 | Fortune $0
Seat 1: Hero (button) folded before Flop
Seat 2: 545c097e (small blind) collected ($0.57)
Seat 3: a5ddf956 (big blind) folded before Flop
Seat 4: 8967e899 folded before Flop (didn't bet)
Seat 5: 76069ee8 folded before Flop (didn't bet)
Seat 6: 54d5ab2 folded before Flop (didn't bet)


Poker Hand #RC1459865056: Hold'em No Limit  ($0.05/$0.1) - 2023/04/08 20:05:13
Table 'RushAndCash3760316' 6-max Seat #1 is the button
Seat 1: dc525443 ($33.29 in chips)
Seat 2: Hero ($14.12 in chips)
Seat 3: 9d55ce9b ($10.76 in chips)
Seat 4: 7f57e0f9 ($149.23 in chips)
Seat 5: 551d9a48 ($11.81 in chips)
Seat 6: 110937af ($10 in chips)
Hero: posts small blind $0.05
9d55ce9b: posts big blind $0.1
*** HOLE CARDS ***
Dealt to dc525443 
Dealt to Hero [4h 5d]
Dealt to 9d55ce9b 
Dealt to 7f57e0f9 
Dealt to 551d9a48 
Dealt to 110937af 
7f57e0f9: folds
551d9a48: folds
110937af: raises $0.12 to $0.22
dc525443: folds
Hero: folds
9d55ce9b: folds
Uncalled bet ($0.12) returned to 110937af
*** SHOWDOWN ***
110937af collected $0.25 from pot
*** SUMMARY ***
Total pot $0.25 | Rake $0 | Jackpot $0 | Bingo $0 | Fortune $0
Seat 1: dc525443 (button) folded before Flop (didn't bet)
Seat 2: Hero (small blind) folded before Flop
Seat 3: 9d55ce9b (big blind) folded before Flop
Seat 4: 7f57e0f9 folded before Flop (didn't bet)
Seat 5: 551d9a48 folded before Flop (didn't bet)
Seat 6: 110937af collected ($0.25)


Poker Hand #RC1459864989: Hold'em No Limit  ($0.05/$0.1) - 2023/04/08 20:05:02
Table 'RushAndCash3760249' 6-max Seat #1 is the button
Seat 1: 846e879f ($13.91 in chips)
Seat 2: Hero ($14.17 in chips)
Seat 3: 76e126c5 ($12.31 in chips)
Seat 4: 9c3d59f5 ($12.67 in chips)
Seat 5: f2def8dc ($11.77 in chips)
Seat 6: 93028ba3 ($10 in chips)
Hero: posts small blind $0.05
76e126c5: posts big blind $0.1
*** HOLE CARDS ***
Dealt to 846e879f 
Dealt to Hero [Kh 2d]
Dealt to 76e126c5 
Dealt to 9c3d59f5 
Dealt to f2def8dc 
Dealt to 93028ba3 
9c3d59f5: folds
f2def8dc: raises $0.14 to $0.24
93028ba3: raises $0.86 to $1.1
846e879f: folds
Hero: folds
76e126c5: folds
f2def8dc: calls $0.86
*** FLOP *** [9d 8h Qh]
f2def8dc: checks
93028ba3: bets $1.3
f2def8dc: calls $1.3
*** TURN *** [9d 8h Qh] [2h]
f2def8dc: checks
93028ba3: checks
*** RIVER *** [9d 8h Qh 2h] [Qd]
f2def8dc: checks
93028ba3: checks
f2def8dc: shows [Kc Qc] (Three Queens)
93028ba3: shows [Jc Js] (Pair of Queens and Pair of Jacks)
*** SHOWDOWN ***
f2def8dc collected $4.56 from pot
*** SUMMARY ***
Total pot $4.95 | Rake $0.24 | Jackpot $0.15 | Bingo $0 | Fortune $0
Board [9d 8h Qh 2h Qd]
Seat 1: 846e879f (button) folded before Flop (didn't bet)
Seat 2: Hero (small blind) folded before Flop
Seat 3: 76e126c5 (big blind) folded before Flop
Seat 4: 9c3d59f5 folded before Flop (didn't bet)
Seat 5: f2def8dc showed [Kc Qc] and won ($4.56) with Three Queens
Seat 6: 93028ba3 showed [Jc Js] and lost with Pair of Queens and Pair of Jacks


Poker Hand #RC1459864956: Hold'em No Limit  ($0.05/$0.1) - 2023/04/08 20:04:56
Table 'RushAndCash3760216' 6-max Seat #1 is the button
Seat 1: 4bcea642 ($10.52 in chips)
Seat 2: de3ead56 ($16.48 in chips)
Seat 3: Hero ($14.27 in chips)
Seat 4: b870bace ($9.76 in chips)
Seat 5: 8113ce85 ($10.05 in chips)
Seat 6: 3cc996d4 ($10.59 in chips)
de3ead56: posts small blind $0.05
Hero: posts big blind $0.1
*** HOLE CARDS ***
Dealt to 4bcea642 
Dealt to de3ead56 
Dealt to Hero [5d 6s]
Dealt to b870bace 
Dealt to 8113ce85 
Dealt to 3cc996d4 
b870bace: raises $0.1 to $0.2
8113ce85: folds
3cc996d4: folds
4bcea642: folds
de3ead56: folds
Hero: folds
Uncalled bet ($0.1) returned to b870bace
*** SHOWDOWN ***
b870bace collected $0.25 from pot
*** SUMMARY ***
Total pot $0.25 | Rake $0 | Jackpot $0 | Bingo $0 | Fortune $0
Seat 1: 4bcea642 (button) folded before Flop (didn't bet)
Seat 2: de3ead56 (small blind) folded before Flop
Seat 3: Hero (big blind) folded before Flop
Seat 4: b870bace collected ($0.25)
Seat 5: 8113ce85 folded before Flop (didn't bet)
Seat 6: 3cc996d4 folded before Flop (didn't bet)


Poker Hand #RC1459864767: Hold'em No Limit  ($0.05/$0.1) - 2023/04/08 20:04:27
Table 'RushAndCash3760027' 6-max Seat #1 is the button
Seat 1: f0bb503d ($8.55 in chips)
Seat 2: 1adff58e ($10.1 in chips)
Seat 3: Hero ($14.47 in chips)
Seat 4: b870bace ($9.53 in chips)
Seat 5: b579d5c8 ($20.56 in chips)
Seat 6: d728232d ($13.25 in chips)
1adff58e: posts small blind $0.05
Hero: posts big blind $0.1
*** HOLE CARDS ***
Dealt to f0bb503d 
Dealt to 1adff58e 
Dealt to Hero [Kh 7h]
Dealt to b870bace 
Dealt to b579d5c8 
Dealt to d728232d 
b870bace: raises $0.1 to $0.2
b579d5c8: folds
d728232d: folds
f0bb503d: folds
1adff58e: folds
Hero: calls $0.1
*** FLOP *** [8s Th Ac]
Hero: checks
b870bace: bets $0.23
Hero: folds
Uncalled bet ($0.23) returned to b870bace
*** SHOWDOWN ***
b870bace collected $0.43 from pot
*** SUMMARY ***
Total pot $0.45 | Rake $0.02 | Jackpot $0 | Bingo $0 | Fortune $0
Board [8s Th Ac]
Seat 1: f0bb503d (button) folded before Flop (didn't bet)
Seat 2: 1adff58e (small blind) folded before Flop
Seat 3: Hero (big blind) folded on the Flop
Seat 4: b870bace won ($0.43)
Seat 5: b579d5c8 folded before Flop (didn't bet)
Seat 6: d728232d folded before Flop (didn't bet)


Poker Hand #RC1459834732: Hold'em No Limit  ($0.05/$0.1) - 2023/04/08 20:04:22
Table 'RushAndCash3759992' 6-max Seat #1 is the button
Seat 1: f1bae32 ($15.25 in chips)
Seat 2: 238ede5a ($13.74 in chips)
Seat 3: 3d1f932f ($9.72 in chips)
Seat 4: Hero ($14.47 in chips)
Seat 5: 5d1fdaa2 ($10.2 in chips)
Seat 6: dc1c7fca ($10.13 in chips)
238ede5a: posts small blind $0.05
3d1f932f: posts big blind $0.1
*** HOLE CARDS ***
Dealt to f1bae32 
Dealt to 238ede5a 
Dealt to 3d1f932f 
Dealt to Hero [Ks Tc]
Dealt to 5d1fdaa2 
Dealt to dc1c7fca 
Hero: folds
5d1fdaa2: folds
dc1c7fca: folds
f1bae32: raises $0.15 to $0.25
238ede5a: folds
3d1f932f: folds
Uncalled bet ($0.15) returned to f1bae32
*** SHOWDOWN ***
f1bae32 collected $0.25 from pot
*** SUMMARY ***
Total pot $0.25 | Rake $0 | Jackpot $0 | Bingo $0 | Fortune $0
Seat 1: f1bae32 (button) collected ($0.25)
Seat 2: 238ede5a (small blind) folded before Flop
Seat 3: 3d1f932f (big blind) folded before Flop
Seat 4: Hero folded before Flop (didn't bet)
Seat 5: 5d1fdaa2 folded before Flop (didn't bet)
Seat 6: dc1c7fca folded before Flop (didn't bet)


Poker Hand #RC1459834513: Hold'em No Limit  ($0.05/$0.1) - 2023/04/08 20:03:48
Table 'RushAndCash3759773' 6-max Seat #1 is the button
Seat 1: e8dad1c8 ($40.63 in chips)
Seat 2: 3d1f932f ($9.97 in chips)
Seat 3: d2e1c7ab ($11.01 in chips)
Seat 4: 110937af ($10.15 in chips)
Seat 5: Hero ($14.15 in chips)
Seat 6: 9692459d ($34.2 in chips)
3d1f932f: posts small blind $0.05
d2e1c7ab: posts big blind $0.1
*** HOLE CARDS ***
Dealt to e8dad1c8 
Dealt to 3d1f932f 
Dealt to d2e1c7ab 
Dealt to 110937af 
Dealt to Hero [Jd Kh]
Dealt to 9692459d 
110937af: folds
Hero: raises $0.15 to $0.25
9692459d: folds
e8dad1c8: folds
3d1f932f: calls $0.2
d2e1c7ab: folds
*** FLOP *** [Kd 9c 8s]
3d1f932f: checks
Hero: bets $0.3
3d1f932f: folds
Uncalled bet ($0.3) returned to Hero
*** SHOWDOWN ***
Hero collected $0.57 from pot
*** SUMMARY ***
Total pot $0.6 | Rake $0.03 | Jackpot $0 | Bingo $0 | Fortune $0
Board [Kd 9c 8s]
Seat 1: e8dad1c8 (button) folded before Flop (didn't bet)
Seat 2: 3d1f932f (small blind) folded on the Flop
Seat 3: d2e1c7ab (big blind) folded before Flop
Seat 4: 110937af folded before Flop (didn't bet)
Seat 5: Hero won ($0.57)
Seat 6: 9692459d folded before Flop (didn't bet)


Poker Hand #RC1459834485: Hold'em No Limit  ($0.05/$0.1) - 2023/04/08 20:03:44
Table 'RushAndCash3759745' 6-max Seat #1 is the button
Seat 1: a4f17ab8 ($13.07 in chips)
Seat 2: 8a38d99 ($26.69 in chips)
Seat 3: 2cb7441a ($28.04 in chips)
Seat 4: 72dd4b8 ($18.25 in chips)
Seat 5: 110937af ($10.15 in chips)
Seat 6: Hero ($14.15 in chips)
8a38d99: posts small blind $0.05
2cb7441a: posts big blind $0.1
*** HOLE CARDS ***
Dealt to a4f17ab8 
Dealt to 8a38d99 
Dealt to 2cb7441a 
Dealt to 72dd4b8 
Dealt to 110937af 
Dealt to Hero [3s Qs]
72dd4b8: folds
110937af: folds
Hero: folds
a4f17ab8: folds
8a38d99: folds
Uncalled bet ($0.05) returned to 2cb7441a
*** SHOWDOWN ***
2cb7441a collected $0.1 from pot
*** SUMMARY ***
Total pot $0.1 | Rake $0 | Jackpot $0 | Bingo $0 | Fortune $0
Seat 1: a4f17ab8 (button) folded before Flop (didn't bet)
Seat 2: 8a38d99 (small blind) folded before Flop
Seat 3: 2cb7441a (big blind) collected ($0.1)
Seat 4: 72dd4b8 folded before Flop (didn't bet)
Seat 5: 110937af folded before Flop (didn't bet)
Seat 6: Hero folded before Flop (didn't bet)


Poker Hand #RC1459834368: Hold'em No Limit  ($0.05/$0.1) - 2023/04/08 20:03:27
Table 'RushAndCash3759628' 6-max Seat #1 is the button
Seat 1: 8ce97662 ($6.63 in chips)
Seat 2: 75d479dc ($10 in chips)
Seat 3: 18e279a4 ($41.16 in chips)
Seat 4: f4ea9ac9 ($10.3 in chips)
Seat 5: b5c87356 ($15.88 in chips)
Seat 6: Hero ($14.15 in chips)
75d479dc: posts small blind $0.05
18e279a4: posts big blind $0.1
*** HOLE CARDS ***
Dealt to 8ce97662 
Dealt to 75d479dc 
Dealt to 18e279a4 
Dealt to f4ea9ac9 
Dealt to b5c87356 
Dealt to Hero [7s 9h]
f4ea9ac9: raises $0.1 to $0.2
b5c87356: folds
Hero: folds
8ce97662: folds
75d479dc: folds
18e279a4: folds
Uncalled bet ($0.1) returned to f4ea9ac9
*** SHOWDOWN ***
f4ea9ac9 collected $0.25 from pot
*** SUMMARY ***
Total pot $0.25 | Rake $0 | Jackpot $0 | Bingo $0 | Fortune $0
Seat 1: 8ce97662 (button) folded before Flop (didn't bet)
Seat 2: 75d479dc (small blind) folded before Flop
Seat 3: 18e279a4 (big blind) folded before Flop
Seat 4: f4ea9ac9 collected ($0.25)
Seat 5: b5c87356 folded before Flop (didn't bet)
Seat 6: Hero folded before Flop (didn't bet)


Poker Hand #RC1459834317: Hold'em No Limit  ($0.05/$0.1) - 2023/04/08 20:03:19
Table 'RushAndCash3759577' 6-max Seat #1 is the button
Seat 1: Hero ($14.15 in chips)
Seat 2: 3e9216b5 ($8.13 in chips)
Seat 3: e69cddd7 ($11.33 in chips)
Seat 4: 2179eb74 ($11.25 in chips)
Seat 5: 845cd800 ($11.66 in chips)
Seat 6: 2cb7441a ($27.89 in chips)
3e9216b5: posts small blind $0.05
e69cddd7: posts big blind $0.1
*** HOLE CARDS ***
Dealt to Hero [Ah 2c]
Dealt to 3e9216b5 
Dealt to e69cddd7 
Dealt to 2179eb74 
Dealt to 845cd800 
Dealt to 2cb7441a 
2179eb74: raises $0.1 to $0.2
845cd800: folds
2cb7441a: folds
Hero: folds
3e9216b5: folds
e69cddd7: calls $0.1
*** FLOP *** [Qd 8d Js]
e69cddd7: checks
2179eb74: bets $0.24
e69cddd7: calls $0.24
*** TURN *** [Qd 8d Js] [Ac]
e69cddd7: checks
2179eb74: bets $0.69
e69cddd7: folds
Uncalled bet ($0.69) returned to 2179eb74
*** SHOWDOWN ***
2179eb74 collected $0.89 from pot
*** SUMMARY ***
Total pot $0.93 | Rake $0.04 | Jackpot $0 | Bingo $0 | Fortune $0
Board [Qd 8d Js Ac]
Seat 1: Hero (button) folded before Flop (didn't bet)
Seat 2: 3e9216b5 (small blind) folded before Flop
Seat 3: e69cddd7 (big blind) folded on the Turn
Seat 4: 2179eb74 won ($0.89)
Seat 5: 845cd800 folded before Flop (didn't bet)
Seat 6: 2cb7441a folded before Flop (didn't bet)


Poker Hand #RC1459834281: Hold'em No Limit  ($0.05/$0.1) - 2023/04/08 20:03:13
Table 'RushAndCash3759541' 6-max Seat #1 is the button
Seat 1: 587a017c ($110.61 in chips)
Seat 2: 7aede39c ($8.11 in chips)
Seat 3: 83034386 ($20.2 in chips)
Seat 4: Hero ($14.15 in chips)
Seat 5: 9d55ce9b ($10.76 in chips)
Seat 6: 45152e70 ($17.14 in chips)
7aede39c: posts small blind $0.05
83034386: posts big blind $0.1
*** HOLE CARDS ***
Dealt to 587a017c 
Dealt to 7aede39c 
Dealt to 83034386 
Dealt to Hero [3d 5h]
Dealt to 9d55ce9b 
Dealt to 45152e70 
Hero: folds
9d55ce9b: folds
45152e70: folds
587a017c: raises $0.15 to $0.25
7aede39c: folds
83034386: folds
Uncalled bet ($0.15) returned to 587a017c
*** SHOWDOWN ***
587a017c collected $0.25 from pot
*** SUMMARY ***
Total pot $0.25 | Rake $0 | Jackpot $0 | Bingo $0 | Fortune $0
Seat 1: 587a017c (button) collected ($0.25)
Seat 2: 7aede39c (small blind) folded before Flop
Seat 3: 83034386 (big blind) folded before Flop
Seat 4: Hero folded before Flop (didn't bet)
Seat 5: 9d55ce9b folded before Flop (didn't bet)
Seat 6: 45152e70 folded before Flop (didn't bet)


Poker Hand #RC1459834239: Hold'em No Limit  ($0.05/$0.1) - 2023/04/08 20:03:06
Table 'RushAndCash3759499' 6-max Seat #1 is the button
Seat 1: 25d2a795 ($7.64 in chips)
Seat 2: 6f09c065 ($8.58 in chips)
Seat 3: 74baa6a4 ($22.47 in chips)
Seat 4: 1a3b235e ($27.84 in chips)
Seat 5: Hero ($14.15 in chips)
Seat 6: c49a4612 ($26.37 in chips)
6f09c065: posts small blind $0.05
74baa6a4: posts big blind $0.1
*** HOLE CARDS ***
Dealt to 25d2a795 
Dealt to 6f09c065 
Dealt to 74baa6a4 
Dealt to 1a3b235e 
Dealt to Hero [8h Qc]
Dealt to c49a4612 
1a3b235e: folds
Hero: folds
c49a4612: folds
25d2a795: raises $0.1 to $0.2
6f09c065: folds
74baa6a4: raises $0.9 to $1.1
25d2a795: calls $0.9
*** FLOP *** [3s 4c 2d]
74baa6a4: bets $0.66
25d2a795: folds
Uncalled bet ($0.66) returned to 74baa6a4
*** SHOWDOWN ***
74baa6a4 collected $2.14 from pot
*** SUMMARY ***
Total pot $2.25 | Rake $0.11 | Jackpot $0 | Bingo $0 | Fortune $0
Board [3s 4c 2d]
Seat 1: 25d2a795 (button) folded on the Flop
Seat 2: 6f09c065 (small blind) folded before Flop
Seat 3: 74baa6a4 (big blind) won ($2.14)
Seat 4: 1a3b235e folded before Flop (didn't bet)
Seat 5: Hero folded before Flop (didn't bet)
Seat 6: c49a4612 folded before Flop (didn't bet)


Poker Hand #RC1459834041: Hold'em No Limit  ($0.05/$0.1) - 2023/04/08 20:02:34
Table 'RushAndCash3759301' 6-max Seat #1 is the button
Seat 1: Hero ($14.4 in chips)
Seat 2: c49a4612 ($26.05 in chips)
Seat 3: 556685d2 ($29.69 in chips)
Seat 4: f4d194a2 ($11.04 in chips)
Seat 5: 7c90268 ($12.08 in chips)
Seat 6: 69b20187 ($9.7 in chips)
c49a4612: posts small blind $0.05
556685d2: posts big blind $0.1
*** HOLE CARDS ***
Dealt to Hero [6c 8c]
Dealt to c49a4612 
Dealt to 556685d2 
Dealt to f4d194a2 
Dealt to 7c90268 
Dealt to 69b20187 
f4d194a2: folds
7c90268: folds
69b20187: folds
Hero: raises $0.15 to $0.25
c49a4612: raises $0.45 to $0.7
556685d2: folds
Hero: folds
Uncalled bet ($0.45) returned to c49a4612
*** SHOWDOWN ***
c49a4612 collected $0.57 from pot
*** SUMMARY ***
Total pot $0.6 | Rake $0.03 | Jackpot $0 | Bingo $0 | Fortune $0
Seat 1: Hero (button) folded before Flop
Seat 2: c49a4612 (small blind) collected ($0.57)
Seat 3: 556685d2 (big blind) folded before Flop
Seat 4: f4d194a2 folded before Flop (didn't bet)
Seat 5: 7c90268 folded before Flop (didn't bet)
Seat 6: 69b20187 folded before Flop (didn't bet)


Poker Hand #RC1459834013: Hold'em No Limit  ($0.05/$0.1) - 2023/04/08 20:02:30
Table 'RushAndCash3759273' 6-max Seat #1 is the button
Seat 1: e414f212 ($32.23 in chips)
Seat 2: de3ead56 ($17.6 in chips)
Seat 3: Hero ($14.5 in chips)
Seat 4: 867e0a9c ($10 in chips)
Seat 5: 5aa1b11f ($10 in chips)
Seat 6: 5317fd34 ($12.57 in chips)
de3ead56: posts small blind $0.05
Hero: posts big blind $0.1
*** HOLE CARDS ***
Dealt to e414f212 
Dealt to de3ead56 
Dealt to Hero [7s Jc]
Dealt to 867e0a9c 
Dealt to 5aa1b11f 
Dealt to 5317fd34 
867e0a9c: folds
5aa1b11f: folds
5317fd34: raises $0.16 to $0.26
e414f212: folds
de3ead56: raises $0.84 to $1.1
Hero: folds
5317fd34: raises $1.96 to $3.06
de3ead56: folds
Uncalled bet ($1.96) returned to 5317fd34
*** SHOWDOWN ***
5317fd34 collected $2.19 from pot
*** SUMMARY ***
Total pot $2.3 | Rake $0.11 | Jackpot $0 | Bingo $0 | Fortune $0
Seat 1: e414f212 (button) folded before Flop (didn't bet)
Seat 2: de3ead56 (small blind) folded before Flop
Seat 3: Hero (big blind) folded before Flop
Seat 4: 867e0a9c folded before Flop (didn't bet)
Seat 5: 5aa1b11f folded before Flop (didn't bet)
Seat 6: 5317fd34 collected ($2.19)


Poker Hand #RC1459833976: Hold'em No Limit  ($0.05/$0.1) - 2023/04/08 20:02:25
Table 'RushAndCash3759236' 6-max Seat #1 is the button
Seat 1: ddde15fd ($13.33 in chips)
Seat 2: Hero ($14.55 in chips)
Seat 3: 75d479dc ($10.15 in chips)
Seat 4: 5663e5da ($10.73 in chips)
Seat 5: 3cefa687 ($9.95 in chips)
Seat 6: ef0fcf52 ($8.34 in chips)
Hero: posts small blind $0.05
75d479dc: posts big blind $0.1
*** HOLE CARDS ***
Dealt to ddde15fd 
Dealt to Hero [9h 7h]
Dealt to 75d479dc 
Dealt to 5663e5da 
Dealt to 3cefa687 
Dealt to ef0fcf52 
5663e5da: folds
3cefa687: raises $0.15 to $0.25
ef0fcf52: raises $0.49 to $0.74
ddde15fd: folds
Hero: folds
75d479dc: folds
3cefa687: folds
Uncalled bet ($0.49) returned to ef0fcf52
*** SHOWDOWN ***
ef0fcf52 collected $0.62 from pot
*** SUMMARY ***
Total pot $0.65 | Rake $0.03 | Jackpot $0 | Bingo $0 | Fortune $0
Seat 1: ddde15fd (button) folded before Flop (didn't bet)
Seat 2: Hero (small blind) folded before Flop
Seat 3: 75d479dc (big blind) folded before Flop
Seat 4: 5663e5da folded before Flop (didn't bet)
Seat 5: 3cefa687 folded before Flop
Seat 6: ef0fcf52 collected ($0.62)


Poker Hand #RC1459833382: Hold'em No Limit  ($0.05/$0.1) - 2023/04/08 20:00:49
Table 'RushAndCash3758642' 6-max Seat #1 is the button
Seat 1: 3fdcb188 ($10.25 in chips)
Seat 2: ddde15fd ($12.6 in chips)
Seat 3: 7a3e4c38 ($12.4 in chips)
Seat 4: 5f6e1d8f ($19.84 in chips)
Seat 5: Hero ($15.25 in chips)
Seat 6: b804915f ($18.24 in chips)
ddde15fd: posts small blind $0.05
7a3e4c38: posts big blind $0.1
*** HOLE CARDS ***
Dealt to 3fdcb188 
Dealt to ddde15fd 
Dealt to 7a3e4c38 
Dealt to 5f6e1d8f 
Dealt to Hero [As Ks]
Dealt to b804915f 
5f6e1d8f: folds
Hero: raises $0.15 to $0.25
b804915f: folds
3fdcb188: folds
ddde15fd: calls $0.2
7a3e4c38: folds
*** FLOP *** [9d 7d Js]
ddde15fd: checks
Hero: checks
*** TURN *** [9d 7d Js] [Ac]
ddde15fd: bets $0.45
Hero: calls $0.45
*** RIVER *** [9d 7d Js Ac] [5h]
ddde15fd: bets $2.4
Hero: folds
Uncalled bet ($2.4) returned to ddde15fd
Hero: shows [As Ks] (Pair of Aces)
*** SHOWDOWN ***
ddde15fd collected $1.43 from pot
*** SUMMARY ***
Total pot $1.5 | Rake $0.07 | Jackpot $0 | Bingo $0 | Fortune $0
Board [9d 7d Js Ac 5h]
Seat 1: 3fdcb188 (button) folded before Flop (didn't bet)
Seat 2: ddde15fd (small blind) won ($1.43)
Seat 3: 7a3e4c38 (big blind) folded before Flop
Seat 4: 5f6e1d8f folded before Flop (didn't bet)
Seat 5: Hero folded on the River
Seat 6: b804915f folded before Flop (didn't bet)


Poker Hand #RC1459833355: Hold'em No Limit  ($0.05/$0.1) - 2023/04/08 20:00:44
Table 'RushAndCash3758615' 6-max Seat #1 is the button
Seat 1: ef0fcf52 ($7.84 in chips)
Seat 2: a51368ca ($24.96 in chips)
Seat 3: da607e40 ($10.06 in chips)
Seat 4: Hero ($15.25 in chips)
Seat 5: efe8777f ($10.75 in chips)
Seat 6: 716dad3 ($10 in chips)
a51368ca: posts small blind $0.05
da607e40: posts big blind $0.1
*** HOLE CARDS ***
Dealt to ef0fcf52 
Dealt to a51368ca 
Dealt to da607e40 
Dealt to Hero [3d 9c]
Dealt to efe8777f 
Dealt to 716dad3 
Hero: folds
efe8777f: folds
716dad3: raises $0.15 to $0.25
ef0fcf52: folds
a51368ca: folds
da607e40: folds
Uncalled bet ($0.15) returned to 716dad3
*** SHOWDOWN ***
716dad3 collected $0.25 from pot
*** SUMMARY ***
Total pot $0.25 | Rake $0 | Jackpot $0 | Bingo $0 | Fortune $0
Seat 1: ef0fcf52 (button) folded before Flop (didn't bet)
Seat 2: a51368ca (small blind) folded before Flop
Seat 3: da607e40 (big blind) folded before Flop
Seat 4: Hero folded before Flop (didn't bet)
Seat 5: efe8777f folded before Flop (didn't bet)
Seat 6: 716dad3 collected ($0.25)


Poker Hand #RC1459833328: Hold'em No Limit  ($0.05/$0.1) - 2023/04/08 20:00:39
Table 'RushAndCash3758588' 6-max Seat #1 is the button
Seat 1: 3058d7a0 ($10 in chips)
Seat 2: e414f212 ($32.53 in chips)
Seat 3: ef3bd8db ($13.27 in chips)
Seat 4: Hero ($15.25 in chips)
Seat 5: 137b9e7f ($11.5 in chips)
Seat 6: 8704ba28 ($10.71 in chips)
e414f212: posts small blind $0.05
ef3bd8db: posts big blind $0.1
*** HOLE CARDS ***
Dealt to 3058d7a0 
Dealt to e414f212 
Dealt to ef3bd8db 
Dealt to Hero [Jh 9s]
Dealt to 137b9e7f 
Dealt to 8704ba28 
Hero: folds
137b9e7f: folds
8704ba28: folds
3058d7a0: folds
e414f212: folds
Uncalled bet ($0.05) returned to ef3bd8db
*** SHOWDOWN ***
ef3bd8db collected $0.1 from pot
*** SUMMARY ***
Total pot $0.1 | Rake $0 | Jackpot $0 | Bingo $0 | Fortune $0
Seat 1: 3058d7a0 (button) folded before Flop (didn't bet)
Seat 2: e414f212 (small blind) folded before Flop
Seat 3: ef3bd8db (big blind) collected ($0.1)
Seat 4: Hero folded before Flop (didn't bet)
Seat 5: 137b9e7f folded before Flop (didn't bet)
Seat 6: 8704ba28 folded before Flop (didn't bet)


Poker Hand #RC1459833301: Hold'em No Limit  ($0.05/$0.1) - 2023/04/08 20:00:35
Table 'RushAndCash3758561' 6-max Seat #1 is the button
Seat 1: 14224def ($10 in chips)
Seat 2: 5dcc7506 ($10 in chips)
Seat 3: 6e387db3 ($10 in chips)
Seat 4: Hero ($15.25 in chips)
Seat 5: ffa2b238 ($10.45 in chips)
Seat 6: caa6760d ($15.21 in chips)
5dcc7506: posts small blind $0.05
6e387db3: posts big blind $0.1
*** HOLE CARDS ***
Dealt to 14224def 
Dealt to 5dcc7506 
Dealt to 6e387db3 
Dealt to Hero [Qc 4d]
Dealt to ffa2b238 
Dealt to caa6760d 
Hero: folds
ffa2b238: folds
caa6760d: folds
14224def: folds
5dcc7506: folds
Uncalled bet ($0.05) returned to 6e387db3
*** SHOWDOWN ***
6e387db3 collected $0.1 from pot
*** SUMMARY ***
Total pot $0.1 | Rake $0 | Jackpot $0 | Bingo $0 | Fortune $0
Seat 1: 14224def (button) folded before Flop (didn't bet)
Seat 2: 5dcc7506 (small blind) folded before Flop
Seat 3: 6e387db3 (big blind) collected ($0.1)
Seat 4: Hero folded before Flop (didn't bet)
Seat 5: ffa2b238 folded before Flop (didn't bet)
Seat 6: caa6760d folded before Flop (didn't bet)


Poker Hand #RC1459833252: Hold'em No Limit  ($0.05/$0.1) - 2023/04/08 20:00:26
Table 'RushAndCash3758512' 6-max Seat #1 is the button
Seat 1: e1c028ac ($8.55 in chips)
Seat 2: ebb0ec7f ($10 in chips)
Seat 3: Hero ($15.2 in chips)
Seat 4: 135b9f7 ($11.99 in chips)
Seat 5: a8fbf7f7 ($7.74 in chips)
Seat 6: 67ea5d5d ($14.9 in chips)
ebb0ec7f: posts small blind $0.05
Hero: posts big blind $0.1
*** HOLE CARDS ***
Dealt to e1c028ac 
Dealt to ebb0ec7f 
Dealt to Hero [3d 9d]
Dealt to 135b9f7 
Dealt to a8fbf7f7 
Dealt to 67ea5d5d 
135b9f7: folds
a8fbf7f7: folds
67ea5d5d: folds
e1c028ac: folds
ebb0ec7f: folds
Uncalled bet ($0.05) returned to Hero
*** SHOWDOWN ***
Hero collected $0.1 from pot
*** SUMMARY ***
Total pot $0.1 | Rake $0 | Jackpot $0 | Bingo $0 | Fortune $0
Seat 1: e1c028ac (button) folded before Flop (didn't bet)
Seat 2: ebb0ec7f (small blind) folded before Flop
Seat 3: Hero (big blind) collected ($0.1)
Seat 4: 135b9f7 folded before Flop (didn't bet)
Seat 5: a8fbf7f7 folded before Flop (didn't bet)
Seat 6: 67ea5d5d folded before Flop (didn't bet)


Poker Hand #RC1459833226: Hold'em No Limit  ($0.05/$0.1) - 2023/04/08 20:00:22
Table 'RushAndCash3758486' 6-max Seat #1 is the button
Seat 1: 2261b544 ($11.04 in chips)
Seat 2: 9c3d59f5 ($18.85 in chips)
Seat 3: 27ed4b31 ($11.26 in chips)
Seat 4: bb68e4fe ($1.76 in chips)
Seat 5: dc431d64 ($23.91 in chips)
Seat 6: Hero ($15.2 in chips)
9c3d59f5: posts small blind $0.05
27ed4b31: posts big blind $0.1
*** HOLE CARDS ***
Dealt to 2261b544 
Dealt to 9c3d59f5 
Dealt to 27ed4b31 
Dealt to bb68e4fe 
Dealt to dc431d64 
Dealt to Hero [3d Qd]
bb68e4fe: folds
dc431d64: raises $0.15 to $0.25
Hero: folds
2261b544: folds
9c3d59f5: raises $0.75 to $1
27ed4b31: calls $0.9
dc431d64: calls $0.75
*** FLOP *** [5d 8h 9h]
9c3d59f5: bets $0.99
27ed4b31: calls $0.99
dc431d64: folds
*** TURN *** [5d 8h 9h] [6s]
9c3d59f5: checks
27ed4b31: checks
*** RIVER *** [5d 8h 9h 6s] [7h]
9c3d59f5: checks
27ed4b31: bets $2.49
9c3d59f5: calls $2.49
27ed4b31: shows [Ts Tc] (Tens-High Straight)
9c3d59f5: shows [Jd Jh] (Nines-High Straight)
*** SHOWDOWN ***
27ed4b31 collected $9.51 from pot
*** SUMMARY ***
Total pot $9.96 | Rake $0.3 | Jackpot $0.15 | Bingo $0 | Fortune $0
Board [5d 8h 9h 6s 7h]
Seat 1: 2261b544 (button) folded before Flop (didn't bet)
Seat 2: 9c3d59f5 (small blind) showed [Jd Jh] and lost with Nines-High Straight
Seat 3: 27ed4b31 (big blind) showed [Ts Tc] and won ($9.51) with Tens-High Straight
Seat 4: bb68e4fe folded before Flop (didn't bet)
Seat 5: dc431d64 folded on the Flop
Seat 6: Hero folded before Flop (didn't bet)


Poker Hand #RC1459833189: Hold'em No Limit  ($0.05/$0.1) - 2023/04/08 20:00:15
Table 'RushAndCash3758449' 6-max Seat #1 is the button
Seat 1: 54dcb36b ($23.28 in chips)
Seat 2: 9612ff88 ($12.51 in chips)
Seat 3: f75540cc ($22.01 in chips)
Seat 4: 859eb237 ($21.9 in chips)
Seat 5: Hero ($15.2 in chips)
Seat 6: 1e812698 ($13.36 in chips)
9612ff88: posts small blind $0.05
f75540cc: posts big blind $0.1
*** HOLE CARDS ***
Dealt to 54dcb36b 
Dealt to 9612ff88 
Dealt to f75540cc 
Dealt to 859eb237 
Dealt to Hero [6h Qs]
Dealt to 1e812698 
859eb237: raises $0.15 to $0.25
Hero: folds
1e812698: folds
54dcb36b: folds
9612ff88: folds
f75540cc: folds
Uncalled bet ($0.15) returned to 859eb237
*** SHOWDOWN ***
859eb237 collected $0.25 from pot
*** SUMMARY ***
Total pot $0.25 | Rake $0 | Jackpot $0 | Bingo $0 | Fortune $0
Seat 1: 54dcb36b (button) folded before Flop (didn't bet)
Seat 2: 9612ff88 (small blind) folded before Flop
Seat 3: f75540cc (big blind) folded before Flop
Seat 4: 859eb237 collected ($0.25)
Seat 5: Hero folded before Flop (didn't bet)
Seat 6: 1e812698 folded before Flop (didn't bet)


Poker Hand #RC1459833079: Hold'em No Limit  ($0.05/$0.1) - 2023/04/08 19:59:59
Table 'RushAndCash3758339' 6-max Seat #1 is the button
Seat 1: Hero ($15.05 in chips)
Seat 2: f96970d3 ($8.98 in chips)
Seat 3: d47c361a ($9.47 in chips)
Seat 4: 845fb6fd ($18.11 in chips)
Seat 5: 5994ee06 ($14.12 in chips)
Seat 6: 135b9f7 ($11.99 in chips)
f96970d3: posts small blind $0.05
d47c361a: posts big blind $0.1
*** HOLE CARDS ***
Dealt to Hero [Qc Jh]
Dealt to f96970d3 
Dealt to d47c361a 
Dealt to 845fb6fd 
Dealt to 5994ee06 
Dealt to 135b9f7 
845fb6fd: folds
5994ee06: folds
135b9f7: folds
Hero: raises $0.15 to $0.25
f96970d3: folds
d47c361a: folds
Uncalled bet ($0.15) returned to Hero
*** SHOWDOWN ***
Hero collected $0.25 from pot
*** SUMMARY ***
Total pot $0.25 | Rake $0 | Jackpot $0 | Bingo $0 | Fortune $0
Seat 1: Hero (button) collected ($0.25)
Seat 2: f96970d3 (small blind) folded before Flop
Seat 3: d47c361a (big blind) folded before Flop
Seat 4: 845fb6fd folded before Flop (didn't bet)
Seat 5: 5994ee06 folded before Flop (didn't bet)
Seat 6: 135b9f7 folded before Flop (didn't bet)


Poker Hand #RC1459832952: Hold'em No Limit  ($0.05/$0.1) - 2023/04/08 19:59:39
Table 'RushAndCash3758212' 6-max Seat #1 is the button
Seat 1: Hero ($14.9 in chips)
Seat 2: ed2d1dce ($10.87 in chips)
Seat 3: 20bb8143 ($1.53 in chips)
Seat 4: ef3bd8db ($13.47 in chips)
Seat 5: 6a933152 ($9.75 in chips)
Seat 6: 14224def ($10.15 in chips)
ed2d1dce: posts small blind $0.05
20bb8143: posts big blind $0.1
*** HOLE CARDS ***
Dealt to Hero [7h Ad]
Dealt to ed2d1dce 
Dealt to 20bb8143 
Dealt to ef3bd8db 
Dealt to 6a933152 
Dealt to 14224def 
ef3bd8db: folds
6a933152: folds
14224def: folds
Hero: raises $0.15 to $0.25
ed2d1dce: folds
20bb8143: folds
Uncalled bet ($0.15) returned to Hero
*** SHOWDOWN ***
Hero collected $0.25 from pot
*** SUMMARY ***
Total pot $0.25 | Rake $0 | Jackpot $0 | Bingo $0 | Fortune $0
Seat 1: Hero (button) collected ($0.25)
Seat 2: ed2d1dce (small blind) folded before Flop
Seat 3: 20bb8143 (big blind) folded before Flop
Seat 4: ef3bd8db folded before Flop (didn't bet)
Seat 5: 6a933152 folded before Flop (didn't bet)
Seat 6: 14224def folded before Flop (didn't bet)


Poker Hand #RC1459832876: Hold'em No Limit  ($0.05/$0.1) - 2023/04/08 19:59:29
Table 'RushAndCash3758136' 6-max Seat #1 is the button
Seat 1: 1c705ba0 ($16.95 in chips)
Seat 2: Hero ($14.95 in chips)
Seat 3: 30ec7a3c ($27.83 in chips)
Seat 4: 3d1f932f ($9.41 in chips)
Seat 5: 5a721ebb ($10.75 in chips)
Seat 6: cbfaf6ea ($10.38 in chips)
Hero: posts small blind $0.05
30ec7a3c: posts big blind $0.1
*** HOLE CARDS ***
Dealt to 1c705ba0 
Dealt to Hero [8s 9c]
Dealt to 30ec7a3c 
Dealt to 3d1f932f 
Dealt to 5a721ebb 
Dealt to cbfaf6ea 
3d1f932f: raises $0.1 to $0.2
5a721ebb: folds
cbfaf6ea: folds
1c705ba0: folds
Hero: folds
30ec7a3c: folds
Uncalled bet ($0.1) returned to 3d1f932f
*** SHOWDOWN ***
3d1f932f collected $0.25 from pot
*** SUMMARY ***
Total pot $0.25 | Rake $0 | Jackpot $0 | Bingo $0 | Fortune $0
Seat 1: 1c705ba0 (button) folded before Flop (didn't bet)
Seat 2: Hero (small blind) folded before Flop
Seat 3: 30ec7a3c (big blind) folded before Flop
Seat 4: 3d1f932f collected ($0.25)
Seat 5: 5a721ebb folded before Flop (didn't bet)
Seat 6: cbfaf6ea folded before Flop (didn't bet)


Poker Hand #RC1459832686: Hold'em No Limit  ($0.05/$0.1) - 2023/04/08 19:59:00
Table 'RushAndCash3757946' 6-max Seat #1 is the button
Seat 1: Hero ($15.2 in chips)
Seat 2: 596739e7 ($12.08 in chips)
Seat 3: 1c705ba0 ($16.67 in chips)
Seat 4: eda2be39 ($12.51 in chips)
Seat 5: b311bb8e ($13.09 in chips)
Seat 6: 77f0e356 ($11.31 in chips)
596739e7: posts small blind $0.05
1c705ba0: posts big blind $0.1
*** HOLE CARDS ***
Dealt to Hero [6s Kd]
Dealt to 596739e7 
Dealt to 1c705ba0 
Dealt to eda2be39 
Dealt to b311bb8e 
Dealt to 77f0e356 
eda2be39: folds
b311bb8e: folds
77f0e356: folds
Hero: raises $0.15 to $0.25
596739e7: folds
1c705ba0: raises $0.44 to $0.69
Hero: folds
Uncalled bet ($0.44) returned to 1c705ba0
*** SHOWDOWN ***
1c705ba0 collected $0.53 from pot
*** SUMMARY ***
Total pot $0.55 | Rake $0.02 | Jackpot $0 | Bingo $0 | Fortune $0
Seat 1: Hero (button) folded before Flop
Seat 2: 596739e7 (small blind) folded before Flop
Seat 3: 1c705ba0 (big blind) collected ($0.53)
Seat 4: eda2be39 folded before Flop (didn't bet)
Seat 5: b311bb8e folded before Flop (didn't bet)
Seat 6: 77f0e356 folded before Flop (didn't bet)


Poker Hand #RC1459832641: Hold'em No Limit  ($0.05/$0.1) - 2023/04/08 19:58:53
Table 'RushAndCash3757901' 6-max Seat #1 is the button
Seat 1: 80783716 ($13.14 in chips)
Seat 2: Hero ($15.25 in chips)
Seat 3: 238ede5a ($10.42 in chips)
Seat 4: 1a0a123c ($24.67 in chips)
Seat 5: 8a8bce3 ($14.35 in chips)
Seat 6: 3d6e315 ($11.79 in chips)
Hero: posts small blind $0.05
238ede5a: posts big blind $0.1
*** HOLE CARDS ***
Dealt to 80783716 
Dealt to Hero [3c Jc]
Dealt to 238ede5a 
Dealt to 1a0a123c 
Dealt to 8a8bce3 
Dealt to 3d6e315 
1a0a123c: folds
8a8bce3: folds
3d6e315: raises $0.1 to $0.2
80783716: folds
Hero: folds
238ede5a: folds
Uncalled bet ($0.1) returned to 3d6e315
*** SHOWDOWN ***
3d6e315 collected $0.25 from pot
*** SUMMARY ***
Total pot $0.25 | Rake $0 | Jackpot $0 | Bingo $0 | Fortune $0
Seat 1: 80783716 (button) folded before Flop (didn't bet)
Seat 2: Hero (small blind) folded before Flop
Seat 3: 238ede5a (big blind) folded before Flop
Seat 4: 1a0a123c folded before Flop (didn't bet)
Seat 5: 8a8bce3 folded before Flop (didn't bet)
Seat 6: 3d6e315 collected ($0.25)


Poker Hand #RC1459832537: Hold'em No Limit  ($0.05/$0.1) - 2023/04/08 19:58:37
Table 'RushAndCash3757797' 6-max Seat #1 is the button
Seat 1: cacd032a ($12.7 in chips)
Seat 2: 8a46d84c ($10 in chips)
Seat 3: Hero ($15.35 in chips)
Seat 4: 583bb900 ($18.02 in chips)
Seat 5: aa0a8acf ($12.39 in chips)
Seat 6: f27e3a8c ($10.21 in chips)
8a46d84c: posts small blind $0.05
Hero: posts big blind $0.1
*** HOLE CARDS ***
Dealt to cacd032a 
Dealt to 8a46d84c 
Dealt to Hero [Th 4c]
Dealt to 583bb900 
Dealt to aa0a8acf 
Dealt to f27e3a8c 
583bb900: raises $0.2 to $0.3
aa0a8acf: folds
f27e3a8c: folds
cacd032a: folds
8a46d84c: folds
Hero: folds
Uncalled bet ($0.2) returned to 583bb900
*** SHOWDOWN ***
583bb900 collected $0.25 from pot
*** SUMMARY ***
Total pot $0.25 | Rake $0 | Jackpot $0 | Bingo $0 | Fortune $0
Seat 1: cacd032a (button) folded before Flop (didn't bet)
Seat 2: 8a46d84c (small blind) folded before Flop
Seat 3: Hero (big blind) folded before Flop
Seat 4: 583bb900 collected ($0.25)
Seat 5: aa0a8acf folded before Flop (didn't bet)
Seat 6: f27e3a8c folded before Flop (didn't bet)


Poker Hand #RC1459832481: Hold'em No Limit  ($0.05/$0.1) - 2023/04/08 19:58:29
Table 'RushAndCash3757741' 6-max Seat #1 is the button
Seat 1: de3ead56 ($15.09 in chips)
Seat 2: d1d2d0a4 ($14.49 in chips)
Seat 3: 67ea5d5d ($14.53 in chips)
Seat 4: 69d66d42 ($9.55 in chips)
Seat 5: 8766a2b ($10.05 in chips)
Seat 6: Hero ($15.35 in chips)
d1d2d0a4: posts small blind $0.05
67ea5d5d: posts big blind $0.1
*** HOLE CARDS ***
Dealt to de3ead56 
Dealt to d1d2d0a4 
Dealt to 67ea5d5d 
Dealt to 69d66d42 
Dealt to 8766a2b 
Dealt to Hero [2d Jc]
69d66d42: folds
8766a2b: raises $0.16 to $0.26
Hero: folds
de3ead56: folds
d1d2d0a4: folds
67ea5d5d: folds
Uncalled bet ($0.16) returned to 8766a2b
*** SHOWDOWN ***
8766a2b collected $0.25 from pot
*** SUMMARY ***
Total pot $0.25 | Rake $0 | Jackpot $0 | Bingo $0 | Fortune $0
Seat 1: de3ead56 (button) folded before Flop (didn't bet)
Seat 2: d1d2d0a4 (small blind) folded before Flop
Seat 3: 67ea5d5d (big blind) folded before Flop
Seat 4: 69d66d42 folded before Flop (didn't bet)
Seat 5: 8766a2b collected ($0.25)
Seat 6: Hero folded before Flop (didn't bet)


Poker Hand #RC1459832431: Hold'em No Limit  ($0.05/$0.1) - 2023/04/08 19:58:20
Table 'RushAndCash3757691' 6-max Seat #1 is the button
Seat 1: 6f09c065 ($9.11 in chips)
Seat 2: 42800cf2 ($6.43 in chips)
Seat 3: ca47437 ($10 in chips)
Seat 4: a4a4271f ($27.28 in chips)
Seat 5: Hero ($15.35 in chips)
Seat 6: 14165a66 ($20.18 in chips)
42800cf2: posts small blind $0.05
ca47437: posts big blind $0.1
*** HOLE CARDS ***
Dealt to 6f09c065 
Dealt to 42800cf2 
Dealt to ca47437 
Dealt to a4a4271f 
Dealt to Hero [Ts 8d]
Dealt to 14165a66 
a4a4271f: raises $0.15 to $0.25
Hero: folds
14165a66: folds
6f09c065: folds
42800cf2: folds
ca47437: raises $0.85 to $1.1
a4a4271f: calls $0.85
*** FLOP *** [4s 9c 3d]
ca47437: bets $0.77
a4a4271f: calls $0.77
*** TURN *** [4s 9c 3d] [Jd]
ca47437: bets $2.28
a4a4271f: calls $2.28
*** RIVER *** [4s 9c 3d Jd] [5h]
ca47437: checks
a4a4271f: checks
ca47437: shows [Qs As] (Ace-High)
a4a4271f: shows [Ad 9d] (Pair of Nines)
*** SHOWDOWN ***
a4a4271f collected $7.71 from pot
*** SUMMARY ***
Total pot $8.35 | Rake $0.49 | Jackpot $0.15 | Bingo $0 | Fortune $0
Board [4s 9c 3d Jd 5h]
Seat 1: 6f09c065 (button) folded before Flop (didn't bet)
Seat 2: 42800cf2 (small blind) folded before Flop
Seat 3: ca47437 (big blind) showed [Qs As] and lost with Ace-High
Seat 4: a4a4271f showed [Ad 9d] and won ($7.71) with Pair of Nines
Seat 5: Hero folded before Flop (didn't bet)
Seat 6: 14165a66 folded before Flop (didn't bet)


Poker Hand #RC1459832364: Hold'em No Limit  ($0.05/$0.1) - 2023/04/08 19:58:09
Table 'RushAndCash3757624' 6-max Seat #1 is the button
Seat 1: 39acc71d ($14.47 in chips)
Seat 2: f35be896 ($14.47 in chips)
Seat 3: Hero ($15.45 in chips)
Seat 4: 30ec7a3c ($27.61 in chips)
Seat 5: 2f04e900 ($15.15 in chips)
Seat 6: 3cefa687 ($9.58 in chips)
f35be896: posts small blind $0.05
Hero: posts big blind $0.1
*** HOLE CARDS ***
Dealt to 39acc71d 
Dealt to f35be896 
Dealt to Hero [Ac 2d]
Dealt to 30ec7a3c 
Dealt to 2f04e900 
Dealt to 3cefa687 
30ec7a3c: folds
2f04e900: raises $0.15 to $0.25
3cefa687: folds
39acc71d: folds
f35be896: folds
Hero: folds
Uncalled bet ($0.15) returned to 2f04e900
*** SHOWDOWN ***
2f04e900 collected $0.25 from pot
*** SUMMARY ***
Total pot $0.25 | Rake $0 | Jackpot $0 | Bingo $0 | Fortune $0
Seat 1: 39acc71d (button) folded before Flop (didn't bet)
Seat 2: f35be896 (small blind) folded before Flop
Seat 3: Hero (big blind) folded before Flop
Seat 4: 30ec7a3c folded before Flop (didn't bet)
Seat 5: 2f04e900 collected ($0.25)
Seat 6: 3cefa687 folded before Flop (didn't bet)


Poker Hand #RC1459832284: Hold'em No Limit  ($0.05/$0.1) - 2023/04/08 19:57:57
Table 'RushAndCash3757544' 6-max Seat #1 is the button
Seat 1: 38b17591 ($11.95 in chips)
Seat 2: Hero ($15.5 in chips)
Seat 3: 1626af20 ($10.23 in chips)
Seat 4: cbfaf6ea ($10.53 in chips)
Seat 5: 9b0fff42 ($15.69 in chips)
Seat 6: 280b7b ($81.31 in chips)
Hero: posts small blind $0.05
1626af20: posts big blind $0.1
*** HOLE CARDS ***
Dealt to 38b17591 
Dealt to Hero [4s 2c]
Dealt to 1626af20 
Dealt to cbfaf6ea 
Dealt to 9b0fff42 
Dealt to 280b7b 
cbfaf6ea: folds
9b0fff42: folds
280b7b: folds
38b17591: folds
Hero: folds
Uncalled bet ($0.05) returned to 1626af20
*** SHOWDOWN ***
1626af20 collected $0.1 from pot
*** SUMMARY ***
Total pot $0.1 | Rake $0 | Jackpot $0 | Bingo $0 | Fortune $0
Seat 1: 38b17591 (button) folded before Flop (didn't bet)
Seat 2: Hero (small blind) folded before Flop
Seat 3: 1626af20 (big blind) collected ($0.1)
Seat 4: cbfaf6ea folded before Flop (didn't bet)
Seat 5: 9b0fff42 folded before Flop (didn't bet)
Seat 6: 280b7b folded before Flop (didn't bet)


Poker Hand #RC1459832159: Hold'em No Limit  ($0.05/$0.1) - 2023/04/08 19:57:39
Table 'RushAndCash3757419' 6-max Seat #1 is the button
Seat 1: 1adff58e ($14.7 in chips)
Seat 2: Hero ($15.55 in chips)
Seat 3: b8f000db ($10.05 in chips)
Seat 4: 4f963d42 ($21.6 in chips)
Seat 5: 11ef0c8 ($14.84 in chips)
Seat 6: cc018f2 ($10.24 in chips)
Hero: posts small blind $0.05
b8f000db: posts big blind $0.1
*** HOLE CARDS ***
Dealt to 1adff58e 
Dealt to Hero [Qd 5d]
Dealt to b8f000db 
Dealt to 4f963d42 
Dealt to 11ef0c8 
Dealt to cc018f2 
4f963d42: raises $0.11 to $0.21
11ef0c8: folds
cc018f2: folds
1adff58e: calls $0.21
Hero: folds
b8f000db: calls $0.11
*** FLOP *** [Ad 8d 7d]
b8f000db: checks
4f963d42: bets $0.23
1adff58e: folds
b8f000db: folds
Uncalled bet ($0.23) returned to 4f963d42
*** SHOWDOWN ***
4f963d42 collected $0.65 from pot
*** SUMMARY ***
Total pot $0.68 | Rake $0.03 | Jackpot $0 | Bingo $0 | Fortune $0
Board [Ad 8d 7d]
Seat 1: 1adff58e (button) folded on the Flop
Seat 2: Hero (small blind) folded before Flop
Seat 3: b8f000db (big blind) folded on the Flop
Seat 4: 4f963d42 won ($0.65)
Seat 5: 11ef0c8 folded before Flop (didn't bet)
Seat 6: cc018f2 folded before Flop (didn't bet)


Poker Hand #RC1459831911: Hold'em No Limit  ($0.05/$0.1) - 2023/04/08 19:57:02
Table 'RushAndCash3757171' 6-max Seat #1 is the button
Seat 1: e3e4b226 ($15.55 in chips)
Seat 2: b579d5c8 ($15.59 in chips)
Seat 3: 4f963d42 ($21.85 in chips)
Seat 4: 43663618 ($23.11 in chips)
Seat 5: c09dbfbc ($17.18 in chips)
Seat 6: Hero ($15.27 in chips)
b579d5c8: posts small blind $0.05
4f963d42: posts big blind $0.1
*** HOLE CARDS ***
Dealt to e3e4b226 
Dealt to b579d5c8 
Dealt to 4f963d42 
Dealt to 43663618 
Dealt to c09dbfbc 
Dealt to Hero [Ad As]
43663618: folds
c09dbfbc: folds
Hero: raises $0.15 to $0.25
e3e4b226: folds
b579d5c8: folds
4f963d42: calls $0.15
*** FLOP *** [3d Jh 5s]
4f963d42: checks
Hero: bets $0.28
4f963d42: folds
Uncalled bet ($0.28) returned to Hero
*** SHOWDOWN ***
Hero collected $0.53 from pot
*** SUMMARY ***
Total pot $0.55 | Rake $0.02 | Jackpot $0 | Bingo $0 | Fortune $0
Board [3d Jh 5s]
Seat 1: e3e4b226 (button) folded before Flop (didn't bet)
Seat 2: b579d5c8 (small blind) folded before Flop
Seat 3: 4f963d42 (big blind) folded on the Flop
Seat 4: 43663618 folded before Flop (didn't bet)
Seat 5: c09dbfbc folded before Flop (didn't bet)
Seat 6: Hero won ($0.53)


Poker Hand #RC1459831881: Hold'em No Limit  ($0.05/$0.1) - 2023/04/08 19:56:57
Table 'RushAndCash3757141' 6-max Seat #1 is the button
Seat 1: 9a1872c7 ($9.4 in chips)
Seat 2: c3c0fb7f ($14.94 in chips)
Seat 3: e8620b4b ($10.4 in chips)
Seat 4: Hero ($15.27 in chips)
Seat 5: 530ac30c ($17.99 in chips)
Seat 6: eda2be39 ($11.21 in chips)
c3c0fb7f: posts small blind $0.05
e8620b4b: posts big blind $0.1
*** HOLE CARDS ***
Dealt to 9a1872c7 
Dealt to c3c0fb7f 
Dealt to e8620b4b 
Dealt to Hero [8d 3c]
Dealt to 530ac30c 
Dealt to eda2be39 
Hero: folds
530ac30c: folds
eda2be39: folds
9a1872c7: folds
c3c0fb7f: raises $0.2 to $0.3
e8620b4b: folds
Uncalled bet ($0.2) returned to c3c0fb7f
*** SHOWDOWN ***
c3c0fb7f collected $0.2 from pot
*** SUMMARY ***
Total pot $0.2 | Rake $0 | Jackpot $0 | Bingo $0 | Fortune $0
Seat 1: 9a1872c7 (button) folded before Flop (didn't bet)
Seat 2: c3c0fb7f (small blind) collected ($0.2)
Seat 3: e8620b4b (big blind) folded before Flop
Seat 4: Hero folded before Flop (didn't bet)
Seat 5: 530ac30c folded before Flop (didn't bet)
Seat 6: eda2be39 folded before Flop (didn't bet)


Poker Hand #RC1459831847: Hold'em No Limit  ($0.05/$0.1) - 2023/04/08 19:56:53
Table 'RushAndCash3757107' 6-max Seat #1 is the button
Seat 1: 3d6e315 ($10.65 in chips)
Seat 2: 76e126c5 ($10 in chips)
Seat 3: 11ef0c8 ($14.47 in chips)
Seat 4: 2f04e900 ($15.01 in chips)
Seat 5: e115cf1e ($12.09 in chips)
Seat 6: Hero ($15.27 in chips)
76e126c5: posts small blind $0.05
11ef0c8: posts big blind $0.1
*** HOLE CARDS ***
Dealt to 3d6e315 
Dealt to 76e126c5 
Dealt to 11ef0c8 
Dealt to 2f04e900 
Dealt to e115cf1e 
Dealt to Hero [4s 5h]
2f04e900: raises $0.15 to $0.25
e115cf1e: folds
Hero: folds
3d6e315: folds
76e126c5: folds
11ef0c8: folds
Uncalled bet ($0.15) returned to 2f04e900
*** SHOWDOWN ***
2f04e900 collected $0.25 from pot
*** SUMMARY ***
Total pot $0.25 | Rake $0 | Jackpot $0 | Bingo $0 | Fortune $0
Seat 1: 3d6e315 (button) folded before Flop (didn't bet)
Seat 2: 76e126c5 (small blind) folded before Flop
Seat 3: 11ef0c8 (big blind) folded before Flop
Seat 4: 2f04e900 collected ($0.25)
Seat 5: e115cf1e folded before Flop (didn't bet)
Seat 6: Hero folded before Flop (didn't bet)


Poker Hand #RC1459831818: Hold'em No Limit  ($0.05/$0.1) - 2023/04/08 19:56:47
Table 'RushAndCash3757078' 6-max Seat #1 is the button
Seat 1: 43ba805e ($10.76 in chips)
Seat 2: b79a8f2a ($13.39 in chips)
Seat 3: 76e126c5 ($10 in chips)
Seat 4: f29982a1 ($4.82 in chips)
Seat 5: Hero ($15.27 in chips)
Seat 6: 9d55ce9b ($8.56 in chips)
b79a8f2a: posts small blind $0.05
76e126c5: posts big blind $0.1
*** HOLE CARDS ***
Dealt to 43ba805e 
Dealt to b79a8f2a 
Dealt to 76e126c5 
Dealt to f29982a1 
Dealt to Hero [6d 2d]
Dealt to 9d55ce9b 
f29982a1: folds
Hero: folds
9d55ce9b: folds
43ba805e: raises $0.15 to $0.25
b79a8f2a: folds
76e126c5: folds
Uncalled bet ($0.15) returned to 43ba805e
*** SHOWDOWN ***
43ba805e collected $0.25 from pot
*** SUMMARY ***
Total pot $0.25 | Rake $0 | Jackpot $0 | Bingo $0 | Fortune $0
Seat 1: 43ba805e (button) collected ($0.25)
Seat 2: b79a8f2a (small blind) folded before Flop
Seat 3: 76e126c5 (big blind) folded before Flop
Seat 4: f29982a1 folded before Flop (didn't bet)
Seat 5: Hero folded before Flop (didn't bet)
Seat 6: 9d55ce9b folded before Flop (didn't bet)


Poker Hand #RC1459831784: Hold'em No Limit  ($0.05/$0.1) - 2023/04/08 19:56:42
Table 'RushAndCash3757044' 6-max Seat #1 is the button
Seat 1: 545c097e ($11.13 in chips)
Seat 2: bb900265 ($7.99 in chips)
Seat 3: b4f0b29d ($11.82 in chips)
Seat 4: Hero ($15.27 in chips)
Seat 5: 2b6d4362 ($10.82 in chips)
Seat 6: 8ff12852 ($9.76 in chips)
bb900265: posts small blind $0.05
b4f0b29d: posts big blind $0.1
*** HOLE CARDS ***
Dealt to 545c097e 
Dealt to bb900265 
Dealt to b4f0b29d 
Dealt to Hero [Qc Tc]
Dealt to 2b6d4362 
Dealt to 8ff12852 
Hero: folds
2b6d4362: folds
8ff12852: folds
545c097e: raises $0.1 to $0.2
bb900265: calls $0.15
b4f0b29d: folds
*** FLOP *** [7d Jh Ad]
bb900265: checks
545c097e: bets $0.25
bb900265: calls $0.25
*** TURN *** [7d Jh Ad] [Kc]
bb900265: checks
545c097e: bets $0.5
bb900265: calls $0.5
*** RIVER *** [7d Jh Ad Kc] [3d]
bb900265: checks
545c097e: checks
bb900265: shows [3c Ah] (Pair of Aces and Pair of Treys)
545c097e: shows [Ac 2s] (Pair of Aces)
*** SHOWDOWN ***
bb900265 collected $1.9 from pot
*** SUMMARY ***
Total pot $2 | Rake $0.1 | Jackpot $0 | Bingo $0 | Fortune $0
Board [7d Jh Ad Kc 3d]
Seat 1: 545c097e (button) showed [Ac 2s] and lost with Pair of Aces
Seat 2: bb900265 (small blind) showed [3c Ah] and won ($1.9) with Pair of Aces and Pair of Treys
Seat 3: b4f0b29d (big blind) folded before Flop
Seat 4: Hero folded before Flop (didn't bet)
Seat 5: 2b6d4362 folded before Flop (didn't bet)
Seat 6: 8ff12852 folded before Flop (didn't bet)


Poker Hand #RC1459831686: Hold'em No Limit  ($0.05/$0.1) - 2023/04/08 19:56:28
Table 'RushAndCash3756946' 6-max Seat #1 is the button
Seat 1: Hero ($15.27 in chips)
Seat 2: cd80bf76 ($10 in chips)
Seat 3: e46ece12 ($11.45 in chips)
Seat 4: 9f653bdd ($9.6 in chips)
Seat 5: 81f476a8 ($10.55 in chips)
Seat 6: 50f2bcd ($10.33 in chips)
cd80bf76: posts small blind $0.05
e46ece12: posts big blind $0.1
*** HOLE CARDS ***
Dealt to Hero [5c As]
Dealt to cd80bf76 
Dealt to e46ece12 
Dealt to 9f653bdd 
Dealt to 81f476a8 
Dealt to 50f2bcd 
9f653bdd: folds
81f476a8: folds
50f2bcd: raises $0.12 to $0.22
Hero: folds
cd80bf76: folds
e46ece12: calls $0.12
*** FLOP *** [Jc 4s 8c]
e46ece12: checks
50f2bcd: checks
*** TURN *** [Jc 4s 8c] [Ac]
e46ece12: checks
50f2bcd: bets $0.37
e46ece12: calls $0.37
*** RIVER *** [Jc 4s 8c Ac] [2h]
e46ece12: checks
50f2bcd: checks
e46ece12: shows [4c 5d] (Pair of Fours)
50f2bcd: shows [5s 6s] (Ace-High)
*** SHOWDOWN ***
e46ece12 collected $1.17 from pot
*** SUMMARY ***
Total pot $1.23 | Rake $0.06 | Jackpot $0 | Bingo $0 | Fortune $0
Board [Jc 4s 8c Ac 2h]
Seat 1: Hero (button) folded before Flop (didn't bet)
Seat 2: cd80bf76 (small blind) folded before Flop
Seat 3: e46ece12 (big blind) showed [4c 5d] and won ($1.17) with Pair of Fours
Seat 4: 9f653bdd folded before Flop (didn't bet)
Seat 5: 81f476a8 folded before Flop (didn't bet)
Seat 6: 50f2bcd showed [5s 6s] and lost with Ace-High


Poker Hand #RC1459831659: Hold'em No Limit  ($0.05/$0.1) - 2023/04/08 19:56:23
Table 'RushAndCash3756919' 6-max Seat #1 is the button
Seat 1: 22ab0c40 ($13.59 in chips)
Seat 2: 81f476a8 ($10.45 in chips)
Seat 3: Hero ($15.37 in chips)
Seat 4: cd80bf76 ($10 in chips)
Seat 5: 1c705ba0 ($17.02 in chips)
Seat 6: 39868051 ($10.94 in chips)
81f476a8: posts small blind $0.05
Hero: posts big blind $0.1
*** HOLE CARDS ***
Dealt to 22ab0c40 
Dealt to 81f476a8 
Dealt to Hero [6h 4c]
Dealt to cd80bf76 
Dealt to 1c705ba0 
Dealt to 39868051 
cd80bf76: folds
1c705ba0: folds
39868051: folds
22ab0c40: raises $0.15 to $0.25
81f476a8: folds
Hero: folds
Uncalled bet ($0.15) returned to 22ab0c40
*** SHOWDOWN ***
22ab0c40 collected $0.25 from pot
*** SUMMARY ***
Total pot $0.25 | Rake $0 | Jackpot $0 | Bingo $0 | Fortune $0
Seat 1: 22ab0c40 (button) collected ($0.25)
Seat 2: 81f476a8 (small blind) folded before Flop
Seat 3: Hero (big blind) folded before Flop
Seat 4: cd80bf76 folded before Flop (didn't bet)
Seat 5: 1c705ba0 folded before Flop (didn't bet)
Seat 6: 39868051 folded before Flop (didn't bet)


Poker Hand #RC1459831598: Hold'em No Limit  ($0.05/$0.1) - 2023/04/08 19:56:14
Table 'RushAndCash3756858' 6-max Seat #1 is the button
Seat 1: 3e9216b5 ($7.69 in chips)
Seat 2: fa183b4a ($19.12 in chips)
Seat 3: 95f24723 ($10 in chips)
Seat 4: Hero ($15.37 in chips)
Seat 5: 8ff12852 ($9.46 in chips)
Seat 6: 11ef0c8 ($14.57 in chips)
fa183b4a: posts small blind $0.05
95f24723: posts big blind $0.1
*** HOLE CARDS ***
Dealt to 3e9216b5 
Dealt to fa183b4a 
Dealt to 95f24723 
Dealt to Hero [9s 8h]
Dealt to 8ff12852 
Dealt to 11ef0c8 
Hero: folds
8ff12852: folds
11ef0c8: folds
3e9216b5: folds
fa183b4a: folds
Uncalled bet ($0.05) returned to 95f24723
*** SHOWDOWN ***
95f24723 collected $0.1 from pot
*** SUMMARY ***
Total pot $0.1 | Rake $0 | Jackpot $0 | Bingo $0 | Fortune $0
Seat 1: 3e9216b5 (button) folded before Flop (didn't bet)
Seat 2: fa183b4a (small blind) folded before Flop
Seat 3: 95f24723 (big blind) collected ($0.1)
Seat 4: Hero folded before Flop (didn't bet)
Seat 5: 8ff12852 folded before Flop (didn't bet)
Seat 6: 11ef0c8 folded before Flop (didn't bet)


Poker Hand #RC1459831568: Hold'em No Limit  ($0.05/$0.1) - 2023/04/08 19:56:10
Table 'RushAndCash3756828' 6-max Seat #1 is the button
Seat 1: cfb1699 ($10.59 in chips)
Seat 2: 94e382b0 ($2.65 in chips)
Seat 3: Hero ($15.47 in chips)
Seat 4: f4fbd3ee ($24.14 in chips)
Seat 5: 1a384da3 ($14 in chips)
Seat 6: f539b9d9 ($32.39 in chips)
94e382b0: posts small blind $0.05
Hero: posts big blind $0.1
*** HOLE CARDS ***
Dealt to cfb1699 
Dealt to 94e382b0 
Dealt to Hero [8c 4h]
Dealt to f4fbd3ee 
Dealt to 1a384da3 
Dealt to f539b9d9 
f4fbd3ee: folds
1a384da3: raises $0.15 to $0.25
f539b9d9: folds
cfb1699: raises $0.65 to $0.9
94e382b0: folds
Hero: folds
1a384da3: raises $1.8 to $2.7
cfb1699: raises $7.89 to $10.59 and is all-in
1a384da3: calls $7.89
cfb1699: shows [Jh Jc]
1a384da3: shows [Kd As]
*** FLOP *** [4c 2s 8h]
*** TURN *** [4c 2s 8h] [3s]
*** RIVER *** [4c 2s 8h 3s] [Ad]
*** SHOWDOWN ***
1a384da3 collected $20.88 from pot
*** SUMMARY ***
Total pot $21.33 | Rake $0.3 | Jackpot $0.15 | Bingo $0 | Fortune $0
Board [4c 2s 8h 3s Ad]
Seat 1: cfb1699 (button) showed [Jh Jc] and lost with Pair of Jacks
Seat 2: 94e382b0 (small blind) folded before Flop
Seat 3: Hero (big blind) folded before Flop
Seat 4: f4fbd3ee folded before Flop (didn't bet)
Seat 5: 1a384da3 showed [Kd As] and won ($20.88) with Pair of Aces
Seat 6: f539b9d9 folded before Flop (didn't bet)


Poker Hand #RC1459831519: Hold'em No Limit  ($0.05/$0.1) - 2023/04/08 19:56:03
Table 'RushAndCash3756779' 6-max Seat #1 is the button
Seat 1: e8dad1c8 ($29.7 in chips)
Seat 2: 1409c15 ($22.87 in chips)
Seat 3: 6e1e4de0 ($14.73 in chips)
Seat 4: Hero ($15.47 in chips)
Seat 5: c89af454 ($10.49 in chips)
Seat 6: 137b9e7f ($11.2 in chips)
1409c15: posts small blind $0.05
6e1e4de0: posts big blind $0.1
*** HOLE CARDS ***
Dealt to e8dad1c8 
Dealt to 1409c15 
Dealt to 6e1e4de0 
Dealt to Hero [7h 5s]
Dealt to c89af454 
Dealt to 137b9e7f 
Hero: folds
c89af454: folds
137b9e7f: folds
e8dad1c8: raises $0.15 to $0.25
1409c15: raises $0.95 to $1.2
6e1e4de0: folds
e8dad1c8: folds
Uncalled bet ($0.95) returned to 1409c15
*** SHOWDOWN ***
1409c15 collected $0.57 from pot
*** SUMMARY ***
Total pot $0.6 | Rake $0.03 | Jackpot $0 | Bingo $0 | Fortune $0
Seat 1: e8dad1c8 (button) folded before Flop
Seat 2: 1409c15 (small blind) collected ($0.57)
Seat 3: 6e1e4de0 (big blind) folded before Flop
Seat 4: Hero folded before Flop (didn't bet)
Seat 5: c89af454 folded before Flop (didn't bet)
Seat 6: 137b9e7f folded before Flop (didn't bet)


Poker Hand #RC1459831497: Hold'em No Limit  ($0.05/$0.1) - 2023/04/08 19:55:58
Table 'RushAndCash3756757' 6-max Seat #1 is the button
Seat 1: 3d2dccb0 ($10 in chips)
Seat 2: 7f958c6d ($11.2 in chips)
Seat 3: bb0e2d3 ($10.64 in chips)
Seat 4: 2acb4590 ($11.5 in chips)
Seat 5: 6cfd1702 ($15.17 in chips)
Seat 6: Hero ($15.47 in chips)
7f958c6d: posts small blind $0.05
bb0e2d3: posts big blind $0.1
*** HOLE CARDS ***
Dealt to 3d2dccb0 
Dealt to 7f958c6d 
Dealt to bb0e2d3 
Dealt to 2acb4590 
Dealt to 6cfd1702 
Dealt to Hero [9s 6c]
2acb4590: folds
6cfd1702: folds
Hero: folds
3d2dccb0: folds
7f958c6d: raises $0.2 to $0.3
bb0e2d3: folds
Uncalled bet ($0.2) returned to 7f958c6d
*** SHOWDOWN ***
7f958c6d collected $0.2 from pot
*** SUMMARY ***
Total pot $0.2 | Rake $0 | Jackpot $0 | Bingo $0 | Fortune $0
Seat 1: 3d2dccb0 (button) folded before Flop (didn't bet)
Seat 2: 7f958c6d (small blind) collected ($0.2)
Seat 3: bb0e2d3 (big blind) folded before Flop
Seat 4: 2acb4590 folded before Flop (didn't bet)
Seat 5: 6cfd1702 folded before Flop (didn't bet)
Seat 6: Hero folded before Flop (didn't bet)


Poker Hand #RC1459831468: Hold'em No Limit  ($0.05/$0.1) - 2023/04/08 19:55:54
Table 'RushAndCash3756728' 6-max Seat #1 is the button
Seat 1: 5fb1c534 ($13.72 in chips)
Seat 2: Hero ($15.52 in chips)
Seat 3: 32eaf87d ($16.97 in chips)
Seat 4: 54f59ada ($13.47 in chips)
Seat 5: f4ea9ac9 ($13.08 in chips)
Seat 6: f27e3a8c ($10.98 in chips)
Hero: posts small blind $0.05
32eaf87d: posts big blind $0.1
*** HOLE CARDS ***
Dealt to 5fb1c534 
Dealt to Hero [4s 7h]
Dealt to 32eaf87d 
Dealt to 54f59ada 
Dealt to f4ea9ac9 
Dealt to f27e3a8c 
54f59ada: folds
f4ea9ac9: folds
f27e3a8c: raises $0.2 to $0.3
5fb1c534: folds
Hero: folds
32eaf87d: folds
Uncalled bet ($0.2) returned to f27e3a8c
*** SHOWDOWN ***
f27e3a8c collected $0.25 from pot
*** SUMMARY ***
Total pot $0.25 | Rake $0 | Jackpot $0 | Bingo $0 | Fortune $0
Seat 1: 5fb1c534 (button) folded before Flop (didn't bet)
Seat 2: Hero (small blind) folded before Flop
Seat 3: 32eaf87d (big blind) folded before Flop
Seat 4: 54f59ada folded before Flop (didn't bet)
Seat 5: f4ea9ac9 folded before Flop (didn't bet)
Seat 6: f27e3a8c collected ($0.25)


Poker Hand #RC1459831440: Hold'em No Limit  ($0.05/$0.1) - 2023/04/08 19:55:50
Table 'RushAndCash3756700' 6-max Seat #1 is the button
Seat 1: Hero ($15.52 in chips)
Seat 2: 4117f135 ($10.6 in chips)
Seat 3: 583bb900 ($17.75 in chips)
Seat 4: fa1722a8 ($19.18 in chips)
Seat 5: bfced173 ($10 in chips)
Seat 6: bd3fac4b ($10 in chips)
4117f135: posts small blind $0.05
583bb900: posts big blind $0.1
*** HOLE CARDS ***
Dealt to Hero [3d 4s]
Dealt to 4117f135 
Dealt to 583bb900 
Dealt to fa1722a8 
Dealt to bfced173 
Dealt to bd3fac4b 
fa1722a8: folds
bfced173: folds
bd3fac4b: folds
Hero: folds
4117f135: raises $0.2 to $0.3
583bb900: folds
Uncalled bet ($0.2) returned to 4117f135
*** SHOWDOWN ***
4117f135 collected $0.2 from pot
*** SUMMARY ***
Total pot $0.2 | Rake $0 | Jackpot $0 | Bingo $0 | Fortune $0
Seat 1: Hero (button) folded before Flop (didn't bet)
Seat 2: 4117f135 (small blind) collected ($0.2)
Seat 3: 583bb900 (big blind) folded before Flop
Seat 4: fa1722a8 folded before Flop (didn't bet)
Seat 5: bfced173 folded before Flop (didn't bet)
Seat 6: bd3fac4b folded before Flop (didn't bet)


Poker Hand #RC1459831213: Hold'em No Limit  ($0.05/$0.1) - 2023/04/08 19:55:14
Table 'RushAndCash3756473' 6-max Seat #1 is the button
Seat 1: bee41a8b ($80.31 in chips)
Seat 2: b9b2d0f9 ($10 in chips)
Seat 3: 77f0e356 ($9.63 in chips)
Seat 4: Hero ($16.12 in chips)
Seat 5: d0399322 ($6.67 in chips)
Seat 6: 979ebe36 ($19.55 in chips)
b9b2d0f9: posts small blind $0.05
77f0e356: posts big blind $0.1
*** HOLE CARDS ***
Dealt to bee41a8b 
Dealt to b9b2d0f9 
Dealt to 77f0e356 
Dealt to Hero [Jd Td]
Dealt to d0399322 
Dealt to 979ebe36 
Hero: raises $0.15 to $0.25
d0399322: folds
979ebe36: folds
bee41a8b: folds
b9b2d0f9: folds
77f0e356: raises $0.35 to $0.6
Hero: calls $0.35
*** FLOP *** [2d 6s Qc]
77f0e356: bets $0.94
Hero: folds
Uncalled bet ($0.94) returned to 77f0e356
*** SHOWDOWN ***
77f0e356 collected $1.19 from pot
*** SUMMARY ***
Total pot $1.25 | Rake $0.06 | Jackpot $0 | Bingo $0 | Fortune $0
Board [2d 6s Qc]
Seat 1: bee41a8b (button) folded before Flop (didn't bet)
Seat 2: b9b2d0f9 (small blind) folded before Flop
Seat 3: 77f0e356 (big blind) won ($1.19)
Seat 4: Hero folded on the Flop
Seat 5: d0399322 folded before Flop (didn't bet)
Seat 6: 979ebe36 folded before Flop (didn't bet)


Poker Hand #RC1459831176: Hold'em No Limit  ($0.05/$0.1) - 2023/04/08 19:55:08
Table 'RushAndCash3756436' 6-max Seat #1 is the button
Seat 1: 264b4dc3 ($7.68 in chips)
Seat 2: 6ffc727b ($43.62 in chips)
Seat 3: 7c703fc4 ($44.42 in chips)
Seat 4: 38bd8899 ($30.85 in chips)
Seat 5: Hero ($16.12 in chips)
Seat 6: d7a2a631 ($23.98 in chips)
6ffc727b: posts small blind $0.05
7c703fc4: posts big blind $0.1
*** HOLE CARDS ***
Dealt to 264b4dc3 
Dealt to 6ffc727b 
Dealt to 7c703fc4 
Dealt to 38bd8899 
Dealt to Hero [5s Jh]
Dealt to d7a2a631 
38bd8899: folds
Hero: folds
d7a2a631: raises $0.15 to $0.25
264b4dc3: folds
6ffc727b: folds
7c703fc4: folds
Uncalled bet ($0.15) returned to d7a2a631
*** SHOWDOWN ***
d7a2a631 collected $0.25 from pot
*** SUMMARY ***
Total pot $0.25 | Rake $0 | Jackpot $0 | Bingo $0 | Fortune $0
Seat 1: 264b4dc3 (button) folded before Flop (didn't bet)
Seat 2: 6ffc727b (small blind) folded before Flop
Seat 3: 7c703fc4 (big blind) folded before Flop
Seat 4: 38bd8899 folded before Flop (didn't bet)
Seat 5: Hero folded before Flop (didn't bet)
Seat 6: d7a2a631 collected ($0.25)


Poker Hand #RC1459831149: Hold'em No Limit  ($0.05/$0.1) - 2023/04/08 19:55:04
Table 'RushAndCash3756409' 6-max Seat #1 is the button
Seat 1: d9ebb3cc ($18.54 in chips)
Seat 2: Hero ($16.02 in chips)
Seat 3: efe8777f ($10 in chips)
Seat 4: 5a721ebb ($10 in chips)
Seat 5: fff78e2 ($18.59 in chips)
Seat 6: 76e126c5 ($10 in chips)
Hero: posts small blind $0.05
efe8777f: posts big blind $0.1
*** HOLE CARDS ***
Dealt to d9ebb3cc 
Dealt to Hero [Jc 5s]
Dealt to efe8777f 
Dealt to 5a721ebb 
Dealt to fff78e2 
Dealt to 76e126c5 
5a721ebb: folds
fff78e2: folds
76e126c5: folds
d9ebb3cc: raises $0.15 to $0.25
Hero: folds
efe8777f: folds
Uncalled bet ($0.15) returned to d9ebb3cc
*** SHOWDOWN ***
d9ebb3cc collected $0.25 from pot
*** SUMMARY ***
Total pot $0.25 | Rake $0 | Jackpot $0 | Bingo $0 | Fortune $0
Seat 1: d9ebb3cc (button) collected ($0.25)
Seat 2: Hero (small blind) folded before Flop
Seat 3: efe8777f (big blind) folded before Flop
Seat 4: 5a721ebb folded before Flop (didn't bet)
Seat 5: fff78e2 folded before Flop (didn't bet)
Seat 6: 76e126c5 folded before Flop (didn't bet)


Poker Hand #RC1459831080: Hold'em No Limit  ($0.05/$0.1) - 2023/04/08 19:54:54
Table 'RushAndCash3756340' 6-max Seat #1 is the button
Seat 1: 5994ee06 ($15.74 in chips)
Seat 2: 938e46a9 ($30.13 in chips)
Seat 3: Hero ($16.12 in chips)
Seat 4: aebf96eb ($40.64 in chips)
Seat 5: a51368ca ($24.55 in chips)
Seat 6: e6f8b112 ($11.99 in chips)
938e46a9: posts small blind $0.05
Hero: posts big blind $0.1
*** HOLE CARDS ***
Dealt to 5994ee06 
Dealt to 938e46a9 
Dealt to Hero [7h Kc]
Dealt to aebf96eb 
Dealt to a51368ca 
Dealt to e6f8b112 
aebf96eb: folds
a51368ca: folds
e6f8b112: folds
5994ee06: folds
938e46a9: folds
Uncalled bet ($0.05) returned to Hero
*** SHOWDOWN ***
Hero collected $0.1 from pot
*** SUMMARY ***
Total pot $0.1 | Rake $0 | Jackpot $0 | Bingo $0 | Fortune $0
Seat 1: 5994ee06 (button) folded before Flop (didn't bet)
Seat 2: 938e46a9 (small blind) folded before Flop
Seat 3: Hero (big blind) collected ($0.1)
Seat 4: aebf96eb folded before Flop (didn't bet)
Seat 5: a51368ca folded before Flop (didn't bet)
Seat 6: e6f8b112 folded before Flop (didn't bet)


Poker Hand #RC1459831023: Hold'em No Limit  ($0.05/$0.1) - 2023/04/08 19:54:45
Table 'RushAndCash3756283' 6-max Seat #1 is the button
Seat 1: Hero ($16.12 in chips)
Seat 2: d12b384c ($5.55 in chips)
Seat 3: bf9dc4c2 ($30.24 in chips)
Seat 4: a8745400 ($23.9 in chips)
Seat 5: d8910378 ($12.68 in chips)
Seat 6: e790267c ($21.65 in chips)
d12b384c: posts small blind $0.05
bf9dc4c2: posts big blind $0.1
*** HOLE CARDS ***
Dealt to Hero [9d Jc]
Dealt to d12b384c 
Dealt to bf9dc4c2 
Dealt to a8745400 
Dealt to d8910378 
Dealt to e790267c 
a8745400: folds
d8910378: folds
e790267c: folds
Hero: folds
d12b384c: raises $0.2 to $0.3
bf9dc4c2: raises $0.75 to $1.05
d12b384c: calls $0.75
*** FLOP *** [6h 4c 4h]
d12b384c: checks
bf9dc4c2: bets $2.63
d12b384c: calls $2.63
*** TURN *** [6h 4c 4h] [7d]
d12b384c: checks
bf9dc4c2: bets $3.68
d12b384c: calls $1.87 and is all-in
Uncalled bet ($1.81) returned to bf9dc4c2
bf9dc4c2: shows [Ks Kc] (Pair of Kings and Pair of Fours)
d12b384c: shows [5h 4d] (Three Fours)
*** RIVER *** [6h 4c 4h 7d] [Qd]
*** SHOWDOWN ***
d12b384c collected $10.45 from pot
*** SUMMARY ***
Total pot $11.1 | Rake $0.5 | Jackpot $0.15 | Bingo $0 | Fortune $0
Board [6h 4c 4h 7d Qd]
Seat 1: Hero (button) folded before Flop (didn't bet)
Seat 2: d12b384c (small blind) showed [5h 4d] and won ($10.45) with Three Fours
Seat 3: bf9dc4c2 (big blind) showed [Ks Kc] and lost with Pair of Kings and Pair of Fours
Seat 4: a8745400 folded before Flop (didn't bet)
Seat 5: d8910378 folded before Flop (didn't bet)
Seat 6: e790267c folded before Flop (didn't bet)


Poker Hand #RC1459830990: Hold'em No Limit  ($0.05/$0.1) - 2023/04/08 19:54:41
Table 'RushAndCash3756250' 6-max Seat #1 is the button
Seat 1: 556685d2 ($32.38 in chips)
Seat 2: 3b82629e ($10.07 in chips)
Seat 3: 10af315d ($9.4 in chips)
Seat 4: 92c0e194 ($12.95 in chips)
Seat 5: Hero ($16.12 in chips)
Seat 6: 39ffd2ac ($26.36 in chips)
3b82629e: posts small blind $0.05
10af315d: posts big blind $0.1
*** HOLE CARDS ***
Dealt to 556685d2 
Dealt to 3b82629e 
Dealt to 10af315d 
Dealt to 92c0e194 
Dealt to Hero [4d Ts]
Dealt to 39ffd2ac 
92c0e194: folds
Hero: folds
39ffd2ac: folds
556685d2: folds
3b82629e: folds
Uncalled bet ($0.05) returned to 10af315d
*** SHOWDOWN ***
10af315d collected $0.1 from pot
*** SUMMARY ***
Total pot $0.1 | Rake $0 | Jackpot $0 | Bingo $0 | Fortune $0
Seat 1: 556685d2 (button) folded before Flop (didn't bet)
Seat 2: 3b82629e (small blind) folded before Flop
Seat 3: 10af315d (big blind) collected ($0.1)
Seat 4: 92c0e194 folded before Flop (didn't bet)
Seat 5: Hero folded before Flop (didn't bet)
Seat 6: 39ffd2ac folded before Flop (didn't bet)


Poker Hand #RC1459830957: Hold'em No Limit  ($0.05/$0.1) - 2023/04/08 19:54:36
Table 'RushAndCash3756217' 6-max Seat #1 is the button
Seat 1: 39ffd2ac ($26.36 in chips)
Seat 2: 54f59ada ($13.37 in chips)
Seat 3: 7340f470 ($34.4 in chips)
Seat 4: Hero ($16.12 in chips)
Seat 5: 1bfa2794 ($10 in chips)
Seat 6: c9d82476 ($9.93 in chips)
54f59ada: posts small blind $0.05
7340f470: posts big blind $0.1
*** HOLE CARDS ***
Dealt to 39ffd2ac 
Dealt to 54f59ada 
Dealt to 7340f470 
Dealt to Hero [Ks 3s]
Dealt to 1bfa2794 
Dealt to c9d82476 
Hero: folds
1bfa2794: folds
c9d82476: raises $0.13 to $0.23
39ffd2ac: folds
54f59ada: folds
7340f470: folds
Uncalled bet ($0.13) returned to c9d82476
*** SHOWDOWN ***
c9d82476 collected $0.25 from pot
*** SUMMARY ***
Total pot $0.25 | Rake $0 | Jackpot $0 | Bingo $0 | Fortune $0
Seat 1: 39ffd2ac (button) folded before Flop (didn't bet)
Seat 2: 54f59ada (small blind) folded before Flop
Seat 3: 7340f470 (big blind) folded before Flop
Seat 4: Hero folded before Flop (didn't bet)
Seat 5: 1bfa2794 folded before Flop (didn't bet)
Seat 6: c9d82476 collected ($0.25)


Poker Hand #RC1459830922: Hold'em No Limit  ($0.05/$0.1) - 2023/04/08 19:54:31
Table 'RushAndCash3756182' 6-max Seat #1 is the button
Seat 1: d214585c ($20.37 in chips)
Seat 2: bee41a8b ($80.56 in chips)
Seat 3: e1f119ce ($22.23 in chips)
Seat 4: Hero ($16.12 in chips)
Seat 5: 9612ff88 ($11.07 in chips)
Seat 6: e918bbff ($7.33 in chips)
bee41a8b: posts small blind $0.05
e1f119ce: posts big blind $0.1
*** HOLE CARDS ***
Dealt to d214585c 
Dealt to bee41a8b 
Dealt to e1f119ce 
Dealt to Hero [9c Th]
Dealt to 9612ff88 
Dealt to e918bbff 
Hero: folds
9612ff88: raises $0.15 to $0.25
e918bbff: folds
d214585c: folds
bee41a8b: calls $0.2
e1f119ce: calls $0.15
*** FLOP *** [4s 3c 5s]
bee41a8b: checks
e1f119ce: checks
9612ff88: bets $0.2
bee41a8b: folds
e1f119ce: raises $0.6 to $0.8
9612ff88: calls $0.6
*** TURN *** [4s 3c 5s] [Jc]
e1f119ce: checks
9612ff88: checks
*** RIVER *** [4s 3c 5s Jc] [Jd]
e1f119ce: bets $1.8
9612ff88: folds
Uncalled bet ($1.8) returned to e1f119ce
*** SHOWDOWN ***
e1f119ce collected $2.24 from pot
*** SUMMARY ***
Total pot $2.35 | Rake $0.11 | Jackpot $0 | Bingo $0 | Fortune $0
Board [4s 3c 5s Jc Jd]
Seat 1: d214585c (button) folded before Flop (didn't bet)
Seat 2: bee41a8b (small blind) folded on the Flop
Seat 3: e1f119ce (big blind) won ($2.24)
Seat 4: Hero folded before Flop (didn't bet)
Seat 5: 9612ff88 folded on the River
Seat 6: e918bbff folded before Flop (didn't bet)


Poker Hand #RC1459830868: Hold'em No Limit  ($0.05/$0.1) - 2023/04/08 19:54:23
Table 'RushAndCash3756128' 6-max Seat #1 is the button
Seat 1: d6bf14bd ($15.35 in chips)
Seat 2: cd80bf76 ($10.05 in chips)
Seat 3: ca0ac342 ($19.44 in chips)
Seat 4: a02f13bb ($33.45 in chips)
Seat 5: Hero ($16.12 in chips)
Seat 6: 9ec053d2 ($50.09 in chips)
cd80bf76: posts small blind $0.05
ca0ac342: posts big blind $0.1
*** HOLE CARDS ***
Dealt to d6bf14bd 
Dealt to cd80bf76 
Dealt to ca0ac342 
Dealt to a02f13bb 
Dealt to Hero [Ks 5s]
Dealt to 9ec053d2 
a02f13bb: folds
Hero: folds
9ec053d2: folds
d6bf14bd: folds
cd80bf76: raises $0.2 to $0.3
ca0ac342: raises $0.7 to $1
cd80bf76: raises $1.6 to $2.6
ca0ac342: calls $1.6
*** FLOP *** [Qs 2d 3d]
cd80bf76: checks
ca0ac342: checks
*** TURN *** [Qs 2d 3d] [3c]
cd80bf76: checks
ca0ac342: bets $1.62
cd80bf76: folds
Uncalled bet ($1.62) returned to ca0ac342
*** SHOWDOWN ***
ca0ac342 collected $4.8 from pot
*** SUMMARY ***
Total pot $5.2 | Rake $0.25 | Jackpot $0.15 | Bingo $0 | Fortune $0
Board [Qs 2d 3d 3c]
Seat 1: d6bf14bd (button) folded before Flop (didn't bet)
Seat 2: cd80bf76 (small blind) folded on the Turn
Seat 3: ca0ac342 (big blind) won ($4.8)
Seat 4: a02f13bb folded before Flop (didn't bet)
Seat 5: Hero folded before Flop (didn't bet)
Seat 6: 9ec053d2 folded before Flop (didn't bet)


Poker Hand #RC1459830779: Hold'em No Limit  ($0.05/$0.1) - 2023/04/08 19:54:11
Table 'RushAndCash3756039' 6-max Seat #1 is the button
Seat 1: 2164d54c ($27.14 in chips)
Seat 2: 9d55ce9b ($8.36 in chips)
Seat 3: Hero ($16.22 in chips)
Seat 4: 38c45073 ($31.99 in chips)
Seat 5: dc525443 ($32.4 in chips)
Seat 6: ee2ca6e ($10 in chips)
9d55ce9b: posts small blind $0.05
Hero: posts big blind $0.1
*** HOLE CARDS ***
Dealt to 2164d54c 
Dealt to 9d55ce9b 
Dealt to Hero [5h Qh]
Dealt to 38c45073 
Dealt to dc525443 
Dealt to ee2ca6e 
38c45073: folds
dc525443: folds
ee2ca6e: raises $0.13 to $0.23
2164d54c: folds
9d55ce9b: folds
Hero: folds
Uncalled bet ($0.13) returned to ee2ca6e
*** SHOWDOWN ***
ee2ca6e collected $0.25 from pot
*** SUMMARY ***
Total pot $0.25 | Rake $0 | Jackpot $0 | Bingo $0 | Fortune $0
Seat 1: 2164d54c (button) folded before Flop (didn't bet)
Seat 2: 9d55ce9b (small blind) folded before Flop
Seat 3: Hero (big blind) folded before Flop
Seat 4: 38c45073 folded before Flop (didn't bet)
Seat 5: dc525443 folded before Flop (didn't bet)
Seat 6: ee2ca6e collected ($0.25)


Poker Hand #RC1459830565: Hold'em No Limit  ($0.05/$0.1) - 2023/04/08 19:53:42
Table 'RushAndCash3755825' 6-max Seat #1 is the button
Seat 1: Hero ($17.02 in chips)
Seat 2: e414f212 ($34.05 in chips)
Seat 3: 38c45073 ($31.23 in chips)
Seat 4: 67a801cb ($10 in chips)
Seat 5: 556685d2 ($32.53 in chips)
Seat 6: 595c378c ($8.2 in chips)
e414f212: posts small blind $0.05
38c45073: posts big blind $0.1
*** HOLE CARDS ***
Dealt to Hero [Kd Jc]
Dealt to e414f212 
Dealt to 38c45073 
Dealt to 67a801cb 
Dealt to 556685d2 
Dealt to 595c378c 
67a801cb: folds
556685d2: folds
595c378c: folds
Hero: raises $0.15 to $0.25
e414f212: folds
38c45073: raises $0.55 to $0.8
Hero: calls $0.55
*** FLOP *** [Qh 7c 8s]
38c45073: bets $0.55
Hero: folds
Uncalled bet ($0.55) returned to 38c45073
*** SHOWDOWN ***
38c45073 collected $1.56 from pot
*** SUMMARY ***
Total pot $1.65 | Rake $0.09 | Jackpot $0 | Bingo $0 | Fortune $0
Board [Qh 7c 8s]
Seat 1: Hero (button) folded on the Flop
Seat 2: e414f212 (small blind) folded before Flop
Seat 3: 38c45073 (big blind) won ($1.56)
Seat 4: 67a801cb folded before Flop (didn't bet)
Seat 5: 556685d2 folded before Flop (didn't bet)
Seat 6: 595c378c folded before Flop (didn't bet)


Poker Hand #RC1459830438: Hold'em No Limit  ($0.05/$0.1) - 2023/04/08 19:53:25
Table 'RushAndCash3755698' 6-max Seat #1 is the button
Seat 1: 83fce378 ($41.26 in chips)
Seat 2: Hero ($17.07 in chips)
Seat 3: c9e32a1d ($16.33 in chips)
Seat 4: d323ad9c ($10 in chips)
Seat 5: c6dcf84b ($10 in chips)
Seat 6: 500fa304 ($49.3 in chips)
Hero: posts small blind $0.05
c9e32a1d: posts big blind $0.1
*** HOLE CARDS ***
Dealt to 83fce378 
Dealt to Hero [5h 3h]
Dealt to c9e32a1d 
Dealt to d323ad9c 
Dealt to c6dcf84b 
Dealt to 500fa304 
d323ad9c: folds
c6dcf84b: raises $0.12 to $0.22
500fa304: folds
83fce378: raises $0.83 to $1.05
Hero: folds
c9e32a1d: folds
c6dcf84b: folds
Uncalled bet ($0.83) returned to 83fce378
*** SHOWDOWN ***
83fce378 collected $0.56 from pot
*** SUMMARY ***
Total pot $0.59 | Rake $0.03 | Jackpot $0 | Bingo $0 | Fortune $0
Seat 1: 83fce378 (button) collected ($0.56)
Seat 2: Hero (small blind) folded before Flop
Seat 3: c9e32a1d (big blind) folded before Flop
Seat 4: d323ad9c folded before Flop (didn't bet)
Seat 5: c6dcf84b folded before Flop
Seat 6: 500fa304 folded before Flop (didn't bet)


Poker Hand #RC1459830401: Hold'em No Limit  ($0.05/$0.1) - 2023/04/08 19:53:20
Table 'RushAndCash3755661' 6-max Seat #1 is the button
Seat 1: 3844ea66 ($5.03 in chips)
Seat 2: cb2f1158 ($12.53 in chips)
Seat 3: cbb4dd63 ($28.25 in chips)
Seat 4: Hero ($17.07 in chips)
Seat 5: 14165a66 ($10.56 in chips)
Seat 6: a9399dc0 ($10.1 in chips)
cb2f1158: posts small blind $0.05
cbb4dd63: posts big blind $0.1
*** HOLE CARDS ***
Dealt to 3844ea66 
Dealt to cb2f1158 
Dealt to cbb4dd63 
Dealt to Hero [8c Ad]
Dealt to 14165a66 
Dealt to a9399dc0 
Hero: folds
14165a66: folds
a9399dc0: folds
3844ea66: raises $0.15 to $0.25
cb2f1158: folds
cbb4dd63: folds
Uncalled bet ($0.15) returned to 3844ea66
*** SHOWDOWN ***
3844ea66 collected $0.25 from pot
*** SUMMARY ***
Total pot $0.25 | Rake $0 | Jackpot $0 | Bingo $0 | Fortune $0
Seat 1: 3844ea66 (button) collected ($0.25)
Seat 2: cb2f1158 (small blind) folded before Flop
Seat 3: cbb4dd63 (big blind) folded before Flop
Seat 4: Hero folded before Flop (didn't bet)
Seat 5: 14165a66 folded before Flop (didn't bet)
Seat 6: a9399dc0 folded before Flop (didn't bet)


Poker Hand #RC1459830356: Hold'em No Limit  ($0.05/$0.1) - 2023/04/08 19:53:14
Table 'RushAndCash3755616' 6-max Seat #1 is the button
Seat 1: 92a48d51 ($11.93 in chips)
Seat 2: 264b4dc3 ($8.21 in chips)
Seat 3: ed2461d3 ($20.41 in chips)
Seat 4: Hero ($17.07 in chips)
Seat 5: c9d82476 ($10 in chips)
Seat 6: 8b84b27b ($10.3 in chips)
264b4dc3: posts small blind $0.05
ed2461d3: posts big blind $0.1
*** HOLE CARDS ***
Dealt to 92a48d51 
Dealt to 264b4dc3 
Dealt to ed2461d3 
Dealt to Hero [5c Ad]
Dealt to c9d82476 
Dealt to 8b84b27b 
Hero: folds
c9d82476: folds
8b84b27b: folds
92a48d51: folds
264b4dc3: folds
Uncalled bet ($0.05) returned to ed2461d3
*** SHOWDOWN ***
ed2461d3 collected $0.1 from pot
*** SUMMARY ***
Total pot $0.1 | Rake $0 | Jackpot $0 | Bingo $0 | Fortune $0
Seat 1: 92a48d51 (button) folded before Flop (didn't bet)
Seat 2: 264b4dc3 (small blind) folded before Flop
Seat 3: ed2461d3 (big blind) collected ($0.1)
Seat 4: Hero folded before Flop (didn't bet)
Seat 5: c9d82476 folded before Flop (didn't bet)
Seat 6: 8b84b27b folded before Flop (didn't bet)


Poker Hand #RC1459830324: Hold'em No Limit  ($0.05/$0.1) - 2023/04/08 19:53:10
Table 'RushAndCash3755584' 6-max Seat #1 is the button
Seat 1: 2f3c8996 ($11.44 in chips)
Seat 2: Hero ($17.12 in chips)
Seat 3: 587a017c ($109.85 in chips)
Seat 4: 8766a2b ($10.15 in chips)
Seat 5: eb3a6963 ($22.2 in chips)
Seat 6: d7a2a631 ($24.28 in chips)
Hero: posts small blind $0.05
587a017c: posts big blind $0.1
*** HOLE CARDS ***
Dealt to 2f3c8996 
Dealt to Hero [4c 8h]
Dealt to 587a017c 
Dealt to 8766a2b 
Dealt to eb3a6963 
Dealt to d7a2a631 
8766a2b: raises $0.16 to $0.26
eb3a6963: raises $0.54 to $0.8
d7a2a631: folds
2f3c8996: folds
Hero: folds
587a017c: folds
8766a2b: calls $0.54
*** FLOP *** [Kh 5d Th]
8766a2b: checks
eb3a6963: bets $0.58
8766a2b: raises $1.61 to $2.19
eb3a6963: calls $1.61
*** TURN *** [Kh 5d Th] [Ad]
8766a2b: bets $2.15
eb3a6963: raises $10.43 to $12.58
8766a2b: calls $5.01 and is all-in
Uncalled bet ($5.42) returned to eb3a6963
eb3a6963: shows [Kd Kc] (Three Kings)
8766a2b: shows [5h 5s] (Three Fives)
*** RIVER *** [Kh 5d Th Ad] [2h]
*** SHOWDOWN ***
eb3a6963 collected $20 from pot
*** SUMMARY ***
Total pot $20.45 | Rake $0.3 | Jackpot $0.15 | Bingo $0 | Fortune $0
Board [Kh 5d Th Ad 2h]
Seat 1: 2f3c8996 (button) folded before Flop (didn't bet)
Seat 2: Hero (small blind) folded before Flop
Seat 3: 587a017c (big blind) folded before Flop
Seat 4: 8766a2b showed [5h 5s] and lost with Three Fives
Seat 5: eb3a6963 showed [Kd Kc] and won ($20) with Three Kings
Seat 6: d7a2a631 folded before Flop (didn't bet)


Poker Hand #RC1459830198: Hold'em No Limit  ($0.05/$0.1) - 2023/04/08 19:52:53
Table 'RushAndCash3755458' 6-max Seat #1 is the button
Seat 1: f9390b9f ($10.23 in chips)
Seat 2: bd3fac4b ($10.15 in chips)
Seat 3: f181dc91 ($57.36 in chips)
Seat 4: 3fdcb188 ($11.55 in chips)
Seat 5: d0b73ea6 ($12.94 in chips)
Seat 6: Hero ($16.97 in chips)
bd3fac4b: posts small blind $0.05
f181dc91: posts big blind $0.1
*** HOLE CARDS ***
Dealt to f9390b9f 
Dealt to bd3fac4b 
Dealt to f181dc91 
Dealt to 3fdcb188 
Dealt to d0b73ea6 
Dealt to Hero [Js 9c]
3fdcb188: folds
d0b73ea6: folds
Hero: raises $0.15 to $0.25
f9390b9f: folds
bd3fac4b: folds
f181dc91: folds
Uncalled bet ($0.15) returned to Hero
*** SHOWDOWN ***
Hero collected $0.25 from pot
*** SUMMARY ***
Total pot $0.25 | Rake $0 | Jackpot $0 | Bingo $0 | Fortune $0
Seat 1: f9390b9f (button) folded before Flop (didn't bet)
Seat 2: bd3fac4b (small blind) folded before Flop
Seat 3: f181dc91 (big blind) folded before Flop
Seat 4: 3fdcb188 folded before Flop (didn't bet)
Seat 5: d0b73ea6 folded before Flop (didn't bet)
Seat 6: Hero collected ($0.25)


Poker Hand #RC1459830153: Hold'em No Limit  ($0.05/$0.1) - 2023/04/08 19:52:47
Table 'RushAndCash3755413' 6-max Seat #1 is the button
Seat 1: ed2d1dce ($10.29 in chips)
Seat 2: 6fdc27d7 ($13.12 in chips)
Seat 3: Hero ($17.07 in chips)
Seat 4: 95c94948 ($9.61 in chips)
Seat 5: 1bfa2794 ($10.08 in chips)
Seat 6: 3368ae52 ($18.6 in chips)
6fdc27d7: posts small blind $0.05
Hero: posts big blind $0.1
*** HOLE CARDS ***
Dealt to ed2d1dce 
Dealt to 6fdc27d7 
Dealt to Hero [5c Jh]
Dealt to 95c94948 
Dealt to 1bfa2794 
Dealt to 3368ae52 
95c94948: folds
1bfa2794: folds
3368ae52: folds
ed2d1dce: folds
6fdc27d7: raises $0.2 to $0.3
Hero: folds
Uncalled bet ($0.2) returned to 6fdc27d7
*** SHOWDOWN ***
6fdc27d7 collected $0.2 from pot
*** SUMMARY ***
Total pot $0.2 | Rake $0 | Jackpot $0 | Bingo $0 | Fortune $0
Seat 1: ed2d1dce (button) folded before Flop (didn't bet)
Seat 2: 6fdc27d7 (small blind) collected ($0.2)
Seat 3: Hero (big blind) folded before Flop
Seat 4: 95c94948 folded before Flop (didn't bet)
Seat 5: 1bfa2794 folded before Flop (didn't bet)
Seat 6: 3368ae52 folded before Flop (didn't bet)


Poker Hand #RC1459830062: Hold'em No Limit  ($0.05/$0.1) - 2023/04/08 19:52:34
Table 'RushAndCash3755322' 6-max Seat #1 is the button
Seat 1: Hero ($17.07 in chips)
Seat 2: 42800cf2 ($8.88 in chips)
Seat 3: 3a725736 ($9.43 in chips)
Seat 4: eb650bcd ($10 in chips)
Seat 5: 3844ea66 ($5.03 in chips)
Seat 6: e918bbff ($9.92 in chips)
42800cf2: posts small blind $0.05
3a725736: posts big blind $0.1
*** HOLE CARDS ***
Dealt to Hero [7s 8d]
Dealt to 42800cf2 
Dealt to 3a725736 
Dealt to eb650bcd 
Dealt to 3844ea66 
Dealt to e918bbff 
eb650bcd: folds
3844ea66: folds
e918bbff: raises $0.15 to $0.25
Hero: folds
42800cf2: folds
3a725736: raises $0.75 to $1
e918bbff: calls $0.75
*** FLOP *** [Qd As 5s]
3a725736: bets $0.68
e918bbff: calls $0.68
*** TURN *** [Qd As 5s] [4c]
3a725736: checks
e918bbff: bets $1.13
3a725736: calls $1.13
*** RIVER *** [Qd As 5s 4c] [9d]
3a725736: checks
e918bbff: checks
3a725736: shows [Ks Kc] (Pair of Kings)
e918bbff: shows [Jd Td] (Ace-High)
*** SHOWDOWN ***
3a725736 collected $5.25 from pot
*** SUMMARY ***
Total pot $5.67 | Rake $0.27 | Jackpot $0.15 | Bingo $0 | Fortune $0
Board [Qd As 5s 4c 9d]
Seat 1: Hero (button) folded before Flop (didn't bet)
Seat 2: 42800cf2 (small blind) folded before Flop
Seat 3: 3a725736 (big blind) showed [Ks Kc] and won ($5.25) with Pair of Kings
Seat 4: eb650bcd folded before Flop (didn't bet)
Seat 5: 3844ea66 folded before Flop (didn't bet)
Seat 6: e918bbff showed [Jd Td] and lost with Ace-High


Poker Hand #RC1459829960: Hold'em No Limit  ($0.05/$0.1) - 2023/04/08 19:52:20
Table 'RushAndCash3755220' 6-max Seat #1 is the button
Seat 1: da607e40 ($10 in chips)
Seat 2: 5ef92a1f ($10 in chips)
Seat 3: 3844ea66 ($5.18 in chips)
Seat 4: Hero ($17.07 in chips)
Seat 5: 20e4e3ed ($17.47 in chips)
Seat 6: ae81be6b ($11.13 in chips)
5ef92a1f: posts small blind $0.05
3844ea66: posts big blind $0.1
*** HOLE CARDS ***
Dealt to da607e40 
Dealt to 5ef92a1f 
Dealt to 3844ea66 
Dealt to Hero [7s Jh]
Dealt to 20e4e3ed 
Dealt to ae81be6b 
Hero: folds
20e4e3ed: folds
ae81be6b: folds
da607e40: folds
5ef92a1f: folds
Uncalled bet ($0.05) returned to 3844ea66
*** SHOWDOWN ***
3844ea66 collected $0.1 from pot
*** SUMMARY ***
Total pot $0.1 | Rake $0 | Jackpot $0 | Bingo $0 | Fortune $0
Seat 1: da607e40 (button) folded before Flop (didn't bet)
Seat 2: 5ef92a1f (small blind) folded before Flop
Seat 3: 3844ea66 (big blind) collected ($0.1)
Seat 4: Hero folded before Flop (didn't bet)
Seat 5: 20e4e3ed folded before Flop (didn't bet)
Seat 6: ae81be6b folded before Flop (didn't bet)


Poker Hand #RC1459829852: Hold'em No Limit  ($0.05/$0.1) - 2023/04/08 19:52:03
Table 'RushAndCash3755112' 6-max Seat #1 is the button
Seat 1: 845cd800 ($11.09 in chips)
Seat 2: f91973da ($14.77 in chips)
Seat 3: 8704ba28 ($10.1 in chips)
Seat 4: 95d2128f ($34.39 in chips)
Seat 5: baddceb ($26.97 in chips)
Seat 6: Hero ($17.07 in chips)
f91973da: posts small blind $0.05
8704ba28: posts big blind $0.1
*** HOLE CARDS ***
Dealt to 845cd800 
Dealt to f91973da 
Dealt to 8704ba28 
Dealt to 95d2128f 
Dealt to baddceb 
Dealt to Hero [3c Kc]
95d2128f: folds
baddceb: folds
Hero: folds
845cd800: folds
f91973da: folds
Uncalled bet ($0.05) returned to 8704ba28
*** SHOWDOWN ***
8704ba28 collected $0.1 from pot
*** SUMMARY ***
Total pot $0.1 | Rake $0 | Jackpot $0 | Bingo $0 | Fortune $0
Seat 1: 845cd800 (button) folded before Flop (didn't bet)
Seat 2: f91973da (small blind) folded before Flop
Seat 3: 8704ba28 (big blind) collected ($0.1)
Seat 4: 95d2128f folded before Flop (didn't bet)
Seat 5: baddceb folded before Flop (didn't bet)
Seat 6: Hero folded before Flop (didn't bet)


Poker Hand #RC1459829420: Hold'em No Limit  ($0.05/$0.1) - 2023/04/08 19:50:59
Table 'RushAndCash3754680' 6-max Seat #1 is the button
Seat 1: b6746050 ($81.09 in chips)
Seat 2: b5be15a0 ($11.59 in chips)
Seat 3: Hero ($15.76 in chips)
Seat 4: eaa761fa ($9.98 in chips)
Seat 5: a0a596a7 ($32.12 in chips)
Seat 6: baddceb ($28.37 in chips)
b5be15a0: posts small blind $0.05
Hero: posts big blind $0.1
*** HOLE CARDS ***
Dealt to b6746050 
Dealt to b5be15a0 
Dealt to Hero [Js Ah]
Dealt to eaa761fa 
Dealt to a0a596a7 
Dealt to baddceb 
eaa761fa: folds
a0a596a7: folds
baddceb: raises $0.2 to $0.3
b6746050: folds
b5be15a0: folds
Hero: calls $0.2
*** FLOP *** [Qc Ks Kc]
Hero: checks
baddceb: bets $0.3
Hero: calls $0.3
*** TURN *** [Qc Ks Kc] [Tc]
Hero: checks
baddceb: bets $0.8
Hero: calls $0.8
*** RIVER *** [Qc Ks Kc Tc] [7c]
Hero: bets $0.6
baddceb: folds
Uncalled bet ($0.6) returned to Hero
*** SHOWDOWN ***
Hero collected $2.71 from pot
*** SUMMARY ***
Total pot $2.85 | Rake $0.14 | Jackpot $0 | Bingo $0 | Fortune $0
Board [Qc Ks Kc Tc 7c]
Seat 1: b6746050 (button) folded before Flop (didn't bet)
Seat 2: b5be15a0 (small blind) folded before Flop
Seat 3: Hero (big blind) won ($2.71)
Seat 4: eaa761fa folded before Flop (didn't bet)
Seat 5: a0a596a7 folded before Flop (didn't bet)
Seat 6: baddceb folded on the River


Poker Hand #RC1459829389: Hold'em No Limit  ($0.05/$0.1) - 2023/04/08 19:50:55
Table 'RushAndCash3754649' 6-max Seat #1 is the button
Seat 1: Hero ($15.76 in chips)
Seat 2: 5489eecc ($34.2 in chips)
Seat 3: 2b2f1ff4 ($9.61 in chips)
Seat 4: 7f57e0f9 ($147.12 in chips)
Seat 5: 62eb6051 ($29.88 in chips)
Seat 6: cfa425fc ($11.83 in chips)
5489eecc: posts small blind $0.05
2b2f1ff4: posts big blind $0.1
*** HOLE CARDS ***
Dealt to Hero [3c 9h]
Dealt to 5489eecc 
Dealt to 2b2f1ff4 
Dealt to 7f57e0f9 
Dealt to 62eb6051 
Dealt to cfa425fc 
7f57e0f9: folds
62eb6051: folds
cfa425fc: folds
Hero: folds
5489eecc: folds
Uncalled bet ($0.05) returned to 2b2f1ff4
*** SHOWDOWN ***
2b2f1ff4 collected $0.1 from pot
*** SUMMARY ***
Total pot $0.1 | Rake $0 | Jackpot $0 | Bingo $0 | Fortune $0
Seat 1: Hero (button) folded before Flop (didn't bet)
Seat 2: 5489eecc (small blind) folded before Flop
Seat 3: 2b2f1ff4 (big blind) collected ($0.1)
Seat 4: 7f57e0f9 folded before Flop (didn't bet)
Seat 5: 62eb6051 folded before Flop (didn't bet)
Seat 6: cfa425fc folded before Flop (didn't bet)


Poker Hand #RC1459829358: Hold'em No Limit  ($0.05/$0.1) - 2023/04/08 19:50:51
Table 'RushAndCash3754618' 6-max Seat #1 is the button
Seat 1: cfa425fc ($11.83 in chips)
Seat 2: 58568431 ($18.23 in chips)
Seat 3: 550648a ($11.52 in chips)
Seat 4: Hero ($15.76 in chips)
Seat 5: 74baa6a4 ($19.82 in chips)
Seat 6: 5489eecc ($34.2 in chips)
58568431: posts small blind $0.05
550648a: posts big blind $0.1
*** HOLE CARDS ***
Dealt to cfa425fc 
Dealt to 58568431 
Dealt to 550648a 
Dealt to Hero [Qc 3h]
Dealt to 74baa6a4 
Dealt to 5489eecc 
Hero: folds
74baa6a4: raises $0.15 to $0.25
5489eecc: folds
cfa425fc: folds
58568431: folds
550648a: calls $0.15
*** FLOP *** [8d 2h Qd]
550648a: checks
74baa6a4: bets $0.2
550648a: folds
Uncalled bet ($0.2) returned to 74baa6a4
*** SHOWDOWN ***
74baa6a4 collected $0.53 from pot
*** SUMMARY ***
Total pot $0.55 | Rake $0.02 | Jackpot $0 | Bingo $0 | Fortune $0
Board [8d 2h Qd]
Seat 1: cfa425fc (button) folded before Flop (didn't bet)
Seat 2: 58568431 (small blind) folded before Flop
Seat 3: 550648a (big blind) folded on the Flop
Seat 4: Hero folded before Flop (didn't bet)
Seat 5: 74baa6a4 won ($0.53)
Seat 6: 5489eecc folded before Flop (didn't bet)


Poker Hand #RC1459829303: Hold'em No Limit  ($0.05/$0.1) - 2023/04/08 19:50:44
Table 'RushAndCash3754563' 6-max Seat #1 is the button
Seat 1: 9369fe84 ($10.76 in chips)
Seat 2: Hero ($15.81 in chips)
Seat 3: afad3d85 ($10.13 in chips)
Seat 4: eaf57a38 ($33.21 in chips)
Seat 5: 56fe61f7 ($10.33 in chips)
Seat 6: 74baa6a4 ($19.82 in chips)
Hero: posts small blind $0.05
afad3d85: posts big blind $0.1
*** HOLE CARDS ***
Dealt to 9369fe84 
Dealt to Hero [6s 8d]
Dealt to afad3d85 
Dealt to eaf57a38 
Dealt to 56fe61f7 
Dealt to 74baa6a4 
eaf57a38: raises $0.1 to $0.2
56fe61f7: folds
74baa6a4: folds
9369fe84: raises $0.4 to $0.6
Hero: folds
afad3d85: folds
eaf57a38: folds
Uncalled bet ($0.4) returned to 9369fe84
*** SHOWDOWN ***
9369fe84 collected $0.53 from pot
*** SUMMARY ***
Total pot $0.55 | Rake $0.02 | Jackpot $0 | Bingo $0 | Fortune $0
Seat 1: 9369fe84 (button) collected ($0.53)
Seat 2: Hero (small blind) folded before Flop
Seat 3: afad3d85 (big blind) folded before Flop
Seat 4: eaf57a38 folded before Flop
Seat 5: 56fe61f7 folded before Flop (didn't bet)
Seat 6: 74baa6a4 folded before Flop (didn't bet)


Poker Hand #RC1459829223: Hold'em No Limit  ($0.05/$0.1) - 2023/04/08 19:50:31
Table 'RushAndCash3754483' 6-max Seat #1 is the button
Seat 1: f513fe95 ($10 in chips)
Seat 2: 7aede39c ($6.38 in chips)
Seat 3: Hero ($15.91 in chips)
Seat 4: ef3bd8db ($11.73 in chips)
Seat 5: 1a3b235e ($28.26 in chips)
Seat 6: 9612ff88 ($11.46 in chips)
7aede39c: posts small blind $0.05
Hero: posts big blind $0.1
*** HOLE CARDS ***
Dealt to f513fe95 
Dealt to 7aede39c 
Dealt to Hero [Qs 3s]
Dealt to ef3bd8db 
Dealt to 1a3b235e 
Dealt to 9612ff88 
ef3bd8db: raises $0.1 to $0.2
1a3b235e: folds
9612ff88: folds
f513fe95: folds
7aede39c: folds
Hero: folds
Uncalled bet ($0.1) returned to ef3bd8db
*** SHOWDOWN ***
ef3bd8db collected $0.25 from pot
*** SUMMARY ***
Total pot $0.25 | Rake $0 | Jackpot $0 | Bingo $0 | Fortune $0
Seat 1: f513fe95 (button) folded before Flop (didn't bet)
Seat 2: 7aede39c (small blind) folded before Flop
Seat 3: Hero (big blind) folded before Flop
Seat 4: ef3bd8db collected ($0.25)
Seat 5: 1a3b235e folded before Flop (didn't bet)
Seat 6: 9612ff88 folded before Flop (didn't bet)


Poker Hand #RC1459829193: Hold'em No Limit  ($0.05/$0.1) - 2023/04/08 19:50:28
Table 'RushAndCash3754453' 6-max Seat #1 is the button
Seat 1: cc9732f3 ($10.15 in chips)
Seat 2: 7349886d ($10 in chips)
Seat 3: 44eb8fb ($10 in chips)
Seat 4: Hero ($15.91 in chips)
Seat 5: 5cddb095 ($11.03 in chips)
Seat 6: 96c7183a ($10 in chips)
7349886d: posts small blind $0.05
44eb8fb: posts big blind $0.1
*** HOLE CARDS ***
Dealt to cc9732f3 
Dealt to 7349886d 
Dealt to 44eb8fb 
Dealt to Hero [7d Jc]
Dealt to 5cddb095 
Dealt to 96c7183a 
Hero: folds
5cddb095: folds
96c7183a: folds
cc9732f3: folds
7349886d: folds
Uncalled bet ($0.05) returned to 44eb8fb
*** SHOWDOWN ***
44eb8fb collected $0.1 from pot
*** SUMMARY ***
Total pot $0.1 | Rake $0 | Jackpot $0 | Bingo $0 | Fortune $0
Seat 1: cc9732f3 (button) folded before Flop (didn't bet)
Seat 2: 7349886d (small blind) folded before Flop
Seat 3: 44eb8fb (big blind) collected ($0.1)
Seat 4: Hero folded before Flop (didn't bet)
Seat 5: 5cddb095 folded before Flop (didn't bet)
Seat 6: 96c7183a folded before Flop (didn't bet)


Poker Hand #RC1459829161: Hold'em No Limit  ($0.05/$0.1) - 2023/04/08 19:50:22
Table 'RushAndCash3754421' 6-max Seat #1 is the button
Seat 1: 8ef0aa95 ($12.02 in chips)
Seat 2: 83fce378 ($39.86 in chips)
Seat 3: d1d2d0a4 ($10.74 in chips)
Seat 4: Hero ($15.91 in chips)
Seat 5: cb2f1158 ($11.8 in chips)
Seat 6: a51368ca ($12.59 in chips)
83fce378: posts small blind $0.05
d1d2d0a4: posts big blind $0.1
*** HOLE CARDS ***
Dealt to 8ef0aa95 
Dealt to 83fce378 
Dealt to d1d2d0a4 
Dealt to Hero [Kc 2d]
Dealt to cb2f1158 
Dealt to a51368ca 
Hero: folds
cb2f1158: folds
a51368ca: folds
8ef0aa95: raises $0.2 to $0.3
83fce378: calls $0.25
d1d2d0a4: raises $1.05 to $1.35
8ef0aa95: calls $1.05
83fce378: folds
*** FLOP *** [Ah 6c 4s]
d1d2d0a4: bets $0.85
8ef0aa95: raises $1.05 to $1.9
d1d2d0a4: raises $3.65 to $5.55
8ef0aa95: folds
Uncalled bet ($3.65) returned to d1d2d0a4
*** SHOWDOWN ***
d1d2d0a4 collected $6.35 from pot
*** SUMMARY ***
Total pot $6.8 | Rake $0.3 | Jackpot $0.15 | Bingo $0 | Fortune $0
Board [Ah 6c 4s]
Seat 1: 8ef0aa95 (button) folded on the Flop
Seat 2: 83fce378 (small blind) folded before Flop
Seat 3: d1d2d0a4 (big blind) won ($6.35)
Seat 4: Hero folded before Flop (didn't bet)
Seat 5: cb2f1158 folded before Flop (didn't bet)
Seat 6: a51368ca folded before Flop (didn't bet)


Poker Hand #RC1459829131: Hold'em No Limit  ($0.05/$0.1) - 2023/04/08 19:50:18
Table 'RushAndCash3754391' 6-max Seat #1 is the button
Seat 1: Hero ($15.91 in chips)
Seat 2: 280b7b ($82.1 in chips)
Seat 3: e0998ea0 ($39.23 in chips)
Seat 4: 4c855208 ($10.15 in chips)
Seat 5: 9c858376 ($10 in chips)
Seat 6: a9d252f2 ($26.97 in chips)
280b7b: posts small blind $0.05
e0998ea0: posts big blind $0.1
*** HOLE CARDS ***
Dealt to Hero [Tc 7h]
Dealt to 280b7b 
Dealt to e0998ea0 
Dealt to 4c855208 
Dealt to 9c858376 
Dealt to a9d252f2 
4c855208: folds
9c858376: raises $0.15 to $0.25
a9d252f2: calls $0.25
Hero: folds
280b7b: folds
e0998ea0: folds
*** FLOP *** [3s 3d 2s]
9c858376: bets $0.33
a9d252f2: calls $0.33
*** TURN *** [3s 3d 2s] [4h]
9c858376: checks
a9d252f2: bets $0.66
9c858376: calls $0.66
*** RIVER *** [3s 3d 2s 4h] [8c]
9c858376: checks
a9d252f2: bets $2.21
9c858376: folds
Uncalled bet ($2.21) returned to a9d252f2
*** SHOWDOWN ***
a9d252f2 collected $2.5 from pot
*** SUMMARY ***
Total pot $2.63 | Rake $0.13 | Jackpot $0 | Bingo $0 | Fortune $0
Board [3s 3d 2s 4h 8c]
Seat 1: Hero (button) folded before Flop (didn't bet)
Seat 2: 280b7b (small blind) folded before Flop
Seat 3: e0998ea0 (big blind) folded before Flop
Seat 4: 4c855208 folded before Flop (didn't bet)
Seat 5: 9c858376 folded on the River
Seat 6: a9d252f2 won ($2.5)


Poker Hand #RC1459829099: Hold'em No Limit  ($0.05/$0.1) - 2023/04/08 19:50:14
Table 'RushAndCash3754359' 6-max Seat #1 is the button
Seat 1: 32767223 ($18.77 in chips)
Seat 2: bdea4bf9 ($12.26 in chips)
Seat 3: 4be89611 ($9.04 in chips)
Seat 4: e489763f ($3.54 in chips)
Seat 5: Hero ($15.91 in chips)
Seat 6: 5ad8e3e2 ($10.31 in chips)
bdea4bf9: posts small blind $0.05
4be89611: posts big blind $0.1
*** HOLE CARDS ***
Dealt to 32767223 
Dealt to bdea4bf9 
Dealt to 4be89611 
Dealt to e489763f 
Dealt to Hero [9s 5s]
Dealt to 5ad8e3e2 
e489763f: folds
Hero: folds
5ad8e3e2: folds
32767223: raises $0.14 to $0.24
bdea4bf9: raises $0.58 to $0.82
4be89611: folds
32767223: folds
Uncalled bet ($0.58) returned to bdea4bf9
*** SHOWDOWN ***
bdea4bf9 collected $0.56 from pot
*** SUMMARY ***
Total pot $0.58 | Rake $0.02 | Jackpot $0 | Bingo $0 | Fortune $0
Seat 1: 32767223 (button) folded before Flop
Seat 2: bdea4bf9 (small blind) collected ($0.56)
Seat 3: 4be89611 (big blind) folded before Flop
Seat 4: e489763f folded before Flop (didn't bet)
Seat 5: Hero folded before Flop (didn't bet)
Seat 6: 5ad8e3e2 folded before Flop (didn't bet)


Poker Hand #RC1459829011: Hold'em No Limit  ($0.05/$0.1) - 2023/04/08 19:50:01
Table 'RushAndCash3754271' 6-max Seat #1 is the button
Seat 1: 10af315d ($9.63 in chips)
Seat 2: Hero ($15.96 in chips)
Seat 3: 97757104 ($13.31 in chips)
Seat 4: b79a8f2a ($15.13 in chips)
Seat 5: a30d472 ($10.03 in chips)
Seat 6: a1b8242b ($11.76 in chips)
Hero: posts small blind $0.05
97757104: posts big blind $0.1
*** HOLE CARDS ***
Dealt to 10af315d 
Dealt to Hero [7c 2s]
Dealt to 97757104 
Dealt to b79a8f2a 
Dealt to a30d472 
Dealt to a1b8242b 
b79a8f2a: folds
a30d472: folds
a1b8242b: folds
10af315d: raises $0.12 to $0.22
Hero: folds
97757104: folds
Uncalled bet ($0.12) returned to 10af315d
*** SHOWDOWN ***
10af315d collected $0.25 from pot
*** SUMMARY ***
Total pot $0.25 | Rake $0 | Jackpot $0 | Bingo $0 | Fortune $0
Seat 1: 10af315d (button) collected ($0.25)
Seat 2: Hero (small blind) folded before Flop
Seat 3: 97757104 (big blind) folded before Flop
Seat 4: b79a8f2a folded before Flop (didn't bet)
Seat 5: a30d472 folded before Flop (didn't bet)
Seat 6: a1b8242b folded before Flop (didn't bet)


Poker Hand #RC1459828961: Hold'em No Limit  ($0.05/$0.1) - 2023/04/08 19:49:53
Table 'RushAndCash3754221' 6-max Seat #1 is the button
Seat 1: Hero ($15.96 in chips)
Seat 2: 983ce84d ($11.42 in chips)
Seat 3: d12b384c ($13.77 in chips)
Seat 4: bb0e2d3 ($11.08 in chips)
Seat 5: 11b8bcd8 ($18.74 in chips)
Seat 6: 7c703fc4 ($45.02 in chips)
983ce84d: posts small blind $0.05
d12b384c: posts big blind $0.1
*** HOLE CARDS ***
Dealt to Hero [6c 4d]
Dealt to 983ce84d 
Dealt to d12b384c 
Dealt to bb0e2d3 
Dealt to 11b8bcd8 
Dealt to 7c703fc4 
bb0e2d3: folds
11b8bcd8: folds
7c703fc4: folds
Hero: folds
983ce84d: folds
Uncalled bet ($0.05) returned to d12b384c
*** SHOWDOWN ***
d12b384c collected $0.1 from pot
*** SUMMARY ***
Total pot $0.1 | Rake $0 | Jackpot $0 | Bingo $0 | Fortune $0
Seat 1: Hero (button) folded before Flop (didn't bet)
Seat 2: 983ce84d (small blind) folded before Flop
Seat 3: d12b384c (big blind) collected ($0.1)
Seat 4: bb0e2d3 folded before Flop (didn't bet)
Seat 5: 11b8bcd8 folded before Flop (didn't bet)
Seat 6: 7c703fc4 folded before Flop (didn't bet)


Poker Hand #RC1459828921: Hold'em No Limit  ($0.05/$0.1) - 2023/04/08 19:49:48
Table 'RushAndCash3754181' 6-max Seat #1 is the button
Seat 1: 238ede5a ($10 in chips)
Seat 2: d6bf14bd ($14.45 in chips)
Seat 3: e6780b07 ($12.23 in chips)
Seat 4: Hero ($15.96 in chips)
Seat 5: dfa3a5cf ($17.56 in chips)
Seat 6: ebb0ec7f ($10.05 in chips)
d6bf14bd: posts small blind $0.05
e6780b07: posts big blind $0.1
*** HOLE CARDS ***
Dealt to 238ede5a 
Dealt to d6bf14bd 
Dealt to e6780b07 
Dealt to Hero [3c Js]
Dealt to dfa3a5cf 
Dealt to ebb0ec7f 
Hero: folds
dfa3a5cf: folds
ebb0ec7f: folds
238ede5a: raises $0.15 to $0.25
d6bf14bd: calls $0.2
e6780b07: folds
*** FLOP *** [5d 3s 9d]
d6bf14bd: checks
238ede5a: bets $0.45
d6bf14bd: calls $0.45
*** TURN *** [5d 3s 9d] [2h]
d6bf14bd: checks
238ede5a: bets $1.13
d6bf14bd: folds
Uncalled bet ($1.13) returned to 238ede5a
*** SHOWDOWN ***
238ede5a collected $1.43 from pot
*** SUMMARY ***
Total pot $1.5 | Rake $0.07 | Jackpot $0 | Bingo $0 | Fortune $0
Board [5d 3s 9d 2h]
Seat 1: 238ede5a (button) won ($1.43)
Seat 2: d6bf14bd (small blind) folded on the Turn
Seat 3: e6780b07 (big blind) folded before Flop
Seat 4: Hero folded before Flop (didn't bet)
Seat 5: dfa3a5cf folded before Flop (didn't bet)
Seat 6: ebb0ec7f folded before Flop (didn't bet)


Poker Hand #RC1459828707: Hold'em No Limit  ($0.05/$0.1) - 2023/04/08 19:49:17
Table 'RushAndCash3753967' 6-max Seat #1 is the button
Seat 1: d323ad9c ($12.56 in chips)
Seat 2: d214585c ($18.97 in chips)
Seat 3: e62769a9 ($8.13 in chips)
Seat 4: e6780b07 ($11.26 in chips)
Seat 5: 16d578c1 ($11.19 in chips)
Seat 6: Hero ($16.88 in chips)
d214585c: posts small blind $0.05
e62769a9: posts big blind $0.1
*** HOLE CARDS ***
Dealt to d323ad9c 
Dealt to d214585c 
Dealt to e62769a9 
Dealt to e6780b07 
Dealt to 16d578c1 
Dealt to Hero [Qd Ad]
e6780b07: raises $0.2 to $0.3
16d578c1: folds
Hero: raises $0.62 to $0.92
d323ad9c: folds
d214585c: folds
e62769a9: folds
e6780b07: raises $1.99 to $2.91
Hero: folds
Uncalled bet ($1.99) returned to e6780b07
*** SHOWDOWN ***
e6780b07 collected $1.89 from pot
*** SUMMARY ***
Total pot $1.99 | Rake $0.1 | Jackpot $0 | Bingo $0 | Fortune $0
Seat 1: d323ad9c (button) folded before Flop (didn't bet)
Seat 2: d214585c (small blind) folded before Flop
Seat 3: e62769a9 (big blind) folded before Flop
Seat 4: e6780b07 collected ($1.89)
Seat 5: 16d578c1 folded before Flop (didn't bet)
Seat 6: Hero folded before Flop


Poker Hand #RC1459828649: Hold'em No Limit  ($0.05/$0.1) - 2023/04/08 19:49:09
Table 'RushAndCash3753909' 6-max Seat #1 is the button
Seat 1: eda2be39 ($10.36 in chips)
Seat 2: Hero ($16.93 in chips)
Seat 3: 4d47383f ($11.52 in chips)
Seat 4: dbd47281 ($19.58 in chips)
Seat 5: a30d472 ($9.85 in chips)
Seat 6: c9e32a1d ($16.71 in chips)
Hero: posts small blind $0.05
4d47383f: posts big blind $0.1
*** HOLE CARDS ***
Dealt to eda2be39 
Dealt to Hero [8h 2h]
Dealt to 4d47383f 
Dealt to dbd47281 
Dealt to a30d472 
Dealt to c9e32a1d 
dbd47281: folds
a30d472: folds
c9e32a1d: folds
eda2be39: folds
Hero: folds
Uncalled bet ($0.05) returned to 4d47383f
*** SHOWDOWN ***
4d47383f collected $0.1 from pot
*** SUMMARY ***
Total pot $0.1 | Rake $0 | Jackpot $0 | Bingo $0 | Fortune $0
Seat 1: eda2be39 (button) folded before Flop (didn't bet)
Seat 2: Hero (small blind) folded before Flop
Seat 3: 4d47383f (big blind) collected ($0.1)
Seat 4: dbd47281 folded before Flop (didn't bet)
Seat 5: a30d472 folded before Flop (didn't bet)
Seat 6: c9e32a1d folded before Flop (didn't bet)


Poker Hand #RC1459828616: Hold'em No Limit  ($0.05/$0.1) - 2023/04/08 19:49:05
Table 'RushAndCash3753876' 6-max Seat #1 is the button
Seat 1: 6a51d7d1 ($14.01 in chips)
Seat 2: 8f09cec9 ($9.64 in chips)
Seat 3: 137b9e7f ($10.88 in chips)
Seat 4: 238ede5a ($10.15 in chips)
Seat 5: ad685734 ($10.28 in chips)
Seat 6: Hero ($16.93 in chips)
8f09cec9: posts small blind $0.05
137b9e7f: posts big blind $0.1
*** HOLE CARDS ***
Dealt to 6a51d7d1 
Dealt to 8f09cec9 
Dealt to 137b9e7f 
Dealt to 238ede5a 
Dealt to ad685734 
Dealt to Hero [Ks 2c]
238ede5a: folds
ad685734: folds
Hero: folds
6a51d7d1: folds
8f09cec9: folds
Uncalled bet ($0.05) returned to 137b9e7f
*** SHOWDOWN ***
137b9e7f collected $0.1 from pot
*** SUMMARY ***
Total pot $0.1 | Rake $0 | Jackpot $0 | Bingo $0 | Fortune $0
Seat 1: 6a51d7d1 (button) folded before Flop (didn't bet)
Seat 2: 8f09cec9 (small blind) folded before Flop
Seat 3: 137b9e7f (big blind) collected ($0.1)
Seat 4: 238ede5a folded before Flop (didn't bet)
Seat 5: ad685734 folded before Flop (didn't bet)
Seat 6: Hero folded before Flop (didn't bet)


Poker Hand #RC1459828582: Hold'em No Limit  ($0.05/$0.1) - 2023/04/08 19:49:00
Table 'RushAndCash3753842' 6-max Seat #1 is the button
Seat 1: a79b470f ($5.52 in chips)
Seat 2: 709d274f ($13.25 in chips)
Seat 3: Hero ($17.03 in chips)
Seat 4: 1b1d9fb9 ($8.57 in chips)
Seat 5: a30d472 ($9.85 in chips)
Seat 6: d9868efd ($20.36 in chips)
709d274f: posts small blind $0.05
Hero: posts big blind $0.1
*** HOLE CARDS ***
Dealt to a79b470f 
Dealt to 709d274f 
Dealt to Hero [Js 4c]
Dealt to 1b1d9fb9 
Dealt to a30d472 
Dealt to d9868efd 
1b1d9fb9: folds
a30d472: folds
d9868efd: raises $0.15 to $0.25
a79b470f: raises $0.65 to $0.9
709d274f: folds
Hero: folds
d9868efd: calls $0.65
*** FLOP *** [9c 5d 9d]
d9868efd: checks
a79b470f: bets $1.06
d9868efd: raises $4.14 to $5.2
a79b470f: calls $3.56 and is all-in
Uncalled bet ($0.58) returned to d9868efd
d9868efd: shows [Ad Qh] (Pair of Nines)
a79b470f: shows [Jd Jc] (Pair of Jacks and Pair of Nines)
*** TURN *** [9c 5d 9d] [8h]
*** RIVER *** [9c 5d 9d 8h] [7s]
*** SHOWDOWN ***
a79b470f collected $10.74 from pot
*** SUMMARY ***
Total pot $11.19 | Rake $0.3 | Jackpot $0.15 | Bingo $0 | Fortune $0
Board [9c 5d 9d 8h 7s]
Seat 1: a79b470f (button) showed [Jd Jc] and won ($10.74) with Pair of Jacks and Pair of Nines
Seat 2: 709d274f (small blind) folded before Flop
Seat 3: Hero (big blind) folded before Flop
Seat 4: 1b1d9fb9 folded before Flop (didn't bet)
Seat 5: a30d472 folded before Flop (didn't bet)
Seat 6: d9868efd showed [Ad Qh] and lost with Pair of Nines


Poker Hand #RC1459828550: Hold'em No Limit  ($0.05/$0.1) - 2023/04/08 19:48:56
Table 'RushAndCash3753810' 6-max Seat #1 is the button
Seat 1: 45331e23 ($10.07 in chips)
Seat 2: e69cddd7 ($10.52 in chips)
Seat 3: 81f21357 ($26.51 in chips)
Seat 4: a3495913 ($8.32 in chips)
Seat 5: Hero ($17.03 in chips)
Seat 6: ed9c405 ($9.85 in chips)
e69cddd7: posts small blind $0.05
81f21357: posts big blind $0.1
*** HOLE CARDS ***
Dealt to 45331e23 
Dealt to e69cddd7 
Dealt to 81f21357 
Dealt to a3495913 
Dealt to Hero [Td 3c]
Dealt to ed9c405 
a3495913: folds
Hero: folds
ed9c405: folds
45331e23: folds
e69cddd7: raises $0.2 to $0.3
81f21357: folds
Uncalled bet ($0.2) returned to e69cddd7
*** SHOWDOWN ***
e69cddd7 collected $0.2 from pot
*** SUMMARY ***
Total pot $0.2 | Rake $0 | Jackpot $0 | Bingo $0 | Fortune $0
Seat 1: 45331e23 (button) folded before Flop (didn't bet)
Seat 2: e69cddd7 (small blind) collected ($0.2)
Seat 3: 81f21357 (big blind) folded before Flop
Seat 4: a3495913 folded before Flop (didn't bet)
Seat 5: Hero folded before Flop (didn't bet)
Seat 6: ed9c405 folded before Flop (didn't bet)


Poker Hand #RC1459828514: Hold'em No Limit  ($0.05/$0.1) - 2023/04/08 19:48:50
Table 'RushAndCash3753774' 6-max Seat #1 is the button
Seat 1: 238ede5a ($10 in chips)
Seat 2: 909716ea ($28.3 in chips)
Seat 3: 3b82629e ($10.57 in chips)
Seat 4: e414f212 ($33.58 in chips)
Seat 5: 7f57e0f9 ($147.29 in chips)
Seat 6: Hero ($17.03 in chips)
909716ea: posts small blind $0.05
3b82629e: posts big blind $0.1
*** HOLE CARDS ***
Dealt to 238ede5a 
Dealt to 909716ea 
Dealt to 3b82629e 
Dealt to e414f212 
Dealt to 7f57e0f9 
Dealt to Hero [4h Qd]
e414f212: folds
7f57e0f9: folds
Hero: folds
238ede5a: raises $0.15 to $0.25
909716ea: folds
3b82629e: folds
Uncalled bet ($0.15) returned to 238ede5a
*** SHOWDOWN ***
238ede5a collected $0.25 from pot
*** SUMMARY ***
Total pot $0.25 | Rake $0 | Jackpot $0 | Bingo $0 | Fortune $0
Seat 1: 238ede5a (button) collected ($0.25)
Seat 2: 909716ea (small blind) folded before Flop
Seat 3: 3b82629e (big blind) folded before Flop
Seat 4: e414f212 folded before Flop (didn't bet)
Seat 5: 7f57e0f9 folded before Flop (didn't bet)
Seat 6: Hero folded before Flop (didn't bet)


Poker Hand #RC1459828475: Hold'em No Limit  ($0.05/$0.1) - 2023/04/08 19:48:45
Table 'RushAndCash3753735' 6-max Seat #1 is the button
Seat 1: dce49951 ($19.48 in chips)
Seat 2: bee41a8b ($80.84 in chips)
Seat 3: c56f5551 ($11.02 in chips)
Seat 4: f80efe5f ($11.01 in chips)
Seat 5: Hero ($17.03 in chips)
Seat 6: 8a72cfc5 ($11.58 in chips)
bee41a8b: posts small blind $0.05
c56f5551: posts big blind $0.1
*** HOLE CARDS ***
Dealt to dce49951 
Dealt to bee41a8b 
Dealt to c56f5551 
Dealt to f80efe5f 
Dealt to Hero [8h 4d]
Dealt to 8a72cfc5 
f80efe5f: folds
Hero: folds
8a72cfc5: raises $0.15 to $0.25
dce49951: folds
bee41a8b: folds
c56f5551: calls $0.15
*** FLOP *** [Ts 8d 4c]
c56f5551: checks
8a72cfc5: bets $0.2
c56f5551: raises $0.5 to $0.7
8a72cfc5: calls $0.5
*** TURN *** [Ts 8d 4c] [6h]
c56f5551: bets $1
8a72cfc5: calls $1
*** RIVER *** [Ts 8d 4c 6h] [Jh]
c56f5551: checks
8a72cfc5: checks
c56f5551: shows [Tc Qh] (Pair of Tens)
8a72cfc5: shows [6s 7s] (Pair of Sixes)
*** SHOWDOWN ***
c56f5551 collected $3.61 from pot
*** SUMMARY ***
Total pot $3.95 | Rake $0.19 | Jackpot $0.15 | Bingo $0 | Fortune $0
Board [Ts 8d 4c 6h Jh]
Seat 1: dce49951 (button) folded before Flop (didn't bet)
Seat 2: bee41a8b (small blind) folded before Flop
Seat 3: c56f5551 (big blind) showed [Tc Qh] and won ($3.61) with Pair of Tens
Seat 4: f80efe5f folded before Flop (didn't bet)
Seat 5: Hero folded before Flop (didn't bet)
Seat 6: 8a72cfc5 showed [6s 7s] and lost with Pair of Sixes


Poker Hand #RC1459828428: Hold'em No Limit  ($0.05/$0.1) - 2023/04/08 19:48:38
Table 'RushAndCash3753688' 6-max Seat #1 is the button
Seat 1: Hero ($17.03 in chips)
Seat 2: 5c6a73f4 ($11.35 in chips)
Seat 3: 2bd599e1 ($11.94 in chips)
Seat 4: 5f6e1d8f ($26.44 in chips)
Seat 5: 9ec053d2 ($38.03 in chips)
Seat 6: 5ad8e3e2 ($10.56 in chips)
5c6a73f4: posts small blind $0.05
2bd599e1: posts big blind $0.1
*** HOLE CARDS ***
Dealt to Hero [2c Qd]
Dealt to 5c6a73f4 
Dealt to 2bd599e1 
Dealt to 5f6e1d8f 
Dealt to 9ec053d2 
Dealt to 5ad8e3e2 
5f6e1d8f: folds
9ec053d2: raises $0.15 to $0.25
5ad8e3e2: calls $0.25
Hero: folds
5c6a73f4: folds
2bd599e1: calls $0.15
*** FLOP *** [3h 9d 3c]
2bd599e1: checks
9ec053d2: checks
5ad8e3e2: checks
*** TURN *** [3h 9d 3c] [8h]
2bd599e1: bets $0.4
9ec053d2: folds
5ad8e3e2: folds
Uncalled bet ($0.4) returned to 2bd599e1
*** SHOWDOWN ***
2bd599e1 collected $0.76 from pot
*** SUMMARY ***
Total pot $0.8 | Rake $0.04 | Jackpot $0 | Bingo $0 | Fortune $0
Board [3h 9d 3c 8h]
Seat 1: Hero (button) folded before Flop (didn't bet)
Seat 2: 5c6a73f4 (small blind) folded before Flop
Seat 3: 2bd599e1 (big blind) won ($0.76)
Seat 4: 5f6e1d8f folded before Flop (didn't bet)
Seat 5: 9ec053d2 folded on the Turn
Seat 6: 5ad8e3e2 folded on the Turn


Poker Hand #RC1459828339: Hold'em No Limit  ($0.05/$0.1) - 2023/04/08 19:48:25
Table 'RushAndCash3753599' 6-max Seat #1 is the button
Seat 1: f513fe95 ($10 in chips)
Seat 2: dbd47281 ($19.73 in chips)
Seat 3: Hero ($16.98 in chips)
Seat 4: 7f958c6d ($16.42 in chips)
Seat 5: 1d14bbd1 ($7.48 in chips)
Seat 6: 3b82629e ($10.42 in chips)
dbd47281: posts small blind $0.05
Hero: posts big blind $0.1
*** HOLE CARDS ***
Dealt to f513fe95 
Dealt to dbd47281 
Dealt to Hero [Td 4d]
Dealt to 7f958c6d 
Dealt to 1d14bbd1 
Dealt to 3b82629e 
7f958c6d: folds
1d14bbd1: folds
3b82629e: folds
f513fe95: folds
dbd47281: folds
Uncalled bet ($0.05) returned to Hero
*** SHOWDOWN ***
Hero collected $0.1 from pot
*** SUMMARY ***
Total pot $0.1 | Rake $0 | Jackpot $0 | Bingo $0 | Fortune $0
Seat 1: f513fe95 (button) folded before Flop (didn't bet)
Seat 2: dbd47281 (small blind) folded before Flop
Seat 3: Hero (big blind) collected ($0.1)
Seat 4: 7f958c6d folded before Flop (didn't bet)
Seat 5: 1d14bbd1 folded before Flop (didn't bet)
Seat 6: 3b82629e folded before Flop (didn't bet)


Poker Hand #RC1459828306: Hold'em No Limit  ($0.05/$0.1) - 2023/04/08 19:48:21
Table 'RushAndCash3753566' 6-max Seat #1 is the button
Seat 1: a02f13bb ($32.35 in chips)
Seat 2: c6dcf84b ($10 in chips)
Seat 3: f3d44b61 ($32.11 in chips)
Seat 4: 9e1f8b69 ($12.32 in chips)
Seat 5: Hero ($16.98 in chips)
Seat 6: 38b17591 ($11.17 in chips)
c6dcf84b: posts small blind $0.05
f3d44b61: posts big blind $0.1
*** HOLE CARDS ***
Dealt to a02f13bb 
Dealt to c6dcf84b 
Dealt to f3d44b61 
Dealt to 9e1f8b69 
Dealt to Hero [6c Qc]
Dealt to 38b17591 
9e1f8b69: folds
Hero: folds
38b17591: folds
a02f13bb: folds
c6dcf84b: folds
Uncalled bet ($0.05) returned to f3d44b61
*** SHOWDOWN ***
f3d44b61 collected $0.1 from pot
*** SUMMARY ***
Total pot $0.1 | Rake $0 | Jackpot $0 | Bingo $0 | Fortune $0
Seat 1: a02f13bb (button) folded before Flop (didn't bet)
Seat 2: c6dcf84b (small blind) folded before Flop
Seat 3: f3d44b61 (big blind) collected ($0.1)
Seat 4: 9e1f8b69 folded before Flop (didn't bet)
Seat 5: Hero folded before Flop (didn't bet)
Seat 6: 38b17591 folded before Flop (didn't bet)


Poker Hand #RC1459828227: Hold'em No Limit  ($0.05/$0.1) - 2023/04/08 19:48:09
Table 'RushAndCash3753487' 6-max Seat #1 is the button
Seat 1: f4b98f78 ($21.78 in chips)
Seat 2: Hero ($17.03 in chips)
Seat 3: c3c0fb7f ($14.23 in chips)
Seat 4: 32342eb5 ($10 in chips)
Seat 5: ca47437 ($11.14 in chips)
Seat 6: ad674ed6 ($9.51 in chips)
Hero: posts small blind $0.05
c3c0fb7f: posts big blind $0.1
*** HOLE CARDS ***
Dealt to f4b98f78 
Dealt to Hero [6h 5d]
Dealt to c3c0fb7f 
Dealt to 32342eb5 
Dealt to ca47437 
Dealt to ad674ed6 
32342eb5: folds
ca47437: folds
ad674ed6: raises $0.2 to $0.3
f4b98f78: folds
Hero: folds
c3c0fb7f: folds
Uncalled bet ($0.2) returned to ad674ed6
*** SHOWDOWN ***
ad674ed6 collected $0.25 from pot
*** SUMMARY ***
Total pot $0.25 | Rake $0 | Jackpot $0 | Bingo $0 | Fortune $0
Seat 1: f4b98f78 (button) folded before Flop (didn't bet)
Seat 2: Hero (small blind) folded before Flop
Seat 3: c3c0fb7f (big blind) folded before Flop
Seat 4: 32342eb5 folded before Flop (didn't bet)
Seat 5: ca47437 folded before Flop (didn't bet)
Seat 6: ad674ed6 collected ($0.25)


Poker Hand #RC1459828140: Hold'em No Limit  ($0.05/$0.1) - 2023/04/08 19:47:55
Table 'RushAndCash3753400' 6-max Seat #1 is the button
Seat 1: 32342eb5 ($10 in chips)
Seat 2: a30d472 ($5.63 in chips)
Seat 3: b6746050 ($78.24 in chips)
Seat 4: e6780b07 ($10.9 in chips)
Seat 5: Hero ($17.03 in chips)
Seat 6: 1d14bbd1 ($7.78 in chips)
a30d472: posts small blind $0.05
b6746050: posts big blind $0.1
*** HOLE CARDS ***
Dealt to 32342eb5 
Dealt to a30d472 
Dealt to b6746050 
Dealt to e6780b07 
Dealt to Hero [Qd 8s]
Dealt to 1d14bbd1 
e6780b07: folds
Hero: folds
1d14bbd1: raises $0.1 to $0.2
32342eb5: folds
a30d472: raises $0.4 to $0.6
b6746050: folds
1d14bbd1: folds
Uncalled bet ($0.4) returned to a30d472
*** SHOWDOWN ***
a30d472 collected $0.48 from pot
*** SUMMARY ***
Total pot $0.5 | Rake $0.02 | Jackpot $0 | Bingo $0 | Fortune $0
Seat 1: 32342eb5 (button) folded before Flop (didn't bet)
Seat 2: a30d472 (small blind) collected ($0.48)
Seat 3: b6746050 (big blind) folded before Flop
Seat 4: e6780b07 folded before Flop (didn't bet)
Seat 5: Hero folded before Flop (didn't bet)
Seat 6: 1d14bbd1 folded before Flop


Poker Hand #RC1459827595: Hold'em No Limit  ($0.05/$0.1) - 2023/04/08 19:46:39
Table 'RushAndCash3752855' 6-max Seat #1 is the button
Seat 1: Hero ($13.87 in chips)
Seat 2: 58568431 ($19.2 in chips)
Seat 3: a30d472 ($9.19 in chips)
Seat 4: 178a96db ($26.55 in chips)
Seat 5: d7cf9b00 ($16.41 in chips)
Seat 6: f2724d93 ($17.79 in chips)
58568431: posts small blind $0.05
a30d472: posts big blind $0.1
*** HOLE CARDS ***
Dealt to Hero [7s 5s]
Dealt to 58568431 
Dealt to a30d472 
Dealt to 178a96db 
Dealt to d7cf9b00 
Dealt to f2724d93 
178a96db: folds
d7cf9b00: folds
f2724d93: folds
Hero: raises $0.15 to $0.25
58568431: folds
a30d472: calls $0.15
*** FLOP *** [8s Tc 9d]
a30d472: checks
Hero: bets $0.28
a30d472: raises $0.37 to $0.65
Hero: calls $0.37
*** TURN *** [8s Tc 9d] [Jh]
a30d472: bets $0.62
Hero: calls $0.62
*** RIVER *** [8s Tc 9d Jh] [4s]
a30d472: bets $2.04
Hero: calls $2.04
a30d472: shows [9h 6h] (Pair of Nines)
Hero: shows [7s 5s] (Jacks-High Straight)
*** SHOWDOWN ***
Hero collected $6.72 from pot
*** SUMMARY ***
Total pot $7.17 | Rake $0.3 | Jackpot $0.15 | Bingo $0 | Fortune $0
Board [8s Tc 9d Jh 4s]
Seat 1: Hero (button) showed [7s 5s] and won ($6.72) with Jacks-High Straight
Seat 2: 58568431 (small blind) folded before Flop
Seat 3: a30d472 (big blind) showed [9h 6h] and lost with Pair of Nines
Seat 4: 178a96db folded before Flop (didn't bet)
Seat 5: d7cf9b00 folded before Flop (didn't bet)
Seat 6: f2724d93 folded before Flop (didn't bet)


Poker Hand #RC1459827547: Hold'em No Limit  ($0.05/$0.1) - 2023/04/08 19:46:31
Table 'RushAndCash3752807' 6-max Seat #1 is the button
Seat 1: 10c83365 ($10.32 in chips)
Seat 2: Hero ($13.92 in chips)
Seat 3: 6587dee ($11.86 in chips)
Seat 4: c9e32a1d ($17.36 in chips)
Seat 5: c563224e ($10.64 in chips)
Seat 6: d5be5c2d ($10.99 in chips)
Hero: posts small blind $0.05
6587dee: posts big blind $0.1
*** HOLE CARDS ***
Dealt to 10c83365 
Dealt to Hero [Qd 7d]
Dealt to 6587dee 
Dealt to c9e32a1d 
Dealt to c563224e 
Dealt to d5be5c2d 
c9e32a1d: folds
c563224e: raises $0.15 to $0.25
d5be5c2d: folds
10c83365: folds
Hero: folds
6587dee: calls $0.15
*** FLOP *** [6h Jd Jc]
6587dee: checks
c563224e: bets $0.28
6587dee: calls $0.28
*** TURN *** [6h Jd Jc] [3s]
6587dee: checks
c563224e: bets $0.37
6587dee: calls $0.37
*** RIVER *** [6h Jd Jc 3s] [8s]
6587dee: checks
c563224e: checks
6587dee: shows [Ac 2c] (Pair of Jacks)
c563224e: shows [Qh As] (Pair of Jacks)
*** SHOWDOWN ***
c563224e collected $1.76 from pot
*** SUMMARY ***
Total pot $1.85 | Rake $0.09 | Jackpot $0 | Bingo $0 | Fortune $0
Board [6h Jd Jc 3s 8s]
Seat 1: 10c83365 (button) folded before Flop (didn't bet)
Seat 2: Hero (small blind) folded before Flop
Seat 3: 6587dee (big blind) showed [Ac 2c] and lost with Pair of Jacks
Seat 4: c9e32a1d folded before Flop (didn't bet)
Seat 5: c563224e showed [Qh As] and won ($1.76) with Pair of Jacks
Seat 6: d5be5c2d folded before Flop (didn't bet)


Poker Hand #RC1459827290: Hold'em No Limit  ($0.05/$0.1) - 2023/04/08 19:45:54
Table 'RushAndCash3752550' 6-max Seat #1 is the button
Seat 1: 229953df ($10.1 in chips)
Seat 2: 1d14bbd1 ($6.75 in chips)
Seat 3: Hero ($14.17 in chips)
Seat 4: 44f17414 ($20.22 in chips)
Seat 5: 6587dee ($11.58 in chips)
Seat 6: 1fabed60 ($25.48 in chips)
1d14bbd1: posts small blind $0.05
Hero: posts big blind $0.1
*** HOLE CARDS ***
Dealt to 229953df 
Dealt to 1d14bbd1 
Dealt to Hero [8s 9s]
Dealt to 44f17414 
Dealt to 6587dee 
Dealt to 1fabed60 
44f17414: folds
6587dee: raises $0.15 to $0.25
1fabed60: folds
229953df: folds
1d14bbd1: folds
Hero: calls $0.15
*** FLOP *** [2d Ah 3c]
Hero: checks
6587dee: bets $0.19
Hero: folds
Uncalled bet ($0.19) returned to 6587dee
*** SHOWDOWN ***
6587dee collected $0.53 from pot
*** SUMMARY ***
Total pot $0.55 | Rake $0.02 | Jackpot $0 | Bingo $0 | Fortune $0
Board [2d Ah 3c]
Seat 1: 229953df (button) folded before Flop (didn't bet)
Seat 2: 1d14bbd1 (small blind) folded before Flop
Seat 3: Hero (big blind) folded on the Flop
Seat 4: 44f17414 folded before Flop (didn't bet)
Seat 5: 6587dee won ($0.53)
Seat 6: 1fabed60 folded before Flop (didn't bet)


Poker Hand #RC1459827209: Hold'em No Limit  ($0.05/$0.1) - 2023/04/08 19:45:43
Table 'RushAndCash3752469' 6-max Seat #1 is the button
Seat 1: Hero ($14.02 in chips)
Seat 2: 47e21b5e ($11.42 in chips)
Seat 3: 715f4d78 ($11.55 in chips)
Seat 4: 1d14bbd1 ($6.75 in chips)
Seat 5: 83034386 ($7.22 in chips)
Seat 6: 2f996d2d ($9.95 in chips)
47e21b5e: posts small blind $0.05
715f4d78: posts big blind $0.1
*** HOLE CARDS ***
Dealt to Hero [Ts Qh]
Dealt to 47e21b5e 
Dealt to 715f4d78 
Dealt to 1d14bbd1 
Dealt to 83034386 
Dealt to 2f996d2d 
1d14bbd1: folds
83034386: folds
2f996d2d: folds
Hero: raises $0.15 to $0.25
47e21b5e: folds
715f4d78: folds
Uncalled bet ($0.15) returned to Hero
*** SHOWDOWN ***
Hero collected $0.25 from pot
*** SUMMARY ***
Total pot $0.25 | Rake $0 | Jackpot $0 | Bingo $0 | Fortune $0
Seat 1: Hero (button) collected ($0.25)
Seat 2: 47e21b5e (small blind) folded before Flop
Seat 3: 715f4d78 (big blind) folded before Flop
Seat 4: 1d14bbd1 folded before Flop (didn't bet)
Seat 5: 83034386 folded before Flop (didn't bet)
Seat 6: 2f996d2d folded before Flop (didn't bet)


Poker Hand #RC1459827176: Hold'em No Limit  ($0.05/$0.1) - 2023/04/08 19:45:38
Table 'RushAndCash3752436' 6-max Seat #1 is the button
Seat 1: d0399322 ($5.58 in chips)
Seat 2: e405bb35 ($5.66 in chips)
Seat 3: 8ef0aa95 ($12.05 in chips)
Seat 4: Hero ($14.02 in chips)
Seat 5: aebf96eb ($17.86 in chips)
Seat 6: 93dd5318 ($5.61 in chips)
e405bb35: posts small blind $0.05
8ef0aa95: posts big blind $0.1
*** HOLE CARDS ***
Dealt to d0399322 
Dealt to e405bb35 
Dealt to 8ef0aa95 
Dealt to Hero [8h 5c]
Dealt to aebf96eb 
Dealt to 93dd5318 
Hero: folds
aebf96eb: folds
93dd5318: raises $0.1 to $0.2
d0399322: folds
e405bb35: calls $0.15
8ef0aa95: folds
*** FLOP *** [Th Ac Ks]
e405bb35: checks
93dd5318: bets $0.1
e405bb35: calls $0.1
*** TURN *** [Th Ac Ks] [Js]
e405bb35: checks
93dd5318: bets $0.1
e405bb35: calls $0.1
*** RIVER *** [Th Ac Ks Js] [2d]
e405bb35: checks
93dd5318: checks
e405bb35: shows [3s As] (Pair of Aces)
93dd5318: shows [6h 5h] (Ace-High)
*** SHOWDOWN ***
e405bb35 collected $0.86 from pot
*** SUMMARY ***
Total pot $0.9 | Rake $0.04 | Jackpot $0 | Bingo $0 | Fortune $0
Board [Th Ac Ks Js 2d]
Seat 1: d0399322 (button) folded before Flop (didn't bet)
Seat 2: e405bb35 (small blind) showed [3s As] and won ($0.86) with Pair of Aces
Seat 3: 8ef0aa95 (big blind) folded before Flop
Seat 4: Hero folded before Flop (didn't bet)
Seat 5: aebf96eb folded before Flop (didn't bet)
Seat 6: 93dd5318 showed [6h 5h] and lost with Ace-High


Poker Hand #RC1459826920: Hold'em No Limit  ($0.05/$0.1) - 2023/04/08 19:45:01
Table 'RushAndCash3752180' 6-max Seat #1 is the button
Seat 1: 93dd5318 ($5.91 in chips)
Seat 2: b804915f ($19.66 in chips)
Seat 3: Hero ($13.7 in chips)
Seat 4: f9390b9f ($10 in chips)
Seat 5: 56fe61f7 ($10.12 in chips)
Seat 6: 4ec6caba ($14.79 in chips)
b804915f: posts small blind $0.05
Hero: posts big blind $0.1
*** HOLE CARDS ***
Dealt to 93dd5318 
Dealt to b804915f 
Dealt to Hero [Th 9h]
Dealt to f9390b9f 
Dealt to 56fe61f7 
Dealt to 4ec6caba 
f9390b9f: folds
56fe61f7: folds
4ec6caba: folds
93dd5318: raises $0.1 to $0.2
b804915f: folds
Hero: calls $0.1
*** FLOP *** [6h 2s 6s]
Hero: checks
93dd5318: bets $0.1
Hero: raises $0.3 to $0.4
93dd5318: folds
Uncalled bet ($0.3) returned to Hero
*** SHOWDOWN ***
Hero collected $0.62 from pot
*** SUMMARY ***
Total pot $0.65 | Rake $0.03 | Jackpot $0 | Bingo $0 | Fortune $0
Board [6h 2s 6s]
Seat 1: 93dd5318 (button) folded on the Flop
Seat 2: b804915f (small blind) folded before Flop
Seat 3: Hero (big blind) won ($0.62)
Seat 4: f9390b9f folded before Flop (didn't bet)
Seat 5: 56fe61f7 folded before Flop (didn't bet)
Seat 6: 4ec6caba folded before Flop (didn't bet)


Poker Hand #RC1459826894: Hold'em No Limit  ($0.05/$0.1) - 2023/04/08 19:44:57
Table 'RushAndCash3752154' 6-max Seat #1 is the button
Seat 1: f75540cc ($6.42 in chips)
Seat 2: e3030a0b ($11.11 in chips)
Seat 3: 859eb237 ($10 in chips)
Seat 4: Hero ($13.7 in chips)
Seat 5: 16d578c1 ($10.63 in chips)
Seat 6: 6a60e6b3 ($10.15 in chips)
e3030a0b: posts small blind $0.05
859eb237: posts big blind $0.1
*** HOLE CARDS ***
Dealt to f75540cc 
Dealt to e3030a0b 
Dealt to 859eb237 
Dealt to Hero [Qs 2s]
Dealt to 16d578c1 
Dealt to 6a60e6b3 
Hero: folds
16d578c1: folds
6a60e6b3: raises $0.15 to $0.25
f75540cc: folds
e3030a0b: folds
859eb237: folds
Uncalled bet ($0.15) returned to 6a60e6b3
*** SHOWDOWN ***
6a60e6b3 collected $0.25 from pot
*** SUMMARY ***
Total pot $0.25 | Rake $0 | Jackpot $0 | Bingo $0 | Fortune $0
Seat 1: f75540cc (button) folded before Flop (didn't bet)
Seat 2: e3030a0b (small blind) folded before Flop
Seat 3: 859eb237 (big blind) folded before Flop
Seat 4: Hero folded before Flop (didn't bet)
Seat 5: 16d578c1 folded before Flop (didn't bet)
Seat 6: 6a60e6b3 collected ($0.25)


Poker Hand #RC1459826764: Hold'em No Limit  ($0.05/$0.1) - 2023/04/08 19:44:39
Table 'RushAndCash3752024' 6-max Seat #1 is the button
Seat 1: 39868051 ($10.5 in chips)
Seat 2: 19bc99cd ($11.67 in chips)
Seat 3: 43663618 ($10 in chips)
Seat 4: Hero ($13.55 in chips)
Seat 5: e69cddd7 ($10.08 in chips)
Seat 6: a4a4271f ($27.59 in chips)
19bc99cd: posts small blind $0.05
43663618: posts big blind $0.1
*** HOLE CARDS ***
Dealt to 39868051 
Dealt to 19bc99cd 
Dealt to 43663618 
Dealt to Hero [Ad Qd]
Dealt to e69cddd7 
Dealt to a4a4271f 
Hero: raises $0.15 to $0.25
e69cddd7: folds
a4a4271f: folds
39868051: folds
19bc99cd: folds
43663618: folds
Uncalled bet ($0.15) returned to Hero
*** SHOWDOWN ***
Hero collected $0.25 from pot
*** SUMMARY ***
Total pot $0.25 | Rake $0 | Jackpot $0 | Bingo $0 | Fortune $0
Seat 1: 39868051 (button) folded before Flop (didn't bet)
Seat 2: 19bc99cd (small blind) folded before Flop
Seat 3: 43663618 (big blind) folded before Flop
Seat 4: Hero collected ($0.25)
Seat 5: e69cddd7 folded before Flop (didn't bet)
Seat 6: a4a4271f folded before Flop (didn't bet)


Poker Hand #RC1459826727: Hold'em No Limit  ($0.05/$0.1) - 2023/04/08 19:44:35
Table 'RushAndCash3751987' 6-max Seat #1 is the button
Seat 1: ec08cfd4 ($9.17 in chips)
Seat 2: bf9dc4c2 ($31.26 in chips)
Seat 3: 551d9a48 ($11.54 in chips)
Seat 4: 8214ce03 ($10.15 in chips)
Seat 5: 983ce84d ($12.01 in chips)
Seat 6: Hero ($13.55 in chips)
bf9dc4c2: posts small blind $0.05
551d9a48: posts big blind $0.1
*** HOLE CARDS ***
Dealt to ec08cfd4 
Dealt to bf9dc4c2 
Dealt to 551d9a48 
Dealt to 8214ce03 
Dealt to 983ce84d 
Dealt to Hero [6c Tc]
8214ce03: raises $0.13 to $0.23
983ce84d: folds
Hero: folds
ec08cfd4: folds
bf9dc4c2: folds
551d9a48: folds
Uncalled bet ($0.13) returned to 8214ce03
*** SHOWDOWN ***
8214ce03 collected $0.25 from pot
*** SUMMARY ***
Total pot $0.25 | Rake $0 | Jackpot $0 | Bingo $0 | Fortune $0
Seat 1: ec08cfd4 (button) folded before Flop (didn't bet)
Seat 2: bf9dc4c2 (small blind) folded before Flop
Seat 3: 551d9a48 (big blind) folded before Flop
Seat 4: 8214ce03 collected ($0.25)
Seat 5: 983ce84d folded before Flop (didn't bet)
Seat 6: Hero folded before Flop (didn't bet)


Poker Hand #RC1459826645: Hold'em No Limit  ($0.05/$0.1) - 2023/04/08 19:44:22
Table 'RushAndCash3751905' 6-max Seat #1 is the button
Seat 1: 4117f135 ($13.04 in chips)
Seat 2: Hero ($13.6 in chips)
Seat 3: c0442f11 ($10 in chips)
Seat 4: b5be15a0 ($11.66 in chips)
Seat 5: c4168b18 ($9.62 in chips)
Seat 6: cc018f2 ($8.27 in chips)
Hero: posts small blind $0.05
c0442f11: posts big blind $0.1
*** HOLE CARDS ***
Dealt to 4117f135 
Dealt to Hero [5s Js]
Dealt to c0442f11 
Dealt to b5be15a0 
Dealt to c4168b18 
Dealt to cc018f2 
b5be15a0: folds
c4168b18: raises $0.1 to $0.2
cc018f2: folds
4117f135: folds
Hero: folds
c0442f11: folds
Uncalled bet ($0.1) returned to c4168b18
*** SHOWDOWN ***
c4168b18 collected $0.25 from pot
*** SUMMARY ***
Total pot $0.25 | Rake $0 | Jackpot $0 | Bingo $0 | Fortune $0
Seat 1: 4117f135 (button) folded before Flop (didn't bet)
Seat 2: Hero (small blind) folded before Flop
Seat 3: c0442f11 (big blind) folded before Flop
Seat 4: b5be15a0 folded before Flop (didn't bet)
Seat 5: c4168b18 collected ($0.25)
Seat 6: cc018f2 folded before Flop (didn't bet)


Poker Hand #RC1459826617: Hold'em No Limit  ($0.05/$0.1) - 2023/04/08 19:44:17
Table 'RushAndCash3751877' 6-max Seat #1 is the button
Seat 1: Hero ($13.6 in chips)
Seat 2: 14165a66 ($10.66 in chips)
Seat 3: 364a85e6 ($19.33 in chips)
Seat 4: 3bb96cf5 ($42.02 in chips)
Seat 5: bd3fac4b ($10 in chips)
Seat 6: ca34ebc2 ($14.65 in chips)
14165a66: posts small blind $0.05
364a85e6: posts big blind $0.1
*** HOLE CARDS ***
Dealt to Hero [8d 2c]
Dealt to 14165a66 
Dealt to 364a85e6 
Dealt to 3bb96cf5 
Dealt to bd3fac4b 
Dealt to ca34ebc2 
3bb96cf5: folds
bd3fac4b: folds
ca34ebc2: folds
Hero: folds
14165a66: raises $0.2 to $0.3
364a85e6: calls $0.2
*** FLOP *** [2h Qd 4d]
14165a66: checks
364a85e6: checks
*** TURN *** [2h Qd 4d] [Tc]
14165a66: checks
364a85e6: checks
*** RIVER *** [2h Qd 4d Tc] [8c]
14165a66: checks
364a85e6: checks
14165a66: shows [Ac 7s] (Ace-High)
364a85e6: shows [5c Ah] (Ace-High)
*** SHOWDOWN ***
14165a66 collected $0.57 from pot
*** SUMMARY ***
Total pot $0.6 | Rake $0.03 | Jackpot $0 | Bingo $0 | Fortune $0
Board [2h Qd 4d Tc 8c]
Seat 1: Hero (button) folded before Flop (didn't bet)
Seat 2: 14165a66 (small blind) showed [Ac 7s] and won ($0.57) with Ace-High
Seat 3: 364a85e6 (big blind) showed [5c Ah] and lost with Ace-High
Seat 4: 3bb96cf5 folded before Flop (didn't bet)
Seat 5: bd3fac4b folded before Flop (didn't bet)
Seat 6: ca34ebc2 folded before Flop (didn't bet)


Poker Hand #RC1459826572: Hold'em No Limit  ($0.05/$0.1) - 2023/04/08 19:44:12
Table 'RushAndCash3751832' 6-max Seat #1 is the button
Seat 1: ca0ac342 ($17.47 in chips)
Seat 2: baddceb ($18.39 in chips)
Seat 3: bee41a8b ($81.24 in chips)
Seat 4: Hero ($13.6 in chips)
Seat 5: e1c028ac ($5.73 in chips)
Seat 6: a02f13bb ($31.4 in chips)
baddceb: posts small blind $0.05
bee41a8b: posts big blind $0.1
*** HOLE CARDS ***
Dealt to ca0ac342 
Dealt to baddceb 
Dealt to bee41a8b 
Dealt to Hero [Th 4s]
Dealt to e1c028ac 
Dealt to a02f13bb 
Hero: folds
e1c028ac: folds
a02f13bb: raises $0.14 to $0.24
ca0ac342: raises $0.56 to $0.8
baddceb: folds
bee41a8b: folds
a02f13bb: calls $0.56
*** FLOP *** [9s 5c Ts]
a02f13bb: checks
ca0ac342: bets $0.62
a02f13bb: folds
Uncalled bet ($0.62) returned to ca0ac342
*** SHOWDOWN ***
ca0ac342 collected $1.67 from pot
*** SUMMARY ***
Total pot $1.75 | Rake $0.08 | Jackpot $0 | Bingo $0 | Fortune $0
Board [9s 5c Ts]
Seat 1: ca0ac342 (button) won ($1.67)
Seat 2: baddceb (small blind) folded before Flop
Seat 3: bee41a8b (big blind) folded before Flop
Seat 4: Hero folded before Flop (didn't bet)
Seat 5: e1c028ac folded before Flop (didn't bet)
Seat 6: a02f13bb folded on the Flop


Poker Hand #RC1459826522: Hold'em No Limit  ($0.05/$0.1) - 2023/04/08 19:44:05
Table 'RushAndCash3751782' 6-max Seat #1 is the button
Seat 1: 7011ea45 ($14.47 in chips)
Seat 2: Hero ($13.65 in chips)
Seat 3: b6789d58 ($12.55 in chips)
Seat 4: 5c6a73f4 ($11.63 in chips)
Seat 5: deb24db5 ($13.66 in chips)
Seat 6: b022ac81 ($10 in chips)
Hero: posts small blind $0.05
b6789d58: posts big blind $0.1
*** HOLE CARDS ***
Dealt to 7011ea45 
Dealt to Hero [7s 4d]
Dealt to b6789d58 
Dealt to 5c6a73f4 
Dealt to deb24db5 
Dealt to b022ac81 
5c6a73f4: folds
deb24db5: folds
b022ac81: folds
7011ea45: raises $0.15 to $0.25
Hero: folds
b6789d58: folds
Uncalled bet ($0.15) returned to 7011ea45
*** SHOWDOWN ***
7011ea45 collected $0.25 from pot
*** SUMMARY ***
Total pot $0.25 | Rake $0 | Jackpot $0 | Bingo $0 | Fortune $0
Seat 1: 7011ea45 (button) collected ($0.25)
Seat 2: Hero (small blind) folded before Flop
Seat 3: b6789d58 (big blind) folded before Flop
Seat 4: 5c6a73f4 folded before Flop (didn't bet)
Seat 5: deb24db5 folded before Flop (didn't bet)
Seat 6: b022ac81 folded before Flop (didn't bet)


Poker Hand #RC1459826458: Hold'em No Limit  ($0.05/$0.1) - 2023/04/08 19:43:55
Table 'RushAndCash3751718' 6-max Seat #1 is the button
Seat 1: 116d5b6a ($10.68 in chips)
Seat 2: e923b594 ($10 in chips)
Seat 3: 12abd392 ($4 in chips)
Seat 4: 54255b83 ($14.01 in chips)
Seat 5: 2ad67ba8 ($10.66 in chips)
Seat 6: Hero ($13.65 in chips)
e923b594: posts small blind $0.05
12abd392: posts big blind $0.1
*** HOLE CARDS ***
Dealt to 116d5b6a 
Dealt to e923b594 
Dealt to 12abd392 
Dealt to 54255b83 
Dealt to 2ad67ba8 
Dealt to Hero [Qs 3h]
54255b83: raises $0.1 to $0.2
2ad67ba8: folds
Hero: folds
116d5b6a: folds
e923b594: folds
12abd392: raises $0.23 to $0.43
54255b83: calls $0.23
*** FLOP *** [4c 9s 5d]
12abd392: bets $0.91
54255b83: calls $0.91
*** TURN *** [4c 9s 5d] [3c]
12abd392: checks
54255b83: checks
*** RIVER *** [4c 9s 5d 3c] [8s]
12abd392: bets $2.66 and is all-in
54255b83: calls $2.66
12abd392: shows [Ah 5s] (Pair of Fives)
54255b83: shows [9c 8c] (Pair of Nines and Pair of Eights)
*** SHOWDOWN ***
54255b83 collected $7.6 from pot
*** SUMMARY ***
Total pot $8.05 | Rake $0.3 | Jackpot $0.15 | Bingo $0 | Fortune $0
Board [4c 9s 5d 3c 8s]
Seat 1: 116d5b6a (button) folded before Flop (didn't bet)
Seat 2: e923b594 (small blind) folded before Flop
Seat 3: 12abd392 (big blind) showed [Ah 5s] and lost with Pair of Fives
Seat 4: 54255b83 showed [9c 8c] and won ($7.6) with Pair of Nines and Pair of Eights
Seat 5: 2ad67ba8 folded before Flop (didn't bet)
Seat 6: Hero folded before Flop (didn't bet)


Poker Hand #RC1459826161: Hold'em No Limit  ($0.05/$0.1) - 2023/04/08 19:43:15
Table 'RushAndCash3751421' 6-max Seat #1 is the button
Seat 1: 57a18fed ($15.28 in chips)
Seat 2: 4ec6caba ($14.37 in chips)
Seat 3: Hero ($13.42 in chips)
Seat 4: 54255b83 ($14.21 in chips)
Seat 5: caed7b6f ($15.39 in chips)
Seat 6: 5663e5da ($10.92 in chips)
4ec6caba: posts small blind $0.05
Hero: posts big blind $0.1
*** HOLE CARDS ***
Dealt to 57a18fed 
Dealt to 4ec6caba 
Dealt to Hero [Js Kc]
Dealt to 54255b83 
Dealt to caed7b6f 
Dealt to 5663e5da 
54255b83: raises $0.1 to $0.2
caed7b6f: folds
5663e5da: folds
57a18fed: folds
4ec6caba: folds
Hero: calls $0.1
*** FLOP *** [3d Qs 3c]
Hero: checks
54255b83: checks
*** TURN *** [3d Qs 3c] [4d]
Hero: checks
54255b83: checks
*** RIVER *** [3d Qs 3c 4d] [4s]
Hero: checks
54255b83: checks
Hero: shows [Js Kc] (Pair of Fours and Pair of Treys)
54255b83: shows [5s 8h] (Pair of Fours and Pair of Treys)
*** SHOWDOWN ***
Hero collected $0.43 from pot
*** SUMMARY ***
Total pot $0.45 | Rake $0.02 | Jackpot $0 | Bingo $0 | Fortune $0
Board [3d Qs 3c 4d 4s]
Seat 1: 57a18fed (button) folded before Flop (didn't bet)
Seat 2: 4ec6caba (small blind) folded before Flop
Seat 3: Hero (big blind) showed [Js Kc] and won ($0.43) with Pair of Fours and Pair of Treys
Seat 4: 54255b83 showed [5s 8h] and lost with Pair of Fours and Pair of Treys
Seat 5: caed7b6f folded before Flop (didn't bet)
Seat 6: 5663e5da folded before Flop (didn't bet)


Poker Hand #RC1459826125: Hold'em No Limit  ($0.05/$0.1) - 2023/04/08 19:43:10
Table 'RushAndCash3751385' 6-max Seat #1 is the button
Seat 1: f4ea9ac9 ($13.54 in chips)
Seat 2: 80783716 ($17.9 in chips)
Seat 3: 9ec33d2f ($11.27 in chips)
Seat 4: 8a72cfc5 ($11.31 in chips)
Seat 5: be2592f5 ($11.35 in chips)
Seat 6: Hero ($13.42 in chips)
80783716: posts small blind $0.05
9ec33d2f: posts big blind $0.1
*** HOLE CARDS ***
Dealt to f4ea9ac9 
Dealt to 80783716 
Dealt to 9ec33d2f 
Dealt to 8a72cfc5 
Dealt to be2592f5 
Dealt to Hero [2s 7d]
8a72cfc5: folds
be2592f5: raises $0.2 to $0.3
Hero: folds
f4ea9ac9: folds
80783716: calls $0.25
9ec33d2f: folds
*** FLOP *** [3c 9c Qc]
80783716: checks
be2592f5: bets $0.56
80783716: folds
Uncalled bet ($0.56) returned to be2592f5
*** SHOWDOWN ***
be2592f5 collected $0.67 from pot
*** SUMMARY ***
Total pot $0.7 | Rake $0.03 | Jackpot $0 | Bingo $0 | Fortune $0
Board [3c 9c Qc]
Seat 1: f4ea9ac9 (button) folded before Flop (didn't bet)
Seat 2: 80783716 (small blind) folded on the Flop
Seat 3: 9ec33d2f (big blind) folded before Flop
Seat 4: 8a72cfc5 folded before Flop (didn't bet)
Seat 5: be2592f5 won ($0.67)
Seat 6: Hero folded before Flop (didn't bet)


Poker Hand #RC1459826093: Hold'em No Limit  ($0.05/$0.1) - 2023/04/08 19:43:06
Table 'RushAndCash3751353' 6-max Seat #1 is the button
Seat 1: 8a72cfc5 ($11.16 in chips)
Seat 2: f76e4ea7 ($10.38 in chips)
Seat 3: 4ec6caba ($14.32 in chips)
Seat 4: Hero ($13.42 in chips)
Seat 5: c6dcf84b ($10.63 in chips)
Seat 6: e69cddd7 ($10.37 in chips)
f76e4ea7: posts small blind $0.05
4ec6caba: posts big blind $0.1
*** HOLE CARDS ***
Dealt to 8a72cfc5 
Dealt to f76e4ea7 
Dealt to 4ec6caba 
Dealt to Hero [8d Tc]
Dealt to c6dcf84b 
Dealt to e69cddd7 
Hero: folds
c6dcf84b: folds
e69cddd7: folds
8a72cfc5: folds
f76e4ea7: folds
Uncalled bet ($0.05) returned to 4ec6caba
*** SHOWDOWN ***
4ec6caba collected $0.1 from pot
*** SUMMARY ***
Total pot $0.1 | Rake $0 | Jackpot $0 | Bingo $0 | Fortune $0
Seat 1: 8a72cfc5 (button) folded before Flop (didn't bet)
Seat 2: f76e4ea7 (small blind) folded before Flop
Seat 3: 4ec6caba (big blind) collected ($0.1)
Seat 4: Hero folded before Flop (didn't bet)
Seat 5: c6dcf84b folded before Flop (didn't bet)
Seat 6: e69cddd7 folded before Flop (didn't bet)


Poker Hand #RC1459826043: Hold'em No Limit  ($0.05/$0.1) - 2023/04/08 19:43:00
Table 'RushAndCash3751303' 6-max Seat #1 is the button
Seat 1: 39200a17 ($10.66 in chips)
Seat 2: 97250a48 ($10.85 in chips)
Seat 3: 595c378c ($7.81 in chips)
Seat 4: Hero ($13.42 in chips)
Seat 5: e0724192 ($10.15 in chips)
Seat 6: f96970d3 ($8.2 in chips)
97250a48: posts small blind $0.05
595c378c: posts big blind $0.1
*** HOLE CARDS ***
Dealt to 39200a17 
Dealt to 97250a48 
Dealt to 595c378c 
Dealt to Hero [Td 8d]
Dealt to e0724192 
Dealt to f96970d3 
Hero: folds
e0724192: folds
f96970d3: calls $0.1
39200a17: folds
97250a48: folds
595c378c: checks
*** FLOP *** [3s Ks Jh]
595c378c: checks
f96970d3: bets $0.13
595c378c: folds
Uncalled bet ($0.13) returned to f96970d3
*** SHOWDOWN ***
f96970d3 collected $0.24 from pot
*** SUMMARY ***
Total pot $0.25 | Rake $0.01 | Jackpot $0 | Bingo $0 | Fortune $0
Board [3s Ks Jh]
Seat 1: 39200a17 (button) folded before Flop (didn't bet)
Seat 2: 97250a48 (small blind) folded before Flop
Seat 3: 595c378c (big blind) folded on the Flop
Seat 4: Hero folded before Flop (didn't bet)
Seat 5: e0724192 folded before Flop (didn't bet)
Seat 6: f96970d3 won ($0.24)


Poker Hand #RC1459826007: Hold'em No Limit  ($0.05/$0.1) - 2023/04/08 19:42:56
Table 'RushAndCash3751267' 6-max Seat #1 is the button
Seat 1: f9390b9f ($10.49 in chips)
Seat 2: Hero ($13.47 in chips)
Seat 3: d0d6b27 ($11.16 in chips)
Seat 4: 97eb9bd4 ($13.21 in chips)
Seat 5: 723338d9 ($21.82 in chips)
Seat 6: db15d716 ($10.69 in chips)
Hero: posts small blind $0.05
d0d6b27: posts big blind $0.1
*** HOLE CARDS ***
Dealt to f9390b9f 
Dealt to Hero [6d 4h]
Dealt to d0d6b27 
Dealt to 97eb9bd4 
Dealt to 723338d9 
Dealt to db15d716 
97eb9bd4: folds
723338d9: folds
db15d716: folds
f9390b9f: folds
Hero: folds
Uncalled bet ($0.05) returned to d0d6b27
*** SHOWDOWN ***
d0d6b27 collected $0.1 from pot
*** SUMMARY ***
Total pot $0.1 | Rake $0 | Jackpot $0 | Bingo $0 | Fortune $0
Seat 1: f9390b9f (button) folded before Flop (didn't bet)
Seat 2: Hero (small blind) folded before Flop
Seat 3: d0d6b27 (big blind) collected ($0.1)
Seat 4: 97eb9bd4 folded before Flop (didn't bet)
Seat 5: 723338d9 folded before Flop (didn't bet)
Seat 6: db15d716 folded before Flop (didn't bet)


Poker Hand #RC1459825855: Hold'em No Limit  ($0.05/$0.1) - 2023/04/08 19:42:34
Table 'RushAndCash3751115' 6-max Seat #1 is the button
Seat 1: f2724d93 ($22.75 in chips)
Seat 2: 696eb7c1 ($24.87 in chips)
Seat 3: eb3a6963 ($23.55 in chips)
Seat 4: 7c90268 ($14.24 in chips)
Seat 5: Hero ($13.19 in chips)
Seat 6: a7d462f5 ($32.01 in chips)
696eb7c1: posts small blind $0.05
eb3a6963: posts big blind $0.1
*** HOLE CARDS ***
Dealt to f2724d93 
Dealt to 696eb7c1 
Dealt to eb3a6963 
Dealt to 7c90268 
Dealt to Hero [Jh As]
Dealt to a7d462f5 
7c90268: folds
Hero: raises $0.15 to $0.25
a7d462f5: folds
f2724d93: folds
696eb7c1: folds
eb3a6963: calls $0.15
*** FLOP *** [2s Tc Ad]
eb3a6963: checks
Hero: bets $0.28
eb3a6963: folds
Uncalled bet ($0.28) returned to Hero
*** SHOWDOWN ***
Hero collected $0.53 from pot
*** SUMMARY ***
Total pot $0.55 | Rake $0.02 | Jackpot $0 | Bingo $0 | Fortune $0
Board [2s Tc Ad]
Seat 1: f2724d93 (button) folded before Flop (didn't bet)
Seat 2: 696eb7c1 (small blind) folded before Flop
Seat 3: eb3a6963 (big blind) folded on the Flop
Seat 4: 7c90268 folded before Flop (didn't bet)
Seat 5: Hero won ($0.53)
Seat 6: a7d462f5 folded before Flop (didn't bet)


Poker Hand #RC1459825827: Hold'em No Limit  ($0.05/$0.1) - 2023/04/08 19:42:30
Table 'RushAndCash3751087' 6-max Seat #1 is the button
Seat 1: 56ad7446 ($13.18 in chips)
Seat 2: ad674ed6 ($8.46 in chips)
Seat 3: f9390b9f ($10.22 in chips)
Seat 4: Hero ($13.19 in chips)
Seat 5: 696eb7c1 ($24.87 in chips)
Seat 6: 7c703fc4 ($45.86 in chips)
ad674ed6: posts small blind $0.05
f9390b9f: posts big blind $0.1
*** HOLE CARDS ***
Dealt to 56ad7446 
Dealt to ad674ed6 
Dealt to f9390b9f 
Dealt to Hero [Ad 9c]
Dealt to 696eb7c1 
Dealt to 7c703fc4 
Hero: folds
696eb7c1: folds
7c703fc4: folds
56ad7446: raises $0.15 to $0.25
ad674ed6: folds
f9390b9f: folds
Uncalled bet ($0.15) returned to 56ad7446
*** SHOWDOWN ***
56ad7446 collected $0.25 from pot
*** SUMMARY ***
Total pot $0.25 | Rake $0 | Jackpot $0 | Bingo $0 | Fortune $0
Seat 1: 56ad7446 (button) collected ($0.25)
Seat 2: ad674ed6 (small blind) folded before Flop
Seat 3: f9390b9f (big blind) folded before Flop
Seat 4: Hero folded before Flop (didn't bet)
Seat 5: 696eb7c1 folded before Flop (didn't bet)
Seat 6: 7c703fc4 folded before Flop (didn't bet)


Poker Hand #RC1459825770: Hold'em No Limit  ($0.05/$0.1) - 2023/04/08 19:42:22
Table 'RushAndCash3751030' 6-max Seat #1 is the button
Seat 1: Hero ($13.19 in chips)
Seat 2: 40e2e276 ($25.27 in chips)
Seat 3: 17c19bb9 ($10.51 in chips)
Seat 4: d633d9b7 ($28.45 in chips)
Seat 5: 1dda2a4d ($16.25 in chips)
Seat 6: 97eb9bd4 ($13.41 in chips)
40e2e276: posts small blind $0.05
17c19bb9: posts big blind $0.1
*** HOLE CARDS ***
Dealt to Hero [4h Td]
Dealt to 40e2e276 
Dealt to 17c19bb9 
Dealt to d633d9b7 
Dealt to 1dda2a4d 
Dealt to 97eb9bd4 
d633d9b7: raises $0.2 to $0.3
1dda2a4d: folds
97eb9bd4: folds
Hero: folds
40e2e276: folds
17c19bb9: calls $0.2
*** FLOP *** [6d Qc Js]
17c19bb9: checks
d633d9b7: checks
*** TURN *** [6d Qc Js] [9c]
17c19bb9: checks
d633d9b7: checks
*** RIVER *** [6d Qc Js 9c] [Kc]
17c19bb9: bets $0.22
d633d9b7: folds
Uncalled bet ($0.22) returned to 17c19bb9
*** SHOWDOWN ***
17c19bb9 collected $0.62 from pot
*** SUMMARY ***
Total pot $0.65 | Rake $0.03 | Jackpot $0 | Bingo $0 | Fortune $0
Board [6d Qc Js 9c Kc]
Seat 1: Hero (button) folded before Flop (didn't bet)
Seat 2: 40e2e276 (small blind) folded before Flop
Seat 3: 17c19bb9 (big blind) won ($0.62)
Seat 4: d633d9b7 folded on the River
Seat 5: 1dda2a4d folded before Flop (didn't bet)
Seat 6: 97eb9bd4 folded before Flop (didn't bet)


Poker Hand #RC1459825722: Hold'em No Limit  ($0.05/$0.1) - 2023/04/08 19:42:16
Table 'RushAndCash3750982' 6-max Seat #1 is the button
Seat 1: Hero ($13.19 in chips)
Seat 2: 27ed4b31 ($10.41 in chips)
Seat 3: b793dede ($12.08 in chips)
Seat 4: 19bc99cd ($10.3 in chips)
Seat 5: b4f0b29d ($10 in chips)
Seat 6: 24e31a43 ($10 in chips)
27ed4b31: posts small blind $0.05
b793dede: posts big blind $0.1
*** HOLE CARDS ***
Dealt to Hero [Ts 3d]
Dealt to 27ed4b31 
Dealt to b793dede 
Dealt to 19bc99cd 
Dealt to b4f0b29d 
Dealt to 24e31a43 
19bc99cd: folds
b4f0b29d: folds
24e31a43: folds
Hero: folds
27ed4b31: folds
Uncalled bet ($0.05) returned to b793dede
*** SHOWDOWN ***
b793dede collected $0.1 from pot
*** SUMMARY ***
Total pot $0.1 | Rake $0 | Jackpot $0 | Bingo $0 | Fortune $0
Seat 1: Hero (button) folded before Flop (didn't bet)
Seat 2: 27ed4b31 (small blind) folded before Flop
Seat 3: b793dede (big blind) collected ($0.1)
Seat 4: 19bc99cd folded before Flop (didn't bet)
Seat 5: b4f0b29d folded before Flop (didn't bet)
Seat 6: 24e31a43 folded before Flop (didn't bet)


Poker Hand #RC1459825686: Hold'em No Limit  ($0.05/$0.1) - 2023/04/08 19:42:12
Table 'RushAndCash3750946' 6-max Seat #1 is the button
Seat 1: cd67075b ($9.85 in chips)
Seat 2: 49f14ae6 ($10 in chips)
Seat 3: 97eb9bd4 ($13.51 in chips)
Seat 4: dc431d64 ($22.05 in chips)
Seat 5: Hero ($13.19 in chips)
Seat 6: 235b39e8 ($10 in chips)
49f14ae6: posts small blind $0.05
97eb9bd4: posts big blind $0.1
*** HOLE CARDS ***
Dealt to cd67075b 
Dealt to 49f14ae6 
Dealt to 97eb9bd4 
Dealt to dc431d64 
Dealt to Hero [4c 9c]
Dealt to 235b39e8 
dc431d64: folds
Hero: folds
235b39e8: raises $0.1 to $0.2
cd67075b: folds
49f14ae6: folds
97eb9bd4: folds
Uncalled bet ($0.1) returned to 235b39e8
*** SHOWDOWN ***
235b39e8 collected $0.25 from pot
*** SUMMARY ***
Total pot $0.25 | Rake $0 | Jackpot $0 | Bingo $0 | Fortune $0
Seat 1: cd67075b (button) folded before Flop (didn't bet)
Seat 2: 49f14ae6 (small blind) folded before Flop
Seat 3: 97eb9bd4 (big blind) folded before Flop
Seat 4: dc431d64 folded before Flop (didn't bet)
Seat 5: Hero folded before Flop (didn't bet)
Seat 6: 235b39e8 collected ($0.25)


Poker Hand #RC1459825303: Hold'em No Limit  ($0.05/$0.1) - 2023/04/08 19:41:18
Table 'RushAndCash3750563' 6-max Seat #1 is the button
Seat 1: ca0392b6 ($6.57 in chips)
Seat 2: 97eb9bd4 ($13.24 in chips)
Seat 3: Hero ($13.49 in chips)
Seat 4: 2ad67ba8 ($12.53 in chips)
Seat 5: 11565501 ($10 in chips)
Seat 6: 4010a1 ($9.54 in chips)
97eb9bd4: posts small blind $0.05
Hero: posts big blind $0.1
*** HOLE CARDS ***
Dealt to ca0392b6 
Dealt to 97eb9bd4 
Dealt to Hero [Ac 5s]
Dealt to 2ad67ba8 
Dealt to 11565501 
Dealt to 4010a1 
2ad67ba8: folds
11565501: folds
4010a1: folds
ca0392b6: folds
97eb9bd4: raises $0.2 to $0.3
Hero: calls $0.2
*** FLOP *** [9s 6d Qd]
97eb9bd4: checks
Hero: checks
*** TURN *** [9s 6d Qd] [Td]
97eb9bd4: checks
Hero: checks
*** RIVER *** [9s 6d Qd Td] [4h]
97eb9bd4: checks
Hero: checks
97eb9bd4: shows [8s 8d] (Pair of Eights)
Hero: shows [Ac 5s] (Ace-High)
*** SHOWDOWN ***
97eb9bd4 collected $0.57 from pot
*** SUMMARY ***
Total pot $0.6 | Rake $0.03 | Jackpot $0 | Bingo $0 | Fortune $0
Board [9s 6d Qd Td 4h]
Seat 1: ca0392b6 (button) folded before Flop (didn't bet)
Seat 2: 97eb9bd4 (small blind) showed [8s 8d] and won ($0.57) with Pair of Eights
Seat 3: Hero (big blind) showed [Ac 5s] and lost with Ace-High
Seat 4: 2ad67ba8 folded before Flop (didn't bet)
Seat 5: 11565501 folded before Flop (didn't bet)
Seat 6: 4010a1 folded before Flop (didn't bet)


Poker Hand #RC1459825276: Hold'em No Limit  ($0.05/$0.1) - 2023/04/08 19:41:14
Table 'RushAndCash3750536' 6-max Seat #1 is the button
Seat 1: 4ec6caba ($14.67 in chips)
Seat 2: Hero ($13.54 in chips)
Seat 3: ad3b4285 ($11.18 in chips)
Seat 4: b8a3156a ($11.15 in chips)
Seat 5: a8a49559 ($18.27 in chips)
Seat 6: a5ddf956 ($21.92 in chips)
Hero: posts small blind $0.05
ad3b4285: posts big blind $0.1
*** HOLE CARDS ***
Dealt to 4ec6caba 
Dealt to Hero [Js 4h]
Dealt to ad3b4285 
Dealt to b8a3156a 
Dealt to a8a49559 
Dealt to a5ddf956 
b8a3156a: folds
a8a49559: folds
a5ddf956: folds
4ec6caba: folds
Hero: folds
Uncalled bet ($0.05) returned to ad3b4285
*** SHOWDOWN ***
ad3b4285 collected $0.1 from pot
*** SUMMARY ***
Total pot $0.1 | Rake $0 | Jackpot $0 | Bingo $0 | Fortune $0
Seat 1: 4ec6caba (button) folded before Flop (didn't bet)
Seat 2: Hero (small blind) folded before Flop
Seat 3: ad3b4285 (big blind) collected ($0.1)
Seat 4: b8a3156a folded before Flop (didn't bet)
Seat 5: a8a49559 folded before Flop (didn't bet)
Seat 6: a5ddf956 folded before Flop (didn't bet)


Poker Hand #RC1459825189: Hold'em No Limit  ($0.05/$0.1) - 2023/04/08 19:41:03
Table 'RushAndCash3750449' 6-max Seat #1 is the button
Seat 1: dd0dba59 ($10 in chips)
Seat 2: 67930fa0 ($10.28 in chips)
Seat 3: Hero ($13.64 in chips)
Seat 4: 5d1fdaa2 ($10.65 in chips)
Seat 5: 75d479dc ($10.39 in chips)
Seat 6: 38c45073 ($28.46 in chips)
67930fa0: posts small blind $0.05
Hero: posts big blind $0.1
*** HOLE CARDS ***
Dealt to dd0dba59 
Dealt to 67930fa0 
Dealt to Hero [Jd 2s]
Dealt to 5d1fdaa2 
Dealt to 75d479dc 
Dealt to 38c45073 
5d1fdaa2: folds
75d479dc: folds
38c45073: raises $0.2 to $0.3
dd0dba59: folds
67930fa0: folds
Hero: folds
Uncalled bet ($0.2) returned to 38c45073
*** SHOWDOWN ***
38c45073 collected $0.25 from pot
*** SUMMARY ***
Total pot $0.25 | Rake $0 | Jackpot $0 | Bingo $0 | Fortune $0
Seat 1: dd0dba59 (button) folded before Flop (didn't bet)
Seat 2: 67930fa0 (small blind) folded before Flop
Seat 3: Hero (big blind) folded before Flop
Seat 4: 5d1fdaa2 folded before Flop (didn't bet)
Seat 5: 75d479dc folded before Flop (didn't bet)
Seat 6: 38c45073 collected ($0.25)


Poker Hand #RC1459774433: Hold'em No Limit  ($0.05/$0.1) - 2023/04/08 19:39:20
Table 'RushAndCash3749693' 6-max Seat #1 is the button
Seat 1: 95d2128f ($34.01 in chips)
Seat 2: d09c7799 ($2.94 in chips)
Seat 3: 364a85e6 ($18.19 in chips)
Seat 4: Hero ($11.34 in chips)
Seat 5: e62769a9 ($7.4 in chips)
Seat 6: 4ec6caba ($17.22 in chips)
d09c7799: posts small blind $0.05
364a85e6: posts big blind $0.1
*** HOLE CARDS ***
Dealt to 95d2128f 
Dealt to d09c7799 
Dealt to 364a85e6 
Dealt to Hero [Ks Ac]
Dealt to e62769a9 
Dealt to 4ec6caba 
Hero: raises $0.15 to $0.25
e62769a9: folds
4ec6caba: raises $0.65 to $0.9
95d2128f: folds
d09c7799: folds
364a85e6: folds
Hero: raises $1.65 to $2.55
4ec6caba: calls $1.65
*** FLOP *** [3s 2c Qh]
Hero: checks
4ec6caba: checks
*** TURN *** [3s 2c Qh] [Kd]
Hero: checks
4ec6caba: checks
*** RIVER *** [3s 2c Qh Kd] [9c]
Hero: bets $2.5
4ec6caba: folds
Uncalled bet ($2.5) returned to Hero
*** SHOWDOWN ***
Hero collected $4.85 from pot
*** SUMMARY ***
Total pot $5.25 | Rake $0.25 | Jackpot $0.15 | Bingo $0 | Fortune $0
Board [3s 2c Qh Kd 9c]
Seat 1: 95d2128f (button) folded before Flop (didn't bet)
Seat 2: d09c7799 (small blind) folded before Flop
Seat 3: 364a85e6 (big blind) folded before Flop
Seat 4: Hero won ($4.85)
Seat 5: e62769a9 folded before Flop (didn't bet)
Seat 6: 4ec6caba folded on the River


Poker Hand #RC1459774356: Hold'em No Limit  ($0.05/$0.1) - 2023/04/08 19:39:10
Table 'RushAndCash3749616' 6-max Seat #1 is the button
Seat 1: 6587dee ($10 in chips)
Seat 2: 9ec053d2 ($40.82 in chips)
Seat 3: 2835214a ($8.18 in chips)
Seat 4: e1c028ac ($5.58 in chips)
Seat 5: fd75ff53 ($10.52 in chips)
Seat 6: Hero ($11.34 in chips)
9ec053d2: posts small blind $0.05
2835214a: posts big blind $0.1
*** HOLE CARDS ***
Dealt to 6587dee 
Dealt to 9ec053d2 
Dealt to 2835214a 
Dealt to e1c028ac 
Dealt to fd75ff53 
Dealt to Hero [6h 8d]
e1c028ac: folds
fd75ff53: folds
Hero: folds
6587dee: folds
9ec053d2: folds
Uncalled bet ($0.05) returned to 2835214a
*** SHOWDOWN ***
2835214a collected $0.1 from pot
*** SUMMARY ***
Total pot $0.1 | Rake $0 | Jackpot $0 | Bingo $0 | Fortune $0
Seat 1: 6587dee (button) folded before Flop (didn't bet)
Seat 2: 9ec053d2 (small blind) folded before Flop
Seat 3: 2835214a (big blind) collected ($0.1)
Seat 4: e1c028ac folded before Flop (didn't bet)
Seat 5: fd75ff53 folded before Flop (didn't bet)
Seat 6: Hero folded before Flop (didn't bet)


Poker Hand #RC1459774326: Hold'em No Limit  ($0.05/$0.1) - 2023/04/08 19:39:06
Table 'RushAndCash3749586' 6-max Seat #1 is the button
Seat 1: afc95140 ($28.87 in chips)
Seat 2: 39ffd2ac ($20.76 in chips)
Seat 3: fff78e2 ($16.16 in chips)
Seat 4: fe74b7c3 ($17.8 in chips)
Seat 5: Hero ($11.34 in chips)
Seat 6: 24e31a43 ($10 in chips)
39ffd2ac: posts small blind $0.05
fff78e2: posts big blind $0.1
*** HOLE CARDS ***
Dealt to afc95140 
Dealt to 39ffd2ac 
Dealt to fff78e2 
Dealt to fe74b7c3 
Dealt to Hero [Qc 2d]
Dealt to 24e31a43 
fe74b7c3: folds
Hero: folds
24e31a43: folds
afc95140: raises $0.11 to $0.21
39ffd2ac: calls $0.16
fff78e2: folds
*** FLOP *** [8h 3c 5s]
39ffd2ac: checks
afc95140: bets $0.26
39ffd2ac: calls $0.26
*** TURN *** [8h 3c 5s] [Jh]
39ffd2ac: checks
afc95140: checks
*** RIVER *** [8h 3c 5s Jh] [4h]
39ffd2ac: checks
afc95140: checks
39ffd2ac: shows [6d 3d] (Pair of Treys)
afc95140: shows [5h 7c] (Pair of Fives)
*** SHOWDOWN ***
afc95140 collected $0.99 from pot
*** SUMMARY ***
Total pot $1.04 | Rake $0.05 | Jackpot $0 | Bingo $0 | Fortune $0
Board [8h 3c 5s Jh 4h]
Seat 1: afc95140 (button) showed [5h 7c] and won ($0.99) with Pair of Fives
Seat 2: 39ffd2ac (small blind) showed [6d 3d] and lost with Pair of Treys
Seat 3: fff78e2 (big blind) folded before Flop
Seat 4: fe74b7c3 folded before Flop (didn't bet)
Seat 5: Hero folded before Flop (didn't bet)
Seat 6: 24e31a43 folded before Flop (didn't bet)


Poker Hand #RC1459774263: Hold'em No Limit  ($0.05/$0.1) - 2023/04/08 19:38:57
Table 'RushAndCash3749523' 6-max Seat #1 is the button
Seat 1: Hero ($11.34 in chips)
Seat 2: 280b7b ($87.2 in chips)
Seat 3: d5be5c2d ($10 in chips)
Seat 4: 60a2c7ea ($23.77 in chips)
Seat 5: f2724d93 ($23.64 in chips)
Seat 6: b1352104 ($5.42 in chips)
280b7b: posts small blind $0.05
d5be5c2d: posts big blind $0.1
*** HOLE CARDS ***
Dealt to Hero [Ad 3h]
Dealt to 280b7b 
Dealt to d5be5c2d 
Dealt to 60a2c7ea 
Dealt to f2724d93 
Dealt to b1352104 
60a2c7ea: raises $0.12 to $0.22
f2724d93: raises $0.74 to $0.96
b1352104: folds
Hero: folds
280b7b: folds
d5be5c2d: folds
60a2c7ea: calls $0.74
*** FLOP *** [9h Qh 8c]
60a2c7ea: checks
f2724d93: checks
*** TURN *** [9h Qh 8c] [Jh]
60a2c7ea: checks
f2724d93: checks
*** RIVER *** [9h Qh 8c Jh] [4c]
60a2c7ea: bets $3.3
f2724d93: folds
Uncalled bet ($3.3) returned to 60a2c7ea
*** SHOWDOWN ***
60a2c7ea collected $1.97 from pot
*** SUMMARY ***
Total pot $2.07 | Rake $0.1 | Jackpot $0 | Bingo $0 | Fortune $0
Board [9h Qh 8c Jh 4c]
Seat 1: Hero (button) folded before Flop (didn't bet)
Seat 2: 280b7b (small blind) folded before Flop
Seat 3: d5be5c2d (big blind) folded before Flop
Seat 4: 60a2c7ea won ($1.97)
Seat 5: f2724d93 folded on the River
Seat 6: b1352104 folded before Flop (didn't bet)


Poker Hand #RC1459774056: Hold'em No Limit  ($0.05/$0.1) - 2023/04/08 19:38:25
Table 'RushAndCash3749316' 6-max Seat #1 is the button
Seat 1: 7a0a5bb1 ($10 in chips)
Seat 2: 60a2c7ea ($23.99 in chips)
Seat 3: Hero ($11.14 in chips)
Seat 4: b014db86 ($20.34 in chips)
Seat 5: 62eb6051 ($23.74 in chips)
Seat 6: 9ec053d2 ($40.67 in chips)
60a2c7ea: posts small blind $0.05
Hero: posts big blind $0.1
*** HOLE CARDS ***
Dealt to 7a0a5bb1 
Dealt to 60a2c7ea 
Dealt to Hero [Qs 7h]
Dealt to b014db86 
Dealt to 62eb6051 
Dealt to 9ec053d2 
b014db86: folds
62eb6051: folds
9ec053d2: folds
7a0a5bb1: folds
60a2c7ea: raises $0.12 to $0.22
Hero: calls $0.12
*** FLOP *** [Ts 9c Jh]
60a2c7ea: checks
Hero: bets $0.32
60a2c7ea: folds
Uncalled bet ($0.32) returned to Hero
*** SHOWDOWN ***
Hero collected $0.42 from pot
*** SUMMARY ***
Total pot $0.44 | Rake $0.02 | Jackpot $0 | Bingo $0 | Fortune $0
Board [Ts 9c Jh]
Seat 1: 7a0a5bb1 (button) folded before Flop (didn't bet)
Seat 2: 60a2c7ea (small blind) folded on the Flop
Seat 3: Hero (big blind) won ($0.42)
Seat 4: b014db86 folded before Flop (didn't bet)
Seat 5: 62eb6051 folded before Flop (didn't bet)
Seat 6: 9ec053d2 folded before Flop (didn't bet)


Poker Hand #RC1459773937: Hold'em No Limit  ($0.05/$0.1) - 2023/04/08 19:38:09
Table 'RushAndCash3749197' 6-max Seat #1 is the button
Seat 1: 62eb6051 ($23.79 in chips)
Seat 2: Hero ($11.04 in chips)
Seat 3: 2a6dcfd6 ($15.44 in chips)
Seat 4: 55ac3cd6 ($10.28 in chips)
Seat 5: f6f523c1 ($10 in chips)
Seat 6: d7c082e2 ($4.7 in chips)
Hero: posts small blind $0.05
2a6dcfd6: posts big blind $0.1
*** HOLE CARDS ***
Dealt to 62eb6051 
Dealt to Hero [9d 9c]
Dealt to 2a6dcfd6 
Dealt to 55ac3cd6 
Dealt to f6f523c1 
Dealt to d7c082e2 
55ac3cd6: folds
f6f523c1: folds
d7c082e2: folds
62eb6051: folds
Hero: raises $0.2 to $0.3
2a6dcfd6: folds
Uncalled bet ($0.2) returned to Hero
*** SHOWDOWN ***
Hero collected $0.2 from pot
*** SUMMARY ***
Total pot $0.2 | Rake $0 | Jackpot $0 | Bingo $0 | Fortune $0
Seat 1: 62eb6051 (button) folded before Flop (didn't bet)
Seat 2: Hero (small blind) collected ($0.2)
Seat 3: 2a6dcfd6 (big blind) folded before Flop
Seat 4: 55ac3cd6 folded before Flop (didn't bet)
Seat 5: f6f523c1 folded before Flop (didn't bet)
Seat 6: d7c082e2 folded before Flop (didn't bet)


Poker Hand #RC1459773900: Hold'em No Limit  ($0.05/$0.1) - 2023/04/08 19:38:04
Table 'RushAndCash3749160' 6-max Seat #1 is the button
Seat 1: e69cddd7 ($10.7 in chips)
Seat 2: ab7f2399 ($8.11 in chips)
Seat 3: 32eaf87d ($20.53 in chips)
Seat 4: 40b1f7c7 ($23.3 in chips)
Seat 5: 30db0348 ($11.12 in chips)
Seat 6: Hero ($11.04 in chips)
ab7f2399: posts small blind $0.05
32eaf87d: posts big blind $0.1
*** HOLE CARDS ***
Dealt to e69cddd7 
Dealt to ab7f2399 
Dealt to 32eaf87d 
Dealt to 40b1f7c7 
Dealt to 30db0348 
Dealt to Hero [9c 7c]
40b1f7c7: folds
30db0348: raises $0.12 to $0.22
Hero: folds
e69cddd7: folds
ab7f2399: folds
32eaf87d: folds
Uncalled bet ($0.12) returned to 30db0348
*** SHOWDOWN ***
30db0348 collected $0.25 from pot
*** SUMMARY ***
Total pot $0.25 | Rake $0 | Jackpot $0 | Bingo $0 | Fortune $0
Seat 1: e69cddd7 (button) folded before Flop (didn't bet)
Seat 2: ab7f2399 (small blind) folded before Flop
Seat 3: 32eaf87d (big blind) folded before Flop
Seat 4: 40b1f7c7 folded before Flop (didn't bet)
Seat 5: 30db0348 collected ($0.25)
Seat 6: Hero folded before Flop (didn't bet)


Poker Hand #RC1459773818: Hold'em No Limit  ($0.05/$0.1) - 2023/04/08 19:37:53
Table 'RushAndCash3749078' 6-max Seat #1 is the button
Seat 1: 1a0a123c ($10 in chips)
Seat 2: 414db570 ($13.53 in chips)
Seat 3: Hero ($11.14 in chips)
Seat 4: 961e7ae ($7.14 in chips)
Seat 5: 210dc0e5 ($33.15 in chips)
Seat 6: 93028ba3 ($10 in chips)
414db570: posts small blind $0.05
Hero: posts big blind $0.1
*** HOLE CARDS ***
Dealt to 1a0a123c 
Dealt to 414db570 
Dealt to Hero [Kh 4d]
Dealt to 961e7ae 
Dealt to 210dc0e5 
Dealt to 93028ba3 
961e7ae: folds
210dc0e5: folds
93028ba3: folds
1a0a123c: raises $0.15 to $0.25
414db570: raises $0.75 to $1
Hero: folds
1a0a123c: calls $0.75
*** FLOP *** [Td 4c 2h]
414db570: bets $1.68
1a0a123c: folds
Uncalled bet ($1.68) returned to 414db570
*** SHOWDOWN ***
414db570 collected $2 from pot
*** SUMMARY ***
Total pot $2.1 | Rake $0.1 | Jackpot $0 | Bingo $0 | Fortune $0
Board [Td 4c 2h]
Seat 1: 1a0a123c (button) folded on the Flop
Seat 2: 414db570 (small blind) won ($2)
Seat 3: Hero (big blind) folded before Flop
Seat 4: 961e7ae folded before Flop (didn't bet)
Seat 5: 210dc0e5 folded before Flop (didn't bet)
Seat 6: 93028ba3 folded before Flop (didn't bet)


Poker Hand #RC1459773769: Hold'em No Limit  ($0.05/$0.1) - 2023/04/08 19:37:46
Table 'RushAndCash3749029' 6-max Seat #1 is the button
Seat 1: 23226b15 ($15.88 in chips)
Seat 2: ca0ac342 ($13.37 in chips)
Seat 3: 599dbff2 ($11.05 in chips)
Seat 4: f4b98f78 ($23.35 in chips)
Seat 5: Hero ($11.14 in chips)
Seat 6: 163b9118 ($12.59 in chips)
ca0ac342: posts small blind $0.05
599dbff2: posts big blind $0.1
*** HOLE CARDS ***
Dealt to 23226b15 
Dealt to ca0ac342 
Dealt to 599dbff2 
Dealt to f4b98f78 
Dealt to Hero [Ks 8h]
Dealt to 163b9118 
f4b98f78: raises $0.1 to $0.2
Hero: folds
163b9118: folds
23226b15: folds
ca0ac342: folds
599dbff2: calls $0.1
*** FLOP *** [9s 3h 6d]
599dbff2: checks
f4b98f78: bets $0.35
599dbff2: calls $0.35
*** TURN *** [9s 3h 6d] [Kc]
599dbff2: checks
f4b98f78: bets $0.63
599dbff2: raises $0.8 to $1.43
f4b98f78: folds
Uncalled bet ($0.8) returned to 599dbff2
*** SHOWDOWN ***
599dbff2 collected $2.29 from pot
*** SUMMARY ***
Total pot $2.41 | Rake $0.12 | Jackpot $0 | Bingo $0 | Fortune $0
Board [9s 3h 6d Kc]
Seat 1: 23226b15 (button) folded before Flop (didn't bet)
Seat 2: ca0ac342 (small blind) folded before Flop
Seat 3: 599dbff2 (big blind) won ($2.29)
Seat 4: f4b98f78 folded on the Turn
Seat 5: Hero folded before Flop (didn't bet)
Seat 6: 163b9118 folded before Flop (didn't bet)


Poker Hand #RC1459773492: Hold'em No Limit  ($0.05/$0.1) - 2023/04/08 19:37:07
Table 'RushAndCash3748752' 6-max Seat #1 is the button
Seat 1: 99fe827a ($15.2 in chips)
Seat 2: ecdd2866 ($12.13 in chips)
Seat 3: 163b9118 ($12.84 in chips)
Seat 4: dfc7c90a ($7.54 in chips)
Seat 5: Hero ($10.86 in chips)
Seat 6: 23696677 ($10 in chips)
ecdd2866: posts small blind $0.05
163b9118: posts big blind $0.1
*** HOLE CARDS ***
Dealt to 99fe827a 
Dealt to ecdd2866 
Dealt to 163b9118 
Dealt to dfc7c90a 
Dealt to Hero [Qc Qs]
Dealt to 23696677 
dfc7c90a: folds
Hero: raises $0.15 to $0.25
23696677: folds
99fe827a: folds
ecdd2866: folds
163b9118: calls $0.15
*** FLOP *** [Ad Jh 3c]
163b9118: checks
Hero: checks
*** TURN *** [Ad Jh 3c] [4s]
163b9118: checks
Hero: bets $0.19
163b9118: folds
Uncalled bet ($0.19) returned to Hero
*** SHOWDOWN ***
Hero collected $0.53 from pot
*** SUMMARY ***
Total pot $0.55 | Rake $0.02 | Jackpot $0 | Bingo $0 | Fortune $0
Board [Ad Jh 3c 4s]
Seat 1: 99fe827a (button) folded before Flop (didn't bet)
Seat 2: ecdd2866 (small blind) folded before Flop
Seat 3: 163b9118 (big blind) folded on the Turn
Seat 4: dfc7c90a folded before Flop (didn't bet)
Seat 5: Hero won ($0.53)
Seat 6: 23696677 folded before Flop (didn't bet)


Poker Hand #RC1459773431: Hold'em No Limit  ($0.05/$0.1) - 2023/04/08 19:37:00
Table 'RushAndCash3748691' 6-max Seat #1 is the button
Seat 1: 3acdf15 ($11.79 in chips)
Seat 2: 47dc33de ($38.93 in chips)
Seat 3: 583bb900 ($26.39 in chips)
Seat 4: 35ac755b ($10.3 in chips)
Seat 5: Hero ($10.86 in chips)
Seat 6: c41992fa ($25.64 in chips)
47dc33de: posts small blind $0.05
583bb900: posts big blind $0.1
*** HOLE CARDS ***
Dealt to 3acdf15 
Dealt to 47dc33de 
Dealt to 583bb900 
Dealt to 35ac755b 
Dealt to Hero [9d Js]
Dealt to c41992fa 
35ac755b: folds
Hero: folds
c41992fa: folds
3acdf15: raises $0.15 to $0.25
47dc33de: folds
583bb900: folds
Uncalled bet ($0.15) returned to 3acdf15
*** SHOWDOWN ***
3acdf15 collected $0.25 from pot
*** SUMMARY ***
Total pot $0.25 | Rake $0 | Jackpot $0 | Bingo $0 | Fortune $0
Seat 1: 3acdf15 (button) collected ($0.25)
Seat 2: 47dc33de (small blind) folded before Flop
Seat 3: 583bb900 (big blind) folded before Flop
Seat 4: 35ac755b folded before Flop (didn't bet)
Seat 5: Hero folded before Flop (didn't bet)
Seat 6: c41992fa folded before Flop (didn't bet)


Poker Hand #RC1459773298: Hold'em No Limit  ($0.05/$0.1) - 2023/04/08 19:36:42
Table 'RushAndCash3748558' 6-max Seat #1 is the button
Seat 1: a51368ca ($9.53 in chips)
Seat 2: Hero ($10.91 in chips)
Seat 3: e33b6a9d ($3.01 in chips)
Seat 4: 2a389271 ($10.15 in chips)
Seat 5: 42800cf2 ($9.68 in chips)
Seat 6: a9e52b86 ($13.64 in chips)
Hero: posts small blind $0.05
e33b6a9d: posts big blind $0.1
*** HOLE CARDS ***
Dealt to a51368ca 
Dealt to Hero [Jc 4c]
Dealt to e33b6a9d 
Dealt to 2a389271 
Dealt to 42800cf2 
Dealt to a9e52b86 
2a389271: folds
42800cf2: folds
a9e52b86: folds
a51368ca: raises $0.15 to $0.25
Hero: folds
e33b6a9d: folds
Uncalled bet ($0.15) returned to a51368ca
*** SHOWDOWN ***
a51368ca collected $0.25 from pot
*** SUMMARY ***
Total pot $0.25 | Rake $0 | Jackpot $0 | Bingo $0 | Fortune $0
Seat 1: a51368ca (button) collected ($0.25)
Seat 2: Hero (small blind) folded before Flop
Seat 3: e33b6a9d (big blind) folded before Flop
Seat 4: 2a389271 folded before Flop (didn't bet)
Seat 5: 42800cf2 folded before Flop (didn't bet)
Seat 6: a9e52b86 folded before Flop (didn't bet)


Poker Hand #RC1459773257: Hold'em No Limit  ($0.05/$0.1) - 2023/04/08 19:36:36
Table 'RushAndCash3748517' 6-max Seat #1 is the button
Seat 1: Hero ($10.91 in chips)
Seat 2: 55ac3cd6 ($11.12 in chips)
Seat 3: b311bb8e ($10 in chips)
Seat 4: 81f21357 ($25.35 in chips)
Seat 5: 709d274f ($10 in chips)
Seat 6: e35f0658 ($2.11 in chips)
55ac3cd6: posts small blind $0.05
b311bb8e: posts big blind $0.1
*** HOLE CARDS ***
Dealt to Hero [7s 3h]
Dealt to 55ac3cd6 
Dealt to b311bb8e 
Dealt to 81f21357 
Dealt to 709d274f 
Dealt to e35f0658 
81f21357: raises $0.15 to $0.25
709d274f: folds
e35f0658: folds
Hero: folds
55ac3cd6: folds
b311bb8e: folds
Uncalled bet ($0.15) returned to 81f21357
*** SHOWDOWN ***
81f21357 collected $0.25 from pot
*** SUMMARY ***
Total pot $0.25 | Rake $0 | Jackpot $0 | Bingo $0 | Fortune $0
Seat 1: Hero (button) folded before Flop (didn't bet)
Seat 2: 55ac3cd6 (small blind) folded before Flop
Seat 3: b311bb8e (big blind) folded before Flop
Seat 4: 81f21357 collected ($0.25)
Seat 5: 709d274f folded before Flop (didn't bet)
Seat 6: e35f0658 folded before Flop (didn't bet)


Poker Hand #RC1459773206: Hold'em No Limit  ($0.05/$0.1) - 2023/04/08 19:36:30
Table 'RushAndCash3748466' 6-max Seat #1 is the button
Seat 1: 4a18a3b9 ($14.44 in chips)
Seat 2: 5621b94c ($12.87 in chips)
Seat 3: a7d462f5 ($32.08 in chips)
Seat 4: c2d25011 ($25.49 in chips)
Seat 5: Hero ($10.91 in chips)
Seat 6: 163b9118 ($12.89 in chips)
5621b94c: posts small blind $0.05
a7d462f5: posts big blind $0.1
*** HOLE CARDS ***
Dealt to 4a18a3b9 
Dealt to 5621b94c 
Dealt to a7d462f5 
Dealt to c2d25011 
Dealt to Hero [4c As]
Dealt to 163b9118 
c2d25011: folds
Hero: folds
163b9118: folds
4a18a3b9: folds
5621b94c: folds
Uncalled bet ($0.05) returned to a7d462f5
*** SHOWDOWN ***
a7d462f5 collected $0.1 from pot
*** SUMMARY ***
Total pot $0.1 | Rake $0 | Jackpot $0 | Bingo $0 | Fortune $0
Seat 1: 4a18a3b9 (button) folded before Flop (didn't bet)
Seat 2: 5621b94c (small blind) folded before Flop
Seat 3: a7d462f5 (big blind) collected ($0.1)
Seat 4: c2d25011 folded before Flop (didn't bet)
Seat 5: Hero folded before Flop (didn't bet)
Seat 6: 163b9118 folded before Flop (didn't bet)


Poker Hand #RC1459773135: Hold'em No Limit  ($0.05/$0.1) - 2023/04/08 19:36:20
Table 'RushAndCash3748395' 6-max Seat #1 is the button
Seat 1: 4061369e ($10 in chips)
Seat 2: 60fecbb9 ($10 in chips)
Seat 3: 846e879f ($21.58 in chips)
Seat 4: Hero ($10.91 in chips)
Seat 5: 19602f8b ($10 in chips)
Seat 6: 938e46a9 ($9.52 in chips)
60fecbb9: posts small blind $0.05
846e879f: posts big blind $0.1
*** HOLE CARDS ***
Dealt to 4061369e 
Dealt to 60fecbb9 
Dealt to 846e879f 
Dealt to Hero [8s 9c]
Dealt to 19602f8b 
Dealt to 938e46a9 
Hero: folds
19602f8b: folds
938e46a9: raises $0.15 to $0.25
4061369e: calls $0.25
60fecbb9: folds
846e879f: calls $0.15
*** FLOP *** [2d Jd 3c]
846e879f: checks
938e46a9: bets $0.6
4061369e: folds
846e879f: calls $0.6
*** TURN *** [2d Jd 3c] [6s]
846e879f: checks
938e46a9: checks
*** RIVER *** [2d Jd 3c 6s] [Qh]
846e879f: checks
938e46a9: bets $1.5
846e879f: folds
Uncalled bet ($1.5) returned to 938e46a9
*** SHOWDOWN ***
938e46a9 collected $1.9 from pot
*** SUMMARY ***
Total pot $2 | Rake $0.1 | Jackpot $0 | Bingo $0 | Fortune $0
Board [2d Jd 3c 6s Qh]
Seat 1: 4061369e (button) folded on the Flop
Seat 2: 60fecbb9 (small blind) folded before Flop
Seat 3: 846e879f (big blind) folded on the River
Seat 4: Hero folded before Flop (didn't bet)
Seat 5: 19602f8b folded before Flop (didn't bet)
Seat 6: 938e46a9 won ($1.9)


Poker Hand #RC1459772825: Hold'em No Limit  ($0.05/$0.1) - 2023/04/08 19:35:41
Table 'RushAndCash3748085' 6-max Seat #1 is the button
Seat 1: 107ad6ef ($8.95 in chips)
Seat 2: 80697e31 ($10.21 in chips)
Seat 3: Hero ($11.14 in chips)
Seat 4: 938e46a9 ($9.26 in chips)
Seat 5: a871713 ($10.42 in chips)
Seat 6: 53e42ad5 ($10 in chips)
80697e31: posts small blind $0.05
Hero: posts big blind $0.1
*** HOLE CARDS ***
Dealt to 107ad6ef 
Dealt to 80697e31 
Dealt to Hero [Td Kc]
Dealt to 938e46a9 
Dealt to a871713 
Dealt to 53e42ad5 
938e46a9: raises $0.13 to $0.23
a871713: folds
53e42ad5: folds
107ad6ef: folds
80697e31: folds
Hero: calls $0.13
*** FLOP *** [7c 3c Js]
Hero: checks
938e46a9: bets $0.26
Hero: folds
Uncalled bet ($0.26) returned to 938e46a9
*** SHOWDOWN ***
938e46a9 collected $0.49 from pot
*** SUMMARY ***
Total pot $0.51 | Rake $0.02 | Jackpot $0 | Bingo $0 | Fortune $0
Board [7c 3c Js]
Seat 1: 107ad6ef (button) folded before Flop (didn't bet)
Seat 2: 80697e31 (small blind) folded before Flop
Seat 3: Hero (big blind) folded on the Flop
Seat 4: 938e46a9 won ($0.49)
Seat 5: a871713 folded before Flop (didn't bet)
Seat 6: 53e42ad5 folded before Flop (didn't bet)


Poker Hand #RC1459772735: Hold'em No Limit  ($0.05/$0.1) - 2023/04/08 19:35:28
Table 'RushAndCash3747995' 6-max Seat #1 is the button
Seat 1: 2eadf610 ($11.23 in chips)
Seat 2: Hero ($11.19 in chips)
Seat 3: 3a7b06c2 ($7.06 in chips)
Seat 4: 1ca5bc12 ($10.52 in chips)
Seat 5: c09dbfbc ($10.75 in chips)
Seat 6: e0ecab42 ($23.15 in chips)
Hero: posts small blind $0.05
3a7b06c2: posts big blind $0.1
*** HOLE CARDS ***
Dealt to 2eadf610 
Dealt to Hero [6d Qd]
Dealt to 3a7b06c2 
Dealt to 1ca5bc12 
Dealt to c09dbfbc 
Dealt to e0ecab42 
1ca5bc12: folds
c09dbfbc: raises $0.15 to $0.25
e0ecab42: folds
2eadf610: folds
Hero: folds
3a7b06c2: folds
Uncalled bet ($0.15) returned to c09dbfbc
*** SHOWDOWN ***
c09dbfbc collected $0.25 from pot
*** SUMMARY ***
Total pot $0.25 | Rake $0 | Jackpot $0 | Bingo $0 | Fortune $0
Seat 1: 2eadf610 (button) folded before Flop (didn't bet)
Seat 2: Hero (small blind) folded before Flop
Seat 3: 3a7b06c2 (big blind) folded before Flop
Seat 4: 1ca5bc12 folded before Flop (didn't bet)
Seat 5: c09dbfbc collected ($0.25)
Seat 6: e0ecab42 folded before Flop (didn't bet)


Poker Hand #RC1459772705: Hold'em No Limit  ($0.05/$0.1) - 2023/04/08 19:35:24
Table 'RushAndCash3747965' 6-max Seat #1 is the button
Seat 1: ad3b4285 ($10.93 in chips)
Seat 2: 7caaec7d ($10 in chips)
Seat 3: 41c7306c ($10.15 in chips)
Seat 4: Hero ($11.19 in chips)
Seat 5: dce49951 ($20.31 in chips)
Seat 6: 38c45073 ($34.92 in chips)
7caaec7d: posts small blind $0.05
41c7306c: posts big blind $0.1
*** HOLE CARDS ***
Dealt to ad3b4285 
Dealt to 7caaec7d 
Dealt to 41c7306c 
Dealt to Hero [Qh 5d]
Dealt to dce49951 
Dealt to 38c45073 
Hero: folds
dce49951: folds
38c45073: raises $0.15 to $0.25
ad3b4285: folds
7caaec7d: raises $0.41 to $0.66
41c7306c: folds
38c45073: folds
Uncalled bet ($0.41) returned to 7caaec7d
*** SHOWDOWN ***
7caaec7d collected $0.57 from pot
*** SUMMARY ***
Total pot $0.6 | Rake $0.03 | Jackpot $0 | Bingo $0 | Fortune $0
Seat 1: ad3b4285 (button) folded before Flop (didn't bet)
Seat 2: 7caaec7d (small blind) collected ($0.57)
Seat 3: 41c7306c (big blind) folded before Flop
Seat 4: Hero folded before Flop (didn't bet)
Seat 5: dce49951 folded before Flop (didn't bet)
Seat 6: 38c45073 folded before Flop


Poker Hand #RC1459772639: Hold'em No Limit  ($0.05/$0.1) - 2023/04/08 19:35:15
Table 'RushAndCash3747899' 6-max Seat #1 is the button
Seat 1: Hero ($11.19 in chips)
Seat 2: 1033bb03 ($16.01 in chips)
Seat 3: d9ebb3cc ($23.02 in chips)
Seat 4: 55ac3cd6 ($10.89 in chips)
Seat 5: fa183b4a ($10 in chips)
Seat 6: 80e5b33b ($3.77 in chips)
1033bb03: posts small blind $0.05
d9ebb3cc: posts big blind $0.1
*** HOLE CARDS ***
Dealt to Hero [Jd 3h]
Dealt to 1033bb03 
Dealt to d9ebb3cc 
Dealt to 55ac3cd6 
Dealt to fa183b4a 
Dealt to 80e5b33b 
55ac3cd6: folds
fa183b4a: raises $0.1 to $0.2
80e5b33b: folds
Hero: folds
1033bb03: folds
d9ebb3cc: folds
Uncalled bet ($0.1) returned to fa183b4a
*** SHOWDOWN ***
fa183b4a collected $0.25 from pot
*** SUMMARY ***
Total pot $0.25 | Rake $0 | Jackpot $0 | Bingo $0 | Fortune $0
Seat 1: Hero (button) folded before Flop (didn't bet)
Seat 2: 1033bb03 (small blind) folded before Flop
Seat 3: d9ebb3cc (big blind) folded before Flop
Seat 4: 55ac3cd6 folded before Flop (didn't bet)
Seat 5: fa183b4a collected ($0.25)
Seat 6: 80e5b33b folded before Flop (didn't bet)


Poker Hand #RC1459772588: Hold'em No Limit  ($0.05/$0.1) - 2023/04/08 19:35:09
Table 'RushAndCash3747848' 6-max Seat #1 is the button
Seat 1: bda1469b ($1.45 in chips)
Seat 2: e62769a9 ($7.08 in chips)
Seat 3: f2724d93 ($23.12 in chips)
Seat 4: Hero ($11.19 in chips)
Seat 5: 2bd599e1 ($11.27 in chips)
Seat 6: 39200a17 ($10.83 in chips)
e62769a9: posts small blind $0.05
f2724d93: posts big blind $0.1
*** HOLE CARDS ***
Dealt to bda1469b 
Dealt to e62769a9 
Dealt to f2724d93 
Dealt to Hero [9c Qd]
Dealt to 2bd599e1 
Dealt to 39200a17 
Hero: folds
2bd599e1: folds
39200a17: folds
bda1469b: folds
e62769a9: raises $0.1 to $0.2
f2724d93: folds
Uncalled bet ($0.1) returned to e62769a9
*** SHOWDOWN ***
e62769a9 collected $0.2 from pot
*** SUMMARY ***
Total pot $0.2 | Rake $0 | Jackpot $0 | Bingo $0 | Fortune $0
Seat 1: bda1469b (button) folded before Flop (didn't bet)
Seat 2: e62769a9 (small blind) collected ($0.2)
Seat 3: f2724d93 (big blind) folded before Flop
Seat 4: Hero folded before Flop (didn't bet)
Seat 5: 2bd599e1 folded before Flop (didn't bet)
Seat 6: 39200a17 folded before Flop (didn't bet)


Poker Hand #RC1459772555: Hold'em No Limit  ($0.05/$0.1) - 2023/04/08 19:35:04
Table 'RushAndCash3747815' 6-max Seat #1 is the button
Seat 1: 3a725736 ($8.93 in chips)
Seat 2: 30e52bc8 ($13.5 in chips)
Seat 3: 364a85e6 ($18.57 in chips)
Seat 4: Hero ($11.19 in chips)
Seat 5: f7e283ad ($10 in chips)
Seat 6: 723338d9 ($10.65 in chips)
30e52bc8: posts small blind $0.05
364a85e6: posts big blind $0.1
*** HOLE CARDS ***
Dealt to 3a725736 
Dealt to 30e52bc8 
Dealt to 364a85e6 
Dealt to Hero [Tc 8d]
Dealt to f7e283ad 
Dealt to 723338d9 
Hero: folds
f7e283ad: folds
723338d9: folds
3a725736: raises $0.13 to $0.23
30e52bc8: folds
364a85e6: folds
Uncalled bet ($0.13) returned to 3a725736
*** SHOWDOWN ***
3a725736 collected $0.25 from pot
*** SUMMARY ***
Total pot $0.25 | Rake $0 | Jackpot $0 | Bingo $0 | Fortune $0
Seat 1: 3a725736 (button) collected ($0.25)
Seat 2: 30e52bc8 (small blind) folded before Flop
Seat 3: 364a85e6 (big blind) folded before Flop
Seat 4: Hero folded before Flop (didn't bet)
Seat 5: f7e283ad folded before Flop (didn't bet)
Seat 6: 723338d9 folded before Flop (didn't bet)


Poker Hand #RC1459772422: Hold'em No Limit  ($0.05/$0.1) - 2023/04/08 19:34:45
Table 'RushAndCash3747682' 6-max Seat #1 is the button
Seat 1: 723338d9 ($10.28 in chips)
Seat 2: ecdd2866 ($12.93 in chips)
Seat 3: 6ccf489d ($11.48 in chips)
Seat 4: 89738755 ($8.58 in chips)
Seat 5: Hero ($11.44 in chips)
Seat 6: dee21b10 ($12.02 in chips)
ecdd2866: posts small blind $0.05
6ccf489d: posts big blind $0.1
*** HOLE CARDS ***
Dealt to 723338d9 
Dealt to ecdd2866 
Dealt to 6ccf489d 
Dealt to 89738755 
Dealt to Hero [9c As]
Dealt to dee21b10 
89738755: folds
Hero: raises $0.15 to $0.25
dee21b10: folds
723338d9: raises $0.49 to $0.74
ecdd2866: folds
6ccf489d: folds
Hero: folds
Uncalled bet ($0.49) returned to 723338d9
*** SHOWDOWN ***
723338d9 collected $0.62 from pot
*** SUMMARY ***
Total pot $0.65 | Rake $0.03 | Jackpot $0 | Bingo $0 | Fortune $0
Seat 1: 723338d9 (button) collected ($0.62)
Seat 2: ecdd2866 (small blind) folded before Flop
Seat 3: 6ccf489d (big blind) folded before Flop
Seat 4: 89738755 folded before Flop (didn't bet)
Seat 5: Hero folded before Flop
Seat 6: dee21b10 folded before Flop (didn't bet)


Poker Hand #RC1459772368: Hold'em No Limit  ($0.05/$0.1) - 2023/04/08 19:34:36
Table 'RushAndCash3747628' 6-max Seat #1 is the button
Seat 1: fe74b7c3 ($14.77 in chips)
Seat 2: Hero ($11.49 in chips)
Seat 3: b804915f ($19.92 in chips)
Seat 4: b7100a36 ($12.31 in chips)
Seat 5: b77466f3 ($22.72 in chips)
Seat 6: 79e5faf8 ($20.43 in chips)
Hero: posts small blind $0.05
b804915f: posts big blind $0.1
*** HOLE CARDS ***
Dealt to fe74b7c3 
Dealt to Hero [3c Qh]
Dealt to b804915f 
Dealt to b7100a36 
Dealt to b77466f3 
Dealt to 79e5faf8 
b7100a36: folds
b77466f3: folds
79e5faf8: raises $0.15 to $0.25
fe74b7c3: folds
Hero: folds
b804915f: folds
Uncalled bet ($0.15) returned to 79e5faf8
*** SHOWDOWN ***
79e5faf8 collected $0.25 from pot
*** SUMMARY ***
Total pot $0.25 | Rake $0 | Jackpot $0 | Bingo $0 | Fortune $0
Seat 1: fe74b7c3 (button) folded before Flop (didn't bet)
Seat 2: Hero (small blind) folded before Flop
Seat 3: b804915f (big blind) folded before Flop
Seat 4: b7100a36 folded before Flop (didn't bet)
Seat 5: b77466f3 folded before Flop (didn't bet)
Seat 6: 79e5faf8 collected ($0.25)


Poker Hand #RC1459772251: Hold'em No Limit  ($0.05/$0.1) - 2023/04/08 19:34:21
Table 'RushAndCash3747511' 6-max Seat #1 is the button
Seat 1: 93028ba3 ($10.21 in chips)
Seat 2: 7c703fc4 ($46.43 in chips)
Seat 3: Hero ($11.44 in chips)
Seat 4: afad3d85 ($10.46 in chips)
Seat 5: 5e17c3c6 ($11.47 in chips)
Seat 6: 7981963d ($11.19 in chips)
7c703fc4: posts small blind $0.05
Hero: posts big blind $0.1
*** HOLE CARDS ***
Dealt to 93028ba3 
Dealt to 7c703fc4 
Dealt to Hero [8c Ah]
Dealt to afad3d85 
Dealt to 5e17c3c6 
Dealt to 7981963d 
afad3d85: folds
5e17c3c6: folds
7981963d: folds
93028ba3: folds
7c703fc4: folds
Uncalled bet ($0.05) returned to Hero
*** SHOWDOWN ***
Hero collected $0.1 from pot
*** SUMMARY ***
Total pot $0.1 | Rake $0 | Jackpot $0 | Bingo $0 | Fortune $0
Seat 1: 93028ba3 (button) folded before Flop (didn't bet)
Seat 2: 7c703fc4 (small blind) folded before Flop
Seat 3: Hero (big blind) collected ($0.1)
Seat 4: afad3d85 folded before Flop (didn't bet)
Seat 5: 5e17c3c6 folded before Flop (didn't bet)
Seat 6: 7981963d folded before Flop (didn't bet)


Poker Hand #RC1459772078: Hold'em No Limit  ($0.05/$0.1) - 2023/04/08 19:33:59
Table 'RushAndCash3747338' 6-max Seat #1 is the button
Seat 1: Hero ($11.69 in chips)
Seat 2: 54dcb36b ($17.87 in chips)
Seat 3: fb68b4f7 ($8.13 in chips)
Seat 4: 9eb62b2 ($11.54 in chips)
Seat 5: 178a96db ($14.36 in chips)
Seat 6: ecdd2866 ($13.18 in chips)
54dcb36b: posts small blind $0.05
fb68b4f7: posts big blind $0.1
*** HOLE CARDS ***
Dealt to Hero [Kc 9s]
Dealt to 54dcb36b 
Dealt to fb68b4f7 
Dealt to 9eb62b2 
Dealt to 178a96db 
Dealt to ecdd2866 
9eb62b2: folds
178a96db: folds
ecdd2866: folds
Hero: raises $0.15 to $0.25
54dcb36b: raises $0.65 to $0.9
fb68b4f7: calls $0.8
Hero: folds
*** FLOP *** [Ts Kh 9d]
54dcb36b: bets $0.65
fb68b4f7: calls $0.65
*** TURN *** [Ts Kh 9d] [4c]
54dcb36b: checks
fb68b4f7: bets $1.28
54dcb36b: calls $1.28
*** RIVER *** [Ts Kh 9d 4c] [9h]
54dcb36b: checks
fb68b4f7: checks
54dcb36b: shows [4d Ad] (Pair of Nines and Pair of Fours)
fb68b4f7: shows [Jd Jc] (Pair of Jacks and Pair of Nines)
*** SHOWDOWN ***
fb68b4f7 collected $5.42 from pot
*** SUMMARY ***
Total pot $5.91 | Rake $0.34 | Jackpot $0.15 | Bingo $0 | Fortune $0
Board [Ts Kh 9d 4c 9h]
Seat 1: Hero (button) folded before Flop
Seat 2: 54dcb36b (small blind) showed [4d Ad] and lost with Pair of Nines and Pair of Fours
Seat 3: fb68b4f7 (big blind) showed [Jd Jc] and won ($5.42) with Pair of Jacks and Pair of Nines
Seat 4: 9eb62b2 folded before Flop (didn't bet)
Seat 5: 178a96db folded before Flop (didn't bet)
Seat 6: ecdd2866 folded before Flop (didn't bet)


Poker Hand #RC1459772049: Hold'em No Limit  ($0.05/$0.1) - 2023/04/08 19:33:54
Table 'RushAndCash3747309' 6-max Seat #1 is the button
Seat 1: 470cf287 ($10.15 in chips)
Seat 2: 92a48d51 ($21.63 in chips)
Seat 3: 790b1321 ($23.81 in chips)
Seat 4: f18ec573 ($23.5 in chips)
Seat 5: 39acc71d ($22.33 in chips)
Seat 6: Hero ($11.69 in chips)
92a48d51: posts small blind $0.05
790b1321: posts big blind $0.1
*** HOLE CARDS ***
Dealt to 470cf287 
Dealt to 92a48d51 
Dealt to 790b1321 
Dealt to f18ec573 
Dealt to 39acc71d 
Dealt to Hero [6s 5h]
f18ec573: folds
39acc71d: folds
Hero: folds
470cf287: folds
92a48d51: folds
Uncalled bet ($0.05) returned to 790b1321
*** SHOWDOWN ***
790b1321 collected $0.1 from pot
*** SUMMARY ***
Total pot $0.1 | Rake $0 | Jackpot $0 | Bingo $0 | Fortune $0
Seat 1: 470cf287 (button) folded before Flop (didn't bet)
Seat 2: 92a48d51 (small blind) folded before Flop
Seat 3: 790b1321 (big blind) collected ($0.1)
Seat 4: f18ec573 folded before Flop (didn't bet)
Seat 5: 39acc71d folded before Flop (didn't bet)
Seat 6: Hero folded before Flop (didn't bet)


Poker Hand #RC1459772017: Hold'em No Limit  ($0.05/$0.1) - 2023/04/08 19:33:50
Table 'RushAndCash3747277' 6-max Seat #1 is the button
Seat 1: fe9a5e1a ($9.04 in chips)
Seat 2: 24e31a43 ($12.23 in chips)
Seat 3: d5e7e96 ($29.17 in chips)
Seat 4: Hero ($11.69 in chips)
Seat 5: 38c45073 ($34.5 in chips)
Seat 6: f18ec573 ($23.5 in chips)
24e31a43: posts small blind $0.05
d5e7e96: posts big blind $0.1
*** HOLE CARDS ***
Dealt to fe9a5e1a 
Dealt to 24e31a43 
Dealt to d5e7e96 
Dealt to Hero [5c 9d]
Dealt to 38c45073 
Dealt to f18ec573 
Hero: folds
38c45073: raises $0.15 to $0.25
f18ec573: folds
fe9a5e1a: folds
24e31a43: calls $0.2
d5e7e96: folds
*** FLOP *** [2d Jc Kh]
24e31a43: checks
38c45073: checks
*** TURN *** [2d Jc Kh] [5h]
24e31a43: checks
38c45073: checks
*** RIVER *** [2d Jc Kh 5h] [Jh]
24e31a43: checks
38c45073: checks
24e31a43: shows [6h 6d] (Pair of Jacks and Pair of Sixes)
38c45073: shows [7h 7s] (Pair of Jacks and Pair of Sevens)
*** SHOWDOWN ***
38c45073 collected $0.57 from pot
*** SUMMARY ***
Total pot $0.6 | Rake $0.03 | Jackpot $0 | Bingo $0 | Fortune $0
Board [2d Jc Kh 5h Jh]
Seat 1: fe9a5e1a (button) folded before Flop (didn't bet)
Seat 2: 24e31a43 (small blind) showed [6h 6d] and lost with Pair of Jacks and Pair of Sixes
Seat 3: d5e7e96 (big blind) folded before Flop
Seat 4: Hero folded before Flop (didn't bet)
Seat 5: 38c45073 showed [7h 7s] and won ($0.57) with Pair of Jacks and Pair of Sevens
Seat 6: f18ec573 folded before Flop (didn't bet)


Poker Hand #RC1459771926: Hold'em No Limit  ($0.05/$0.1) - 2023/04/08 19:33:38
Table 'RushAndCash3747186' 6-max Seat #1 is the button
Seat 1: Hero ($11.54 in chips)
Seat 2: b82fd860 ($9.3 in chips)
Seat 3: 3d16c2db ($21.77 in chips)
Seat 4: 4b10708a ($33.74 in chips)
Seat 5: cf03a1c9 ($32.69 in chips)
Seat 6: 57a18fed ($13.29 in chips)
b82fd860: posts small blind $0.05
3d16c2db: posts big blind $0.1
*** HOLE CARDS ***
Dealt to Hero [Jd Kc]
Dealt to b82fd860 
Dealt to 3d16c2db 
Dealt to 4b10708a 
Dealt to cf03a1c9 
Dealt to 57a18fed 
4b10708a: folds
cf03a1c9: folds
57a18fed: folds
Hero: raises $0.15 to $0.25
b82fd860: folds
3d16c2db: folds
Uncalled bet ($0.15) returned to Hero
*** SHOWDOWN ***
Hero collected $0.25 from pot
*** SUMMARY ***
Total pot $0.25 | Rake $0 | Jackpot $0 | Bingo $0 | Fortune $0
Seat 1: Hero (button) collected ($0.25)
Seat 2: b82fd860 (small blind) folded before Flop
Seat 3: 3d16c2db (big blind) folded before Flop
Seat 4: 4b10708a folded before Flop (didn't bet)
Seat 5: cf03a1c9 folded before Flop (didn't bet)
Seat 6: 57a18fed folded before Flop (didn't bet)


Poker Hand #RC1459771830: Hold'em No Limit  ($0.05/$0.1) - 2023/04/08 19:33:24
Table 'RushAndCash3747090' 6-max Seat #1 is the button
Seat 1: 2e9a8f64 ($10.79 in chips)
Seat 2: 32c1b142 ($10.03 in chips)
Seat 3: Hero ($11.64 in chips)
Seat 4: b342ae3f ($17.3 in chips)
Seat 5: 3294ece5 ($30.9 in chips)
Seat 6: d09c7799 ($3.02 in chips)
32c1b142: posts small blind $0.05
Hero: posts big blind $0.1
*** HOLE CARDS ***
Dealt to 2e9a8f64 
Dealt to 32c1b142 
Dealt to Hero [5h 4h]
Dealt to b342ae3f 
Dealt to 3294ece5 
Dealt to d09c7799 
b342ae3f: folds
3294ece5: folds
d09c7799: raises $0.2 to $0.3
2e9a8f64: raises $0.6 to $0.9
32c1b142: folds
Hero: folds
d09c7799: folds
Uncalled bet ($0.6) returned to 2e9a8f64
*** SHOWDOWN ***
2e9a8f64 collected $0.72 from pot
*** SUMMARY ***
Total pot $0.75 | Rake $0.03 | Jackpot $0 | Bingo $0 | Fortune $0
Seat 1: 2e9a8f64 (button) collected ($0.72)
Seat 2: 32c1b142 (small blind) folded before Flop
Seat 3: Hero (big blind) folded before Flop
Seat 4: b342ae3f folded before Flop (didn't bet)
Seat 5: 3294ece5 folded before Flop (didn't bet)
Seat 6: d09c7799 folded before Flop


Poker Hand #RC1459771593: Hold'em No Limit  ($0.05/$0.1) - 2023/04/08 19:32:50
Table 'RushAndCash3746853' 6-max Seat #1 is the button
Seat 1: 57a18fed ($13.44 in chips)
Seat 2: 49da03d9 ($17.43 in chips)
Seat 3: d09c7799 ($3.27 in chips)
Seat 4: baddceb ($17.36 in chips)
Seat 5: 3a7b06c2 ($6.27 in chips)
Seat 6: Hero ($11.36 in chips)
49da03d9: posts small blind $0.05
d09c7799: posts big blind $0.1
*** HOLE CARDS ***
Dealt to 57a18fed 
Dealt to 49da03d9 
Dealt to d09c7799 
Dealt to baddceb 
Dealt to 3a7b06c2 
Dealt to Hero [Kc 9c]
baddceb: folds
3a7b06c2: folds
Hero: raises $0.15 to $0.25
57a18fed: folds
49da03d9: folds
d09c7799: calls $0.15
*** FLOP *** [Jc Jh 8d]
d09c7799: checks
Hero: checks
*** TURN *** [Jc Jh 8d] [Th]
d09c7799: checks
Hero: bets $0.28
d09c7799: folds
Uncalled bet ($0.28) returned to Hero
*** SHOWDOWN ***
Hero collected $0.53 from pot
*** SUMMARY ***
Total pot $0.55 | Rake $0.02 | Jackpot $0 | Bingo $0 | Fortune $0
Board [Jc Jh 8d Th]
Seat 1: 57a18fed (button) folded before Flop (didn't bet)
Seat 2: 49da03d9 (small blind) folded before Flop
Seat 3: d09c7799 (big blind) folded on the Turn
Seat 4: baddceb folded before Flop (didn't bet)
Seat 5: 3a7b06c2 folded before Flop (didn't bet)
Seat 6: Hero won ($0.53)


Poker Hand #RC1459771517: Hold'em No Limit  ($0.05/$0.1) - 2023/04/08 19:32:39
Table 'RushAndCash3746777' 6-max Seat #1 is the button
Seat 1: 2bb1f524 ($13.93 in chips)
Seat 2: Hero ($11.41 in chips)
Seat 3: 1fcf81a5 ($24.57 in chips)
Seat 4: 5bbf6d6e ($10.11 in chips)
Seat 5: ce8eee04 ($6.68 in chips)
Seat 6: af43d45c ($7.73 in chips)
Hero: posts small blind $0.05
1fcf81a5: posts big blind $0.1
*** HOLE CARDS ***
Dealt to 2bb1f524 
Dealt to Hero [2c 6c]
Dealt to 1fcf81a5 
Dealt to 5bbf6d6e 
Dealt to ce8eee04 
Dealt to af43d45c 
5bbf6d6e: folds
ce8eee04: folds
af43d45c: calls $0.1
2bb1f524: folds
Hero: folds
1fcf81a5: checks
*** FLOP *** [Ad 8s Kd]
1fcf81a5: checks
af43d45c: bets $0.13
1fcf81a5: calls $0.13
*** TURN *** [Ad 8s Kd] [3d]
1fcf81a5: checks
af43d45c: checks
*** RIVER *** [Ad 8s Kd 3d] [Qd]
1fcf81a5: bets $0.17
af43d45c: folds
Uncalled bet ($0.17) returned to 1fcf81a5
*** SHOWDOWN ***
1fcf81a5 collected $0.49 from pot
*** SUMMARY ***
Total pot $0.51 | Rake $0.02 | Jackpot $0 | Bingo $0 | Fortune $0
Board [Ad 8s Kd 3d Qd]
Seat 1: 2bb1f524 (button) folded before Flop (didn't bet)
Seat 2: Hero (small blind) folded before Flop
Seat 3: 1fcf81a5 (big blind) won ($0.49)
Seat 4: 5bbf6d6e folded before Flop (didn't bet)
Seat 5: ce8eee04 folded before Flop (didn't bet)
Seat 6: af43d45c folded on the River


Poker Hand #RC1459771385: Hold'em No Limit  ($0.05/$0.1) - 2023/04/08 19:32:20
Table 'RushAndCash3746645' 6-max Seat #1 is the button
Seat 1: 8a8bce3 ($18.83 in chips)
Seat 2: 514c7d55 ($11.68 in chips)
Seat 3: d0b73ea6 ($12.66 in chips)
Seat 4: b82fd860 ($9.45 in chips)
Seat 5: 6f09c065 ($13.42 in chips)
Seat 6: Hero ($11.41 in chips)
514c7d55: posts small blind $0.05
d0b73ea6: posts big blind $0.1
*** HOLE CARDS ***
Dealt to 8a8bce3 
Dealt to 514c7d55 
Dealt to d0b73ea6 
Dealt to b82fd860 
Dealt to 6f09c065 
Dealt to Hero [Ah 4h]
b82fd860: folds
6f09c065: raises $0.19 to $0.29
Hero: folds
8a8bce3: folds
514c7d55: folds
d0b73ea6: folds
Uncalled bet ($0.19) returned to 6f09c065
*** SHOWDOWN ***
6f09c065 collected $0.25 from pot
*** SUMMARY ***
Total pot $0.25 | Rake $0 | Jackpot $0 | Bingo $0 | Fortune $0
Seat 1: 8a8bce3 (button) folded before Flop (didn't bet)
Seat 2: 514c7d55 (small blind) folded before Flop
Seat 3: d0b73ea6 (big blind) folded before Flop
Seat 4: b82fd860 folded before Flop (didn't bet)
Seat 5: 6f09c065 collected ($0.25)
Seat 6: Hero folded before Flop (didn't bet)


Poker Hand #RC1459771329: Hold'em No Limit  ($0.05/$0.1) - 2023/04/08 19:32:12
Table 'RushAndCash3746589' 6-max Seat #1 is the button
Seat 1: 546e56e1 ($11.34 in chips)
Seat 2: b77466f3 ($22.5 in chips)
Seat 3: Hero ($11.36 in chips)
Seat 4: 5c132109 ($11.24 in chips)
Seat 5: 41208841 ($10.25 in chips)
Seat 6: d0399322 ($7.56 in chips)
b77466f3: posts small blind $0.05
Hero: posts big blind $0.1
*** HOLE CARDS ***
Dealt to 546e56e1 
Dealt to b77466f3 
Dealt to Hero [8s Jd]
Dealt to 5c132109 
Dealt to 41208841 
Dealt to d0399322 
5c132109: folds
41208841: folds
d0399322: folds
546e56e1: folds
b77466f3: folds
Uncalled bet ($0.05) returned to Hero
*** SHOWDOWN ***
Hero collected $0.1 from pot
*** SUMMARY ***
Total pot $0.1 | Rake $0 | Jackpot $0 | Bingo $0 | Fortune $0
Seat 1: 546e56e1 (button) folded before Flop (didn't bet)
Seat 2: b77466f3 (small blind) folded before Flop
Seat 3: Hero (big blind) collected ($0.1)
Seat 4: 5c132109 folded before Flop (didn't bet)
Seat 5: 41208841 folded before Flop (didn't bet)
Seat 6: d0399322 folded before Flop (didn't bet)


Poker Hand #RC1459771252: Hold'em No Limit  ($0.05/$0.1) - 2023/04/08 19:32:00
Table 'RushAndCash3746512' 6-max Seat #1 is the button
Seat 1: 107ad6ef ($11.05 in chips)
Seat 2: fcb88c86 ($10.45 in chips)
Seat 3: 39bd8e3a ($10.35 in chips)
Seat 4: 35ac755b ($10.15 in chips)
Seat 5: b532d8aa ($13.61 in chips)
Seat 6: Hero ($11.36 in chips)
fcb88c86: posts small blind $0.05
39bd8e3a: posts big blind $0.1
*** HOLE CARDS ***
Dealt to 107ad6ef 
Dealt to fcb88c86 
Dealt to 39bd8e3a 
Dealt to 35ac755b 
Dealt to b532d8aa 
Dealt to Hero [9h 6d]
35ac755b: raises $0.15 to $0.25
b532d8aa: folds
Hero: folds
107ad6ef: folds
fcb88c86: folds
39bd8e3a: calls $0.15
*** FLOP *** [2d Th 3d]
39bd8e3a: checks
35ac755b: checks
*** TURN *** [2d Th 3d] [8h]
39bd8e3a: bets $0.42
35ac755b: folds
Uncalled bet ($0.42) returned to 39bd8e3a
*** SHOWDOWN ***
39bd8e3a collected $0.53 from pot
*** SUMMARY ***
Total pot $0.55 | Rake $0.02 | Jackpot $0 | Bingo $0 | Fortune $0
Board [2d Th 3d 8h]
Seat 1: 107ad6ef (button) folded before Flop (didn't bet)
Seat 2: fcb88c86 (small blind) folded before Flop
Seat 3: 39bd8e3a (big blind) won ($0.53)
Seat 4: 35ac755b folded on the Turn
Seat 5: b532d8aa folded before Flop (didn't bet)
Seat 6: Hero folded before Flop (didn't bet)


Poker Hand #RC1459771205: Hold'em No Limit  ($0.05/$0.1) - 2023/04/08 19:31:54
Table 'RushAndCash3746465' 6-max Seat #1 is the button
Seat 1: 7981963d ($11.32 in chips)
Seat 2: Hero ($11.41 in chips)
Seat 3: 79e5faf8 ($21.42 in chips)
Seat 4: 41208841 ($10.1 in chips)
Seat 5: ed1f4251 ($2.45 in chips)
Seat 6: a4a4271f ($15.45 in chips)
Hero: posts small blind $0.05
79e5faf8: posts big blind $0.1
*** HOLE CARDS ***
Dealt to 7981963d 
Dealt to Hero [8d 6d]
Dealt to 79e5faf8 
Dealt to 41208841 
Dealt to ed1f4251 
Dealt to a4a4271f 
41208841: raises $0.15 to $0.25
ed1f4251: folds
a4a4271f: folds
7981963d: folds
Hero: folds
79e5faf8: folds
Uncalled bet ($0.15) returned to 41208841
*** SHOWDOWN ***
41208841 collected $0.25 from pot
*** SUMMARY ***
Total pot $0.25 | Rake $0 | Jackpot $0 | Bingo $0 | Fortune $0
Seat 1: 7981963d (button) folded before Flop (didn't bet)
Seat 2: Hero (small blind) folded before Flop
Seat 3: 79e5faf8 (big blind) folded before Flop
Seat 4: 41208841 collected ($0.25)
Seat 5: ed1f4251 folded before Flop (didn't bet)
Seat 6: a4a4271f folded before Flop (didn't bet)


Poker Hand #RC1459771170: Hold'em No Limit  ($0.05/$0.1) - 2023/04/08 19:31:48
Table 'RushAndCash3746430' 6-max Seat #1 is the button
Seat 1: 78b5efe ($21.86 in chips)
Seat 2: be2592f5 ($10 in chips)
Seat 3: 1a0a123c ($10 in chips)
Seat 4: Hero ($11.41 in chips)
Seat 5: 34e2d266 ($7.49 in chips)
Seat 6: 8064075d ($26.05 in chips)
be2592f5: posts small blind $0.05
1a0a123c: posts big blind $0.1
*** HOLE CARDS ***
Dealt to 78b5efe 
Dealt to be2592f5 
Dealt to 1a0a123c 
Dealt to Hero [2s Js]
Dealt to 34e2d266 
Dealt to 8064075d 
Hero: folds
34e2d266: raises $0.2 to $0.3
8064075d: folds
78b5efe: folds
be2592f5: folds
1a0a123c: calls $0.2
*** FLOP *** [As Ah Ac]
1a0a123c: checks
34e2d266: bets $0.25
1a0a123c: calls $0.25
*** TURN *** [As Ah Ac] [5s]
1a0a123c: checks
34e2d266: checks
*** RIVER *** [As Ah Ac 5s] [6c]
1a0a123c: checks
34e2d266: checks
1a0a123c: shows [Kh Qs] (Three Aces)
34e2d266: shows [9h Ts] (Three Aces)
*** SHOWDOWN ***
1a0a123c collected $1.1 from pot
*** SUMMARY ***
Total pot $1.15 | Rake $0.05 | Jackpot $0 | Bingo $0 | Fortune $0
Board [As Ah Ac 5s 6c]
Seat 1: 78b5efe (button) folded before Flop (didn't bet)
Seat 2: be2592f5 (small blind) folded before Flop
Seat 3: 1a0a123c (big blind) showed [Kh Qs] and won ($1.1) with Three Aces
Seat 4: Hero folded before Flop (didn't bet)
Seat 5: 34e2d266 showed [9h Ts] and lost with Three Aces
Seat 6: 8064075d folded before Flop (didn't bet)


Poker Hand #RC1459771125: Hold'em No Limit  ($0.05/$0.1) - 2023/04/08 19:31:42
Table 'RushAndCash3746385' 6-max Seat #1 is the button
Seat 1: 67930fa0 ($11.01 in chips)
Seat 2: 43663618 ($10.33 in chips)
Seat 3: caa6760d ($11.82 in chips)
Seat 4: Hero ($11.41 in chips)
Seat 5: a9ec7a72 ($10 in chips)
Seat 6: 11ef0c8 ($6.79 in chips)
43663618: posts small blind $0.05
caa6760d: posts big blind $0.1
*** HOLE CARDS ***
Dealt to 67930fa0 
Dealt to 43663618 
Dealt to caa6760d 
Dealt to Hero [3s Kd]
Dealt to a9ec7a72 
Dealt to 11ef0c8 
Hero: folds
a9ec7a72: folds
11ef0c8: folds
67930fa0: folds
43663618: raises $0.14 to $0.24
caa6760d: calls $0.14
*** FLOP *** [Kh 5h Qc]
43663618: checks
caa6760d: checks
*** TURN *** [Kh 5h Qc] [5d]
43663618: bets $0.24
caa6760d: folds
Uncalled bet ($0.24) returned to 43663618
*** SHOWDOWN ***
43663618 collected $0.46 from pot
*** SUMMARY ***
Total pot $0.48 | Rake $0.02 | Jackpot $0 | Bingo $0 | Fortune $0
Board [Kh 5h Qc 5d]
Seat 1: 67930fa0 (button) folded before Flop (didn't bet)
Seat 2: 43663618 (small blind) won ($0.46)
Seat 3: caa6760d (big blind) folded on the Turn
Seat 4: Hero folded before Flop (didn't bet)
Seat 5: a9ec7a72 folded before Flop (didn't bet)
Seat 6: 11ef0c8 folded before Flop (didn't bet)


Poker Hand #RC1459771095: Hold'em No Limit  ($0.05/$0.1) - 2023/04/08 19:31:38
Table 'RushAndCash3746355' 6-max Seat #1 is the button
Seat 1: Hero ($11.41 in chips)
Seat 2: 846e879f ($24.36 in chips)
Seat 3: ae81be6b ($10.5 in chips)
Seat 4: e918bbff ($13.78 in chips)
Seat 5: a39cbea1 ($10.42 in chips)
Seat 6: d47c361a ($10.15 in chips)
846e879f: posts small blind $0.05
ae81be6b: posts big blind $0.1
*** HOLE CARDS ***
Dealt to Hero [2c 3d]
Dealt to 846e879f 
Dealt to ae81be6b 
Dealt to e918bbff 
Dealt to a39cbea1 
Dealt to d47c361a 
e918bbff: raises $0.15 to $0.25
a39cbea1: folds
d47c361a: folds
Hero: folds
846e879f: folds
ae81be6b: folds
Uncalled bet ($0.15) returned to e918bbff
*** SHOWDOWN ***
e918bbff collected $0.25 from pot
*** SUMMARY ***
Total pot $0.25 | Rake $0 | Jackpot $0 | Bingo $0 | Fortune $0
Seat 1: Hero (button) folded before Flop (didn't bet)
Seat 2: 846e879f (small blind) folded before Flop
Seat 3: ae81be6b (big blind) folded before Flop
Seat 4: e918bbff collected ($0.25)
Seat 5: a39cbea1 folded before Flop (didn't bet)
Seat 6: d47c361a folded before Flop (didn't bet)


Poker Hand #RC1459770964: Hold'em No Limit  ($0.05/$0.1) - 2023/04/08 19:31:20
Table 'RushAndCash3746224' 6-max Seat #1 is the button
Seat 1: ad9785 ($20.49 in chips)
Seat 2: 1e0deb92 ($12.07 in chips)
Seat 3: fea23e8c ($22.01 in chips)
Seat 4: 7eec5224 ($11.55 in chips)
Seat 5: Hero ($11.26 in chips)
Seat 6: 94b6df17 ($10 in chips)
1e0deb92: posts small blind $0.05
fea23e8c: posts big blind $0.1
*** HOLE CARDS ***
Dealt to ad9785 
Dealt to 1e0deb92 
Dealt to fea23e8c 
Dealt to 7eec5224 
Dealt to Hero [Td As]
Dealt to 94b6df17 
7eec5224: folds
Hero: raises $0.15 to $0.25
94b6df17: folds
ad9785: folds
1e0deb92: folds
fea23e8c: folds
Uncalled bet ($0.15) returned to Hero
*** SHOWDOWN ***
Hero collected $0.25 from pot
*** SUMMARY ***
Total pot $0.25 | Rake $0 | Jackpot $0 | Bingo $0 | Fortune $0
Seat 1: ad9785 (button) folded before Flop (didn't bet)
Seat 2: 1e0deb92 (small blind) folded before Flop
Seat 3: fea23e8c (big blind) folded before Flop
Seat 4: 7eec5224 folded before Flop (didn't bet)
Seat 5: Hero collected ($0.25)
Seat 6: 94b6df17 folded before Flop (didn't bet)


Poker Hand #RC1459770934: Hold'em No Limit  ($0.05/$0.1) - 2023/04/08 19:31:16
Table 'RushAndCash3746194' 6-max Seat #1 is the button
Seat 1: Hero ($11.26 in chips)
Seat 2: 54255b83 ($11.06 in chips)
Seat 3: 4ec6caba ($12.82 in chips)
Seat 4: 81f21357 ($26.2 in chips)
Seat 5: 7faf8c75 ($47.4 in chips)
Seat 6: ed2461d3 ($18.03 in chips)
54255b83: posts small blind $0.05
4ec6caba: posts big blind $0.1
*** HOLE CARDS ***
Dealt to Hero [Jd 4c]
Dealt to 54255b83 
Dealt to 4ec6caba 
Dealt to 81f21357 
Dealt to 7faf8c75 
Dealt to ed2461d3 
81f21357: folds
7faf8c75: raises $0.15 to $0.25
ed2461d3: folds
Hero: folds
54255b83: raises $0.15 to $0.4
4ec6caba: folds
7faf8c75: calls $0.15
*** FLOP *** [3s 6d 3c]
54255b83: checks
7faf8c75: checks
*** TURN *** [3s 6d 3c] [5h]
54255b83: checks
7faf8c75: checks
*** RIVER *** [3s 6d 3c 5h] [Th]
54255b83: checks
7faf8c75: checks
54255b83: shows [Qd As] (Pair of Treys)
7faf8c75: shows [Ac Qh] (Pair of Treys)
*** SHOWDOWN ***
54255b83 collected $0.43 from pot
7faf8c75 collected $0.43 from pot
*** SUMMARY ***
Total pot $0.9 | Rake $0.04 | Jackpot $0 | Bingo $0 | Fortune $0
Board [3s 6d 3c 5h Th]
Seat 1: Hero (button) folded before Flop (didn't bet)
Seat 2: 54255b83 (small blind) showed [Qd As] and won ($0.43) with Pair of Treys
Seat 3: 4ec6caba (big blind) folded before Flop
Seat 4: 81f21357 folded before Flop (didn't bet)
Seat 5: 7faf8c75 showed [Ac Qh] and won ($0.43) with Pair of Treys
Seat 6: ed2461d3 folded before Flop (didn't bet)


Poker Hand #RC1459770877: Hold'em No Limit  ($0.05/$0.1) - 2023/04/08 19:31:07
Table 'RushAndCash3746137' 6-max Seat #1 is the button
Seat 1: b84bb4a5 ($10 in chips)
Seat 2: 210dc0e5 ($32.41 in chips)
Seat 3: Hero ($11.36 in chips)
Seat 4: 7d4eb619 ($10 in chips)
Seat 5: b82fd860 ($10.5 in chips)
Seat 6: 475fe736 ($28.53 in chips)
210dc0e5: posts small blind $0.05
Hero: posts big blind $0.1
*** HOLE CARDS ***
Dealt to b84bb4a5 
Dealt to 210dc0e5 
Dealt to Hero [4d Js]
Dealt to 7d4eb619 
Dealt to b82fd860 
Dealt to 475fe736 
7d4eb619: raises $0.2 to $0.3
b82fd860: folds
475fe736: folds
b84bb4a5: folds
210dc0e5: folds
Hero: folds
Uncalled bet ($0.2) returned to 7d4eb619
*** SHOWDOWN ***
7d4eb619 collected $0.25 from pot
*** SUMMARY ***
Total pot $0.25 | Rake $0 | Jackpot $0 | Bingo $0 | Fortune $0
Seat 1: b84bb4a5 (button) folded before Flop (didn't bet)
Seat 2: 210dc0e5 (small blind) folded before Flop
Seat 3: Hero (big blind) folded before Flop
Seat 4: 7d4eb619 collected ($0.25)
Seat 5: b82fd860 folded before Flop (didn't bet)
Seat 6: 475fe736 folded before Flop (didn't bet)


Poker Hand #RC1459770824: Hold'em No Limit  ($0.05/$0.1) - 2023/04/08 19:30:59
Table 'RushAndCash3746084' 6-max Seat #1 is the button
Seat 1: 3d1f932f ($9.95 in chips)
Seat 2: Hero ($11.41 in chips)
Seat 3: 546e56e1 ($10 in chips)
Seat 4: b793dede ($7.71 in chips)
Seat 5: fbc401b8 ($10.33 in chips)
Seat 6: da6f67a2 ($19.35 in chips)
Hero: posts small blind $0.05
546e56e1: posts big blind $0.1
*** HOLE CARDS ***
Dealt to 3d1f932f 
Dealt to Hero [Tc 2c]
Dealt to 546e56e1 
Dealt to b793dede 
Dealt to fbc401b8 
Dealt to da6f67a2 
b793dede: folds
fbc401b8: folds
da6f67a2: folds
3d1f932f: folds
Hero: folds
Uncalled bet ($0.05) returned to 546e56e1
*** SHOWDOWN ***
546e56e1 collected $0.1 from pot
*** SUMMARY ***
Total pot $0.1 | Rake $0 | Jackpot $0 | Bingo $0 | Fortune $0
Seat 1: 3d1f932f (button) folded before Flop (didn't bet)
Seat 2: Hero (small blind) folded before Flop
Seat 3: 546e56e1 (big blind) collected ($0.1)
Seat 4: b793dede folded before Flop (didn't bet)
Seat 5: fbc401b8 folded before Flop (didn't bet)
Seat 6: da6f67a2 folded before Flop (didn't bet)


Poker Hand #RC1459770750: Hold'em No Limit  ($0.05/$0.1) - 2023/04/08 19:30:49
Table 'RushAndCash3746010' 6-max Seat #1 is the button
Seat 1: 240df39a ($11.32 in chips)
Seat 2: 3610c1a3 ($23.54 in chips)
Seat 3: 280b7b ($79.66 in chips)
Seat 4: Hero ($11.41 in chips)
Seat 5: 4bd3987a ($10.88 in chips)
Seat 6: e5c7d102 ($12.42 in chips)
3610c1a3: posts small blind $0.05
280b7b: posts big blind $0.1
*** HOLE CARDS ***
Dealt to 240df39a 
Dealt to 3610c1a3 
Dealt to 280b7b 
Dealt to Hero [4d 8h]
Dealt to 4bd3987a 
Dealt to e5c7d102 
Hero: folds
4bd3987a: folds
e5c7d102: raises $0.15 to $0.25
240df39a: folds
3610c1a3: folds
280b7b: folds
Uncalled bet ($0.15) returned to e5c7d102
*** SHOWDOWN ***
e5c7d102 collected $0.25 from pot
*** SUMMARY ***
Total pot $0.25 | Rake $0 | Jackpot $0 | Bingo $0 | Fortune $0
Seat 1: 240df39a (button) folded before Flop (didn't bet)
Seat 2: 3610c1a3 (small blind) folded before Flop
Seat 3: 280b7b (big blind) folded before Flop
Seat 4: Hero folded before Flop (didn't bet)
Seat 5: 4bd3987a folded before Flop (didn't bet)
Seat 6: e5c7d102 collected ($0.25)


Poker Hand #RC1459770634: Hold'em No Limit  ($0.05/$0.1) - 2023/04/08 19:30:30
Table 'RushAndCash3745894' 6-max Seat #1 is the button
Seat 1: 56fe61f7 ($10.15 in chips)
Seat 2: 11565501 ($10.2 in chips)
Seat 3: ca0392b6 ($0.54 in chips)
Seat 4: ca47437 ($10 in chips)
Seat 5: Hero ($11.26 in chips)
Seat 6: bdea4bf9 ($10 in chips)
11565501: posts small blind $0.05
ca0392b6: posts big blind $0.1
*** HOLE CARDS ***
Dealt to 56fe61f7 
Dealt to 11565501 
Dealt to ca0392b6 
Dealt to ca47437 
Dealt to Hero [Jd Ks]
Dealt to bdea4bf9 
ca47437: folds
Hero: raises $0.15 to $0.25
bdea4bf9: folds
56fe61f7: folds
11565501: folds
ca0392b6: folds
Uncalled bet ($0.15) returned to Hero
*** SHOWDOWN ***
Hero collected $0.25 from pot
*** SUMMARY ***
Total pot $0.25 | Rake $0 | Jackpot $0 | Bingo $0 | Fortune $0
Seat 1: 56fe61f7 (button) folded before Flop (didn't bet)
Seat 2: 11565501 (small blind) folded before Flop
Seat 3: ca0392b6 (big blind) folded before Flop
Seat 4: ca47437 folded before Flop (didn't bet)
Seat 5: Hero collected ($0.25)
Seat 6: bdea4bf9 folded before Flop (didn't bet)


Poker Hand #RC1459770593: Hold'em No Limit  ($0.05/$0.1) - 2023/04/08 19:30:24
Table 'RushAndCash3745853' 6-max Seat #1 is the button
Seat 1: 39bd8e3a ($10.45 in chips)
Seat 2: 7c8cdc2e ($6.13 in chips)
Seat 3: bda1469b ($3.18 in chips)
Seat 4: 20e4e3ed ($14.57 in chips)
Seat 5: 81f21357 ($26.6 in chips)
Seat 6: Hero ($11.26 in chips)
7c8cdc2e: posts small blind $0.05
bda1469b: posts big blind $0.1
*** HOLE CARDS ***
Dealt to 39bd8e3a 
Dealt to 7c8cdc2e 
Dealt to bda1469b 
Dealt to 20e4e3ed 
Dealt to 81f21357 
Dealt to Hero [4s Jc]
20e4e3ed: folds
81f21357: folds
Hero: folds
39bd8e3a: raises $0.15 to $0.25
7c8cdc2e: folds
bda1469b: folds
Uncalled bet ($0.15) returned to 39bd8e3a
*** SHOWDOWN ***
39bd8e3a collected $0.25 from pot
*** SUMMARY ***
Total pot $0.25 | Rake $0 | Jackpot $0 | Bingo $0 | Fortune $0
Seat 1: 39bd8e3a (button) collected ($0.25)
Seat 2: 7c8cdc2e (small blind) folded before Flop
Seat 3: bda1469b (big blind) folded before Flop
Seat 4: 20e4e3ed folded before Flop (didn't bet)
Seat 5: 81f21357 folded before Flop (didn't bet)
Seat 6: Hero folded before Flop (didn't bet)


Poker Hand #RC1459770532: Hold'em No Limit  ($0.05/$0.1) - 2023/04/08 19:30:15
Table 'RushAndCash3745792' 6-max Seat #1 is the button
Seat 1: 55ac3cd6 ($10.3 in chips)
Seat 2: d81ea08f ($13.7 in chips)
Seat 3: 46b2eca6 ($13.72 in chips)
Seat 4: c49a4612 ($15 in chips)
Seat 5: 8ef0aa95 ($10.81 in chips)
Seat 6: Hero ($11.26 in chips)
d81ea08f: posts small blind $0.05
46b2eca6: posts big blind $0.1
*** HOLE CARDS ***
Dealt to 55ac3cd6 
Dealt to d81ea08f 
Dealt to 46b2eca6 
Dealt to c49a4612 
Dealt to 8ef0aa95 
Dealt to Hero [Qc 6c]
c49a4612: folds
8ef0aa95: folds
Hero: folds
55ac3cd6: raises $0.1 to $0.2
d81ea08f: folds
46b2eca6: folds
Uncalled bet ($0.1) returned to 55ac3cd6
*** SHOWDOWN ***
55ac3cd6 collected $0.25 from pot
*** SUMMARY ***
Total pot $0.25 | Rake $0 | Jackpot $0 | Bingo $0 | Fortune $0
Seat 1: 55ac3cd6 (button) collected ($0.25)
Seat 2: d81ea08f (small blind) folded before Flop
Seat 3: 46b2eca6 (big blind) folded before Flop
Seat 4: c49a4612 folded before Flop (didn't bet)
Seat 5: 8ef0aa95 folded before Flop (didn't bet)
Seat 6: Hero folded before Flop (didn't bet)


Poker Hand #RC1459770345: Hold'em No Limit  ($0.05/$0.1) - 2023/04/08 19:29:47
Table 'RushAndCash3745605' 6-max Seat #1 is the button
Seat 1: Hero ($11.51 in chips)
Seat 2: 1904434e ($12.82 in chips)
Seat 3: d81ea08f ($13.42 in chips)
Seat 4: 550648a ($10.86 in chips)
Seat 5: 3edd334f ($32.81 in chips)
Seat 6: 2f7d31ea ($30.62 in chips)
1904434e: posts small blind $0.05
d81ea08f: posts big blind $0.1
*** HOLE CARDS ***
Dealt to Hero [3d As]
Dealt to 1904434e 
Dealt to d81ea08f 
Dealt to 550648a 
Dealt to 3edd334f 
Dealt to 2f7d31ea 
550648a: folds
3edd334f: folds
2f7d31ea: folds
Hero: raises $0.15 to $0.25
1904434e: folds
d81ea08f: raises $0.97 to $1.22
Hero: folds
Uncalled bet ($0.97) returned to d81ea08f
*** SHOWDOWN ***
d81ea08f collected $0.53 from pot
*** SUMMARY ***
Total pot $0.55 | Rake $0.02 | Jackpot $0 | Bingo $0 | Fortune $0
Seat 1: Hero (button) folded before Flop
Seat 2: 1904434e (small blind) folded before Flop
Seat 3: d81ea08f (big blind) collected ($0.53)
Seat 4: 550648a folded before Flop (didn't bet)
Seat 5: 3edd334f folded before Flop (didn't bet)
Seat 6: 2f7d31ea folded before Flop (didn't bet)


Poker Hand #RC1459770112: Hold'em No Limit  ($0.05/$0.1) - 2023/04/08 19:29:12
Table 'RushAndCash3745372' 6-max Seat #1 is the button
Seat 1: d81ea08f ($13.67 in chips)
Seat 2: 40e2e276 ($17.33 in chips)
Seat 3: Hero ($11.23 in chips)
Seat 4: a32142c9 ($11.06 in chips)
Seat 5: ae81be6b ($10 in chips)
Seat 6: b79a8f2a ($10.15 in chips)
40e2e276: posts small blind $0.05
Hero: posts big blind $0.1
*** HOLE CARDS ***
Dealt to d81ea08f 
Dealt to 40e2e276 
Dealt to Hero [As Th]
Dealt to a32142c9 
Dealt to ae81be6b 
Dealt to b79a8f2a 
a32142c9: folds
ae81be6b: folds
b79a8f2a: folds
d81ea08f: raises $0.15 to $0.25
40e2e276: folds
Hero: raises $0.75 to $1
d81ea08f: folds
Uncalled bet ($0.75) returned to Hero
*** SHOWDOWN ***
Hero collected $0.53 from pot
*** SUMMARY ***
Total pot $0.55 | Rake $0.02 | Jackpot $0 | Bingo $0 | Fortune $0
Seat 1: d81ea08f (button) folded before Flop
Seat 2: 40e2e276 (small blind) folded before Flop
Seat 3: Hero (big blind) collected ($0.53)
Seat 4: a32142c9 folded before Flop (didn't bet)
Seat 5: ae81be6b folded before Flop (didn't bet)
Seat 6: b79a8f2a folded before Flop (didn't bet)


Poker Hand #RC1459770063: Hold'em No Limit  ($0.05/$0.1) - 2023/04/08 19:29:05
Table 'RushAndCash3745323' 6-max Seat #1 is the button
Seat 1: d9b8a67d ($17.92 in chips)
Seat 2: ec33c1bf ($5.79 in chips)
Seat 3: 20e4e3ed ($14.57 in chips)
Seat 4: df2920d3 ($8.22 in chips)
Seat 5: Hero ($11.23 in chips)
Seat 6: e461d7f0 ($15.41 in chips)
ec33c1bf: posts small blind $0.05
20e4e3ed: posts big blind $0.1
*** HOLE CARDS ***
Dealt to d9b8a67d 
Dealt to ec33c1bf 
Dealt to 20e4e3ed 
Dealt to df2920d3 
Dealt to Hero [4c 9c]
Dealt to e461d7f0 
df2920d3: raises $0.15 to $0.25
Hero: folds
e461d7f0: folds
d9b8a67d: folds
ec33c1bf: folds
20e4e3ed: folds
Uncalled bet ($0.15) returned to df2920d3
*** SHOWDOWN ***
df2920d3 collected $0.25 from pot
*** SUMMARY ***
Total pot $0.25 | Rake $0 | Jackpot $0 | Bingo $0 | Fortune $0
Seat 1: d9b8a67d (button) folded before Flop (didn't bet)
Seat 2: ec33c1bf (small blind) folded before Flop
Seat 3: 20e4e3ed (big blind) folded before Flop
Seat 4: df2920d3 collected ($0.25)
Seat 5: Hero folded before Flop (didn't bet)
Seat 6: e461d7f0 folded before Flop (didn't bet)


Poker Hand #RC1459769997: Hold'em No Limit  ($0.05/$0.1) - 2023/04/08 19:28:57
Table 'RushAndCash3745257' 6-max Seat #1 is the button
Seat 1: b019a2ea ($7.27 in chips)
Seat 2: Hero ($11.28 in chips)
Seat 3: eda2be39 ($10.23 in chips)
Seat 4: 470cf287 ($10 in chips)
Seat 5: 62dc1925 ($10 in chips)
Seat 6: 77d09b13 ($10.62 in chips)
Hero: posts small blind $0.05
eda2be39: posts big blind $0.1
*** HOLE CARDS ***
Dealt to b019a2ea 
Dealt to Hero [4d Th]
Dealt to eda2be39 
Dealt to 470cf287 
Dealt to 62dc1925 
Dealt to 77d09b13 
470cf287: folds
62dc1925: raises $0.15 to $0.25
77d09b13: folds
b019a2ea: folds
Hero: folds
eda2be39: folds
Uncalled bet ($0.15) returned to 62dc1925
*** SHOWDOWN ***
62dc1925 collected $0.25 from pot
*** SUMMARY ***
Total pot $0.25 | Rake $0 | Jackpot $0 | Bingo $0 | Fortune $0
Seat 1: b019a2ea (button) folded before Flop (didn't bet)
Seat 2: Hero (small blind) folded before Flop
Seat 3: eda2be39 (big blind) folded before Flop
Seat 4: 470cf287 folded before Flop (didn't bet)
Seat 5: 62dc1925 collected ($0.25)
Seat 6: 77d09b13 folded before Flop (didn't bet)


Poker Hand #RC1459769938: Hold'em No Limit  ($0.05/$0.1) - 2023/04/08 19:28:48
Table 'RushAndCash3745198' 6-max Seat #1 is the button
Seat 1: 49da03d9 ($17.31 in chips)
Seat 2: 9fdde15e ($15.45 in chips)
Seat 3: 4cda30a6 ($31.01 in chips)
Seat 4: b4f0b29d ($10.55 in chips)
Seat 5: d844e4ca ($10.9 in chips)
Seat 6: Hero ($11.28 in chips)
9fdde15e: posts small blind $0.05
4cda30a6: posts big blind $0.1
*** HOLE CARDS ***
Dealt to 49da03d9 
Dealt to 9fdde15e 
Dealt to 4cda30a6 
Dealt to b4f0b29d 
Dealt to d844e4ca 
Dealt to Hero [Qs 7s]
b4f0b29d: folds
d844e4ca: raises $0.1 to $0.2
Hero: folds
49da03d9: folds
9fdde15e: calls $0.15
4cda30a6: folds
*** FLOP *** [3h 8s 3d]
9fdde15e: checks
d844e4ca: checks
*** TURN *** [3h 8s 3d] [5d]
9fdde15e: checks
d844e4ca: checks
*** RIVER *** [3h 8s 3d 5d] [4c]
9fdde15e: checks
d844e4ca: checks
9fdde15e: shows [Ah 6h] (Pair of Treys)
d844e4ca: shows [As Jc] (Pair of Treys)
*** SHOWDOWN ***
d844e4ca collected $0.48 from pot
*** SUMMARY ***
Total pot $0.5 | Rake $0.02 | Jackpot $0 | Bingo $0 | Fortune $0
Board [3h 8s 3d 5d 4c]
Seat 1: 49da03d9 (button) folded before Flop (didn't bet)
Seat 2: 9fdde15e (small blind) showed [Ah 6h] and lost with Pair of Treys
Seat 3: 4cda30a6 (big blind) folded before Flop
Seat 4: b4f0b29d folded before Flop (didn't bet)
Seat 5: d844e4ca showed [As Jc] and won ($0.48) with Pair of Treys
Seat 6: Hero folded before Flop (didn't bet)


Poker Hand #RC1459769901: Hold'em No Limit  ($0.05/$0.1) - 2023/04/08 19:28:43
Table 'RushAndCash3745161' 6-max Seat #1 is the button
Seat 1: 54dcb36b ($20.09 in chips)
Seat 2: d9868efd ($10 in chips)
Seat 3: c9f2633a ($19.9 in chips)
Seat 4: Hero ($11.28 in chips)
Seat 5: ca34ebc2 ($11.64 in chips)
Seat 6: 7cce80b8 ($14.17 in chips)
d9868efd: posts small blind $0.05
c9f2633a: posts big blind $0.1
*** HOLE CARDS ***
Dealt to 54dcb36b 
Dealt to d9868efd 
Dealt to c9f2633a 
Dealt to Hero [8h 6h]
Dealt to ca34ebc2 
Dealt to 7cce80b8 
Hero: folds
ca34ebc2: folds
7cce80b8: folds
54dcb36b: folds
d9868efd: folds
Uncalled bet ($0.05) returned to c9f2633a
*** SHOWDOWN ***
c9f2633a collected $0.1 from pot
*** SUMMARY ***
Total pot $0.1 | Rake $0 | Jackpot $0 | Bingo $0 | Fortune $0
Seat 1: 54dcb36b (button) folded before Flop (didn't bet)
Seat 2: d9868efd (small blind) folded before Flop
Seat 3: c9f2633a (big blind) collected ($0.1)
Seat 4: Hero folded before Flop (didn't bet)
Seat 5: ca34ebc2 folded before Flop (didn't bet)
Seat 6: 7cce80b8 folded before Flop (didn't bet)


Poker Hand #RC1459769091: Hold'em No Limit  ($0.05/$0.1) - 2023/04/08 19:26:52
Table 'RushAndCash3744351' 6-max Seat #1 is the button
Seat 1: d2dac9c0 ($6.9 in chips)
Seat 2: 7647ac83 ($12.97 in chips)
Seat 3: Hero ($11.38 in chips)
Seat 4: ceea82c1 ($11.64 in chips)
Seat 5: 80697e31 ($10.19 in chips)
Seat 6: b0fe1ac7 ($10 in chips)
7647ac83: posts small blind $0.05
Hero: posts big blind $0.1
*** HOLE CARDS ***
Dealt to d2dac9c0 
Dealt to 7647ac83 
Dealt to Hero [Jh 9s]
Dealt to ceea82c1 
Dealt to 80697e31 
Dealt to b0fe1ac7 
ceea82c1: raises $0.1 to $0.2
80697e31: folds
b0fe1ac7: folds
d2dac9c0: raises $0.19 to $0.39
7647ac83: folds
Hero: folds
ceea82c1: calls $0.19
*** FLOP *** [3h Ac 6s]
ceea82c1: checks
d2dac9c0: checks
*** TURN *** [3h Ac 6s] [8d]
ceea82c1: checks
d2dac9c0: checks
*** RIVER *** [3h Ac 6s 8d] [4s]
ceea82c1: bets $0.2
d2dac9c0: folds
Uncalled bet ($0.2) returned to ceea82c1
*** SHOWDOWN ***
ceea82c1 collected $0.89 from pot
*** SUMMARY ***
Total pot $0.93 | Rake $0.04 | Jackpot $0 | Bingo $0 | Fortune $0
Board [3h Ac 6s 8d 4s]
Seat 1: d2dac9c0 (button) folded on the River
Seat 2: 7647ac83 (small blind) folded before Flop
Seat 3: Hero (big blind) folded before Flop
Seat 4: ceea82c1 won ($0.89)
Seat 5: 80697e31 folded before Flop (didn't bet)
Seat 6: b0fe1ac7 folded before Flop (didn't bet)


Poker Hand #RC1459769039: Hold'em No Limit  ($0.05/$0.1) - 2023/04/08 19:26:45
Table 'RushAndCash3744299' 6-max Seat #1 is the button
Seat 1: Hero ($11.38 in chips)
Seat 2: 5f3211dc ($10.24 in chips)
Seat 3: 59a5df64 ($13.73 in chips)
Seat 4: 909716ea ($28.62 in chips)
Seat 5: 31c9a826 ($25.68 in chips)
Seat 6: 3bdd0030 ($19.7 in chips)
5f3211dc: posts small blind $0.05
59a5df64: posts big blind $0.1
*** HOLE CARDS ***
Dealt to Hero [Qc 4c]
Dealt to 5f3211dc 
Dealt to 59a5df64 
Dealt to 909716ea 
Dealt to 31c9a826 
Dealt to 3bdd0030 
909716ea: folds
31c9a826: raises $0.2 to $0.3
3bdd0030: folds
Hero: folds
5f3211dc: folds
59a5df64: folds
Uncalled bet ($0.2) returned to 31c9a826
*** SHOWDOWN ***
31c9a826 collected $0.25 from pot
*** SUMMARY ***
Total pot $0.25 | Rake $0 | Jackpot $0 | Bingo $0 | Fortune $0
Seat 1: Hero (button) folded before Flop (didn't bet)
Seat 2: 5f3211dc (small blind) folded before Flop
Seat 3: 59a5df64 (big blind) folded before Flop
Seat 4: 909716ea folded before Flop (didn't bet)
Seat 5: 31c9a826 collected ($0.25)
Seat 6: 3bdd0030 folded before Flop (didn't bet)


Poker Hand #RC1459768782: Hold'em No Limit  ($0.05/$0.1) - 2023/04/08 19:26:12
Table 'RushAndCash3744042' 6-max Seat #1 is the button
Seat 1: de56b68c ($15.16 in chips)
Seat 2: 4cda30a6 ($30.28 in chips)
Seat 3: e461d7f0 ($16.19 in chips)
Seat 4: fe74b7c3 ($10.07 in chips)
Seat 5: 470cf287 ($10 in chips)
Seat 6: Hero ($11.23 in chips)
4cda30a6: posts small blind $0.05
e461d7f0: posts big blind $0.1
*** HOLE CARDS ***
Dealt to de56b68c 
Dealt to 4cda30a6 
Dealt to e461d7f0 
Dealt to fe74b7c3 
Dealt to 470cf287 
Dealt to Hero [As 8s]
fe74b7c3: folds
470cf287: folds
Hero: raises $0.15 to $0.25
de56b68c: folds
4cda30a6: folds
e461d7f0: folds
Uncalled bet ($0.15) returned to Hero
*** SHOWDOWN ***
Hero collected $0.25 from pot
*** SUMMARY ***
Total pot $0.25 | Rake $0 | Jackpot $0 | Bingo $0 | Fortune $0
Seat 1: de56b68c (button) folded before Flop (didn't bet)
Seat 2: 4cda30a6 (small blind) folded before Flop
Seat 3: e461d7f0 (big blind) folded before Flop
Seat 4: fe74b7c3 folded before Flop (didn't bet)
Seat 5: 470cf287 folded before Flop (didn't bet)
Seat 6: Hero collected ($0.25)


Poker Hand #RC1459768693: Hold'em No Limit  ($0.05/$0.1) - 2023/04/08 19:26:01
Table 'RushAndCash3743953' 6-max Seat #1 is the button
Seat 1: 318bf4b0 ($10.45 in chips)
Seat 2: Hero ($11.28 in chips)
Seat 3: 4bd3987a ($10.47 in chips)
Seat 4: 311237d ($9.68 in chips)
Seat 5: c8452cef ($8.79 in chips)
Seat 6: 62dc1925 ($10 in chips)
Hero: posts small blind $0.05
4bd3987a: posts big blind $0.1
*** HOLE CARDS ***
Dealt to 318bf4b0 
Dealt to Hero [7s 4d]
Dealt to 4bd3987a 
Dealt to 311237d 
Dealt to c8452cef 
Dealt to 62dc1925 
311237d: folds
c8452cef: folds
62dc1925: raises $0.15 to $0.25
318bf4b0: folds
Hero: folds
4bd3987a: folds
Uncalled bet ($0.15) returned to 62dc1925
*** SHOWDOWN ***
62dc1925 collected $0.25 from pot
*** SUMMARY ***
Total pot $0.25 | Rake $0 | Jackpot $0 | Bingo $0 | Fortune $0
Seat 1: 318bf4b0 (button) folded before Flop (didn't bet)
Seat 2: Hero (small blind) folded before Flop
Seat 3: 4bd3987a (big blind) folded before Flop
Seat 4: 311237d folded before Flop (didn't bet)
Seat 5: c8452cef folded before Flop (didn't bet)
Seat 6: 62dc1925 collected ($0.25)


Poker Hand #RC1459768554: Hold'em No Limit  ($0.05/$0.1) - 2023/04/08 19:25:43
Table 'RushAndCash3743814' 6-max Seat #1 is the button
Seat 1: b83483a7 ($31.83 in chips)
Seat 2: Hero ($11.33 in chips)
Seat 3: 5fb1c534 ($11.43 in chips)
Seat 4: 35a10c37 ($8.64 in chips)
Seat 5: 7c703fc4 ($46.84 in chips)
Seat 6: 556685d2 ($29.49 in chips)
Hero: posts small blind $0.05
5fb1c534: posts big blind $0.1
*** HOLE CARDS ***
Dealt to b83483a7 
Dealt to Hero [Js 6c]
Dealt to 5fb1c534 
Dealt to 35a10c37 
Dealt to 7c703fc4 
Dealt to 556685d2 
35a10c37: folds
7c703fc4: folds
556685d2: folds
b83483a7: folds
Hero: folds
Uncalled bet ($0.05) returned to 5fb1c534
*** SHOWDOWN ***
5fb1c534 collected $0.1 from pot
*** SUMMARY ***
Total pot $0.1 | Rake $0 | Jackpot $0 | Bingo $0 | Fortune $0
Seat 1: b83483a7 (button) folded before Flop (didn't bet)
Seat 2: Hero (small blind) folded before Flop
Seat 3: 5fb1c534 (big blind) collected ($0.1)
Seat 4: 35a10c37 folded before Flop (didn't bet)
Seat 5: 7c703fc4 folded before Flop (didn't bet)
Seat 6: 556685d2 folded before Flop (didn't bet)


Poker Hand #RC1459768309: Hold'em No Limit  ($0.05/$0.1) - 2023/04/08 19:25:09
Table 'RushAndCash3743569' 6-max Seat #1 is the button
Seat 1: 283c70be ($10 in chips)
Seat 2: 933aeb35 ($51.12 in chips)
Seat 3: Hero ($10.82 in chips)
Seat 4: 7faf8c75 ($48.25 in chips)
Seat 5: 9eb62b2 ($10.95 in chips)
Seat 6: 303cbb65 ($19.65 in chips)
933aeb35: posts small blind $0.05
Hero: posts big blind $0.1
*** HOLE CARDS ***
Dealt to 283c70be 
Dealt to 933aeb35 
Dealt to Hero [Jd Jc]
Dealt to 7faf8c75 
Dealt to 9eb62b2 
Dealt to 303cbb65 
7faf8c75: raises $0.15 to $0.25
9eb62b2: folds
303cbb65: folds
283c70be: calls $0.25
933aeb35: folds
Hero: raises $1.05 to $1.3
7faf8c75: folds
283c70be: folds
Uncalled bet ($1.05) returned to Hero
*** SHOWDOWN ***
Hero collected $0.76 from pot
*** SUMMARY ***
Total pot $0.8 | Rake $0.04 | Jackpot $0 | Bingo $0 | Fortune $0
Seat 1: 283c70be (button) folded before Flop
Seat 2: 933aeb35 (small blind) folded before Flop
Seat 3: Hero (big blind) collected ($0.76)
Seat 4: 7faf8c75 folded before Flop
Seat 5: 9eb62b2 folded before Flop (didn't bet)
Seat 6: 303cbb65 folded before Flop (didn't bet)


Poker Hand #RC1459768277: Hold'em No Limit  ($0.05/$0.1) - 2023/04/08 19:25:04
Table 'RushAndCash3743537' 6-max Seat #1 is the button
Seat 1: c2d25011 ($17.98 in chips)
Seat 2: 312e100b ($10.05 in chips)
Seat 3: a9e52b86 ($11.86 in chips)
Seat 4: Hero ($10.82 in chips)
Seat 5: 3acdf15 ($10 in chips)
Seat 6: 245ee62b ($11.59 in chips)
312e100b: posts small blind $0.05
a9e52b86: posts big blind $0.1
*** HOLE CARDS ***
Dealt to c2d25011 
Dealt to 312e100b 
Dealt to a9e52b86 
Dealt to Hero [2d Tc]
Dealt to 3acdf15 
Dealt to 245ee62b 
Hero: folds
3acdf15: folds
245ee62b: folds
c2d25011: raises $0.15 to $0.25
312e100b: raises $0.55 to $0.8
a9e52b86: folds
c2d25011: calls $0.55
*** FLOP *** [Qc 3s 6s]
312e100b: bets $0.85
c2d25011: raises $1.7 to $2.55
312e100b: raises $6.7 to $9.25 and is all-in
c2d25011: folds
Uncalled bet ($6.7) returned to 312e100b
*** SHOWDOWN ***
312e100b collected $6.35 from pot
*** SUMMARY ***
Total pot $6.8 | Rake $0.3 | Jackpot $0.15 | Bingo $0 | Fortune $0
Board [Qc 3s 6s]
Seat 1: c2d25011 (button) folded on the Flop
Seat 2: 312e100b (small blind) won ($6.35)
Seat 3: a9e52b86 (big blind) folded before Flop
Seat 4: Hero folded before Flop (didn't bet)
Seat 5: 3acdf15 folded before Flop (didn't bet)
Seat 6: 245ee62b folded before Flop (didn't bet)


Poker Hand #RC1459767994: Hold'em No Limit  ($0.05/$0.1) - 2023/04/08 19:24:24
Table 'RushAndCash3743254' 6-max Seat #1 is the button
Seat 1: Hero ($10.49 in chips)
Seat 2: da0b0b67 ($10 in chips)
Seat 3: 62eb6051 ($25.19 in chips)
Seat 4: dbc96150 ($6.65 in chips)
Seat 5: de05a33d ($10 in chips)
Seat 6: f2301105 ($12.71 in chips)
da0b0b67: posts small blind $0.05
62eb6051: posts big blind $0.1
*** HOLE CARDS ***
Dealt to Hero [8d Jd]
Dealt to da0b0b67 
Dealt to 62eb6051 
Dealt to dbc96150 
Dealt to de05a33d 
Dealt to f2301105 
dbc96150: raises $0.1 to $0.2
de05a33d: folds
f2301105: folds
Hero: calls $0.2
da0b0b67: folds
62eb6051: folds
*** FLOP *** [Kd 4h Th]
dbc96150: checks
Hero: bets $0.28
dbc96150: folds
Uncalled bet ($0.28) returned to Hero
*** SHOWDOWN ***
Hero collected $0.53 from pot
*** SUMMARY ***
Total pot $0.55 | Rake $0.02 | Jackpot $0 | Bingo $0 | Fortune $0
Board [Kd 4h Th]
Seat 1: Hero (button) won ($0.53)
Seat 2: da0b0b67 (small blind) folded before Flop
Seat 3: 62eb6051 (big blind) folded before Flop
Seat 4: dbc96150 folded on the Flop
Seat 5: de05a33d folded before Flop (didn't bet)
Seat 6: f2301105 folded before Flop (didn't bet)


Poker Hand #RC1459767961: Hold'em No Limit  ($0.05/$0.1) - 2023/04/08 19:24:20
Table 'RushAndCash3743221' 6-max Seat #1 is the button
Seat 1: 690adb04 ($13.98 in chips)
Seat 2: 6a138b47 ($10.71 in chips)
Seat 3: d426725f ($16.18 in chips)
Seat 4: 895e867c ($34.31 in chips)
Seat 5: fa1722a8 ($6.1 in chips)
Seat 6: Hero ($10.49 in chips)
6a138b47: posts small blind $0.05
d426725f: posts big blind $0.1
*** HOLE CARDS ***
Dealt to 690adb04 
Dealt to 6a138b47 
Dealt to d426725f 
Dealt to 895e867c 
Dealt to fa1722a8 
Dealt to Hero [7d Qc]
895e867c: folds
fa1722a8: folds
Hero: folds
690adb04: raises $0.15 to $0.25
6a138b47: folds
d426725f: calls $0.15
*** FLOP *** [Td 5s 9s]
d426725f: checks
690adb04: bets $0.19
d426725f: calls $0.19
*** TURN *** [Td 5s 9s] [Jc]
d426725f: checks
690adb04: bets $0.93
d426725f: calls $0.93
*** RIVER *** [Td 5s 9s Jc] [Kh]
d426725f: checks
690adb04: checks
d426725f: shows [8s Th] (Pair of Tens)
690adb04: shows [Ks 2s] (Pair of Kings)
*** SHOWDOWN ***
690adb04 collected $2.68 from pot
*** SUMMARY ***
Total pot $2.79 | Rake $0.11 | Jackpot $0 | Bingo $0 | Fortune $0
Board [Td 5s 9s Jc Kh]
Seat 1: 690adb04 (button) showed [Ks 2s] and won ($2.68) with Pair of Kings
Seat 2: 6a138b47 (small blind) folded before Flop
Seat 3: d426725f (big blind) showed [8s Th] and lost with Pair of Tens
Seat 4: 895e867c folded before Flop (didn't bet)
Seat 5: fa1722a8 folded before Flop (didn't bet)
Seat 6: Hero folded before Flop (didn't bet)


Poker Hand #RC1459767914: Hold'em No Limit  ($0.05/$0.1) - 2023/04/08 19:24:13
Table 'RushAndCash3743174' 6-max Seat #1 is the button
Seat 1: d0b73ea6 ($11.4 in chips)
Seat 2: fbc401b8 ($10 in chips)
Seat 3: 163b9118 ($11.06 in chips)
Seat 4: 5ce5d003 ($18.82 in chips)
Seat 5: Hero ($10.49 in chips)
Seat 6: 2f04e900 ($13.49 in chips)
fbc401b8: posts small blind $0.05
163b9118: posts big blind $0.1
*** HOLE CARDS ***
Dealt to d0b73ea6 
Dealt to fbc401b8 
Dealt to 163b9118 
Dealt to 5ce5d003 
Dealt to Hero [8d Td]
Dealt to 2f04e900 
5ce5d003: folds
Hero: folds
2f04e900: folds
d0b73ea6: folds
fbc401b8: raises $0.2 to $0.3
163b9118: folds
Uncalled bet ($0.2) returned to fbc401b8
*** SHOWDOWN ***
fbc401b8 collected $0.2 from pot
*** SUMMARY ***
Total pot $0.2 | Rake $0 | Jackpot $0 | Bingo $0 | Fortune $0
Seat 1: d0b73ea6 (button) folded before Flop (didn't bet)
Seat 2: fbc401b8 (small blind) collected ($0.2)
Seat 3: 163b9118 (big blind) folded before Flop
Seat 4: 5ce5d003 folded before Flop (didn't bet)
Seat 5: Hero folded before Flop (didn't bet)
Seat 6: 2f04e900 folded before Flop (didn't bet)


Poker Hand #RC1459767885: Hold'em No Limit  ($0.05/$0.1) - 2023/04/08 19:24:08
Table 'RushAndCash3743145' 6-max Seat #1 is the button
Seat 1: 7011ea45 ($10 in chips)
Seat 2: Hero ($10.54 in chips)
Seat 3: 991623b5 ($21.58 in chips)
Seat 4: 163b9118 ($11.06 in chips)
Seat 5: 9fdde15e ($14.69 in chips)
Seat 6: 81f21357 ($27.12 in chips)
Hero: posts small blind $0.05
991623b5: posts big blind $0.1
*** HOLE CARDS ***
Dealt to 7011ea45 
Dealt to Hero [Th 8h]
Dealt to 991623b5 
Dealt to 163b9118 
Dealt to 9fdde15e 
Dealt to 81f21357 
163b9118: folds
9fdde15e: folds
81f21357: folds
7011ea45: folds
Hero: folds
Uncalled bet ($0.05) returned to 991623b5
*** SHOWDOWN ***
991623b5 collected $0.1 from pot
*** SUMMARY ***
Total pot $0.1 | Rake $0 | Jackpot $0 | Bingo $0 | Fortune $0
Seat 1: 7011ea45 (button) folded before Flop (didn't bet)
Seat 2: Hero (small blind) folded before Flop
Seat 3: 991623b5 (big blind) collected ($0.1)
Seat 4: 163b9118 folded before Flop (didn't bet)
Seat 5: 9fdde15e folded before Flop (didn't bet)
Seat 6: 81f21357 folded before Flop (didn't bet)


Poker Hand #RC1459767577: Hold'em No Limit  ($0.05/$0.1) - 2023/04/08 19:23:28
Table 'RushAndCash3742837' 6-max Seat #1 is the button
Seat 1: 551d9a48 ($11.47 in chips)
Seat 2: afad3d85 ($12.22 in chips)
Seat 3: 500fa304 ($49.18 in chips)
Seat 4: Hero ($10.74 in chips)
Seat 5: a2d4518a ($10.05 in chips)
Seat 6: 9d75b6de ($10 in chips)
afad3d85: posts small blind $0.05
500fa304: posts big blind $0.1
*** HOLE CARDS ***
Dealt to 551d9a48 
Dealt to afad3d85 
Dealt to 500fa304 
Dealt to Hero [2d 2h]
Dealt to a2d4518a 
Dealt to 9d75b6de 
Hero: raises $0.1 to $0.2
a2d4518a: folds
9d75b6de: folds
551d9a48: folds
afad3d85: calls $0.15
500fa304: folds
*** FLOP *** [Th Qh Ad]
afad3d85: checks
Hero: checks
*** TURN *** [Th Qh Ad] [8h]
afad3d85: bets $0.4
Hero: folds
Uncalled bet ($0.4) returned to afad3d85
*** SHOWDOWN ***
afad3d85 collected $0.48 from pot
*** SUMMARY ***
Total pot $0.5 | Rake $0.02 | Jackpot $0 | Bingo $0 | Fortune $0
Board [Th Qh Ad 8h]
Seat 1: 551d9a48 (button) folded before Flop (didn't bet)
Seat 2: afad3d85 (small blind) won ($0.48)
Seat 3: 500fa304 (big blind) folded before Flop
Seat 4: Hero folded on the Turn
Seat 5: a2d4518a folded before Flop (didn't bet)
Seat 6: 9d75b6de folded before Flop (didn't bet)


Poker Hand #RC1459767478: Hold'em No Limit  ($0.05/$0.1) - 2023/04/08 19:23:12
Table 'RushAndCash3742738' 6-max Seat #1 is the button
Seat 1: 2a94273e ($11.09 in chips)
Seat 2: 800d12f4 ($10 in chips)
Seat 3: Hero ($10.84 in chips)
Seat 4: 723809a3 ($9.44 in chips)
Seat 5: 447c4e6 ($50.36 in chips)
Seat 6: eeacef4b ($7.69 in chips)
800d12f4: posts small blind $0.05
Hero: posts big blind $0.1
*** HOLE CARDS ***
Dealt to 2a94273e 
Dealt to 800d12f4 
Dealt to Hero [2s 8h]
Dealt to 723809a3 
Dealt to 447c4e6 
Dealt to eeacef4b 
723809a3: folds
447c4e6: folds
eeacef4b: folds
2a94273e: raises $0.15 to $0.25
800d12f4: folds
Hero: folds
Uncalled bet ($0.15) returned to 2a94273e
*** SHOWDOWN ***
2a94273e collected $0.25 from pot
*** SUMMARY ***
Total pot $0.25 | Rake $0 | Jackpot $0 | Bingo $0 | Fortune $0
Seat 1: 2a94273e (button) collected ($0.25)
Seat 2: 800d12f4 (small blind) folded before Flop
Seat 3: Hero (big blind) folded before Flop
Seat 4: 723809a3 folded before Flop (didn't bet)
Seat 5: 447c4e6 folded before Flop (didn't bet)
Seat 6: eeacef4b folded before Flop (didn't bet)


Poker Hand #RC1459767419: Hold'em No Limit  ($0.05/$0.1) - 2023/04/08 19:23:04
Table 'RushAndCash3742679' 6-max Seat #1 is the button
Seat 1: Hero ($10.84 in chips)
Seat 2: 7cce80b8 ($12.23 in chips)
Seat 3: 54670715 ($10.77 in chips)
Seat 4: 1c2f390e ($20.11 in chips)
Seat 5: 1b974fd ($14.2 in chips)
Seat 6: c156847f ($11.53 in chips)
7cce80b8: posts small blind $0.05
54670715: posts big blind $0.1
*** HOLE CARDS ***
Dealt to Hero [2c 5d]
Dealt to 7cce80b8 
Dealt to 54670715 
Dealt to 1c2f390e 
Dealt to 1b974fd 
Dealt to c156847f 
1c2f390e: folds
1b974fd: raises $0.15 to $0.25
c156847f: folds
Hero: folds
7cce80b8: raises $1.01 to $1.26
54670715: folds
1b974fd: folds
Uncalled bet ($1.01) returned to 7cce80b8
*** SHOWDOWN ***
7cce80b8 collected $0.57 from pot
*** SUMMARY ***
Total pot $0.6 | Rake $0.03 | Jackpot $0 | Bingo $0 | Fortune $0
Seat 1: Hero (button) folded before Flop (didn't bet)
Seat 2: 7cce80b8 (small blind) collected ($0.57)
Seat 3: 54670715 (big blind) folded before Flop
Seat 4: 1c2f390e folded before Flop (didn't bet)
Seat 5: 1b974fd folded before Flop
Seat 6: c156847f folded before Flop (didn't bet)


Poker Hand #RC1459767237: Hold'em No Limit  ($0.05/$0.1) - 2023/04/08 19:22:37
Table 'RushAndCash3742497' 6-max Seat #1 is the button
Seat 1: c9e32a1d ($18.55 in chips)
Seat 2: 41208841 ($10.87 in chips)
Seat 3: 178a96db ($17.34 in chips)
Seat 4: 60a2c7ea ($28.11 in chips)
Seat 5: 40e2e276 ($17.64 in chips)
Seat 6: Hero ($10.69 in chips)
41208841: posts small blind $0.05
178a96db: posts big blind $0.1
*** HOLE CARDS ***
Dealt to c9e32a1d 
Dealt to 41208841 
Dealt to 178a96db 
Dealt to 60a2c7ea 
Dealt to 40e2e276 
Dealt to Hero [2h 2s]
60a2c7ea: folds
40e2e276: folds
Hero: raises $0.1 to $0.2
c9e32a1d: folds
41208841: folds
178a96db: folds
Uncalled bet ($0.1) returned to Hero
*** SHOWDOWN ***
Hero collected $0.25 from pot
*** SUMMARY ***
Total pot $0.25 | Rake $0 | Jackpot $0 | Bingo $0 | Fortune $0
Seat 1: c9e32a1d (button) folded before Flop (didn't bet)
Seat 2: 41208841 (small blind) folded before Flop
Seat 3: 178a96db (big blind) folded before Flop
Seat 4: 60a2c7ea folded before Flop (didn't bet)
Seat 5: 40e2e276 folded before Flop (didn't bet)
Seat 6: Hero collected ($0.25)


Poker Hand #RC1459767061: Hold'em No Limit  ($0.05/$0.1) - 2023/04/08 19:22:13
Table 'RushAndCash3742321' 6-max Seat #1 is the button
Seat 1: 3643d412 ($10.15 in chips)
Seat 2: b014db86 ($26.21 in chips)
Seat 3: 3486bea3 ($11.49 in chips)
Seat 4: Hero ($10.69 in chips)
Seat 5: 1290ddf9 ($11.26 in chips)
Seat 6: 7d4eb619 ($10.22 in chips)
b014db86: posts small blind $0.05
3486bea3: posts big blind $0.1
*** HOLE CARDS ***
Dealt to 3643d412 
Dealt to b014db86 
Dealt to 3486bea3 
Dealt to Hero [3h Qh]
Dealt to 1290ddf9 
Dealt to 7d4eb619 
Hero: folds
1290ddf9: folds
7d4eb619: folds
3643d412: raises $0.15 to $0.25
b014db86: folds
3486bea3: calls $0.15
*** FLOP *** [6h 2h Js]
3486bea3: checks
3643d412: bets $0.19
3486bea3: calls $0.19
*** TURN *** [6h 2h Js] [4h]
3486bea3: checks
3643d412: checks
*** RIVER *** [6h 2h Js 4h] [2c]
3486bea3: bets $0.31
3643d412: folds
Uncalled bet ($0.31) returned to 3486bea3
*** SHOWDOWN ***
3486bea3 collected $0.89 from pot
*** SUMMARY ***
Total pot $0.93 | Rake $0.04 | Jackpot $0 | Bingo $0 | Fortune $0
Board [6h 2h Js 4h 2c]
Seat 1: 3643d412 (button) folded on the River
Seat 2: b014db86 (small blind) folded before Flop
Seat 3: 3486bea3 (big blind) won ($0.89)
Seat 4: Hero folded before Flop (didn't bet)
Seat 5: 1290ddf9 folded before Flop (didn't bet)
Seat 6: 7d4eb619 folded before Flop (didn't bet)


Poker Hand #RC1459767020: Hold'em No Limit  ($0.05/$0.1) - 2023/04/08 19:22:08
Table 'RushAndCash3742280' 6-max Seat #1 is the button
Seat 1: 723809a3 ($9.39 in chips)
Seat 2: 4ec6caba ($14.01 in chips)
Seat 3: a2b03d4f ($10.16 in chips)
Seat 4: Hero ($10.69 in chips)
Seat 5: a4a4271f ($13.94 in chips)
Seat 6: 9eb62b2 ($10.61 in chips)
4ec6caba: posts small blind $0.05
a2b03d4f: posts big blind $0.1
*** HOLE CARDS ***
Dealt to 723809a3 
Dealt to 4ec6caba 
Dealt to a2b03d4f 
Dealt to Hero [3h 9s]
Dealt to a4a4271f 
Dealt to 9eb62b2 
Hero: folds
a4a4271f: folds
9eb62b2: folds
723809a3: folds
4ec6caba: folds
Uncalled bet ($0.05) returned to a2b03d4f
*** SHOWDOWN ***
a2b03d4f collected $0.1 from pot
*** SUMMARY ***
Total pot $0.1 | Rake $0 | Jackpot $0 | Bingo $0 | Fortune $0
Seat 1: 723809a3 (button) folded before Flop (didn't bet)
Seat 2: 4ec6caba (small blind) folded before Flop
Seat 3: a2b03d4f (big blind) collected ($0.1)
Seat 4: Hero folded before Flop (didn't bet)
Seat 5: a4a4271f folded before Flop (didn't bet)
Seat 6: 9eb62b2 folded before Flop (didn't bet)


Poker Hand #RC1459766956: Hold'em No Limit  ($0.05/$0.1) - 2023/04/08 19:22:00
Table 'RushAndCash3742216' 6-max Seat #1 is the button
Seat 1: 30ec7a3c ($9.02 in chips)
Seat 2: 6ffc727b ($60.83 in chips)
Seat 3: 68888d2b ($37.2 in chips)
Seat 4: f4ea9ac9 ($4.78 in chips)
Seat 5: Hero ($10.69 in chips)
Seat 6: be2592f5 ($10 in chips)
6ffc727b: posts small blind $0.05
68888d2b: posts big blind $0.1
*** HOLE CARDS ***
Dealt to 30ec7a3c 
Dealt to 6ffc727b 
Dealt to 68888d2b 
Dealt to f4ea9ac9 
Dealt to Hero [9c 2d]
Dealt to be2592f5 
f4ea9ac9: raises $0.1 to $0.2
Hero: folds
be2592f5: folds
30ec7a3c: folds
6ffc727b: folds
68888d2b: folds
Uncalled bet ($0.1) returned to f4ea9ac9
*** SHOWDOWN ***
f4ea9ac9 collected $0.25 from pot
*** SUMMARY ***
Total pot $0.25 | Rake $0 | Jackpot $0 | Bingo $0 | Fortune $0
Seat 1: 30ec7a3c (button) folded before Flop (didn't bet)
Seat 2: 6ffc727b (small blind) folded before Flop
Seat 3: 68888d2b (big blind) folded before Flop
Seat 4: f4ea9ac9 collected ($0.25)
Seat 5: Hero folded before Flop (didn't bet)
Seat 6: be2592f5 folded before Flop (didn't bet)


Poker Hand #RC1459766792: Hold'em No Limit  ($0.05/$0.1) - 2023/04/08 19:21:36
Table 'RushAndCash3742052' 6-max Seat #1 is the button
Seat 1: e35f0658 ($9.04 in chips)
Seat 2: Hero ($10.74 in chips)
Seat 3: 18e279a4 ($46.31 in chips)
Seat 4: d98fdf09 ($10.1 in chips)
Seat 5: 76be446b ($20.27 in chips)
Seat 6: 7eec5224 ($14.12 in chips)
Hero: posts small blind $0.05
18e279a4: posts big blind $0.1
*** HOLE CARDS ***
Dealt to e35f0658 
Dealt to Hero [7h 2s]
Dealt to 18e279a4 
Dealt to d98fdf09 
Dealt to 76be446b 
Dealt to 7eec5224 
d98fdf09: folds
76be446b: folds
7eec5224: raises $0.11 to $0.21
e35f0658: folds
Hero: folds
18e279a4: calls $0.11
*** FLOP *** [8h Ad 8c]
18e279a4: checks
7eec5224: bets $0.17
18e279a4: calls $0.17
*** TURN *** [8h Ad 8c] [Jd]
18e279a4: checks
7eec5224: checks
*** RIVER *** [8h Ad 8c Jd] [Ah]
18e279a4: checks
7eec5224: checks
18e279a4: shows [Tc Td] (Pair of Aces and Pair of Tens)
7eec5224: shows [Ks Qd] (Pair of Aces and Pair of Eights)
*** SHOWDOWN ***
18e279a4 collected $0.77 from pot
*** SUMMARY ***
Total pot $0.81 | Rake $0.04 | Jackpot $0 | Bingo $0 | Fortune $0
Board [8h Ad 8c Jd Ah]
Seat 1: e35f0658 (button) folded before Flop (didn't bet)
Seat 2: Hero (small blind) folded before Flop
Seat 3: 18e279a4 (big blind) showed [Tc Td] and won ($0.77) with Pair of Aces and Pair of Tens
Seat 4: d98fdf09 folded before Flop (didn't bet)
Seat 5: 76be446b folded before Flop (didn't bet)
Seat 6: 7eec5224 showed [Ks Qd] and lost with Pair of Aces and Pair of Eights


Poker Hand #RC1459766731: Hold'em No Limit  ($0.05/$0.1) - 2023/04/08 19:21:27
Table 'RushAndCash3741991' 6-max Seat #1 is the button
Seat 1: Hero ($10.74 in chips)
Seat 2: 47eb4aaa ($10.27 in chips)
Seat 3: bda1469b ($4.42 in chips)
Seat 4: b014db86 ($25.66 in chips)
Seat 5: d9b8a67d ($14.21 in chips)
Seat 6: 4d185a91 ($10.19 in chips)
47eb4aaa: posts small blind $0.05
bda1469b: posts big blind $0.1
*** HOLE CARDS ***
Dealt to Hero [2h Jd]
Dealt to 47eb4aaa 
Dealt to bda1469b 
Dealt to b014db86 
Dealt to d9b8a67d 
Dealt to 4d185a91 
b014db86: raises $0.15 to $0.25
d9b8a67d: folds
4d185a91: folds
Hero: folds
47eb4aaa: folds
bda1469b: folds
Uncalled bet ($0.15) returned to b014db86
*** SHOWDOWN ***
b014db86 collected $0.25 from pot
*** SUMMARY ***
Total pot $0.25 | Rake $0 | Jackpot $0 | Bingo $0 | Fortune $0
Seat 1: Hero (button) folded before Flop (didn't bet)
Seat 2: 47eb4aaa (small blind) folded before Flop
Seat 3: bda1469b (big blind) folded before Flop
Seat 4: b014db86 collected ($0.25)
Seat 5: d9b8a67d folded before Flop (didn't bet)
Seat 6: 4d185a91 folded before Flop (didn't bet)


Poker Hand #RC1459766649: Hold'em No Limit  ($0.05/$0.1) - 2023/04/08 19:21:17
Table 'RushAndCash3741909' 6-max Seat #1 is the button
Seat 1: 4cda30a6 ($32.09 in chips)
Seat 2: 56fe61f7 ($20.93 in chips)
Seat 3: Hero ($10.69 in chips)
Seat 4: 9b34f129 ($6.09 in chips)
Seat 5: 852668b4 ($14.15 in chips)
Seat 6: 73953e2b ($4.25 in chips)
56fe61f7: posts small blind $0.05
Hero: posts big blind $0.1
*** HOLE CARDS ***
Dealt to 4cda30a6 
Dealt to 56fe61f7 
Dealt to Hero [5c 6d]
Dealt to 9b34f129 
Dealt to 852668b4 
Dealt to 73953e2b 
9b34f129: folds
852668b4: folds
73953e2b: folds
4cda30a6: folds
56fe61f7: folds
Uncalled bet ($0.05) returned to Hero
*** SHOWDOWN ***
Hero collected $0.1 from pot
*** SUMMARY ***
Total pot $0.1 | Rake $0 | Jackpot $0 | Bingo $0 | Fortune $0
Seat 1: 4cda30a6 (button) folded before Flop (didn't bet)
Seat 2: 56fe61f7 (small blind) folded before Flop
Seat 3: Hero (big blind) collected ($0.1)
Seat 4: 9b34f129 folded before Flop (didn't bet)
Seat 5: 852668b4 folded before Flop (didn't bet)
Seat 6: 73953e2b folded before Flop (didn't bet)


Poker Hand #RC1459766594: Hold'em No Limit  ($0.05/$0.1) - 2023/04/08 19:21:10
Table 'RushAndCash3741854' 6-max Seat #1 is the button
Seat 1: 2a44e667 ($11.9 in chips)
Seat 2: 5ef07beb ($9.9 in chips)
Seat 3: 7c703fc4 ($47.67 in chips)
Seat 4: Hero ($10.69 in chips)
Seat 5: b4f0b29d ($10 in chips)
Seat 6: bee41a8b ($35.2 in chips)
5ef07beb: posts small blind $0.05
7c703fc4: posts big blind $0.1
*** HOLE CARDS ***
Dealt to 2a44e667 
Dealt to 5ef07beb 
Dealt to 7c703fc4 
Dealt to Hero [8d Ks]
Dealt to b4f0b29d 
Dealt to bee41a8b 
Hero: folds
b4f0b29d: folds
bee41a8b: folds
2a44e667: raises $0.15 to $0.25
5ef07beb: folds
7c703fc4: raises $0.75 to $1
2a44e667: folds
Uncalled bet ($0.75) returned to 7c703fc4
*** SHOWDOWN ***
7c703fc4 collected $0.53 from pot
*** SUMMARY ***
Total pot $0.55 | Rake $0.02 | Jackpot $0 | Bingo $0 | Fortune $0
Seat 1: 2a44e667 (button) folded before Flop
Seat 2: 5ef07beb (small blind) folded before Flop
Seat 3: 7c703fc4 (big blind) collected ($0.53)
Seat 4: Hero folded before Flop (didn't bet)
Seat 5: b4f0b29d folded before Flop (didn't bet)
Seat 6: bee41a8b folded before Flop (didn't bet)


Poker Hand #RC1459766564: Hold'em No Limit  ($0.05/$0.1) - 2023/04/08 19:21:05
Table 'RushAndCash3741824' 6-max Seat #1 is the button
Seat 1: cbb4dd63 ($22.25 in chips)
Seat 2: Hero ($10.74 in chips)
Seat 3: 89d24b76 ($28.12 in chips)
Seat 4: 46aaf475 ($10 in chips)
Seat 5: f18ec573 ($13.16 in chips)
Seat 6: c2f048da ($15.15 in chips)
Hero: posts small blind $0.05
89d24b76: posts big blind $0.1
*** HOLE CARDS ***
Dealt to cbb4dd63 
Dealt to Hero [7s 2s]
Dealt to 89d24b76 
Dealt to 46aaf475 
Dealt to f18ec573 
Dealt to c2f048da 
46aaf475: folds
f18ec573: folds
c2f048da: raises $0.15 to $0.25
cbb4dd63: folds
Hero: folds
89d24b76: folds
Uncalled bet ($0.15) returned to c2f048da
*** SHOWDOWN ***
c2f048da collected $0.25 from pot
*** SUMMARY ***
Total pot $0.25 | Rake $0 | Jackpot $0 | Bingo $0 | Fortune $0
Seat 1: cbb4dd63 (button) folded before Flop (didn't bet)
Seat 2: Hero (small blind) folded before Flop
Seat 3: 89d24b76 (big blind) folded before Flop
Seat 4: 46aaf475 folded before Flop (didn't bet)
Seat 5: f18ec573 folded before Flop (didn't bet)
Seat 6: c2f048da collected ($0.25)


Poker Hand #RC1459766523: Hold'em No Limit  ($0.05/$0.1) - 2023/04/08 19:21:00
Table 'RushAndCash3741783' 6-max Seat #1 is the button
Seat 1: 17c19bb9 ($10 in chips)
Seat 2: 6e671f1d ($16.94 in chips)
Seat 3: 1e0deb92 ($14.18 in chips)
Seat 4: 2835214a ($2.33 in chips)
Seat 5: Hero ($10.74 in chips)
Seat 6: 33b86f0b ($26.93 in chips)
6e671f1d: posts small blind $0.05
1e0deb92: posts big blind $0.1
*** HOLE CARDS ***
Dealt to 17c19bb9 
Dealt to 6e671f1d 
Dealt to 1e0deb92 
Dealt to 2835214a 
Dealt to Hero [7s 4c]
Dealt to 33b86f0b 
2835214a: folds
Hero: folds
33b86f0b: folds
17c19bb9: folds
6e671f1d: calls $0.05
1e0deb92: checks
*** FLOP *** [8c Tc 9h]
6e671f1d: bets $0.1
1e0deb92: calls $0.1
*** TURN *** [8c Tc 9h] [5h]
6e671f1d: bets $0.4
1e0deb92: calls $0.4
*** RIVER *** [8c Tc 9h 5h] [Jd]
6e671f1d: bets $0.9
1e0deb92: calls $0.9
6e671f1d: shows [7h 2h] (Jacks-High Straight)
1e0deb92: shows [Td Kc] (Pair of Tens)
*** SHOWDOWN ***
6e671f1d collected $2.71 from pot
*** SUMMARY ***
Total pot $3 | Rake $0.14 | Jackpot $0.15 | Bingo $0 | Fortune $0
Board [8c Tc 9h 5h Jd]
Seat 1: 17c19bb9 (button) folded before Flop (didn't bet)
Seat 2: 6e671f1d (small blind) showed [7h 2h] and won ($2.71) with Jacks-High Straight
Seat 3: 1e0deb92 (big blind) showed [Td Kc] and lost with Pair of Tens
Seat 4: 2835214a folded before Flop (didn't bet)
Seat 5: Hero folded before Flop (didn't bet)
Seat 6: 33b86f0b folded before Flop (didn't bet)


Poker Hand #RC1459766452: Hold'em No Limit  ($0.05/$0.1) - 2023/04/08 19:20:50
Table 'RushAndCash3741712' 6-max Seat #1 is the button
Seat 1: Hero ($10.74 in chips)
Seat 2: 1922731d ($10.57 in chips)
Seat 3: d318a3f7 ($13.75 in chips)
Seat 4: 4b43eee ($11.68 in chips)
Seat 5: 1f161108 ($10 in chips)
Seat 6: 7647ac83 ($10.09 in chips)
1922731d: posts small blind $0.05
d318a3f7: posts big blind $0.1
*** HOLE CARDS ***
Dealt to Hero [Th Kc]
Dealt to 1922731d 
Dealt to d318a3f7 
Dealt to 4b43eee 
Dealt to 1f161108 
Dealt to 7647ac83 
4b43eee: folds
1f161108: folds
7647ac83: raises $0.2 to $0.3
Hero: folds
1922731d: folds
d318a3f7: folds
Uncalled bet ($0.2) returned to 7647ac83
*** SHOWDOWN ***
7647ac83 collected $0.25 from pot
*** SUMMARY ***
Total pot $0.25 | Rake $0 | Jackpot $0 | Bingo $0 | Fortune $0
Seat 1: Hero (button) folded before Flop (didn't bet)
Seat 2: 1922731d (small blind) folded before Flop
Seat 3: d318a3f7 (big blind) folded before Flop
Seat 4: 4b43eee folded before Flop (didn't bet)
Seat 5: 1f161108 folded before Flop (didn't bet)
Seat 6: 7647ac83 collected ($0.25)


Poker Hand #RC1459766375: Hold'em No Limit  ($0.05/$0.1) - 2023/04/08 19:20:39
Table 'RushAndCash3741635' 6-max Seat #1 is the button
Seat 1: 23226b15 ($12.88 in chips)
Seat 2: 895e867c ($34.71 in chips)
Seat 3: Hero ($10.84 in chips)
Seat 4: 32aac465 ($8.62 in chips)
Seat 5: 2910f350 ($10.47 in chips)
Seat 6: e790267c ($10.16 in chips)
895e867c: posts small blind $0.05
Hero: posts big blind $0.1
*** HOLE CARDS ***
Dealt to 23226b15 
Dealt to 895e867c 
Dealt to Hero [9c Qd]
Dealt to 32aac465 
Dealt to 2910f350 
Dealt to e790267c 
32aac465: folds
2910f350: folds
e790267c: folds
23226b15: raises $0.2 to $0.3
895e867c: folds
Hero: folds
Uncalled bet ($0.2) returned to 23226b15
*** SHOWDOWN ***
23226b15 collected $0.25 from pot
*** SUMMARY ***
Total pot $0.25 | Rake $0 | Jackpot $0 | Bingo $0 | Fortune $0
Seat 1: 23226b15 (button) collected ($0.25)
Seat 2: 895e867c (small blind) folded before Flop
Seat 3: Hero (big blind) folded before Flop
Seat 4: 32aac465 folded before Flop (didn't bet)
Seat 5: 2910f350 folded before Flop (didn't bet)
Seat 6: e790267c folded before Flop (didn't bet)


Poker Hand #RC1459766343: Hold'em No Limit  ($0.05/$0.1) - 2023/04/08 19:20:34
Table 'RushAndCash3741603' 6-max Seat #1 is the button
Seat 1: bd04a220 ($10 in chips)
Seat 2: d72e6b3b ($17.21 in chips)
Seat 3: 5cd2a977 ($18.56 in chips)
Seat 4: c235e83c ($10 in chips)
Seat 5: Hero ($10.84 in chips)
Seat 6: 5b3cb986 ($12.34 in chips)
d72e6b3b: posts small blind $0.05
5cd2a977: posts big blind $0.1
*** HOLE CARDS ***
Dealt to bd04a220 
Dealt to d72e6b3b 
Dealt to 5cd2a977 
Dealt to c235e83c 
Dealt to Hero [5c Qs]
Dealt to 5b3cb986 
c235e83c: folds
Hero: folds
5b3cb986: folds
bd04a220: raises $0.15 to $0.25
d72e6b3b: folds
5cd2a977: folds
Uncalled bet ($0.15) returned to bd04a220
*** SHOWDOWN ***
bd04a220 collected $0.25 from pot
*** SUMMARY ***
Total pot $0.25 | Rake $0 | Jackpot $0 | Bingo $0 | Fortune $0
Seat 1: bd04a220 (button) collected ($0.25)
Seat 2: d72e6b3b (small blind) folded before Flop
Seat 3: 5cd2a977 (big blind) folded before Flop
Seat 4: c235e83c folded before Flop (didn't bet)
Seat 5: Hero folded before Flop (didn't bet)
Seat 6: 5b3cb986 folded before Flop (didn't bet)


Poker Hand #RC1459766268: Hold'em No Limit  ($0.05/$0.1) - 2023/04/08 19:20:25
Table 'RushAndCash3741528' 6-max Seat #1 is the button
Seat 1: Hero ($10.84 in chips)
Seat 2: ca34ebc2 ($10.37 in chips)
Seat 3: 3229108d ($8.09 in chips)
Seat 4: 74baa6a4 ($15.59 in chips)
Seat 5: f54c9c3b ($11.83 in chips)
Seat 6: 475fe736 ($17.4 in chips)
ca34ebc2: posts small blind $0.05
3229108d: posts big blind $0.1
*** HOLE CARDS ***
Dealt to Hero [7s 9s]
Dealt to ca34ebc2 
Dealt to 3229108d 
Dealt to 74baa6a4 
Dealt to f54c9c3b 
Dealt to 475fe736 
74baa6a4: folds
f54c9c3b: folds
475fe736: raises $0.17 to $0.27
Hero: folds
ca34ebc2: raises $0.93 to $1.2
3229108d: raises $2.67 to $3.87
475fe736: calls $3.6
ca34ebc2: calls $2.67
*** FLOP *** [9h Th 6s]
ca34ebc2: checks
3229108d: bets $4.22 and is all-in
475fe736: calls $4.22
ca34ebc2: folds
3229108d: shows [Kd Kc] (Pair of Kings)
475fe736: shows [Ah As] (Pair of Aces)
*** TURN *** [9h Th 6s] [2c]
*** RIVER *** [9h Th 6s 2c] [5d]
*** SHOWDOWN ***
475fe736 collected $19.6 from pot
*** SUMMARY ***
Total pot $20.05 | Rake $0.3 | Jackpot $0.15 | Bingo $0 | Fortune $0
Board [9h Th 6s 2c 5d]
Seat 1: Hero (button) folded before Flop (didn't bet)
Seat 2: ca34ebc2 (small blind) folded on the Flop
Seat 3: 3229108d (big blind) showed [Kd Kc] and lost with Pair of Kings
Seat 4: 74baa6a4 folded before Flop (didn't bet)
Seat 5: f54c9c3b folded before Flop (didn't bet)
Seat 6: 475fe736 showed [Ah As] and won ($19.6) with Pair of Aces


Poker Hand #RC1459765745: Hold'em No Limit  ($0.05/$0.1) - 2023/04/08 19:19:13
Table 'RushAndCash3741005' 6-max Seat #1 is the button
Seat 1: 696eb7c1 ($10.77 in chips)
Seat 2: 979ebe36 ($16.98 in chips)
Seat 3: 9b34f129 ($5.53 in chips)
Seat 4: Hero ($11.79 in chips)
Seat 5: d84db53e ($10.44 in chips)
Seat 6: 8695c5ae ($11.27 in chips)
979ebe36: posts small blind $0.05
9b34f129: posts big blind $0.1
*** HOLE CARDS ***
Dealt to 696eb7c1 
Dealt to 979ebe36 
Dealt to 9b34f129 
Dealt to Hero [Jh Th]
Dealt to d84db53e 
Dealt to 8695c5ae 
Hero: raises $0.15 to $0.25
d84db53e: folds
8695c5ae: folds
696eb7c1: folds
979ebe36: folds
9b34f129: calls $0.15
*** FLOP *** [7d Qh 5c]
9b34f129: checks
Hero: bets $0.28
9b34f129: calls $0.28
*** TURN *** [7d Qh 5c] [2s]
9b34f129: checks
Hero: bets $0.42
9b34f129: calls $0.42
*** RIVER *** [7d Qh 5c 2s] [Ks]
9b34f129: checks
Hero: checks
9b34f129: shows [Qc Kh] (Pair of Kings and Pair of Queens)
Hero: shows [Jh Th] (King-High)
*** SHOWDOWN ***
9b34f129 collected $1.86 from pot
*** SUMMARY ***
Total pot $1.95 | Rake $0.09 | Jackpot $0 | Bingo $0 | Fortune $0
Board [7d Qh 5c 2s Ks]
Seat 1: 696eb7c1 (button) folded before Flop (didn't bet)
Seat 2: 979ebe36 (small blind) folded before Flop
Seat 3: 9b34f129 (big blind) showed [Qc Kh] and won ($1.86) with Pair of Kings and Pair of Queens
Seat 4: Hero showed [Jh Th] and lost with King-High
Seat 5: d84db53e folded before Flop (didn't bet)
Seat 6: 8695c5ae folded before Flop (didn't bet)


Poker Hand #RC1459765710: Hold'em No Limit  ($0.05/$0.1) - 2023/04/08 19:19:08
Table 'RushAndCash3740970' 6-max Seat #1 is the button
Seat 1: 10943f36 ($14.32 in chips)
Seat 2: 37660608 ($10 in chips)
Seat 3: 210dc0e5 ($34.87 in chips)
Seat 4: Hero ($11.79 in chips)
Seat 5: c2d25011 ($15.94 in chips)
Seat 6: dfc7c90a ($7.32 in chips)
37660608: posts small blind $0.05
210dc0e5: posts big blind $0.1
*** HOLE CARDS ***
Dealt to 10943f36 
Dealt to 37660608 
Dealt to 210dc0e5 
Dealt to Hero [7c Qs]
Dealt to c2d25011 
Dealt to dfc7c90a 
Hero: folds
c2d25011: raises $0.1 to $0.2
dfc7c90a: folds
10943f36: folds
37660608: folds
210dc0e5: folds
Uncalled bet ($0.1) returned to c2d25011
*** SHOWDOWN ***
c2d25011 collected $0.25 from pot
*** SUMMARY ***
Total pot $0.25 | Rake $0 | Jackpot $0 | Bingo $0 | Fortune $0
Seat 1: 10943f36 (button) folded before Flop (didn't bet)
Seat 2: 37660608 (small blind) folded before Flop
Seat 3: 210dc0e5 (big blind) folded before Flop
Seat 4: Hero folded before Flop (didn't bet)
Seat 5: c2d25011 collected ($0.25)
Seat 6: dfc7c90a folded before Flop (didn't bet)


Poker Hand #RC1459765633: Hold'em No Limit  ($0.05/$0.1) - 2023/04/08 19:18:58
Table 'RushAndCash3740893' 6-max Seat #1 is the button
Seat 1: 5bdb01ab ($13.64 in chips)
Seat 2: 4117f135 ($13.37 in chips)
Seat 3: Hero ($11.89 in chips)
Seat 4: 895e867c ($34 in chips)
Seat 5: ad8fef19 ($16.73 in chips)
Seat 6: ce8eee04 ($11.78 in chips)
4117f135: posts small blind $0.05
Hero: posts big blind $0.1
*** HOLE CARDS ***
Dealt to 5bdb01ab 
Dealt to 4117f135 
Dealt to Hero [5h 7d]
Dealt to 895e867c 
Dealt to ad8fef19 
Dealt to ce8eee04 
895e867c: folds
ad8fef19: raises $0.14 to $0.24
ce8eee04: folds
5bdb01ab: folds
4117f135: folds
Hero: folds
Uncalled bet ($0.14) returned to ad8fef19
*** SHOWDOWN ***
ad8fef19 collected $0.25 from pot
*** SUMMARY ***
Total pot $0.25 | Rake $0 | Jackpot $0 | Bingo $0 | Fortune $0
Seat 1: 5bdb01ab (button) folded before Flop (didn't bet)
Seat 2: 4117f135 (small blind) folded before Flop
Seat 3: Hero (big blind) folded before Flop
Seat 4: 895e867c folded before Flop (didn't bet)
Seat 5: ad8fef19 collected ($0.25)
Seat 6: ce8eee04 folded before Flop (didn't bet)


Poker Hand #RC1459765558: Hold'em No Limit  ($0.05/$0.1) - 2023/04/08 19:18:48
Table 'RushAndCash3740818' 6-max Seat #1 is the button
Seat 1: a4a4271f ($14.14 in chips)
Seat 2: Hero ($11.94 in chips)
Seat 3: 32aac465 ($7.46 in chips)
Seat 4: f181dc91 ($64.13 in chips)
Seat 5: e918bbff ($11.04 in chips)
Seat 6: 30499e87 ($10 in chips)
Hero: posts small blind $0.05
32aac465: posts big blind $0.1
*** HOLE CARDS ***
Dealt to a4a4271f 
Dealt to Hero [Qc 4s]
Dealt to 32aac465 
Dealt to f181dc91 
Dealt to e918bbff 
Dealt to 30499e87 
f181dc91: folds
e918bbff: folds
30499e87: folds
a4a4271f: folds
Hero: folds
Uncalled bet ($0.05) returned to 32aac465
*** SHOWDOWN ***
32aac465 collected $0.1 from pot
*** SUMMARY ***
Total pot $0.1 | Rake $0 | Jackpot $0 | Bingo $0 | Fortune $0
Seat 1: a4a4271f (button) folded before Flop (didn't bet)
Seat 2: Hero (small blind) folded before Flop
Seat 3: 32aac465 (big blind) collected ($0.1)
Seat 4: f181dc91 folded before Flop (didn't bet)
Seat 5: e918bbff folded before Flop (didn't bet)
Seat 6: 30499e87 folded before Flop (didn't bet)


Poker Hand #RC1459765528: Hold'em No Limit  ($0.05/$0.1) - 2023/04/08 19:18:43
Table 'RushAndCash3740788' 6-max Seat #1 is the button
Seat 1: 3432133f ($14.05 in chips)
Seat 2: dc525443 ($18.27 in chips)
Seat 3: 387fe40d ($2.51 in chips)
Seat 4: 7647ac83 ($10.44 in chips)
Seat 5: 81cf78c3 ($22.18 in chips)
Seat 6: Hero ($11.94 in chips)
dc525443: posts small blind $0.05
387fe40d: posts big blind $0.1
*** HOLE CARDS ***
Dealt to 3432133f 
Dealt to dc525443 
Dealt to 387fe40d 
Dealt to 7647ac83 
Dealt to 81cf78c3 
Dealt to Hero [8d 9c]
7647ac83: folds
81cf78c3: raises $0.15 to $0.25
Hero: folds
3432133f: folds
dc525443: folds
387fe40d: calls $0.15
*** FLOP *** [4h 9s 7d]
387fe40d: checks
81cf78c3: checks
*** TURN *** [4h 9s 7d] [2h]
387fe40d: bets $0.42
81cf78c3: folds
Uncalled bet ($0.42) returned to 387fe40d
*** SHOWDOWN ***
387fe40d collected $0.53 from pot
*** SUMMARY ***
Total pot $0.55 | Rake $0.02 | Jackpot $0 | Bingo $0 | Fortune $0
Board [4h 9s 7d 2h]
Seat 1: 3432133f (button) folded before Flop (didn't bet)
Seat 2: dc525443 (small blind) folded before Flop
Seat 3: 387fe40d (big blind) won ($0.53)
Seat 4: 7647ac83 folded before Flop (didn't bet)
Seat 5: 81cf78c3 folded on the Turn
Seat 6: Hero folded before Flop (didn't bet)


Poker Hand #RC1459765499: Hold'em No Limit  ($0.05/$0.1) - 2023/04/08 19:18:39
Table 'RushAndCash3740759' 6-max Seat #1 is the button
Seat 1: e643056c ($11.23 in chips)
Seat 2: 8beae1b7 ($14.46 in chips)
Seat 3: 4d3e6ac2 ($11.1 in chips)
Seat 4: dd817753 ($1.57 in chips)
Seat 5: e62769a9 ($9.12 in chips)
Seat 6: Hero ($11.94 in chips)
8beae1b7: posts small blind $0.05
4d3e6ac2: posts big blind $0.1
*** HOLE CARDS ***
Dealt to e643056c 
Dealt to 8beae1b7 
Dealt to 4d3e6ac2 
Dealt to dd817753 
Dealt to e62769a9 
Dealt to Hero [Kd 2h]
dd817753: folds
e62769a9: folds
Hero: folds
e643056c: raises $0.12 to $0.22
8beae1b7: folds
4d3e6ac2: folds
Uncalled bet ($0.12) returned to e643056c
*** SHOWDOWN ***
e643056c collected $0.25 from pot
*** SUMMARY ***
Total pot $0.25 | Rake $0 | Jackpot $0 | Bingo $0 | Fortune $0
Seat 1: e643056c (button) collected ($0.25)
Seat 2: 8beae1b7 (small blind) folded before Flop
Seat 3: 4d3e6ac2 (big blind) folded before Flop
Seat 4: dd817753 folded before Flop (didn't bet)
Seat 5: e62769a9 folded before Flop (didn't bet)
Seat 6: Hero folded before Flop (didn't bet)


Poker Hand #RC1459765460: Hold'em No Limit  ($0.05/$0.1) - 2023/04/08 19:18:33
Table 'RushAndCash3740720' 6-max Seat #1 is the button
Seat 1: 43818e35 ($13.9 in chips)
Seat 2: 10943f36 ($14.05 in chips)
Seat 3: 210dc0e5 ($35.17 in chips)
Seat 4: cbb4dd63 ($21.17 in chips)
Seat 5: Hero ($11.94 in chips)
Seat 6: 690adb04 ($11.74 in chips)
10943f36: posts small blind $0.05
210dc0e5: posts big blind $0.1
*** HOLE CARDS ***
Dealt to 43818e35 
Dealt to 10943f36 
Dealt to 210dc0e5 
Dealt to cbb4dd63 
Dealt to Hero [5d Th]
Dealt to 690adb04 
cbb4dd63: folds
Hero: folds
690adb04: folds
43818e35: folds
10943f36: raises $0.2 to $0.3
210dc0e5: calls $0.2
*** FLOP *** [9d 3h 9h]
10943f36: checks
210dc0e5: checks
*** TURN *** [9d 3h 9h] [9s]
10943f36: checks
210dc0e5: checks
*** RIVER *** [9d 3h 9h 9s] [Td]
10943f36: checks
210dc0e5: checks
10943f36: shows [Ah Qs] (Three Nines)
210dc0e5: shows [6s Ks] (Three Nines)
*** SHOWDOWN ***
10943f36 collected $0.57 from pot
*** SUMMARY ***
Total pot $0.6 | Rake $0.03 | Jackpot $0 | Bingo $0 | Fortune $0
Board [9d 3h 9h 9s Td]
Seat 1: 43818e35 (button) folded before Flop (didn't bet)
Seat 2: 10943f36 (small blind) showed [Ah Qs] and won ($0.57) with Three Nines
Seat 3: 210dc0e5 (big blind) showed [6s Ks] and lost with Three Nines
Seat 4: cbb4dd63 folded before Flop (didn't bet)
Seat 5: Hero folded before Flop (didn't bet)
Seat 6: 690adb04 folded before Flop (didn't bet)


Poker Hand #RC1459765418: Hold'em No Limit  ($0.05/$0.1) - 2023/04/08 19:18:27
Table 'RushAndCash3740678' 6-max Seat #1 is the button
Seat 1: ae582ec6 ($20.34 in chips)
Seat 2: c89af454 ($12.09 in chips)
Seat 3: 845fb6fd ($20.33 in chips)
Seat 4: 6fa5752a ($9.24 in chips)
Seat 5: Hero ($11.94 in chips)
Seat 6: 2ad67ba8 ($10.3 in chips)
c89af454: posts small blind $0.05
845fb6fd: posts big blind $0.1
*** HOLE CARDS ***
Dealt to ae582ec6 
Dealt to c89af454 
Dealt to 845fb6fd 
Dealt to 6fa5752a 
Dealt to Hero [8s 2c]
Dealt to 2ad67ba8 
6fa5752a: raises $0.2 to $0.3
Hero: folds
2ad67ba8: calls $0.3
ae582ec6: folds
c89af454: folds
845fb6fd: folds
*** FLOP *** [Jh Th 5d]
6fa5752a: bets $0.38
2ad67ba8: folds
Uncalled bet ($0.38) returned to 6fa5752a
*** SHOWDOWN ***
6fa5752a collected $0.71 from pot
*** SUMMARY ***
Total pot $0.75 | Rake $0.04 | Jackpot $0 | Bingo $0 | Fortune $0
Board [Jh Th 5d]
Seat 1: ae582ec6 (button) folded before Flop (didn't bet)
Seat 2: c89af454 (small blind) folded before Flop
Seat 3: 845fb6fd (big blind) folded before Flop
Seat 4: 6fa5752a won ($0.71)
Seat 5: Hero folded before Flop (didn't bet)
Seat 6: 2ad67ba8 folded on the Flop


Poker Hand #RC1459765104: Hold'em No Limit  ($0.05/$0.1) - 2023/04/08 19:17:42
Table 'RushAndCash3740364' 6-max Seat #1 is the button
Seat 1: 6fa5752a ($8.92 in chips)
Seat 2: 5a2e12e8 ($11.41 in chips)
Seat 3: Hero ($12.24 in chips)
Seat 4: 17c19bb9 ($11.08 in chips)
Seat 5: 478f266f ($3.66 in chips)
Seat 6: 4144e484 ($8.19 in chips)
5a2e12e8: posts small blind $0.05
Hero: posts big blind $0.1
*** HOLE CARDS ***
Dealt to 6fa5752a 
Dealt to 5a2e12e8 
Dealt to Hero [Qd 9d]
Dealt to 17c19bb9 
Dealt to 478f266f 
Dealt to 4144e484 
17c19bb9: folds
478f266f: folds
4144e484: folds
6fa5752a: raises $0.2 to $0.3
5a2e12e8: folds
Hero: calls $0.2
*** FLOP *** [Kd 8c 4h]
Hero: checks
6fa5752a: bets $0.33
Hero: folds
Uncalled bet ($0.33) returned to 6fa5752a
*** SHOWDOWN ***
6fa5752a collected $0.62 from pot
*** SUMMARY ***
Total pot $0.65 | Rake $0.03 | Jackpot $0 | Bingo $0 | Fortune $0
Board [Kd 8c 4h]
Seat 1: 6fa5752a (button) won ($0.62)
Seat 2: 5a2e12e8 (small blind) folded before Flop
Seat 3: Hero (big blind) folded on the Flop
Seat 4: 17c19bb9 folded before Flop (didn't bet)
Seat 5: 478f266f folded before Flop (didn't bet)
Seat 6: 4144e484 folded before Flop (didn't bet)


Poker Hand #RC1459754692: Hold'em No Limit  ($0.05/$0.1) - 2023/04/08 19:16:47
Table 'RushAndCash3739952' 6-max Seat #1 is the button
Seat 1: 38c45073 ($39.77 in chips)
Seat 2: Hero ($11.79 in chips)
Seat 3: 478f266f ($4.16 in chips)
Seat 4: 18e0192a ($9.85 in chips)
Seat 5: 690adb04 ($12.09 in chips)
Seat 6: 933aeb35 ($51.15 in chips)
Hero: posts small blind $0.05
478f266f: posts big blind $0.1
*** HOLE CARDS ***
Dealt to 38c45073 
Dealt to Hero [7c 6h]
Dealt to 478f266f 
Dealt to 18e0192a 
Dealt to 690adb04 
Dealt to 933aeb35 
18e0192a: folds
690adb04: folds
933aeb35: folds
38c45073: folds
Hero: raises $0.15 to $0.25
478f266f: calls $0.15
*** FLOP *** [Tc Jc Qc]
Hero: bets $0.25
478f266f: calls $0.25
*** TURN *** [Tc Jc Qc] [9c]
Hero: checks
478f266f: checks
*** RIVER *** [Tc Jc Qc 9c] [2s]
Hero: checks
478f266f: checks
Hero: shows [7c 6h] (Queen High Flush)
478f266f: shows [5h Ah] (Ace-High)
*** SHOWDOWN ***
Hero collected $0.95 from pot
*** SUMMARY ***
Total pot $1 | Rake $0.05 | Jackpot $0 | Bingo $0 | Fortune $0
Board [Tc Jc Qc 9c 2s]
Seat 1: 38c45073 (button) folded before Flop (didn't bet)
Seat 2: Hero (small blind) showed [7c 6h] and won ($0.95) with Queen High Flush
Seat 3: 478f266f (big blind) showed [5h Ah] and lost with Ace-High
Seat 4: 18e0192a folded before Flop (didn't bet)
Seat 5: 690adb04 folded before Flop (didn't bet)
Seat 6: 933aeb35 folded before Flop (didn't bet)


Poker Hand #RC1459754655: Hold'em No Limit  ($0.05/$0.1) - 2023/04/08 19:16:42
Table 'RushAndCash3739915' 6-max Seat #1 is the button
Seat 1: Hero ($11.79 in chips)
Seat 2: 3077b607 ($10.39 in chips)
Seat 3: 93dd5318 ($5.68 in chips)
Seat 4: 93028ba3 ($10.2 in chips)
Seat 5: 2b14119f ($10.43 in chips)
Seat 6: b635d82c ($15.58 in chips)
3077b607: posts small blind $0.05
93dd5318: posts big blind $0.1
*** HOLE CARDS ***
Dealt to Hero [4c Js]
Dealt to 3077b607 
Dealt to 93dd5318 
Dealt to 93028ba3 
Dealt to 2b14119f 
Dealt to b635d82c 
93028ba3: folds
2b14119f: folds
b635d82c: folds
Hero: folds
3077b607: raises $0.2 to $0.3
93dd5318: folds
Uncalled bet ($0.2) returned to 3077b607
*** SHOWDOWN ***
3077b607 collected $0.2 from pot
*** SUMMARY ***
Total pot $0.2 | Rake $0 | Jackpot $0 | Bingo $0 | Fortune $0
Seat 1: Hero (button) folded before Flop (didn't bet)
Seat 2: 3077b607 (small blind) collected ($0.2)
Seat 3: 93dd5318 (big blind) folded before Flop
Seat 4: 93028ba3 folded before Flop (didn't bet)
Seat 5: 2b14119f folded before Flop (didn't bet)
Seat 6: b635d82c folded before Flop (didn't bet)


Poker Hand #RC1459754597: Hold'em No Limit  ($0.05/$0.1) - 2023/04/08 19:16:35
Table 'RushAndCash3739857' 6-max Seat #1 is the button
Seat 1: 5645d589 ($10 in chips)
Seat 2: 80697e31 ($11.51 in chips)
Seat 3: 312e100b ($10 in chips)
Seat 4: Hero ($11.79 in chips)
Seat 5: 2f996d2d ($9.49 in chips)
Seat 6: d7c082e2 ($11.33 in chips)
80697e31: posts small blind $0.05
312e100b: posts big blind $0.1
*** HOLE CARDS ***
Dealt to 5645d589 
Dealt to 80697e31 
Dealt to 312e100b 
Dealt to Hero [4c Kc]
Dealt to 2f996d2d 
Dealt to d7c082e2 
Hero: folds
2f996d2d: folds
d7c082e2: raises $0.15 to $0.25
5645d589: folds
80697e31: folds
312e100b: folds
Uncalled bet ($0.15) returned to d7c082e2
*** SHOWDOWN ***
d7c082e2 collected $0.25 from pot
*** SUMMARY ***
Total pot $0.25 | Rake $0 | Jackpot $0 | Bingo $0 | Fortune $0
Seat 1: 5645d589 (button) folded before Flop (didn't bet)
Seat 2: 80697e31 (small blind) folded before Flop
Seat 3: 312e100b (big blind) folded before Flop
Seat 4: Hero folded before Flop (didn't bet)
Seat 5: 2f996d2d folded before Flop (didn't bet)
Seat 6: d7c082e2 collected ($0.25)


Poker Hand #RC1459754387: Hold'em No Limit  ($0.05/$0.1) - 2023/04/08 19:16:09
Table 'RushAndCash3739647' 6-max Seat #1 is the button
Seat 1: 27089392 ($10 in chips)
Seat 2: cfe96088 ($10.83 in chips)
Seat 3: 8a8bce3 ($13.52 in chips)
Seat 4: 4cfc00f5 ($14.7 in chips)
Seat 5: Hero ($11.79 in chips)
Seat 6: e0ecab42 ($10.33 in chips)
cfe96088: posts small blind $0.05
8a8bce3: posts big blind $0.1
*** HOLE CARDS ***
Dealt to 27089392 
Dealt to cfe96088 
Dealt to 8a8bce3 
Dealt to 4cfc00f5 
Dealt to Hero [3s 9c]
Dealt to e0ecab42 
4cfc00f5: folds
Hero: folds
e0ecab42: folds
27089392: folds
cfe96088: folds
Uncalled bet ($0.05) returned to 8a8bce3
*** SHOWDOWN ***
8a8bce3 collected $0.1 from pot
*** SUMMARY ***
Total pot $0.1 | Rake $0 | Jackpot $0 | Bingo $0 | Fortune $0
Seat 1: 27089392 (button) folded before Flop (didn't bet)
Seat 2: cfe96088 (small blind) folded before Flop
Seat 3: 8a8bce3 (big blind) collected ($0.1)
Seat 4: 4cfc00f5 folded before Flop (didn't bet)
Seat 5: Hero folded before Flop (didn't bet)
Seat 6: e0ecab42 folded before Flop (didn't bet)


Poker Hand #RC1459754335: Hold'em No Limit  ($0.05/$0.1) - 2023/04/08 19:16:02
Table 'RushAndCash3739595' 6-max Seat #1 is the button
Seat 1: 83fce378 ($41.3 in chips)
Seat 2: 6160addd ($14.34 in chips)
Seat 3: 79e5faf8 ($14.54 in chips)
Seat 4: Hero ($11.79 in chips)
Seat 5: ae1a7250 ($9.86 in chips)
Seat 6: 43663618 ($10.42 in chips)
6160addd: posts small blind $0.05
79e5faf8: posts big blind $0.1
*** HOLE CARDS ***
Dealt to 83fce378 
Dealt to 6160addd 
Dealt to 79e5faf8 
Dealt to Hero [8d Th]
Dealt to ae1a7250 
Dealt to 43663618 
Hero: folds
ae1a7250: folds
43663618: folds
83fce378: folds
6160addd: raises $0.2 to $0.3
79e5faf8: calls $0.2
*** FLOP *** [7h Qc 2c]
6160addd: bets $0.3
79e5faf8: folds
Uncalled bet ($0.3) returned to 6160addd
*** SHOWDOWN ***
6160addd collected $0.57 from pot
*** SUMMARY ***
Total pot $0.6 | Rake $0.03 | Jackpot $0 | Bingo $0 | Fortune $0
Board [7h Qc 2c]
Seat 1: 83fce378 (button) folded before Flop (didn't bet)
Seat 2: 6160addd (small blind) won ($0.57)
Seat 3: 79e5faf8 (big blind) folded on the Flop
Seat 4: Hero folded before Flop (didn't bet)
Seat 5: ae1a7250 folded before Flop (didn't bet)
Seat 6: 43663618 folded before Flop (didn't bet)


Poker Hand #RC1459754228: Hold'em No Limit  ($0.05/$0.1) - 2023/04/08 19:15:47
Table 'RushAndCash3739488' 6-max Seat #1 is the button
Seat 1: 303cbb65 ($10.05 in chips)
Seat 2: d7f1b380 ($13.82 in chips)
Seat 3: Hero ($11.89 in chips)
Seat 4: 8b024078 ($30.33 in chips)
Seat 5: 1fcf81a5 ($16.52 in chips)
Seat 6: dca4a549 ($10.32 in chips)
d7f1b380: posts small blind $0.05
Hero: posts big blind $0.1
*** HOLE CARDS ***
Dealt to 303cbb65 
Dealt to d7f1b380 
Dealt to Hero [4c Tc]
Dealt to 8b024078 
Dealt to 1fcf81a5 
Dealt to dca4a549 
8b024078: folds
1fcf81a5: folds
dca4a549: raises $0.15 to $0.25
303cbb65: folds
d7f1b380: folds
Hero: folds
Uncalled bet ($0.15) returned to dca4a549
*** SHOWDOWN ***
dca4a549 collected $0.25 from pot
*** SUMMARY ***
Total pot $0.25 | Rake $0 | Jackpot $0 | Bingo $0 | Fortune $0
Seat 1: 303cbb65 (button) folded before Flop (didn't bet)
Seat 2: d7f1b380 (small blind) folded before Flop
Seat 3: Hero (big blind) folded before Flop
Seat 4: 8b024078 folded before Flop (didn't bet)
Seat 5: 1fcf81a5 folded before Flop (didn't bet)
Seat 6: dca4a549 collected ($0.25)


Poker Hand #RC1459753911: Hold'em No Limit  ($0.05/$0.1) - 2023/04/08 19:15:06
Table 'RushAndCash3739171' 6-max Seat #1 is the button
Seat 1: c443d6bf ($9.75 in chips)
Seat 2: Hero ($12.19 in chips)
Seat 3: 8b024078 ($30.06 in chips)
Seat 4: 43818e35 ($10 in chips)
Seat 5: e6d7d0b5 ($41.94 in chips)
Seat 6: f4ea9ac9 ($3.85 in chips)
Hero: posts small blind $0.05
8b024078: posts big blind $0.1
*** HOLE CARDS ***
Dealt to c443d6bf 
Dealt to Hero [Ks Td]
Dealt to 8b024078 
Dealt to 43818e35 
Dealt to e6d7d0b5 
Dealt to f4ea9ac9 
43818e35: folds
e6d7d0b5: folds
f4ea9ac9: folds
c443d6bf: folds
Hero: raises $0.2 to $0.3
8b024078: calls $0.2
*** FLOP *** [6h 4h 3s]
Hero: checks
8b024078: checks
*** TURN *** [6h 4h 3s] [2h]
Hero: checks
8b024078: bets $0.3
Hero: folds
Uncalled bet ($0.3) returned to 8b024078
*** SHOWDOWN ***
8b024078 collected $0.57 from pot
*** SUMMARY ***
Total pot $0.6 | Rake $0.03 | Jackpot $0 | Bingo $0 | Fortune $0
Board [6h 4h 3s 2h]
Seat 1: c443d6bf (button) folded before Flop (didn't bet)
Seat 2: Hero (small blind) folded on the Turn
Seat 3: 8b024078 (big blind) won ($0.57)
Seat 4: 43818e35 folded before Flop (didn't bet)
Seat 5: e6d7d0b5 folded before Flop (didn't bet)
Seat 6: f4ea9ac9 folded before Flop (didn't bet)


Poker Hand #RC1459753877: Hold'em No Limit  ($0.05/$0.1) - 2023/04/08 19:15:00
Table 'RushAndCash3739137' 6-max Seat #1 is the button
Seat 1: Hero ($12.19 in chips)
Seat 2: 67f76365 ($10.44 in chips)
Seat 3: 8064075d ($21.05 in chips)
Seat 4: f9cffa95 ($20.29 in chips)
Seat 5: 2bd599e1 ($13.19 in chips)
Seat 6: 5645d589 ($10.33 in chips)
67f76365: posts small blind $0.05
8064075d: posts big blind $0.1
*** HOLE CARDS ***
Dealt to Hero [5c Td]
Dealt to 67f76365 
Dealt to 8064075d 
Dealt to f9cffa95 
Dealt to 2bd599e1 
Dealt to 5645d589 
f9cffa95: raises $0.15 to $0.25
2bd599e1: folds
5645d589: folds
Hero: folds
67f76365: folds
8064075d: calls $0.15
*** FLOP *** [As 6s 2c]
8064075d: checks
f9cffa95: checks
*** TURN *** [As 6s 2c] [9s]
8064075d: checks
f9cffa95: bets $0.37
8064075d: calls $0.37
*** RIVER *** [As 6s 2c 9s] [8s]
8064075d: checks
f9cffa95: bets $1.1
8064075d: folds
Uncalled bet ($1.1) returned to f9cffa95
*** SHOWDOWN ***
f9cffa95 collected $1.23 from pot
*** SUMMARY ***
Total pot $1.29 | Rake $0.06 | Jackpot $0 | Bingo $0 | Fortune $0
Board [As 6s 2c 9s 8s]
Seat 1: Hero (button) folded before Flop (didn't bet)
Seat 2: 67f76365 (small blind) folded before Flop
Seat 3: 8064075d (big blind) folded on the River
Seat 4: f9cffa95 won ($1.23)
Seat 5: 2bd599e1 folded before Flop (didn't bet)
Seat 6: 5645d589 folded before Flop (didn't bet)


Poker Hand #RC1459753814: Hold'em No Limit  ($0.05/$0.1) - 2023/04/08 19:14:52
Table 'RushAndCash3739074' 6-max Seat #1 is the button
Seat 1: Hero ($12.19 in chips)
Seat 2: 49da03d9 ($16.57 in chips)
Seat 3: fff78e2 ($19.13 in chips)
Seat 4: 5ad8e3e2 ($5.57 in chips)
Seat 5: 595c378c ($9.71 in chips)
Seat 6: 30d41aaa ($10.52 in chips)
49da03d9: posts small blind $0.05
fff78e2: posts big blind $0.1
*** HOLE CARDS ***
Dealt to Hero [Ah 7c]
Dealt to 49da03d9 
Dealt to fff78e2 
Dealt to 5ad8e3e2 
Dealt to 595c378c 
Dealt to 30d41aaa 
5ad8e3e2: folds
595c378c: folds
30d41aaa: raises $0.1 to $0.2
Hero: folds
49da03d9: folds
fff78e2: folds
Uncalled bet ($0.1) returned to 30d41aaa
*** SHOWDOWN ***
30d41aaa collected $0.25 from pot
*** SUMMARY ***
Total pot $0.25 | Rake $0 | Jackpot $0 | Bingo $0 | Fortune $0
Seat 1: Hero (button) folded before Flop (didn't bet)
Seat 2: 49da03d9 (small blind) folded before Flop
Seat 3: fff78e2 (big blind) folded before Flop
Seat 4: 5ad8e3e2 folded before Flop (didn't bet)
Seat 5: 595c378c folded before Flop (didn't bet)
Seat 6: 30d41aaa collected ($0.25)


Poker Hand #RC1459753754: Hold'em No Limit  ($0.05/$0.1) - 2023/04/08 19:14:44
Table 'RushAndCash3739014' 6-max Seat #1 is the button
Seat 1: d7f1b380 ($14.92 in chips)
Seat 2: 4d3e6ac2 ($11.44 in chips)
Seat 3: 15ec50c7 ($12.55 in chips)
Seat 4: 3bb96cf5 ($10.85 in chips)
Seat 5: c443d6bf ($9.6 in chips)
Seat 6: Hero ($12.19 in chips)
4d3e6ac2: posts small blind $0.05
15ec50c7: posts big blind $0.1
*** HOLE CARDS ***
Dealt to d7f1b380 
Dealt to 4d3e6ac2 
Dealt to 15ec50c7 
Dealt to 3bb96cf5 
Dealt to c443d6bf 
Dealt to Hero [Tc Jd]
3bb96cf5: calls $0.1
c443d6bf: folds
Hero: folds
d7f1b380: folds
4d3e6ac2: folds
15ec50c7: checks
*** FLOP *** [Ks 4h Ts]
15ec50c7: checks
3bb96cf5: checks
*** TURN *** [Ks 4h Ts] [3s]
15ec50c7: checks
3bb96cf5: bets $0.1
15ec50c7: folds
Uncalled bet ($0.1) returned to 3bb96cf5
*** SHOWDOWN ***
3bb96cf5 collected $0.24 from pot
*** SUMMARY ***
Total pot $0.25 | Rake $0.01 | Jackpot $0 | Bingo $0 | Fortune $0
Board [Ks 4h Ts 3s]
Seat 1: d7f1b380 (button) folded before Flop (didn't bet)
Seat 2: 4d3e6ac2 (small blind) folded before Flop
Seat 3: 15ec50c7 (big blind) folded on the Turn
Seat 4: 3bb96cf5 won ($0.24)
Seat 5: c443d6bf folded before Flop (didn't bet)
Seat 6: Hero folded before Flop (didn't bet)


Poker Hand #RC1459753716: Hold'em No Limit  ($0.05/$0.1) - 2023/04/08 19:14:40
Table 'RushAndCash3738976' 6-max Seat #1 is the button
Seat 1: 3bb96cf5 ($10.85 in chips)
Seat 2: 95d2128f ($25.61 in chips)
Seat 3: fcb88c86 ($12.4 in chips)
Seat 4: 1fcf81a5 ($14.63 in chips)
Seat 5: Hero ($12.19 in chips)
Seat 6: f9f79a03 ($6 in chips)
95d2128f: posts small blind $0.05
fcb88c86: posts big blind $0.1
*** HOLE CARDS ***
Dealt to 3bb96cf5 
Dealt to 95d2128f 
Dealt to fcb88c86 
Dealt to 1fcf81a5 
Dealt to Hero [Kd 4s]
Dealt to f9f79a03 
1fcf81a5: folds
Hero: folds
f9f79a03: folds
3bb96cf5: folds
95d2128f: folds
Uncalled bet ($0.05) returned to fcb88c86
*** SHOWDOWN ***
fcb88c86 collected $0.1 from pot
*** SUMMARY ***
Total pot $0.1 | Rake $0 | Jackpot $0 | Bingo $0 | Fortune $0
Seat 1: 3bb96cf5 (button) folded before Flop (didn't bet)
Seat 2: 95d2128f (small blind) folded before Flop
Seat 3: fcb88c86 (big blind) collected ($0.1)
Seat 4: 1fcf81a5 folded before Flop (didn't bet)
Seat 5: Hero folded before Flop (didn't bet)
Seat 6: f9f79a03 folded before Flop (didn't bet)


Poker Hand #RC1459753628: Hold'em No Limit  ($0.05/$0.1) - 2023/04/08 19:14:27
Table 'RushAndCash3738888' 6-max Seat #1 is the button
Seat 1: 447c4e6 ($51.54 in chips)
Seat 2: 824bacad ($17.04 in chips)
Seat 3: Hero ($12.14 in chips)
Seat 4: 9120593f ($10.75 in chips)
Seat 5: 1c763e5f ($15.7 in chips)
Seat 6: e69cddd7 ($10.77 in chips)
824bacad: posts small blind $0.05
Hero: posts big blind $0.1
*** HOLE CARDS ***
Dealt to 447c4e6 
Dealt to 824bacad 
Dealt to Hero [Kd Th]
Dealt to 9120593f 
Dealt to 1c763e5f 
Dealt to e69cddd7 
9120593f: folds
1c763e5f: folds
e69cddd7: folds
447c4e6: folds
824bacad: folds
Uncalled bet ($0.05) returned to Hero
*** SHOWDOWN ***
Hero collected $0.1 from pot
*** SUMMARY ***
Total pot $0.1 | Rake $0 | Jackpot $0 | Bingo $0 | Fortune $0
Seat 1: 447c4e6 (button) folded before Flop (didn't bet)
Seat 2: 824bacad (small blind) folded before Flop
Seat 3: Hero (big blind) collected ($0.1)
Seat 4: 9120593f folded before Flop (didn't bet)
Seat 5: 1c763e5f folded before Flop (didn't bet)
Seat 6: e69cddd7 folded before Flop (didn't bet)


Poker Hand #RC1459753597: Hold'em No Limit  ($0.05/$0.1) - 2023/04/08 19:14:22
Table 'RushAndCash3738857' 6-max Seat #1 is the button
Seat 1: c9f2633a ($24.89 in chips)
Seat 2: Hero ($12.19 in chips)
Seat 3: f2215822 ($10.64 in chips)
Seat 4: 40125b6a ($4.95 in chips)
Seat 5: e35f0658 ($12.24 in chips)
Seat 6: 92a48d51 ($21.73 in chips)
Hero: posts small blind $0.05
f2215822: posts big blind $0.1
*** HOLE CARDS ***
Dealt to c9f2633a 
Dealt to Hero [Js 4h]
Dealt to f2215822 
Dealt to 40125b6a 
Dealt to e35f0658 
Dealt to 92a48d51 
40125b6a: folds
e35f0658: folds
92a48d51: folds
c9f2633a: folds
Hero: folds
Uncalled bet ($0.05) returned to f2215822
*** SHOWDOWN ***
f2215822 collected $0.1 from pot
*** SUMMARY ***
Total pot $0.1 | Rake $0 | Jackpot $0 | Bingo $0 | Fortune $0
Seat 1: c9f2633a (button) folded before Flop (didn't bet)
Seat 2: Hero (small blind) folded before Flop
Seat 3: f2215822 (big blind) collected ($0.1)
Seat 4: 40125b6a folded before Flop (didn't bet)
Seat 5: e35f0658 folded before Flop (didn't bet)
Seat 6: 92a48d51 folded before Flop (didn't bet)


Poker Hand #RC1459753562: Hold'em No Limit  ($0.05/$0.1) - 2023/04/08 19:14:18
Table 'RushAndCash3738822' 6-max Seat #1 is the button
Seat 1: 266d7d90 ($5.94 in chips)
Seat 2: d2dac9c0 ($9.75 in chips)
Seat 3: 9c3d59f5 ($10 in chips)
Seat 4: bf421c79 ($9.73 in chips)
Seat 5: f6f523c1 ($14.04 in chips)
Seat 6: Hero ($12.19 in chips)
d2dac9c0: posts small blind $0.05
9c3d59f5: posts big blind $0.1
*** HOLE CARDS ***
Dealt to 266d7d90 
Dealt to d2dac9c0 
Dealt to 9c3d59f5 
Dealt to bf421c79 
Dealt to f6f523c1 
Dealt to Hero [Ks 3d]
bf421c79: folds
f6f523c1: folds
Hero: folds
266d7d90: raises $0.1 to $0.2
d2dac9c0: folds
9c3d59f5: calls $0.1
*** FLOP *** [3s 2d 8c]
9c3d59f5: checks
266d7d90: checks
*** TURN *** [3s 2d 8c] [Kd]
9c3d59f5: checks
266d7d90: bets $0.23
9c3d59f5: calls $0.23
*** RIVER *** [3s 2d 8c Kd] [4d]
9c3d59f5: checks
266d7d90: checks
9c3d59f5: shows [5s 5h] (Pair of Fives)
266d7d90: shows [Qs Kc] (Pair of Kings)
*** SHOWDOWN ***
266d7d90 collected $0.87 from pot
*** SUMMARY ***
Total pot $0.91 | Rake $0.04 | Jackpot $0 | Bingo $0 | Fortune $0
Board [3s 2d 8c Kd 4d]
Seat 1: 266d7d90 (button) showed [Qs Kc] and won ($0.87) with Pair of Kings
Seat 2: d2dac9c0 (small blind) folded before Flop
Seat 3: 9c3d59f5 (big blind) showed [5s 5h] and lost with Pair of Fives
Seat 4: bf421c79 folded before Flop (didn't bet)
Seat 5: f6f523c1 folded before Flop (didn't bet)
Seat 6: Hero folded before Flop (didn't bet)


Poker Hand #RC1459753306: Hold'em No Limit  ($0.05/$0.1) - 2023/04/08 19:13:42
Table 'RushAndCash3738566' 6-max Seat #1 is the button
Seat 1: 12d2816f ($10.26 in chips)
Seat 2: 4d3e6ac2 ($11.88 in chips)
Seat 3: d2dac9c0 ($10 in chips)
Seat 4: Hero ($11.91 in chips)
Seat 5: 933aeb35 ($51.07 in chips)
Seat 6: e33b6a9d ($8.58 in chips)
4d3e6ac2: posts small blind $0.05
d2dac9c0: posts big blind $0.1
*** HOLE CARDS ***
Dealt to 12d2816f 
Dealt to 4d3e6ac2 
Dealt to d2dac9c0 
Dealt to Hero [9c Ts]
Dealt to 933aeb35 
Dealt to e33b6a9d 
Hero: raises $0.15 to $0.25
933aeb35: folds
e33b6a9d: folds
12d2816f: folds
4d3e6ac2: folds
d2dac9c0: calls $0.15
*** FLOP *** [9h 8c 4c]
d2dac9c0: checks
Hero: bets $0.28
d2dac9c0: folds
Uncalled bet ($0.28) returned to Hero
*** SHOWDOWN ***
Hero collected $0.53 from pot
*** SUMMARY ***
Total pot $0.55 | Rake $0.02 | Jackpot $0 | Bingo $0 | Fortune $0
Board [9h 8c 4c]
Seat 1: 12d2816f (button) folded before Flop (didn't bet)
Seat 2: 4d3e6ac2 (small blind) folded before Flop
Seat 3: d2dac9c0 (big blind) folded on the Flop
Seat 4: Hero won ($0.53)
Seat 5: 933aeb35 folded before Flop (didn't bet)
Seat 6: e33b6a9d folded before Flop (didn't bet)


Poker Hand #RC1459752807: Hold'em No Limit  ($0.05/$0.1) - 2023/04/08 19:12:31
Table 'RushAndCash3738067' 6-max Seat #1 is the button
Seat 1: ff3e3866 ($14.91 in chips)
Seat 2: dbc96150 ($7.55 in chips)
Seat 3: 4d3e6ac2 ($10.63 in chips)
Seat 4: Hero ($12.56 in chips)
Seat 5: 12d2816f ($10.91 in chips)
Seat 6: e790267c ($10 in chips)
dbc96150: posts small blind $0.05
4d3e6ac2: posts big blind $0.1
*** HOLE CARDS ***
Dealt to ff3e3866 
Dealt to dbc96150 
Dealt to 4d3e6ac2 
Dealt to Hero [9s Ts]
Dealt to 12d2816f 
Dealt to e790267c 
Hero: raises $0.15 to $0.25
12d2816f: calls $0.25
e790267c: folds
ff3e3866: folds
dbc96150: folds
4d3e6ac2: calls $0.15
*** FLOP *** [Qh 5s 4h]
4d3e6ac2: checks
Hero: bets $0.4
12d2816f: calls $0.4
4d3e6ac2: calls $0.4
*** TURN *** [Qh 5s 4h] [Jc]
4d3e6ac2: checks
Hero: checks
12d2816f: checks
*** RIVER *** [Qh 5s 4h Jc] [9h]
4d3e6ac2: checks
Hero: checks
12d2816f: checks
4d3e6ac2: shows [Th Qs] (Pair of Queens)
Hero: shows [9s Ts] (Pair of Nines)
12d2816f: shows [8s 8h] (Pair of Eights)
*** SHOWDOWN ***
4d3e6ac2 collected $1.9 from pot
*** SUMMARY ***
Total pot $2 | Rake $0.1 | Jackpot $0 | Bingo $0 | Fortune $0
Board [Qh 5s 4h Jc 9h]
Seat 1: ff3e3866 (button) folded before Flop (didn't bet)
Seat 2: dbc96150 (small blind) folded before Flop
Seat 3: 4d3e6ac2 (big blind) showed [Th Qs] and won ($1.9) with Pair of Queens
Seat 4: Hero showed [9s Ts] and lost with Pair of Nines
Seat 5: 12d2816f showed [8s 8h] and lost with Pair of Eights
Seat 6: e790267c folded before Flop (didn't bet)


Poker Hand #RC1459752719: Hold'em No Limit  ($0.05/$0.1) - 2023/04/08 19:12:19
Table 'RushAndCash3737979' 6-max Seat #1 is the button
Seat 1: Hero ($12.56 in chips)
Seat 2: b4f0b29d ($10.57 in chips)
Seat 3: c41992fa ($14.43 in chips)
Seat 4: 8064075d ($19.94 in chips)
Seat 5: 81f21357 ($29.39 in chips)
Seat 6: 4d3e6ac2 ($10.63 in chips)
b4f0b29d: posts small blind $0.05
c41992fa: posts big blind $0.1
*** HOLE CARDS ***
Dealt to Hero [7c 3h]
Dealt to b4f0b29d 
Dealt to c41992fa 
Dealt to 8064075d 
Dealt to 81f21357 
Dealt to 4d3e6ac2 
8064075d: folds
81f21357: folds
4d3e6ac2: folds
Hero: folds
b4f0b29d: raises $0.15 to $0.25
c41992fa: folds
Uncalled bet ($0.15) returned to b4f0b29d
*** SHOWDOWN ***
b4f0b29d collected $0.2 from pot
*** SUMMARY ***
Total pot $0.2 | Rake $0 | Jackpot $0 | Bingo $0 | Fortune $0
Seat 1: Hero (button) folded before Flop (didn't bet)
Seat 2: b4f0b29d (small blind) collected ($0.2)
Seat 3: c41992fa (big blind) folded before Flop
Seat 4: 8064075d folded before Flop (didn't bet)
Seat 5: 81f21357 folded before Flop (didn't bet)
Seat 6: 4d3e6ac2 folded before Flop (didn't bet)


Poker Hand #RC1459752630: Hold'em No Limit  ($0.05/$0.1) - 2023/04/08 19:12:07
Table 'RushAndCash3737890' 6-max Seat #1 is the button
Seat 1: f2301105 ($11.56 in chips)
Seat 2: Hero ($12.61 in chips)
Seat 3: 49952623 ($12 in chips)
Seat 4: fa1722a8 ($16.89 in chips)
Seat 5: 7f165885 ($14.96 in chips)
Seat 6: a2d4518a ($10.93 in chips)
Hero: posts small blind $0.05
49952623: posts big blind $0.1
*** HOLE CARDS ***
Dealt to f2301105 
Dealt to Hero [3c 2s]
Dealt to 49952623 
Dealt to fa1722a8 
Dealt to 7f165885 
Dealt to a2d4518a 
fa1722a8: folds
7f165885: raises $0.1 to $0.2
a2d4518a: folds
f2301105: raises $0.55 to $0.75
Hero: folds
49952623: folds
7f165885: folds
Uncalled bet ($0.55) returned to f2301105
*** SHOWDOWN ***
f2301105 collected $0.53 from pot
*** SUMMARY ***
Total pot $0.55 | Rake $0.02 | Jackpot $0 | Bingo $0 | Fortune $0
Seat 1: f2301105 (button) collected ($0.53)
Seat 2: Hero (small blind) folded before Flop
Seat 3: 49952623 (big blind) folded before Flop
Seat 4: fa1722a8 folded before Flop (didn't bet)
Seat 5: 7f165885 folded before Flop
Seat 6: a2d4518a folded before Flop (didn't bet)


Poker Hand #RC1459752529: Hold'em No Limit  ($0.05/$0.1) - 2023/04/08 19:11:52
Table 'RushAndCash3737789' 6-max Seat #1 is the button
Seat 1: fa1722a8 ($16.94 in chips)
Seat 2: 690adb04 ($10 in chips)
Seat 3: Hero ($12.71 in chips)
Seat 4: b7f7b21b ($3.73 in chips)
Seat 5: f429fef4 ($21.3 in chips)
Seat 6: 650c2154 ($9.17 in chips)
690adb04: posts small blind $0.05
Hero: posts big blind $0.1
*** HOLE CARDS ***
Dealt to fa1722a8 
Dealt to 690adb04 
Dealt to Hero [Qs 4c]
Dealt to b7f7b21b 
Dealt to f429fef4 
Dealt to 650c2154 
b7f7b21b: calls $0.1
f429fef4: raises $0.28 to $0.38
650c2154: folds
fa1722a8: folds
690adb04: folds
Hero: folds
b7f7b21b: folds
Uncalled bet ($0.28) returned to f429fef4
*** SHOWDOWN ***
f429fef4 collected $0.34 from pot
*** SUMMARY ***
Total pot $0.35 | Rake $0.01 | Jackpot $0 | Bingo $0 | Fortune $0
Seat 1: fa1722a8 (button) folded before Flop (didn't bet)
Seat 2: 690adb04 (small blind) folded before Flop
Seat 3: Hero (big blind) folded before Flop
Seat 4: b7f7b21b folded before Flop
Seat 5: f429fef4 collected ($0.34)
Seat 6: 650c2154 folded before Flop (didn't bet)


Poker Hand #RC1459752291: Hold'em No Limit  ($0.05/$0.1) - 2023/04/08 19:11:19
Table 'RushAndCash3737551' 6-max Seat #1 is the button
Seat 1: 2a94273e ($9.85 in chips)
Seat 2: 6e671f1d ($8.77 in chips)
Seat 3: d728232d ($19.49 in chips)
Seat 4: 3058d7a0 ($10.05 in chips)
Seat 5: f2785f73 ($43.58 in chips)
Seat 6: Hero ($12.96 in chips)
6e671f1d: posts small blind $0.05
d728232d: posts big blind $0.1
*** HOLE CARDS ***
Dealt to 2a94273e 
Dealt to 6e671f1d 
Dealt to d728232d 
Dealt to 3058d7a0 
Dealt to f2785f73 
Dealt to Hero [Ks Jh]
3058d7a0: folds
f2785f73: folds
Hero: raises $0.15 to $0.25
2a94273e: folds
6e671f1d: folds
d728232d: raises $0.95 to $1.2
Hero: folds
Uncalled bet ($0.95) returned to d728232d
*** SHOWDOWN ***
d728232d collected $0.53 from pot
*** SUMMARY ***
Total pot $0.55 | Rake $0.02 | Jackpot $0 | Bingo $0 | Fortune $0
Seat 1: 2a94273e (button) folded before Flop (didn't bet)
Seat 2: 6e671f1d (small blind) folded before Flop
Seat 3: d728232d (big blind) collected ($0.53)
Seat 4: 3058d7a0 folded before Flop (didn't bet)
Seat 5: f2785f73 folded before Flop (didn't bet)
Seat 6: Hero folded before Flop


Poker Hand #RC1459752256: Hold'em No Limit  ($0.05/$0.1) - 2023/04/08 19:11:14
Table 'RushAndCash3737516' 6-max Seat #1 is the button
Seat 1: 3e9216b5 ($9.6 in chips)
Seat 2: 11140997 ($6.25 in chips)
Seat 3: 6add1adb ($10.08 in chips)
Seat 4: Hero ($12.96 in chips)
Seat 5: 800d12f4 ($11.51 in chips)
Seat 6: 561f91cc ($15.34 in chips)
11140997: posts small blind $0.05
6add1adb: posts big blind $0.1
*** HOLE CARDS ***
Dealt to 3e9216b5 
Dealt to 11140997 
Dealt to 6add1adb 
Dealt to Hero [9c Qd]
Dealt to 800d12f4 
Dealt to 561f91cc 
Hero: folds
800d12f4: folds
561f91cc: folds
3e9216b5: folds
11140997: folds
Uncalled bet ($0.05) returned to 6add1adb
*** SHOWDOWN ***
6add1adb collected $0.1 from pot
*** SUMMARY ***
Total pot $0.1 | Rake $0 | Jackpot $0 | Bingo $0 | Fortune $0
Seat 1: 3e9216b5 (button) folded before Flop (didn't bet)
Seat 2: 11140997 (small blind) folded before Flop
Seat 3: 6add1adb (big blind) collected ($0.1)
Seat 4: Hero folded before Flop (didn't bet)
Seat 5: 800d12f4 folded before Flop (didn't bet)
Seat 6: 561f91cc folded before Flop (didn't bet)


Poker Hand #RC1459751879: Hold'em No Limit  ($0.05/$0.1) - 2023/04/08 19:10:18
Table 'RushAndCash3737139' 6-max Seat #1 is the button
Seat 1: 23f2aa4c ($19.37 in chips)
Seat 2: c77afeb9 ($10.27 in chips)
Seat 3: 3e9216b5 ($9.85 in chips)
Seat 4: 505787cf ($10.19 in chips)
Seat 5: 314a7cce ($13.57 in chips)
Seat 6: Hero ($12.68 in chips)
c77afeb9: posts small blind $0.05
3e9216b5: posts big blind $0.1
*** HOLE CARDS ***
Dealt to 23f2aa4c 
Dealt to c77afeb9 
Dealt to 3e9216b5 
Dealt to 505787cf 
Dealt to 314a7cce 
Dealt to Hero [Kh Qc]
505787cf: folds
314a7cce: folds
Hero: raises $0.15 to $0.25
23f2aa4c: folds
c77afeb9: folds
3e9216b5: calls $0.15
*** FLOP *** [Tc Th 7d]
3e9216b5: checks
Hero: checks
*** TURN *** [Tc Th 7d] [6d]
3e9216b5: checks
Hero: checks
*** RIVER *** [Tc Th 7d 6d] [3s]
3e9216b5: checks
Hero: checks
3e9216b5: shows [Jd Qh] (Pair of Tens)
Hero: shows [Kh Qc] (Pair of Tens)
*** SHOWDOWN ***
Hero collected $0.53 from pot
*** SUMMARY ***
Total pot $0.55 | Rake $0.02 | Jackpot $0 | Bingo $0 | Fortune $0
Board [Tc Th 7d 6d 3s]
Seat 1: 23f2aa4c (button) folded before Flop (didn't bet)
Seat 2: c77afeb9 (small blind) folded before Flop
Seat 3: 3e9216b5 (big blind) showed [Jd Qh] and lost with Pair of Tens
Seat 4: 505787cf folded before Flop (didn't bet)
Seat 5: 314a7cce folded before Flop (didn't bet)
Seat 6: Hero showed [Kh Qc] and won ($0.53) with Pair of Tens


Poker Hand #RC1459751833: Hold'em No Limit  ($0.05/$0.1) - 2023/04/08 19:10:11
Table 'RushAndCash3737093' 6-max Seat #1 is the button
Seat 1: 9eb62b2 ($10 in chips)
Seat 2: b8ec3090 ($35.26 in chips)
Seat 3: d728232d ($19.84 in chips)
Seat 4: Hero ($12.68 in chips)
Seat 5: f53cdad ($14.78 in chips)
Seat 6: e5c7d102 ($10.15 in chips)
b8ec3090: posts small blind $0.05
d728232d: posts big blind $0.1
*** HOLE CARDS ***
Dealt to 9eb62b2 
Dealt to b8ec3090 
Dealt to d728232d 
Dealt to Hero [6c Qd]
Dealt to f53cdad 
Dealt to e5c7d102 
Hero: folds
f53cdad: folds
e5c7d102: folds
9eb62b2: folds
b8ec3090: raises $0.15 to $0.25
d728232d: folds
Uncalled bet ($0.15) returned to b8ec3090
*** SHOWDOWN ***
b8ec3090 collected $0.2 from pot
*** SUMMARY ***
Total pot $0.2 | Rake $0 | Jackpot $0 | Bingo $0 | Fortune $0
Seat 1: 9eb62b2 (button) folded before Flop (didn't bet)
Seat 2: b8ec3090 (small blind) collected ($0.2)
Seat 3: d728232d (big blind) folded before Flop
Seat 4: Hero folded before Flop (didn't bet)
Seat 5: f53cdad folded before Flop (didn't bet)
Seat 6: e5c7d102 folded before Flop (didn't bet)


Poker Hand #RC1459751798: Hold'em No Limit  ($0.05/$0.1) - 2023/04/08 19:10:06
Table 'RushAndCash3737058' 6-max Seat #1 is the button
Seat 1: Hero ($12.68 in chips)
Seat 2: a951861a ($19.98 in chips)
Seat 3: 253968a7 ($11.28 in chips)
Seat 4: 583bb900 ($14.15 in chips)
Seat 5: 95d2128f ($27.7 in chips)
Seat 6: 3e9216b5 ($9.85 in chips)
a951861a: posts small blind $0.05
253968a7: posts big blind $0.1
*** HOLE CARDS ***
Dealt to Hero [Qc 8s]
Dealt to a951861a 
Dealt to 253968a7 
Dealt to 583bb900 
Dealt to 95d2128f 
Dealt to 3e9216b5 
583bb900: folds
95d2128f: folds
3e9216b5: folds
Hero: folds
a951861a: raises $0.25 to $0.35
253968a7: calls $0.25
*** FLOP *** [Js 4s 7h]
a951861a: bets $0.35
253968a7: folds
Uncalled bet ($0.35) returned to a951861a
*** SHOWDOWN ***
a951861a collected $0.67 from pot
*** SUMMARY ***
Total pot $0.7 | Rake $0.03 | Jackpot $0 | Bingo $0 | Fortune $0
Board [Js 4s 7h]
Seat 1: Hero (button) folded before Flop (didn't bet)
Seat 2: a951861a (small blind) won ($0.67)
Seat 3: 253968a7 (big blind) folded on the Flop
Seat 4: 583bb900 folded before Flop (didn't bet)
Seat 5: 95d2128f folded before Flop (didn't bet)
Seat 6: 3e9216b5 folded before Flop (didn't bet)


Poker Hand #RC1459751737: Hold'em No Limit  ($0.05/$0.1) - 2023/04/08 19:09:57
Table 'RushAndCash3736997' 6-max Seat #1 is the button
Seat 1: f93472f3 ($16.71 in chips)
Seat 2: 4cda30a6 ($23.96 in chips)
Seat 3: Hero ($12.78 in chips)
Seat 4: b9edb257 ($6.5 in chips)
Seat 5: b3f91a41 ($10.22 in chips)
Seat 6: 39ffd2ac ($10 in chips)
4cda30a6: posts small blind $0.05
Hero: posts big blind $0.1
*** HOLE CARDS ***
Dealt to f93472f3 
Dealt to 4cda30a6 
Dealt to Hero [9c 3h]
Dealt to b9edb257 
Dealt to b3f91a41 
Dealt to 39ffd2ac 
b9edb257: folds
b3f91a41: folds
39ffd2ac: folds
f93472f3: folds
4cda30a6: raises $0.18 to $0.28
Hero: folds
Uncalled bet ($0.18) returned to 4cda30a6
*** SHOWDOWN ***
4cda30a6 collected $0.2 from pot
*** SUMMARY ***
Total pot $0.2 | Rake $0 | Jackpot $0 | Bingo $0 | Fortune $0
Seat 1: f93472f3 (button) folded before Flop (didn't bet)
Seat 2: 4cda30a6 (small blind) collected ($0.2)
Seat 3: Hero (big blind) folded before Flop
Seat 4: b9edb257 folded before Flop (didn't bet)
Seat 5: b3f91a41 folded before Flop (didn't bet)
Seat 6: 39ffd2ac folded before Flop (didn't bet)


Poker Hand #RC1459751635: Hold'em No Limit  ($0.05/$0.1) - 2023/04/08 19:09:43
Table 'RushAndCash3736895' 6-max Seat #1 is the button
Seat 1: ed2461d3 ($10.6 in chips)
Seat 2: Hero ($12.83 in chips)
Seat 3: c9b96e58 ($16.71 in chips)
Seat 4: ec57ad7a ($12.61 in chips)
Seat 5: 7d68864a ($10.47 in chips)
Seat 6: 650c2154 ($9.37 in chips)
Hero: posts small blind $0.05
c9b96e58: posts big blind $0.1
*** HOLE CARDS ***
Dealt to ed2461d3 
Dealt to Hero [4h 6h]
Dealt to c9b96e58 
Dealt to ec57ad7a 
Dealt to 7d68864a 
Dealt to 650c2154 
ec57ad7a: folds
7d68864a: folds
650c2154: folds
ed2461d3: raises $0.15 to $0.25
Hero: folds
c9b96e58: folds
Uncalled bet ($0.15) returned to ed2461d3
*** SHOWDOWN ***
ed2461d3 collected $0.25 from pot
*** SUMMARY ***
Total pot $0.25 | Rake $0 | Jackpot $0 | Bingo $0 | Fortune $0
Seat 1: ed2461d3 (button) collected ($0.25)
Seat 2: Hero (small blind) folded before Flop
Seat 3: c9b96e58 (big blind) folded before Flop
Seat 4: ec57ad7a folded before Flop (didn't bet)
Seat 5: 7d68864a folded before Flop (didn't bet)
Seat 6: 650c2154 folded before Flop (didn't bet)


Poker Hand #RC1459751449: Hold'em No Limit  ($0.05/$0.1) - 2023/04/08 19:09:15
Table 'RushAndCash3736709' 6-max Seat #1 is the button
Seat 1: 4451b644 ($11.64 in chips)
Seat 2: dbc96150 ($6.49 in chips)
Seat 3: 20e4e3ed ($10 in chips)
Seat 4: 7340f470 ($40.22 in chips)
Seat 5: Hero ($12.68 in chips)
Seat 6: 38c45073 ($22.05 in chips)
dbc96150: posts small blind $0.05
20e4e3ed: posts big blind $0.1
*** HOLE CARDS ***
Dealt to 4451b644 
Dealt to dbc96150 
Dealt to 20e4e3ed 
Dealt to 7340f470 
Dealt to Hero [6h 6s]
Dealt to 38c45073 
7340f470: folds
Hero: raises $0.15 to $0.25
38c45073: folds
4451b644: folds
dbc96150: folds
20e4e3ed: folds
Uncalled bet ($0.15) returned to Hero
*** SHOWDOWN ***
Hero collected $0.25 from pot
*** SUMMARY ***
Total pot $0.25 | Rake $0 | Jackpot $0 | Bingo $0 | Fortune $0
Seat 1: 4451b644 (button) folded before Flop (didn't bet)
Seat 2: dbc96150 (small blind) folded before Flop
Seat 3: 20e4e3ed (big blind) folded before Flop
Seat 4: 7340f470 folded before Flop (didn't bet)
Seat 5: Hero collected ($0.25)
Seat 6: 38c45073 folded before Flop (didn't bet)


Poker Hand #RC1459751421: Hold'em No Limit  ($0.05/$0.1) - 2023/04/08 19:09:11
Table 'RushAndCash3736681' 6-max Seat #1 is the button
Seat 1: 2bb1f524 ($10 in chips)
Seat 2: 4d185a91 ($10.26 in chips)
Seat 3: 4a759e88 ($10.15 in chips)
Seat 4: Hero ($12.68 in chips)
Seat 5: 1c6d6598 ($10 in chips)
Seat 6: baddceb ($12.24 in chips)
4d185a91: posts small blind $0.05
4a759e88: posts big blind $0.1
*** HOLE CARDS ***
Dealt to 2bb1f524 
Dealt to 4d185a91 
Dealt to 4a759e88 
Dealt to Hero [Js 7c]
Dealt to 1c6d6598 
Dealt to baddceb 
Hero: folds
1c6d6598: folds
baddceb: folds
2bb1f524: folds
4d185a91: raises $0.2 to $0.3
4a759e88: folds
Uncalled bet ($0.2) returned to 4d185a91
*** SHOWDOWN ***
4d185a91 collected $0.2 from pot
*** SUMMARY ***
Total pot $0.2 | Rake $0 | Jackpot $0 | Bingo $0 | Fortune $0
Seat 1: 2bb1f524 (button) folded before Flop (didn't bet)
Seat 2: 4d185a91 (small blind) collected ($0.2)
Seat 3: 4a759e88 (big blind) folded before Flop
Seat 4: Hero folded before Flop (didn't bet)
Seat 5: 1c6d6598 folded before Flop (didn't bet)
Seat 6: baddceb folded before Flop (didn't bet)


Poker Hand #RC1459751370: Hold'em No Limit  ($0.05/$0.1) - 2023/04/08 19:09:03
Table 'RushAndCash3736630' 6-max Seat #1 is the button
Seat 1: e918bbff ($10.15 in chips)
Seat 2: 264b4dc3 ($10.31 in chips)
Seat 3: ad402a2 ($12.38 in chips)
Seat 4: 8f56ac67 ($11.15 in chips)
Seat 5: Hero ($12.68 in chips)
Seat 6: 6c63fdd2 ($10 in chips)
264b4dc3: posts small blind $0.05
ad402a2: posts big blind $0.1
*** HOLE CARDS ***
Dealt to e918bbff 
Dealt to 264b4dc3 
Dealt to ad402a2 
Dealt to 8f56ac67 
Dealt to Hero [Th 6s]
Dealt to 6c63fdd2 
8f56ac67: folds
Hero: folds
6c63fdd2: folds
e918bbff: folds
264b4dc3: raises $0.18 to $0.28
ad402a2: raises $0.62 to $0.9
264b4dc3: folds
Uncalled bet ($0.62) returned to ad402a2
*** SHOWDOWN ***
ad402a2 collected $0.54 from pot
*** SUMMARY ***
Total pot $0.56 | Rake $0.02 | Jackpot $0 | Bingo $0 | Fortune $0
Seat 1: e918bbff (button) folded before Flop (didn't bet)
Seat 2: 264b4dc3 (small blind) folded before Flop
Seat 3: ad402a2 (big blind) collected ($0.54)
Seat 4: 8f56ac67 folded before Flop (didn't bet)
Seat 5: Hero folded before Flop (didn't bet)
Seat 6: 6c63fdd2 folded before Flop (didn't bet)


Poker Hand #RC1459751280: Hold'em No Limit  ($0.05/$0.1) - 2023/04/08 19:08:49
Table 'RushAndCash3736540' 6-max Seat #1 is the button
Seat 1: 1daf0faf ($15.16 in chips)
Seat 2: Hero ($12.73 in chips)
Seat 3: 7faf8c75 ($35.34 in chips)
Seat 4: f6ff3121 ($15.3 in chips)
Seat 5: ae582ec6 ($21.43 in chips)
Seat 6: 2cdc313d ($11.22 in chips)
Hero: posts small blind $0.05
7faf8c75: posts big blind $0.1
*** HOLE CARDS ***
Dealt to 1daf0faf 
Dealt to Hero [7s 5h]
Dealt to 7faf8c75 
Dealt to f6ff3121 
Dealt to ae582ec6 
Dealt to 2cdc313d 
f6ff3121: raises $0.15 to $0.25
ae582ec6: folds
2cdc313d: folds
1daf0faf: raises $0.65 to $0.9
Hero: folds
7faf8c75: folds
f6ff3121: calls $0.65
*** FLOP *** [Ts Qd 9s]
f6ff3121: checks
1daf0faf: bets $1.47
f6ff3121: calls $1.47
*** TURN *** [Ts Qd 9s] [3h]
f6ff3121: checks
1daf0faf: bets $3.67
f6ff3121: calls $3.67
*** RIVER *** [Ts Qd 9s 3h] [9d]
f6ff3121: checks
1daf0faf: checks
f6ff3121: shows [6s As] (Pair of Nines)
1daf0faf: shows [Ah Qs] (Pair of Queens and Pair of Nines)
*** SHOWDOWN ***
1daf0faf collected $11.78 from pot
*** SUMMARY ***
Total pot $12.23 | Rake $0.3 | Jackpot $0.15 | Bingo $0 | Fortune $0
Board [Ts Qd 9s 3h 9d]
Seat 1: 1daf0faf (button) showed [Ah Qs] and won ($11.78) with Pair of Queens and Pair of Nines
Seat 2: Hero (small blind) folded before Flop
Seat 3: 7faf8c75 (big blind) folded before Flop
Seat 4: f6ff3121 showed [6s As] and lost with Pair of Nines
Seat 5: ae582ec6 folded before Flop (didn't bet)
Seat 6: 2cdc313d folded before Flop (didn't bet)


Poker Hand #RC1459750799: Hold'em No Limit  ($0.05/$0.1) - 2023/04/08 19:07:40
Table 'RushAndCash3736059' 6-max Seat #1 is the button
Seat 1: 59aac686 ($10.82 in chips)
Seat 2: e86a6ab ($10.76 in chips)
Seat 3: Hero ($8.38 in chips)
Seat 4: 1e2bdbc1 ($9.92 in chips)
Seat 5: 5e20bab2 ($12.83 in chips)
Seat 6: 9c2c10d2 ($22.88 in chips)
e86a6ab: posts small blind $0.05
Hero: posts big blind $0.1
*** HOLE CARDS ***
Dealt to 59aac686 
Dealt to e86a6ab 
Dealt to Hero [7h As]
Dealt to 1e2bdbc1 
Dealt to 5e20bab2 
Dealt to 9c2c10d2 
1e2bdbc1: folds
5e20bab2: folds
9c2c10d2: folds
59aac686: folds
e86a6ab: raises $0.2 to $0.3
Hero: raises $0.5 to $0.8
e86a6ab: calls $0.5
*** FLOP *** [7c 4s Qd]
e86a6ab: checks
Hero: checks
*** TURN *** [7c 4s Qd] [8d]
e86a6ab: bets $1.2
Hero: calls $1.2
*** RIVER *** [7c 4s Qd 8d] [3c]
e86a6ab: bets $2.8
Hero: calls $2.8
e86a6ab: shows [Ac Th] (Ace-High)
Hero: shows [7h As] (Pair of Sevens)
*** SHOWDOWN ***
Hero collected $9.15 from pot
*** SUMMARY ***
Total pot $9.6 | Rake $0.3 | Jackpot $0.15 | Bingo $0 | Fortune $0
Board [7c 4s Qd 8d 3c]
Seat 1: 59aac686 (button) folded before Flop (didn't bet)
Seat 2: e86a6ab (small blind) showed [Ac Th] and lost with Ace-High
Seat 3: Hero (big blind) showed [7h As] and won ($9.15) with Pair of Sevens
Seat 4: 1e2bdbc1 folded before Flop (didn't bet)
Seat 5: 5e20bab2 folded before Flop (didn't bet)
Seat 6: 9c2c10d2 folded before Flop (didn't bet)


Poker Hand #RC1459750771: Hold'em No Limit  ($0.05/$0.1) - 2023/04/08 19:07:35
Table 'RushAndCash3736031' 6-max Seat #1 is the button
Seat 1: ae1a7250 ($10.81 in chips)
Seat 2: 99437e12 ($27.33 in chips)
Seat 3: eb3a6963 ($10.3 in chips)
Seat 4: b23b7076 ($10.73 in chips)
Seat 5: a0a596a7 ($36.56 in chips)
Seat 6: Hero ($8.38 in chips)
99437e12: posts small blind $0.05
eb3a6963: posts big blind $0.1
*** HOLE CARDS ***
Dealt to ae1a7250 
Dealt to 99437e12 
Dealt to eb3a6963 
Dealt to b23b7076 
Dealt to a0a596a7 
Dealt to Hero [8h 5h]
b23b7076: raises $0.15 to $0.25
a0a596a7: folds
Hero: folds
ae1a7250: calls $0.25
99437e12: folds
eb3a6963: calls $0.15
*** FLOP *** [3s Kd 2s]
eb3a6963: checks
b23b7076: bets $0.27
ae1a7250: calls $0.27
eb3a6963: folds
*** TURN *** [3s Kd 2s] [Qs]
b23b7076: checks
ae1a7250: checks
*** RIVER *** [3s Kd 2s Qs] [9h]
b23b7076: bets $0.45
ae1a7250: folds
Uncalled bet ($0.45) returned to b23b7076
*** SHOWDOWN ***
b23b7076 collected $1.28 from pot
*** SUMMARY ***
Total pot $1.34 | Rake $0.06 | Jackpot $0 | Bingo $0 | Fortune $0
Board [3s Kd 2s Qs 9h]
Seat 1: ae1a7250 (button) folded on the River
Seat 2: 99437e12 (small blind) folded before Flop
Seat 3: eb3a6963 (big blind) folded on the Flop
Seat 4: b23b7076 won ($1.28)
Seat 5: a0a596a7 folded before Flop (didn't bet)
Seat 6: Hero folded before Flop (didn't bet)


Poker Hand #RC1459750710: Hold'em No Limit  ($0.05/$0.1) - 2023/04/08 19:07:27
Table 'RushAndCash3735970' 6-max Seat #1 is the button
Seat 1: 6a138b47 ($12.93 in chips)
Seat 2: f9cffa95 ($20.31 in chips)
Seat 3: e0bfbef3 ($8.82 in chips)
Seat 4: 2f996d2d ($9.8 in chips)
Seat 5: Hero ($8.38 in chips)
Seat 6: c235e83c ($10 in chips)
f9cffa95: posts small blind $0.05
e0bfbef3: posts big blind $0.1
*** HOLE CARDS ***
Dealt to 6a138b47 
Dealt to f9cffa95 
Dealt to e0bfbef3 
Dealt to 2f996d2d 
Dealt to Hero [Kh 3d]
Dealt to c235e83c 
2f996d2d: folds
Hero: folds
c235e83c: folds
6a138b47: raises $0.1 to $0.2
f9cffa95: folds
e0bfbef3: folds
Uncalled bet ($0.1) returned to 6a138b47
*** SHOWDOWN ***
6a138b47 collected $0.25 from pot
*** SUMMARY ***
Total pot $0.25 | Rake $0 | Jackpot $0 | Bingo $0 | Fortune $0
Seat 1: 6a138b47 (button) collected ($0.25)
Seat 2: f9cffa95 (small blind) folded before Flop
Seat 3: e0bfbef3 (big blind) folded before Flop
Seat 4: 2f996d2d folded before Flop (didn't bet)
Seat 5: Hero folded before Flop (didn't bet)
Seat 6: c235e83c folded before Flop (didn't bet)


Poker Hand #RC1459750673: Hold'em No Limit  ($0.05/$0.1) - 2023/04/08 19:07:22
Table 'RushAndCash3735933' 6-max Seat #1 is the button
Seat 1: Hero ($8.38 in chips)
Seat 2: 8f56ac67 ($11.05 in chips)
Seat 3: 5078e668 ($13.13 in chips)
Seat 4: ca67fe73 ($12.29 in chips)
Seat 5: bbcf60cb ($10 in chips)
Seat 6: c56f5551 ($10.72 in chips)
8f56ac67: posts small blind $0.05
5078e668: posts big blind $0.1
*** HOLE CARDS ***
Dealt to Hero [Th 6h]
Dealt to 8f56ac67 
Dealt to 5078e668 
Dealt to ca67fe73 
Dealt to bbcf60cb 
Dealt to c56f5551 
ca67fe73: folds
bbcf60cb: folds
c56f5551: folds
Hero: folds
8f56ac67: folds
Uncalled bet ($0.05) returned to 5078e668
*** SHOWDOWN ***
5078e668 collected $0.1 from pot
*** SUMMARY ***
Total pot $0.1 | Rake $0 | Jackpot $0 | Bingo $0 | Fortune $0
Seat 1: Hero (button) folded before Flop (didn't bet)
Seat 2: 8f56ac67 (small blind) folded before Flop
Seat 3: 5078e668 (big blind) collected ($0.1)
Seat 4: ca67fe73 folded before Flop (didn't bet)
Seat 5: bbcf60cb folded before Flop (didn't bet)
Seat 6: c56f5551 folded before Flop (didn't bet)


Poker Hand #RC1459750637: Hold'em No Limit  ($0.05/$0.1) - 2023/04/08 19:07:16
Table 'RushAndCash3735897' 6-max Seat #1 is the button
Seat 1: 3486bea3 ($19.1 in chips)
Seat 2: 5d4ccf13 ($12.35 in chips)
Seat 3: 9692459d ($19.32 in chips)
Seat 4: fefe32df ($11.15 in chips)
Seat 5: 266d7d90 ($5.55 in chips)
Seat 6: Hero ($8.38 in chips)
5d4ccf13: posts small blind $0.05
9692459d: posts big blind $0.1
*** HOLE CARDS ***
Dealt to 3486bea3 
Dealt to 5d4ccf13 
Dealt to 9692459d 
Dealt to fefe32df 
Dealt to 266d7d90 
Dealt to Hero [8s 2s]
fefe32df: folds
266d7d90: folds
Hero: folds
3486bea3: folds
5d4ccf13: folds
Uncalled bet ($0.05) returned to 9692459d
*** SHOWDOWN ***
9692459d collected $0.1 from pot
*** SUMMARY ***
Total pot $0.1 | Rake $0 | Jackpot $0 | Bingo $0 | Fortune $0
Seat 1: 3486bea3 (button) folded before Flop (didn't bet)
Seat 2: 5d4ccf13 (small blind) folded before Flop
Seat 3: 9692459d (big blind) collected ($0.1)
Seat 4: fefe32df folded before Flop (didn't bet)
Seat 5: 266d7d90 folded before Flop (didn't bet)
Seat 6: Hero folded before Flop (didn't bet)


Poker Hand #RC1459750603: Hold'em No Limit  ($0.05/$0.1) - 2023/04/08 19:07:12
Table 'RushAndCash3735863' 6-max Seat #1 is the button
Seat 1: ff3e3866 ($14.93 in chips)
Seat 2: 23acc691 ($14.53 in chips)
Seat 3: Hero ($8.48 in chips)
Seat 4: 3edd334f ($38.27 in chips)
Seat 5: 991623b5 ($10.77 in chips)
Seat 6: 1904434e ($7.42 in chips)
23acc691: posts small blind $0.05
Hero: posts big blind $0.1
*** HOLE CARDS ***
Dealt to ff3e3866 
Dealt to 23acc691 
Dealt to Hero [8c 9h]
Dealt to 3edd334f 
Dealt to 991623b5 
Dealt to 1904434e 
3edd334f: folds
991623b5: folds
1904434e: raises $0.2 to $0.3
ff3e3866: folds
23acc691: folds
Hero: folds
Uncalled bet ($0.2) returned to 1904434e
*** SHOWDOWN ***
1904434e collected $0.25 from pot
*** SUMMARY ***
Total pot $0.25 | Rake $0 | Jackpot $0 | Bingo $0 | Fortune $0
Seat 1: ff3e3866 (button) folded before Flop (didn't bet)
Seat 2: 23acc691 (small blind) folded before Flop
Seat 3: Hero (big blind) folded before Flop
Seat 4: 3edd334f folded before Flop (didn't bet)
Seat 5: 991623b5 folded before Flop (didn't bet)
Seat 6: 1904434e collected ($0.25)


Poker Hand #RC1459750570: Hold'em No Limit  ($0.05/$0.1) - 2023/04/08 19:07:07
Table 'RushAndCash3735830' 6-max Seat #1 is the button
Seat 1: Hero ($8.48 in chips)
Seat 2: 895e867c ($34.59 in chips)
Seat 3: 99724f70 ($4.04 in chips)
Seat 4: 637a1fd7 ($2.59 in chips)
Seat 5: c9b96e58 ($17.56 in chips)
Seat 6: ff3e3866 ($14.93 in chips)
895e867c: posts small blind $0.05
99724f70: posts big blind $0.1
*** HOLE CARDS ***
Dealt to Hero [2h 5c]
Dealt to 895e867c 
Dealt to 99724f70 
Dealt to 637a1fd7 
Dealt to c9b96e58 
Dealt to ff3e3866 
637a1fd7: folds
c9b96e58: raises $0.15 to $0.25
ff3e3866: folds
Hero: folds
895e867c: folds
99724f70: folds
Uncalled bet ($0.15) returned to c9b96e58
*** SHOWDOWN ***
c9b96e58 collected $0.25 from pot
*** SUMMARY ***
Total pot $0.25 | Rake $0 | Jackpot $0 | Bingo $0 | Fortune $0
Seat 1: Hero (button) folded before Flop (didn't bet)
Seat 2: 895e867c (small blind) folded before Flop
Seat 3: 99724f70 (big blind) folded before Flop
Seat 4: 637a1fd7 folded before Flop (didn't bet)
Seat 5: c9b96e58 collected ($0.25)
Seat 6: ff3e3866 folded before Flop (didn't bet)


Poker Hand #RC1459750380: Hold'em No Limit  ($0.05/$0.1) - 2023/04/08 19:06:42
Table 'RushAndCash3735640' 6-max Seat #1 is the button
Seat 1: 637a1fd7 ($2.92 in chips)
Seat 2: Hero ($8.08 in chips)
Seat 3: f4b98f78 ($22.11 in chips)
Seat 4: 23f2aa4c ($10 in chips)
Seat 5: 5a63579c ($22.35 in chips)
Seat 6: 556685d2 ($29.98 in chips)
Hero: posts small blind $0.05
f4b98f78: posts big blind $0.1
*** HOLE CARDS ***
Dealt to 637a1fd7 
Dealt to Hero [8c 7c]
Dealt to f4b98f78 
Dealt to 23f2aa4c 
Dealt to 5a63579c 
Dealt to 556685d2 
23f2aa4c: folds
5a63579c: folds
556685d2: folds
637a1fd7: calls $0.1
Hero: raises $0.23 to $0.33
f4b98f78: folds
637a1fd7: calls $0.23
*** FLOP *** [6h Ac 4d]
Hero: bets $0.31
637a1fd7: folds
Uncalled bet ($0.31) returned to Hero
*** SHOWDOWN ***
Hero collected $0.73 from pot
*** SUMMARY ***
Total pot $0.76 | Rake $0.03 | Jackpot $0 | Bingo $0 | Fortune $0
Board [6h Ac 4d]
Seat 1: 637a1fd7 (button) folded on the Flop
Seat 2: Hero (small blind) won ($0.73)
Seat 3: f4b98f78 (big blind) folded before Flop
Seat 4: 23f2aa4c folded before Flop (didn't bet)
Seat 5: 5a63579c folded before Flop (didn't bet)
Seat 6: 556685d2 folded before Flop (didn't bet)


Poker Hand #RC1459750344: Hold'em No Limit  ($0.05/$0.1) - 2023/04/08 19:06:38
Table 'RushAndCash3735604' 6-max Seat #1 is the button
Seat 1: ccc8505d ($10.19 in chips)
Seat 2: eaf57a38 ($38.14 in chips)
Seat 3: 1fabed60 ($16.83 in chips)
Seat 4: Hero ($8.08 in chips)
Seat 5: 161da14b ($13.8 in chips)
Seat 6: 99724f70 ($3.71 in chips)
eaf57a38: posts small blind $0.05
1fabed60: posts big blind $0.1
*** HOLE CARDS ***
Dealt to ccc8505d 
Dealt to eaf57a38 
Dealt to 1fabed60 
Dealt to Hero [7h 3s]
Dealt to 161da14b 
Dealt to 99724f70 
Hero: folds
161da14b: raises $0.1 to $0.2
99724f70: calls $0.2
ccc8505d: folds
eaf57a38: folds
1fabed60: folds
*** FLOP *** [8d 2c 5d]
161da14b: checks
99724f70: bets $0.28
161da14b: folds
Uncalled bet ($0.28) returned to 99724f70
*** SHOWDOWN ***
99724f70 collected $0.53 from pot
*** SUMMARY ***
Total pot $0.55 | Rake $0.02 | Jackpot $0 | Bingo $0 | Fortune $0
Board [8d 2c 5d]
Seat 1: ccc8505d (button) folded before Flop (didn't bet)
Seat 2: eaf57a38 (small blind) folded before Flop
Seat 3: 1fabed60 (big blind) folded before Flop
Seat 4: Hero folded before Flop (didn't bet)
Seat 5: 161da14b folded on the Flop
Seat 6: 99724f70 won ($0.53)


Poker Hand #RC1459750314: Hold'em No Limit  ($0.05/$0.1) - 2023/04/08 19:06:32
Table 'RushAndCash3735574' 6-max Seat #1 is the button
Seat 1: deb24db5 ($23.83 in chips)
Seat 2: Hero ($8.13 in chips)
Seat 3: 48717c47 ($7.9 in chips)
Seat 4: d0b73ea6 ($14.18 in chips)
Seat 5: b635d82c ($10.25 in chips)
Seat 6: a2d4518a ($11.23 in chips)
Hero: posts small blind $0.05
48717c47: posts big blind $0.1
*** HOLE CARDS ***
Dealt to deb24db5 
Dealt to Hero [2h 6s]
Dealt to 48717c47 
Dealt to d0b73ea6 
Dealt to b635d82c 
Dealt to a2d4518a 
d0b73ea6: folds
b635d82c: folds
a2d4518a: folds
deb24db5: folds
Hero: folds
Uncalled bet ($0.05) returned to 48717c47
*** SHOWDOWN ***
48717c47 collected $0.1 from pot
*** SUMMARY ***
Total pot $0.1 | Rake $0 | Jackpot $0 | Bingo $0 | Fortune $0
Seat 1: deb24db5 (button) folded before Flop (didn't bet)
Seat 2: Hero (small blind) folded before Flop
Seat 3: 48717c47 (big blind) collected ($0.1)
Seat 4: d0b73ea6 folded before Flop (didn't bet)
Seat 5: b635d82c folded before Flop (didn't bet)
Seat 6: a2d4518a folded before Flop (didn't bet)


Poker Hand #RC1459750273: Hold'em No Limit  ($0.05/$0.1) - 2023/04/08 19:06:26
Table 'RushAndCash3735533' 6-max Seat #1 is the button
Seat 1: de61cff8 ($10.07 in chips)
Seat 2: 9e1f8b69 ($11.08 in chips)
Seat 3: 4a759e88 ($10.37 in chips)
Seat 4: 777c2e5c ($10 in chips)
Seat 5: Hero ($8.13 in chips)
Seat 6: f2785f73 ($44.38 in chips)
9e1f8b69: posts small blind $0.05
4a759e88: posts big blind $0.1
*** HOLE CARDS ***
Dealt to de61cff8 
Dealt to 9e1f8b69 
Dealt to 4a759e88 
Dealt to 777c2e5c 
Dealt to Hero [8c 7d]
Dealt to f2785f73 
777c2e5c: folds
Hero: folds
f2785f73: raises $0.15 to $0.25
de61cff8: folds
9e1f8b69: folds
4a759e88: folds
Uncalled bet ($0.15) returned to f2785f73
*** SHOWDOWN ***
f2785f73 collected $0.25 from pot
*** SUMMARY ***
Total pot $0.25 | Rake $0 | Jackpot $0 | Bingo $0 | Fortune $0
Seat 1: de61cff8 (button) folded before Flop (didn't bet)
Seat 2: 9e1f8b69 (small blind) folded before Flop
Seat 3: 4a759e88 (big blind) folded before Flop
Seat 4: 777c2e5c folded before Flop (didn't bet)
Seat 5: Hero folded before Flop (didn't bet)
Seat 6: f2785f73 collected ($0.25)


Poker Hand #RC1459749833: Hold'em No Limit  ($0.05/$0.1) - 2023/04/08 19:05:23
Table 'RushAndCash3735093' 6-max Seat #1 is the button
Seat 1: 33b86f0b ($21.42 in chips)
Seat 2: ad685734 ($10.24 in chips)
Seat 3: 9e1f8b69 ($10 in chips)
Seat 4: Hero ($9.27 in chips)
Seat 5: f429fef4 ($23.76 in chips)
Seat 6: de61cff8 ($10.22 in chips)
ad685734: posts small blind $0.05
9e1f8b69: posts big blind $0.1
*** HOLE CARDS ***
Dealt to 33b86f0b 
Dealt to ad685734 
Dealt to 9e1f8b69 
Dealt to Hero [Qd Ac]
Dealt to f429fef4 
Dealt to de61cff8 
Hero: raises $0.15 to $0.25
f429fef4: folds
de61cff8: folds
33b86f0b: folds
ad685734: folds
9e1f8b69: calls $0.15
*** FLOP *** [3s 3h 3c]
9e1f8b69: checks
Hero: bets $0.19
9e1f8b69: calls $0.19
*** TURN *** [3s 3h 3c] [Th]
9e1f8b69: checks
Hero: checks
*** RIVER *** [3s 3h 3c Th] [4c]
9e1f8b69: bets $0.7
Hero: calls $0.7
9e1f8b69: shows [Tc Jc] (Treys Full over Tens)
Hero: shows [Qd Ac] (Three Treys)
*** SHOWDOWN ***
9e1f8b69 collected $2.22 from pot
*** SUMMARY ***
Total pot $2.33 | Rake $0.11 | Jackpot $0 | Bingo $0 | Fortune $0
Board [3s 3h 3c Th 4c]
Seat 1: 33b86f0b (button) folded before Flop (didn't bet)
Seat 2: ad685734 (small blind) folded before Flop
Seat 3: 9e1f8b69 (big blind) showed [Tc Jc] and won ($2.22) with Treys Full over Tens
Seat 4: Hero showed [Qd Ac] and lost with Three Treys
Seat 5: f429fef4 folded before Flop (didn't bet)
Seat 6: de61cff8 folded before Flop (didn't bet)


Poker Hand #RC1459749181: Hold'em No Limit  ($0.05/$0.1) - 2023/04/08 19:03:50
Table 'RushAndCash3734441' 6-max Seat #1 is the button
Seat 1: Hero ($7.91 in chips)
Seat 2: 2ddfd374 ($10.88 in chips)
Seat 3: 7037da16 ($16.65 in chips)
Seat 4: f25b6422 ($21.03 in chips)
Seat 5: 4a8c7660 ($16.68 in chips)
Seat 6: d90c0be1 ($10.47 in chips)
2ddfd374: posts small blind $0.05
7037da16: posts big blind $0.1
*** HOLE CARDS ***
Dealt to Hero [7c 7s]
Dealt to 2ddfd374 
Dealt to 7037da16 
Dealt to f25b6422 
Dealt to 4a8c7660 
Dealt to d90c0be1 
f25b6422: folds
4a8c7660: folds
d90c0be1: raises $0.2 to $0.3
Hero: calls $0.3
2ddfd374: folds
7037da16: folds
*** FLOP *** [Ts 4h 3s]
d90c0be1: bets $0.48
Hero: calls $0.48
*** TURN *** [Ts 4h 3s] [Ac]
d90c0be1: bets $0.57
Hero: calls $0.57
*** RIVER *** [Ts 4h 3s Ac] [7h]
d90c0be1: checks
Hero: bets $1.43
d90c0be1: folds
Uncalled bet ($1.43) returned to Hero
*** SHOWDOWN ***
Hero collected $2.71 from pot
*** SUMMARY ***
Total pot $2.85 | Rake $0.14 | Jackpot $0 | Bingo $0 | Fortune $0
Board [Ts 4h 3s Ac 7h]
Seat 1: Hero (button) won ($2.71)
Seat 2: 2ddfd374 (small blind) folded before Flop
Seat 3: 7037da16 (big blind) folded before Flop
Seat 4: f25b6422 folded before Flop (didn't bet)
Seat 5: 4a8c7660 folded before Flop (didn't bet)
Seat 6: d90c0be1 folded on the River


Poker Hand #RC1459749110: Hold'em No Limit  ($0.05/$0.1) - 2023/04/08 19:03:41
Table 'RushAndCash3734370' 6-max Seat #1 is the button
Seat 1: 38860ce5 ($36.68 in chips)
Seat 2: 46aaf475 ($10 in chips)
Seat 3: Hero ($7.86 in chips)
Seat 4: 978ff711 ($10.89 in chips)
Seat 5: b6746050 ($82.74 in chips)
Seat 6: 28514d8f ($10 in chips)
46aaf475: posts small blind $0.05
Hero: posts big blind $0.1
*** HOLE CARDS ***
Dealt to 38860ce5 
Dealt to 46aaf475 
Dealt to Hero [Ah Jc]
Dealt to 978ff711 
Dealt to b6746050 
Dealt to 28514d8f 
978ff711: folds
b6746050: folds
28514d8f: folds
38860ce5: folds
46aaf475: folds
Uncalled bet ($0.05) returned to Hero
*** SHOWDOWN ***
Hero collected $0.1 from pot
*** SUMMARY ***
Total pot $0.1 | Rake $0 | Jackpot $0 | Bingo $0 | Fortune $0
Seat 1: 38860ce5 (button) folded before Flop (didn't bet)
Seat 2: 46aaf475 (small blind) folded before Flop
Seat 3: Hero (big blind) collected ($0.1)
Seat 4: 978ff711 folded before Flop (didn't bet)
Seat 5: b6746050 folded before Flop (didn't bet)
Seat 6: 28514d8f folded before Flop (didn't bet)


Poker Hand #RC1459749021: Hold'em No Limit  ($0.05/$0.1) - 2023/04/08 19:03:29
Table 'RushAndCash3734281' 6-max Seat #1 is the button
Seat 1: 8389c69a ($10.34 in chips)
Seat 2: 23f2aa4c ($11.24 in chips)
Seat 3: 2a17f3d6 ($16.76 in chips)
Seat 4: df441de2 ($10 in chips)
Seat 5: 5e20bab2 ($12.88 in chips)
Seat 6: Hero ($7.86 in chips)
23f2aa4c: posts small blind $0.05
2a17f3d6: posts big blind $0.1
*** HOLE CARDS ***
Dealt to 8389c69a 
Dealt to 23f2aa4c 
Dealt to 2a17f3d6 
Dealt to df441de2 
Dealt to 5e20bab2 
Dealt to Hero [3c Qc]
df441de2: folds
5e20bab2: raises $0.1 to $0.2
Hero: folds
8389c69a: folds
23f2aa4c: folds
2a17f3d6: calls $0.1
*** FLOP *** [8d 2d 6s]
2a17f3d6: checks
5e20bab2: bets $0.15
2a17f3d6: calls $0.15
*** TURN *** [8d 2d 6s] [Td]
2a17f3d6: checks
5e20bab2: checks
*** RIVER *** [8d 2d 6s Td] [Ad]
2a17f3d6: bets $0.25
5e20bab2: folds
Uncalled bet ($0.25) returned to 2a17f3d6
*** SHOWDOWN ***
2a17f3d6 collected $0.72 from pot
*** SUMMARY ***
Total pot $0.75 | Rake $0.03 | Jackpot $0 | Bingo $0 | Fortune $0
Board [8d 2d 6s Td Ad]
Seat 1: 8389c69a (button) folded before Flop (didn't bet)
Seat 2: 23f2aa4c (small blind) folded before Flop
Seat 3: 2a17f3d6 (big blind) won ($0.72)
Seat 4: df441de2 folded before Flop (didn't bet)
Seat 5: 5e20bab2 folded on the River
Seat 6: Hero folded before Flop (didn't bet)


Poker Hand #RC1459748976: Hold'em No Limit  ($0.05/$0.1) - 2023/04/08 19:03:22
Table 'RushAndCash3734236' 6-max Seat #1 is the button
Seat 1: b83483a7 ($37.77 in chips)
Seat 2: f0be966 ($26.22 in chips)
Seat 3: eb3a6963 ($10.49 in chips)
Seat 4: f6c84855 ($10.05 in chips)
Seat 5: Hero ($7.86 in chips)
Seat 6: dbd47281 ($13.81 in chips)
f0be966: posts small blind $0.05
eb3a6963: posts big blind $0.1
*** HOLE CARDS ***
Dealt to b83483a7 
Dealt to f0be966 
Dealt to eb3a6963 
Dealt to f6c84855 
Dealt to Hero [6s Jh]
Dealt to dbd47281 
f6c84855: raises $0.2 to $0.3
Hero: folds
dbd47281: folds
b83483a7: folds
f0be966: folds
eb3a6963: folds
Uncalled bet ($0.2) returned to f6c84855
*** SHOWDOWN ***
f6c84855 collected $0.25 from pot
*** SUMMARY ***
Total pot $0.25 | Rake $0 | Jackpot $0 | Bingo $0 | Fortune $0
Seat 1: b83483a7 (button) folded before Flop (didn't bet)
Seat 2: f0be966 (small blind) folded before Flop
Seat 3: eb3a6963 (big blind) folded before Flop
Seat 4: f6c84855 collected ($0.25)
Seat 5: Hero folded before Flop (didn't bet)
Seat 6: dbd47281 folded before Flop (didn't bet)


Poker Hand #RC1459748927: Hold'em No Limit  ($0.05/$0.1) - 2023/04/08 19:03:16
Table 'RushAndCash3734187' 6-max Seat #1 is the button
Seat 1: 6959ceb5 ($13.02 in chips)
Seat 2: 7340f470 ($22.62 in chips)
Seat 3: d4642ec9 ($16.9 in chips)
Seat 4: 78b5efe ($18.33 in chips)
Seat 5: Hero ($7.86 in chips)
Seat 6: 749c96f7 ($5.03 in chips)
7340f470: posts small blind $0.05
d4642ec9: posts big blind $0.1
*** HOLE CARDS ***
Dealt to 6959ceb5 
Dealt to 7340f470 
Dealt to d4642ec9 
Dealt to 78b5efe 
Dealt to Hero [Th 9d]
Dealt to 749c96f7 
78b5efe: folds
Hero: folds
749c96f7: folds
6959ceb5: folds
7340f470: folds
Uncalled bet ($0.05) returned to d4642ec9
*** SHOWDOWN ***
d4642ec9 collected $0.1 from pot
*** SUMMARY ***
Total pot $0.1 | Rake $0 | Jackpot $0 | Bingo $0 | Fortune $0
Seat 1: 6959ceb5 (button) folded before Flop (didn't bet)
Seat 2: 7340f470 (small blind) folded before Flop
Seat 3: d4642ec9 (big blind) collected ($0.1)
Seat 4: 78b5efe folded before Flop (didn't bet)
Seat 5: Hero folded before Flop (didn't bet)
Seat 6: 749c96f7 folded before Flop (didn't bet)


Poker Hand #RC1459748836: Hold'em No Limit  ($0.05/$0.1) - 2023/04/08 19:03:05
Table 'RushAndCash3734096' 6-max Seat #1 is the button
Seat 1: 49f14ae6 ($10.22 in chips)
Seat 2: Hero ($7.91 in chips)
Seat 3: 5fb1c534 ($9.93 in chips)
Seat 4: 9a235145 ($54.18 in chips)
Seat 5: 92a48d51 ($9.79 in chips)
Seat 6: 1c763e5f ($20.29 in chips)
Hero: posts small blind $0.05
5fb1c534: posts big blind $0.1
*** HOLE CARDS ***
Dealt to 49f14ae6 
Dealt to Hero [Jc Td]
Dealt to 5fb1c534 
Dealt to 9a235145 
Dealt to 92a48d51 
Dealt to 1c763e5f 
9a235145: folds
92a48d51: folds
1c763e5f: raises $0.15 to $0.25
49f14ae6: folds
Hero: folds
5fb1c534: calls $0.15
*** FLOP *** [Jd Ah Qh]
5fb1c534: checks
1c763e5f: bets $0.19
5fb1c534: calls $0.19
*** TURN *** [Jd Ah Qh] [Th]
5fb1c534: checks
1c763e5f: checks
*** RIVER *** [Jd Ah Qh Th] [4d]
5fb1c534: checks
1c763e5f: checks
5fb1c534: shows [6c As] (Pair of Aces)
1c763e5f: shows [7d 7h] (Pair of Sevens)
*** SHOWDOWN ***
5fb1c534 collected $0.89 from pot
*** SUMMARY ***
Total pot $0.93 | Rake $0.04 | Jackpot $0 | Bingo $0 | Fortune $0
Board [Jd Ah Qh Th 4d]
Seat 1: 49f14ae6 (button) folded before Flop (didn't bet)
Seat 2: Hero (small blind) folded before Flop
Seat 3: 5fb1c534 (big blind) showed [6c As] and won ($0.89) with Pair of Aces
Seat 4: 9a235145 folded before Flop (didn't bet)
Seat 5: 92a48d51 folded before Flop (didn't bet)
Seat 6: 1c763e5f showed [7d 7h] and lost with Pair of Sevens


Poker Hand #RC1459748636: Hold'em No Limit  ($0.05/$0.1) - 2023/04/08 19:02:39
Table 'RushAndCash3733896' 6-max Seat #1 is the button
Seat 1: Hero ($8.16 in chips)
Seat 2: 25e9a9fe ($10.68 in chips)
Seat 3: 92a48d51 ($9.51 in chips)
Seat 4: e414f212 ($30.9 in chips)
Seat 5: 41208841 ($13.4 in chips)
Seat 6: ad5f2e40 ($9.93 in chips)
25e9a9fe: posts small blind $0.05
92a48d51: posts big blind $0.1
*** HOLE CARDS ***
Dealt to Hero [Kh 9h]
Dealt to 25e9a9fe 
Dealt to 92a48d51 
Dealt to e414f212 
Dealt to 41208841 
Dealt to ad5f2e40 
e414f212: folds
41208841: folds
ad5f2e40: folds
Hero: raises $0.15 to $0.25
25e9a9fe: folds
92a48d51: raises $0.75 to $1
Hero: folds
Uncalled bet ($0.75) returned to 92a48d51
*** SHOWDOWN ***
92a48d51 collected $0.53 from pot
*** SUMMARY ***
Total pot $0.55 | Rake $0.02 | Jackpot $0 | Bingo $0 | Fortune $0
Seat 1: Hero (button) folded before Flop
Seat 2: 25e9a9fe (small blind) folded before Flop
Seat 3: 92a48d51 (big blind) collected ($0.53)
Seat 4: e414f212 folded before Flop (didn't bet)
Seat 5: 41208841 folded before Flop (didn't bet)
Seat 6: ad5f2e40 folded before Flop (didn't bet)


Poker Hand #RC1459748163: Hold'em No Limit  ($0.05/$0.1) - 2023/04/08 19:01:33
Table 'RushAndCash3733423' 6-max Seat #1 is the button
Seat 1: 92a48d51 ($10.21 in chips)
Seat 2: 34567ffa ($13.88 in chips)
Seat 3: Hero ($7.48 in chips)
Seat 4: bf9dc4c2 ($31.82 in chips)
Seat 5: 2ddfd374 ($9.3 in chips)
Seat 6: 25abf568 ($11.5 in chips)
34567ffa: posts small blind $0.05
Hero: posts big blind $0.1
*** HOLE CARDS ***
Dealt to 92a48d51 
Dealt to 34567ffa 
Dealt to Hero [Th Jd]
Dealt to bf9dc4c2 
Dealt to 2ddfd374 
Dealt to 25abf568 
bf9dc4c2: folds
2ddfd374: folds
25abf568: folds
92a48d51: raises $0.2 to $0.3
34567ffa: folds
Hero: calls $0.2
*** FLOP *** [Ts 9s 9h]
Hero: checks
92a48d51: bets $0.4
Hero: calls $0.4
*** TURN *** [Ts 9s 9h] [Tc]
Hero: checks
92a48d51: checks
*** RIVER *** [Ts 9s 9h Tc] [2h]
Hero: checks
92a48d51: checks
Hero: shows [Th Jd] (Tens Full over Nines)
92a48d51: shows [Js 8s] (Pair of Tens and Pair of Nines)
*** SHOWDOWN ***
Hero collected $1.38 from pot
*** SUMMARY ***
Total pot $1.45 | Rake $0.07 | Jackpot $0 | Bingo $0 | Fortune $0
Board [Ts 9s 9h Tc 2h]
Seat 1: 92a48d51 (button) showed [Js 8s] and lost with Pair of Tens and Pair of Nines
Seat 2: 34567ffa (small blind) folded before Flop
Seat 3: Hero (big blind) showed [Th Jd] and won ($1.38) with Tens Full over Nines
Seat 4: bf9dc4c2 folded before Flop (didn't bet)
Seat 5: 2ddfd374 folded before Flop (didn't bet)
Seat 6: 25abf568 folded before Flop (didn't bet)


Poker Hand #RC1459748125: Hold'em No Limit  ($0.05/$0.1) - 2023/04/08 19:01:28
Table 'RushAndCash3733385' 6-max Seat #1 is the button
Seat 1: ad8fef19 ($10.71 in chips)
Seat 2: 1e3a92e6 ($11.11 in chips)
Seat 3: 9692459d ($20.41 in chips)
Seat 4: f6f523c1 ($13.36 in chips)
Seat 5: 573a43d6 ($11.58 in chips)
Seat 6: Hero ($7.48 in chips)
1e3a92e6: posts small blind $0.05
9692459d: posts big blind $0.1
*** HOLE CARDS ***
Dealt to ad8fef19 
Dealt to 1e3a92e6 
Dealt to 9692459d 
Dealt to f6f523c1 
Dealt to 573a43d6 
Dealt to Hero [2s 7c]
f6f523c1: folds
573a43d6: raises $0.15 to $0.25
Hero: folds
ad8fef19: folds
1e3a92e6: folds
9692459d: folds
Uncalled bet ($0.15) returned to 573a43d6
*** SHOWDOWN ***
573a43d6 collected $0.25 from pot
*** SUMMARY ***
Total pot $0.25 | Rake $0 | Jackpot $0 | Bingo $0 | Fortune $0
Seat 1: ad8fef19 (button) folded before Flop (didn't bet)
Seat 2: 1e3a92e6 (small blind) folded before Flop
Seat 3: 9692459d (big blind) folded before Flop
Seat 4: f6f523c1 folded before Flop (didn't bet)
Seat 5: 573a43d6 collected ($0.25)
Seat 6: Hero folded before Flop (didn't bet)


Poker Hand #RC1459748090: Hold'em No Limit  ($0.05/$0.1) - 2023/04/08 19:01:23
Table 'RushAndCash3733350' 6-max Seat #1 is the button
Seat 1: af2ee96d ($6.6 in chips)
Seat 2: f6f523c1 ($13.41 in chips)
Seat 3: 11ef0c8 ($10.79 in chips)
Seat 4: 8e94c650 ($12.86 in chips)
Seat 5: 13c97bf5 ($10.52 in chips)
Seat 6: Hero ($7.48 in chips)
f6f523c1: posts small blind $0.05
11ef0c8: posts big blind $0.1
*** HOLE CARDS ***
Dealt to af2ee96d 
Dealt to f6f523c1 
Dealt to 11ef0c8 
Dealt to 8e94c650 
Dealt to 13c97bf5 
Dealt to Hero [9d Jh]
8e94c650: raises $0.1 to $0.2
13c97bf5: folds
Hero: folds
af2ee96d: folds
f6f523c1: folds
11ef0c8: folds
Uncalled bet ($0.1) returned to 8e94c650
*** SHOWDOWN ***
8e94c650 collected $0.25 from pot
*** SUMMARY ***
Total pot $0.25 | Rake $0 | Jackpot $0 | Bingo $0 | Fortune $0
Seat 1: af2ee96d (button) folded before Flop (didn't bet)
Seat 2: f6f523c1 (small blind) folded before Flop
Seat 3: 11ef0c8 (big blind) folded before Flop
Seat 4: 8e94c650 collected ($0.25)
Seat 5: 13c97bf5 folded before Flop (didn't bet)
Seat 6: Hero folded before Flop (didn't bet)


Poker Hand #RC1459748031: Hold'em No Limit  ($0.05/$0.1) - 2023/04/08 19:01:15
Table 'RushAndCash3733291' 6-max Seat #1 is the button
Seat 1: 8e334265 ($73.23 in chips)
Seat 2: Hero ($7.53 in chips)
Seat 3: 95866cb2 ($19.83 in chips)
Seat 4: 5d10c340 ($11.68 in chips)
Seat 5: 4b43eee ($10 in chips)
Seat 6: 4519596f ($10 in chips)
Hero: posts small blind $0.05
95866cb2: posts big blind $0.1
*** HOLE CARDS ***
Dealt to 8e334265 
Dealt to Hero [Qh 7d]
Dealt to 95866cb2 
Dealt to 5d10c340 
Dealt to 4b43eee 
Dealt to 4519596f 
5d10c340: calls $0.1
4b43eee: folds
4519596f: folds
8e334265: folds
Hero: folds
95866cb2: checks
*** FLOP *** [9h 8h Qs]
95866cb2: checks
5d10c340: bets $0.13
95866cb2: calls $0.13
*** TURN *** [9h 8h Qs] [5s]
95866cb2: checks
5d10c340: checks
*** RIVER *** [9h 8h Qs 5s] [Kc]
95866cb2: checks
5d10c340: checks
95866cb2: shows [Qd 3d] (Pair of Queens)
5d10c340: shows [5h 3h] (Pair of Fives)
*** SHOWDOWN ***
95866cb2 collected $0.49 from pot
*** SUMMARY ***
Total pot $0.51 | Rake $0.02 | Jackpot $0 | Bingo $0 | Fortune $0
Board [9h 8h Qs 5s Kc]
Seat 1: 8e334265 (button) folded before Flop (didn't bet)
Seat 2: Hero (small blind) folded before Flop
Seat 3: 95866cb2 (big blind) showed [Qd 3d] and won ($0.49) with Pair of Queens
Seat 4: 5d10c340 showed [5h 3h] and lost with Pair of Fives
Seat 5: 4b43eee folded before Flop (didn't bet)
Seat 6: 4519596f folded before Flop (didn't bet)


Poker Hand #RC1459747909: Hold'em No Limit  ($0.05/$0.1) - 2023/04/08 19:00:59
Table 'RushAndCash3733169' 6-max Seat #1 is the button
Seat 1: 3acdf15 ($11.98 in chips)
Seat 2: 819c6d72 ($9.64 in chips)
Seat 3: Hero ($7.63 in chips)
Seat 4: 94b6df17 ($10.94 in chips)
Seat 5: 933aeb35 ($45.89 in chips)
Seat 6: 898c27ab ($22.6 in chips)
819c6d72: posts small blind $0.05
Hero: posts big blind $0.1
*** HOLE CARDS ***
Dealt to 3acdf15 
Dealt to 819c6d72 
Dealt to Hero [4d Js]
Dealt to 94b6df17 
Dealt to 933aeb35 
Dealt to 898c27ab 
94b6df17: folds
933aeb35: raises $0.2 to $0.3
898c27ab: calls $0.3
3acdf15: folds
819c6d72: calls $0.25
Hero: folds
*** FLOP *** [6c 9h 3s]
819c6d72: checks
933aeb35: bets $0.25
898c27ab: calls $0.25
819c6d72: folds
*** TURN *** [6c 9h 3s] [6d]
933aeb35: checks
898c27ab: bets $0.75
933aeb35: calls $0.75
*** RIVER *** [6c 9h 3s 6d] [Qd]
933aeb35: checks
898c27ab: checks
933aeb35: shows [9c Ac] (Pair of Nines and Pair of Sixes)
898c27ab: shows [7s 7c] (Pair of Sevens and Pair of Sixes)
*** SHOWDOWN ***
933aeb35 collected $2.71 from pot
*** SUMMARY ***
Total pot $3 | Rake $0.14 | Jackpot $0.15 | Bingo $0 | Fortune $0
Board [6c 9h 3s 6d Qd]
Seat 1: 3acdf15 (button) folded before Flop (didn't bet)
Seat 2: 819c6d72 (small blind) folded on the Flop
Seat 3: Hero (big blind) folded before Flop
Seat 4: 94b6df17 folded before Flop (didn't bet)
Seat 5: 933aeb35 showed [9c Ac] and won ($2.71) with Pair of Nines and Pair of Sixes
Seat 6: 898c27ab showed [7s 7c] and lost with Pair of Sevens and Pair of Sixes


Poker Hand #RC1459747814: Hold'em No Limit  ($0.05/$0.1) - 2023/04/08 19:00:46
Table 'RushAndCash3733074' 6-max Seat #1 is the button
Seat 1: Hero ($7.63 in chips)
Seat 2: 5bbf6d6e ($10.45 in chips)
Seat 3: baa8ee47 ($10.72 in chips)
Seat 4: 30db0348 ($10 in chips)
Seat 5: 80783716 ($8.7 in chips)
Seat 6: 52acc5fe ($10.65 in chips)
5bbf6d6e: posts small blind $0.05
baa8ee47: posts big blind $0.1
*** HOLE CARDS ***
Dealt to Hero [3s Th]
Dealt to 5bbf6d6e 
Dealt to baa8ee47 
Dealt to 30db0348 
Dealt to 80783716 
Dealt to 52acc5fe 
30db0348: raises $0.12 to $0.22
80783716: folds
52acc5fe: folds
Hero: folds
5bbf6d6e: folds
baa8ee47: folds
Uncalled bet ($0.12) returned to 30db0348
*** SHOWDOWN ***
30db0348 collected $0.25 from pot
*** SUMMARY ***
Total pot $0.25 | Rake $0 | Jackpot $0 | Bingo $0 | Fortune $0
Seat 1: Hero (button) folded before Flop (didn't bet)
Seat 2: 5bbf6d6e (small blind) folded before Flop
Seat 3: baa8ee47 (big blind) folded before Flop
Seat 4: 30db0348 collected ($0.25)
Seat 5: 80783716 folded before Flop (didn't bet)
Seat 6: 52acc5fe folded before Flop (didn't bet)


Poker Hand #RC1459747777: Hold'em No Limit  ($0.05/$0.1) - 2023/04/08 19:00:41
Table 'RushAndCash3733037' 6-max Seat #1 is the button
Seat 1: ad5f2e40 ($7.83 in chips)
Seat 2: e86a6ab ($10.14 in chips)
Seat 3: dc525443 ($17.76 in chips)
Seat 4: Hero ($7.63 in chips)
Seat 5: f9cffa95 ($20.86 in chips)
Seat 6: c25184f9 ($7.51 in chips)
e86a6ab: posts small blind $0.05
dc525443: posts big blind $0.1
*** HOLE CARDS ***
Dealt to ad5f2e40 
Dealt to e86a6ab 
Dealt to dc525443 
Dealt to Hero [As 4h]
Dealt to f9cffa95 
Dealt to c25184f9 
Hero: folds
f9cffa95: raises $0.15 to $0.25
c25184f9: folds
ad5f2e40: folds
e86a6ab: folds
dc525443: folds
Uncalled bet ($0.15) returned to f9cffa95
*** SHOWDOWN ***
f9cffa95 collected $0.25 from pot
*** SUMMARY ***
Total pot $0.25 | Rake $0 | Jackpot $0 | Bingo $0 | Fortune $0
Seat 1: ad5f2e40 (button) folded before Flop (didn't bet)
Seat 2: e86a6ab (small blind) folded before Flop
Seat 3: dc525443 (big blind) folded before Flop
Seat 4: Hero folded before Flop (didn't bet)
Seat 5: f9cffa95 collected ($0.25)
Seat 6: c25184f9 folded before Flop (didn't bet)


Poker Hand #RC1459747737: Hold'em No Limit  ($0.05/$0.1) - 2023/04/08 19:00:35
Table 'RushAndCash3732997' 6-max Seat #1 is the button
Seat 1: f6bd6db7 ($12.2 in chips)
Seat 2: ab173843 ($13.75 in chips)
Seat 3: 54f59ada ($18.29 in chips)
Seat 4: 4fc360e5 ($26.05 in chips)
Seat 5: a742d7a2 ($25.63 in chips)
Seat 6: Hero ($7.63 in chips)
ab173843: posts small blind $0.05
54f59ada: posts big blind $0.1
*** HOLE CARDS ***
Dealt to f6bd6db7 
Dealt to ab173843 
Dealt to 54f59ada 
Dealt to 4fc360e5 
Dealt to a742d7a2 
Dealt to Hero [4s Kc]
4fc360e5: folds
a742d7a2: raises $0.15 to $0.25
Hero: folds
f6bd6db7: calls $0.25
ab173843: folds
54f59ada: folds
*** FLOP *** [2d Jc 6s]
a742d7a2: bets $0.35
f6bd6db7: calls $0.35
*** TURN *** [2d Jc 6s] [Ac]
a742d7a2: checks
f6bd6db7: checks
*** RIVER *** [2d Jc 6s Ac] [7h]
a742d7a2: checks
f6bd6db7: bets $0.68
a742d7a2: calls $0.68
f6bd6db7: shows [Ks Js] (Pair of Jacks)
a742d7a2: shows [Qh Jh] (Pair of Jacks)
*** SHOWDOWN ***
f6bd6db7 collected $2.58 from pot
*** SUMMARY ***
Total pot $2.71 | Rake $0.13 | Jackpot $0 | Bingo $0 | Fortune $0
Board [2d Jc 6s Ac 7h]
Seat 1: f6bd6db7 (button) showed [Ks Js] and won ($2.58) with Pair of Jacks
Seat 2: ab173843 (small blind) folded before Flop
Seat 3: 54f59ada (big blind) folded before Flop
Seat 4: 4fc360e5 folded before Flop (didn't bet)
Seat 5: a742d7a2 showed [Qh Jh] and lost with Pair of Jacks
Seat 6: Hero folded before Flop (didn't bet)


Poker Hand #RC1459747701: Hold'em No Limit  ($0.05/$0.1) - 2023/04/08 19:00:30
Table 'RushAndCash3732961' 6-max Seat #1 is the button
Seat 1: 83fce378 ($46.1 in chips)
Seat 2: 3f764cd1 ($4.02 in chips)
Seat 3: 723338d9 ($10 in chips)
Seat 4: Hero ($7.63 in chips)
Seat 5: 1e3a92e6 ($11.16 in chips)
Seat 6: fa1722a8 ($18.2 in chips)
3f764cd1: posts small blind $0.05
723338d9: posts big blind $0.1
*** HOLE CARDS ***
Dealt to 83fce378 
Dealt to 3f764cd1 
Dealt to 723338d9 
Dealt to Hero [Tc Qd]
Dealt to 1e3a92e6 
Dealt to fa1722a8 
Hero: folds
1e3a92e6: folds
fa1722a8: folds
83fce378: folds
3f764cd1: folds
Uncalled bet ($0.05) returned to 723338d9
*** SHOWDOWN ***
723338d9 collected $0.1 from pot
*** SUMMARY ***
Total pot $0.1 | Rake $0 | Jackpot $0 | Bingo $0 | Fortune $0
Seat 1: 83fce378 (button) folded before Flop (didn't bet)
Seat 2: 3f764cd1 (small blind) folded before Flop
Seat 3: 723338d9 (big blind) collected ($0.1)
Seat 4: Hero folded before Flop (didn't bet)
Seat 5: 1e3a92e6 folded before Flop (didn't bet)
Seat 6: fa1722a8 folded before Flop (didn't bet)


Poker Hand #RC1459747666: Hold'em No Limit  ($0.05/$0.1) - 2023/04/08 19:00:24
Table 'RushAndCash3732926' 6-max Seat #1 is the button
Seat 1: baa8ee47 ($10.72 in chips)
Seat 2: c9b96e58 ($11.74 in chips)
Seat 3: c9e32a1d ($9.7 in chips)
Seat 4: 3610c1a3 ($43.62 in chips)
Seat 5: Hero ($7.63 in chips)
Seat 6: b6746050 ($81.17 in chips)
c9b96e58: posts small blind $0.05
c9e32a1d: posts big blind $0.1
*** HOLE CARDS ***
Dealt to baa8ee47 
Dealt to c9b96e58 
Dealt to c9e32a1d 
Dealt to 3610c1a3 
Dealt to Hero [3c Th]
Dealt to b6746050 
3610c1a3: folds
Hero: folds
b6746050: raises $0.15 to $0.25
baa8ee47: folds
c9b96e58: folds
c9e32a1d: folds
Uncalled bet ($0.15) returned to b6746050
*** SHOWDOWN ***
b6746050 collected $0.25 from pot
*** SUMMARY ***
Total pot $0.25 | Rake $0 | Jackpot $0 | Bingo $0 | Fortune $0
Seat 1: baa8ee47 (button) folded before Flop (didn't bet)
Seat 2: c9b96e58 (small blind) folded before Flop
Seat 3: c9e32a1d (big blind) folded before Flop
Seat 4: 3610c1a3 folded before Flop (didn't bet)
Seat 5: Hero folded before Flop (didn't bet)
Seat 6: b6746050 collected ($0.25)


Poker Hand #RC1459747565: Hold'em No Limit  ($0.05/$0.1) - 2023/04/08 19:00:10
Table 'RushAndCash3732825' 6-max Seat #1 is the button
Seat 1: Hero ($7.48 in chips)
Seat 2: 39acc71d ($11.25 in chips)
Seat 3: bee41a8b ($9.8 in chips)
Seat 4: 433c725d ($10.61 in chips)
Seat 5: dd51b60a ($15.63 in chips)
Seat 6: d12b384c ($14.79 in chips)
39acc71d: posts small blind $0.05
bee41a8b: posts big blind $0.1
*** HOLE CARDS ***
Dealt to Hero [Th Qc]
Dealt to 39acc71d 
Dealt to bee41a8b 
Dealt to 433c725d 
Dealt to dd51b60a 
Dealt to d12b384c 
433c725d: folds
dd51b60a: folds
d12b384c: folds
Hero: raises $0.15 to $0.25
39acc71d: folds
bee41a8b: folds
Uncalled bet ($0.15) returned to Hero
*** SHOWDOWN ***
Hero collected $0.25 from pot
*** SUMMARY ***
Total pot $0.25 | Rake $0 | Jackpot $0 | Bingo $0 | Fortune $0
Seat 1: Hero (button) collected ($0.25)
Seat 2: 39acc71d (small blind) folded before Flop
Seat 3: bee41a8b (big blind) folded before Flop
Seat 4: 433c725d folded before Flop (didn't bet)
Seat 5: dd51b60a folded before Flop (didn't bet)
Seat 6: d12b384c folded before Flop (didn't bet)


Poker Hand #RC1459747528: Hold'em No Limit  ($0.05/$0.1) - 2023/04/08 19:00:06
Table 'RushAndCash3732788' 6-max Seat #1 is the button
Seat 1: 8c816db8 ($10 in chips)
Seat 2: a3163bbd ($10 in chips)
Seat 3: Hero ($7.58 in chips)
Seat 4: d5e7e96 ($26.14 in chips)
Seat 5: 39acc71d ($11.25 in chips)
Seat 6: 17dfcb7c ($9.5 in chips)
a3163bbd: posts small blind $0.05
Hero: posts big blind $0.1
*** HOLE CARDS ***
Dealt to 8c816db8 
Dealt to a3163bbd 
Dealt to Hero [2s 4d]
Dealt to d5e7e96 
Dealt to 39acc71d 
Dealt to 17dfcb7c 
d5e7e96: folds
39acc71d: folds
17dfcb7c: folds
8c816db8: folds
a3163bbd: raises $0.2 to $0.3
Hero: folds
Uncalled bet ($0.2) returned to a3163bbd
*** SHOWDOWN ***
a3163bbd collected $0.2 from pot
*** SUMMARY ***
Total pot $0.2 | Rake $0 | Jackpot $0 | Bingo $0 | Fortune $0
Seat 1: 8c816db8 (button) folded before Flop (didn't bet)
Seat 2: a3163bbd (small blind) collected ($0.2)
Seat 3: Hero (big blind) folded before Flop
Seat 4: d5e7e96 folded before Flop (didn't bet)
Seat 5: 39acc71d folded before Flop (didn't bet)
Seat 6: 17dfcb7c folded before Flop (didn't bet)


Poker Hand #RC1459747484: Hold'em No Limit  ($0.05/$0.1) - 2023/04/08 19:00:00
Table 'RushAndCash3732744' 6-max Seat #1 is the button
Seat 1: 380ac1ef ($13.68 in chips)
Seat 2: Hero ($7.63 in chips)
Seat 3: d57685a7 ($5.59 in chips)
Seat 4: 9894759a ($20.99 in chips)
Seat 5: 8beae1b7 ($10 in chips)
Seat 6: 68ffc847 ($11.02 in chips)
Hero: posts small blind $0.05
d57685a7: posts big blind $0.1
*** HOLE CARDS ***
Dealt to 380ac1ef 
Dealt to Hero [Js 4h]
Dealt to d57685a7 
Dealt to 9894759a 
Dealt to 8beae1b7 
Dealt to 68ffc847 
9894759a: folds
8beae1b7: folds
68ffc847: raises $0.1 to $0.2
380ac1ef: raises $0.5 to $0.7
Hero: folds
d57685a7: folds
68ffc847: calls $0.5
*** FLOP *** [Qc 9s Jd]
68ffc847: checks
380ac1ef: bets $0.52
68ffc847: calls $0.52
*** TURN *** [Qc 9s Jd] [3s]
68ffc847: bets $1.5
380ac1ef: folds
Uncalled bet ($1.5) returned to 68ffc847
*** SHOWDOWN ***
68ffc847 collected $2.46 from pot
*** SUMMARY ***
Total pot $2.59 | Rake $0.13 | Jackpot $0 | Bingo $0 | Fortune $0
Board [Qc 9s Jd 3s]
Seat 1: 380ac1ef (button) folded on the Turn
Seat 2: Hero (small blind) folded before Flop
Seat 3: d57685a7 (big blind) folded before Flop
Seat 4: 9894759a folded before Flop (didn't bet)
Seat 5: 8beae1b7 folded before Flop (didn't bet)
Seat 6: 68ffc847 won ($2.46)


Poker Hand #RC1459747373: Hold'em No Limit  ($0.05/$0.1) - 2023/04/08 18:59:46
Table 'RushAndCash3732633' 6-max Seat #1 is the button
Seat 1: 7981963d ($11.01 in chips)
Seat 2: 25bcf459 ($11.64 in chips)
Seat 3: 53974721 ($24.24 in chips)
Seat 4: Hero ($7.63 in chips)
Seat 5: a546356d ($16.25 in chips)
Seat 6: 1409c15 ($22.47 in chips)
25bcf459: posts small blind $0.05
53974721: posts big blind $0.1
*** HOLE CARDS ***
Dealt to 7981963d 
Dealt to 25bcf459 
Dealt to 53974721 
Dealt to Hero [5c 9h]
Dealt to a546356d 
Dealt to 1409c15 
Hero: folds
a546356d: folds
1409c15: folds
7981963d: raises $0.1 to $0.2
25bcf459: folds
53974721: folds
Uncalled bet ($0.1) returned to 7981963d
*** SHOWDOWN ***
7981963d collected $0.25 from pot
*** SUMMARY ***
Total pot $0.25 | Rake $0 | Jackpot $0 | Bingo $0 | Fortune $0
Seat 1: 7981963d (button) collected ($0.25)
Seat 2: 25bcf459 (small blind) folded before Flop
Seat 3: 53974721 (big blind) folded before Flop
Seat 4: Hero folded before Flop (didn't bet)
Seat 5: a546356d folded before Flop (didn't bet)
Seat 6: 1409c15 folded before Flop (didn't bet)


Poker Hand #RC1459747252: Hold'em No Limit  ($0.05/$0.1) - 2023/04/08 18:59:29
Table 'RushAndCash3732512' 6-max Seat #1 is the button
Seat 1: 49da03d9 ($16.66 in chips)
Seat 2: eb1dfdf ($18.27 in chips)
Seat 3: 59aac686 ($10 in chips)
Seat 4: 9e7be7ac ($10.09 in chips)
Seat 5: Hero ($7.63 in chips)
Seat 6: b5896cd4 ($19.93 in chips)
eb1dfdf: posts small blind $0.05
59aac686: posts big blind $0.1
*** HOLE CARDS ***
Dealt to 49da03d9 
Dealt to eb1dfdf 
Dealt to 59aac686 
Dealt to 9e7be7ac 
Dealt to Hero [9h 2c]
Dealt to b5896cd4 
9e7be7ac: folds
Hero: folds
b5896cd4: folds
49da03d9: folds
eb1dfdf: raises $0.2 to $0.3
59aac686: folds
Uncalled bet ($0.2) returned to eb1dfdf
*** SHOWDOWN ***
eb1dfdf collected $0.2 from pot
*** SUMMARY ***
Total pot $0.2 | Rake $0 | Jackpot $0 | Bingo $0 | Fortune $0
Seat 1: 49da03d9 (button) folded before Flop (didn't bet)
Seat 2: eb1dfdf (small blind) collected ($0.2)
Seat 3: 59aac686 (big blind) folded before Flop
Seat 4: 9e7be7ac folded before Flop (didn't bet)
Seat 5: Hero folded before Flop (didn't bet)
Seat 6: b5896cd4 folded before Flop (didn't bet)


Poker Hand #RC1459746716: Hold'em No Limit  ($0.05/$0.1) - 2023/04/08 18:58:21
Table 'RushAndCash3731976' 6-max Seat #1 is the button
Seat 1: c3c0fb7f ($10.45 in chips)
Seat 2: 10f053f3 ($8.73 in chips)
Seat 3: eb1dfdf ($18.52 in chips)
Seat 4: Hero ($7.35 in chips)
Seat 5: 2eadf610 ($10.84 in chips)
Seat 6: df441de2 ($10 in chips)
10f053f3: posts small blind $0.05
eb1dfdf: posts big blind $0.1
*** HOLE CARDS ***
Dealt to c3c0fb7f 
Dealt to 10f053f3 
Dealt to eb1dfdf 
Dealt to Hero [6d 7d]
Dealt to 2eadf610 
Dealt to df441de2 
Hero: raises $0.15 to $0.25
2eadf610: folds
df441de2: folds
c3c0fb7f: folds
10f053f3: folds
eb1dfdf: calls $0.15
*** FLOP *** [9h Tc Kh]
eb1dfdf: checks
Hero: checks
*** TURN *** [9h Tc Kh] [Ad]
eb1dfdf: checks
Hero: checks
*** RIVER *** [9h Tc Kh Ad] [8c]
eb1dfdf: checks
Hero: bets $0.42
eb1dfdf: folds
Uncalled bet ($0.42) returned to Hero
*** SHOWDOWN ***
Hero collected $0.53 from pot
*** SUMMARY ***
Total pot $0.55 | Rake $0.02 | Jackpot $0 | Bingo $0 | Fortune $0
Board [9h Tc Kh Ad 8c]
Seat 1: c3c0fb7f (button) folded before Flop (didn't bet)
Seat 2: 10f053f3 (small blind) folded before Flop
Seat 3: eb1dfdf (big blind) folded on the River
Seat 4: Hero won ($0.53)
Seat 5: 2eadf610 folded before Flop (didn't bet)
Seat 6: df441de2 folded before Flop (didn't bet)


Poker Hand #RC1459746665: Hold'em No Limit  ($0.05/$0.1) - 2023/04/08 18:58:16
Table 'RushAndCash3731925' 6-max Seat #1 is the button
Seat 1: df441de2 ($10 in chips)
Seat 2: Hero ($7.4 in chips)
Seat 3: 8a8bce3 ($20.04 in chips)
Seat 4: 1c763e5f ($24.75 in chips)
Seat 5: 7a054253 ($4.95 in chips)
Seat 6: 3edd334f ($36.43 in chips)
Hero: posts small blind $0.05
8a8bce3: posts big blind $0.1
*** HOLE CARDS ***
Dealt to df441de2 
Dealt to Hero [Ks 7h]
Dealt to 8a8bce3 
Dealt to 1c763e5f 
Dealt to 7a054253 
Dealt to 3edd334f 
1c763e5f: folds
7a054253: raises $0.2 to $0.3
3edd334f: folds
df441de2: folds
Hero: folds
8a8bce3: folds
Uncalled bet ($0.2) returned to 7a054253
*** SHOWDOWN ***
7a054253 collected $0.25 from pot
*** SUMMARY ***
Total pot $0.25 | Rake $0 | Jackpot $0 | Bingo $0 | Fortune $0
Seat 1: df441de2 (button) folded before Flop (didn't bet)
Seat 2: Hero (small blind) folded before Flop
Seat 3: 8a8bce3 (big blind) folded before Flop
Seat 4: 1c763e5f folded before Flop (didn't bet)
Seat 5: 7a054253 collected ($0.25)
Seat 6: 3edd334f folded before Flop (didn't bet)


Poker Hand #RC1459746610: Hold'em No Limit  ($0.05/$0.1) - 2023/04/08 18:58:07
Table 'RushAndCash3731870' 6-max Seat #1 is the button
Seat 1: Hero ($7.4 in chips)
Seat 2: 90e23308 ($10.18 in chips)
Seat 3: fff78e2 ($17.75 in chips)
Seat 4: 13c97bf5 ($12.38 in chips)
Seat 5: 3edd334f ($36.43 in chips)
Seat 6: bbba4529 ($12.26 in chips)
90e23308: posts small blind $0.05
fff78e2: posts big blind $0.1
*** HOLE CARDS ***
Dealt to Hero [9c 5d]
Dealt to 90e23308 
Dealt to fff78e2 
Dealt to 13c97bf5 
Dealt to 3edd334f 
Dealt to bbba4529 
13c97bf5: folds
3edd334f: folds
bbba4529: raises $0.15 to $0.25
Hero: folds
90e23308: folds
fff78e2: folds
Uncalled bet ($0.15) returned to bbba4529
*** SHOWDOWN ***
bbba4529 collected $0.25 from pot
*** SUMMARY ***
Total pot $0.25 | Rake $0 | Jackpot $0 | Bingo $0 | Fortune $0
Seat 1: Hero (button) folded before Flop (didn't bet)
Seat 2: 90e23308 (small blind) folded before Flop
Seat 3: fff78e2 (big blind) folded before Flop
Seat 4: 13c97bf5 folded before Flop (didn't bet)
Seat 5: 3edd334f folded before Flop (didn't bet)
Seat 6: bbba4529 collected ($0.25)


Poker Hand #RC1459746128: Hold'em No Limit  ($0.05/$0.1) - 2023/04/08 18:57:03
Table 'RushAndCash3731388' 6-max Seat #1 is the button
Seat 1: 96b23dd8 ($10 in chips)
Seat 2: 3f89ec2f ($11.11 in chips)
Seat 3: Hero ($6.87 in chips)
Seat 4: baddceb ($10 in chips)
Seat 5: 561f91cc ($14.94 in chips)
Seat 6: 35a10c37 ($7.83 in chips)
3f89ec2f: posts small blind $0.05
Hero: posts big blind $0.1
*** HOLE CARDS ***
Dealt to 96b23dd8 
Dealt to 3f89ec2f 
Dealt to Hero [Kh Ts]
Dealt to baddceb 
Dealt to 561f91cc 
Dealt to 35a10c37 
baddceb: folds
561f91cc: folds
35a10c37: folds
96b23dd8: raises $0.15 to $0.25
3f89ec2f: folds
Hero: calls $0.15
*** FLOP *** [Qs Tc Jc]
Hero: checks
96b23dd8: bets $0.28
Hero: calls $0.28
*** TURN *** [Qs Tc Jc] [2h]
Hero: checks
96b23dd8: checks
*** RIVER *** [Qs Tc Jc 2h] [Qd]
Hero: checks
96b23dd8: checks
Hero: shows [Kh Ts] (Pair of Queens and Pair of Tens)
96b23dd8: shows [8h Ad] (Pair of Queens)
*** SHOWDOWN ***
Hero collected $1.06 from pot
*** SUMMARY ***
Total pot $1.11 | Rake $0.05 | Jackpot $0 | Bingo $0 | Fortune $0
Board [Qs Tc Jc 2h Qd]
Seat 1: 96b23dd8 (button) showed [8h Ad] and lost with Pair of Queens
Seat 2: 3f89ec2f (small blind) folded before Flop
Seat 3: Hero (big blind) showed [Kh Ts] and won ($1.06) with Pair of Queens and Pair of Tens
Seat 4: baddceb folded before Flop (didn't bet)
Seat 5: 561f91cc folded before Flop (didn't bet)
Seat 6: 35a10c37 folded before Flop (didn't bet)


Poker Hand #RC1459746064: Hold'em No Limit  ($0.05/$0.1) - 2023/04/08 18:56:56
Table 'RushAndCash3731324' 6-max Seat #1 is the button
Seat 1: 7cf4a7e ($4.61 in chips)
Seat 2: 49da03d9 ($17.61 in chips)
Seat 3: e97cd73a ($13.4 in chips)
Seat 4: ad402a2 ($13.71 in chips)
Seat 5: 32eaf87d ($13.06 in chips)
Seat 6: Hero ($6.87 in chips)
49da03d9: posts small blind $0.05
e97cd73a: posts big blind $0.1
*** HOLE CARDS ***
Dealt to 7cf4a7e 
Dealt to 49da03d9 
Dealt to e97cd73a 
Dealt to ad402a2 
Dealt to 32eaf87d 
Dealt to Hero [3h 9s]
ad402a2: raises $0.1 to $0.2
32eaf87d: folds
Hero: folds
7cf4a7e: folds
49da03d9: folds
e97cd73a: folds
Uncalled bet ($0.1) returned to ad402a2
*** SHOWDOWN ***
ad402a2 collected $0.25 from pot
*** SUMMARY ***
Total pot $0.25 | Rake $0 | Jackpot $0 | Bingo $0 | Fortune $0
Seat 1: 7cf4a7e (button) folded before Flop (didn't bet)
Seat 2: 49da03d9 (small blind) folded before Flop
Seat 3: e97cd73a (big blind) folded before Flop
Seat 4: ad402a2 collected ($0.25)
Seat 5: 32eaf87d folded before Flop (didn't bet)
Seat 6: Hero folded before Flop (didn't bet)


Poker Hand #RC1459745928: Hold'em No Limit  ($0.05/$0.1) - 2023/04/08 18:56:36
Table 'RushAndCash3731188' 6-max Seat #1 is the button
Seat 1: c59bc4d5 ($10.7 in chips)
Seat 2: 3cb0c429 ($12.13 in chips)
Seat 3: a0a596a7 ($23.45 in chips)
Seat 4: 5b870df8 ($10.76 in chips)
Seat 5: Hero ($6.72 in chips)
Seat 6: 6473b70b ($5 in chips)
3cb0c429: posts small blind $0.05
a0a596a7: posts big blind $0.1
*** HOLE CARDS ***
Dealt to c59bc4d5 
Dealt to 3cb0c429 
Dealt to a0a596a7 
Dealt to 5b870df8 
Dealt to Hero [9s Js]
Dealt to 6473b70b 
5b870df8: folds
Hero: raises $0.15 to $0.25
6473b70b: folds
c59bc4d5: folds
3cb0c429: folds
a0a596a7: folds
Uncalled bet ($0.15) returned to Hero
*** SHOWDOWN ***
Hero collected $0.25 from pot
*** SUMMARY ***
Total pot $0.25 | Rake $0 | Jackpot $0 | Bingo $0 | Fortune $0
Seat 1: c59bc4d5 (button) folded before Flop (didn't bet)
Seat 2: 3cb0c429 (small blind) folded before Flop
Seat 3: a0a596a7 (big blind) folded before Flop
Seat 4: 5b870df8 folded before Flop (didn't bet)
Seat 5: Hero collected ($0.25)
Seat 6: 6473b70b folded before Flop (didn't bet)


Poker Hand #RC1459745494: Hold'em No Limit  ($0.05/$0.1) - 2023/04/08 18:55:41
Table 'RushAndCash3730754' 6-max Seat #1 is the button
Seat 1: 15ec50c7 ($10.84 in chips)
Seat 2: ca34ebc2 ($10 in chips)
Seat 3: 3cb0c429 ($10 in chips)
Seat 4: 1c6d6598 ($10 in chips)
Seat 5: Hero ($8.92 in chips)
Seat 6: 5bbf6d6e ($11.88 in chips)
ca34ebc2: posts small blind $0.05
3cb0c429: posts big blind $0.1
*** HOLE CARDS ***
Dealt to 15ec50c7 
Dealt to ca34ebc2 
Dealt to 3cb0c429 
Dealt to 1c6d6598 
Dealt to Hero [Qh Qd]
Dealt to 5bbf6d6e 
1c6d6598: raises $0.15 to $0.25
Hero: raises $0.54 to $0.79
5bbf6d6e: folds
15ec50c7: folds
ca34ebc2: folds
3cb0c429: raises $1.41 to $2.2
1c6d6598: folds
Hero: calls $1.41
*** FLOP *** [7s 6h Kh]
3cb0c429: bets $3.53
Hero: folds
Uncalled bet ($3.53) returned to 3cb0c429
3cb0c429: shows [Ac Kc] (Pair of Kings)
*** SHOWDOWN ***
3cb0c429 collected $4.33 from pot
*** SUMMARY ***
Total pot $4.7 | Rake $0.22 | Jackpot $0.15 | Bingo $0 | Fortune $0
Board [7s 6h Kh]
Seat 1: 15ec50c7 (button) folded before Flop (didn't bet)
Seat 2: ca34ebc2 (small blind) folded before Flop
Seat 3: 3cb0c429 (big blind) showed [Ac Kc] and won ($4.33) with Pair of Kings
Seat 4: 1c6d6598 folded before Flop
Seat 5: Hero folded on the Flop
Seat 6: 5bbf6d6e folded before Flop (didn't bet)


Poker Hand #RC1459745422: Hold'em No Limit  ($0.05/$0.1) - 2023/04/08 18:55:31
Table 'RushAndCash3730682' 6-max Seat #1 is the button
Seat 1: Hero ($8.92 in chips)
Seat 2: bbcf60cb ($10 in chips)
Seat 3: 3acdf15 ($13.26 in chips)
Seat 4: d9b8a67d ($11.32 in chips)
Seat 5: 54dcb36b ($17.86 in chips)
Seat 6: b8ec3090 ($28.73 in chips)
bbcf60cb: posts small blind $0.05
3acdf15: posts big blind $0.1
*** HOLE CARDS ***
Dealt to Hero [7c Kh]
Dealt to bbcf60cb 
Dealt to 3acdf15 
Dealt to d9b8a67d 
Dealt to 54dcb36b 
Dealt to b8ec3090 
d9b8a67d: folds
54dcb36b: folds
b8ec3090: raises $0.15 to $0.25
Hero: folds
bbcf60cb: folds
3acdf15: folds
Uncalled bet ($0.15) returned to b8ec3090
*** SHOWDOWN ***
b8ec3090 collected $0.25 from pot
*** SUMMARY ***
Total pot $0.25 | Rake $0 | Jackpot $0 | Bingo $0 | Fortune $0
Seat 1: Hero (button) folded before Flop (didn't bet)
Seat 2: bbcf60cb (small blind) folded before Flop
Seat 3: 3acdf15 (big blind) folded before Flop
Seat 4: d9b8a67d folded before Flop (didn't bet)
Seat 5: 54dcb36b folded before Flop (didn't bet)
Seat 6: b8ec3090 collected ($0.25)


Poker Hand #RC1459745328: Hold'em No Limit  ($0.05/$0.1) - 2023/04/08 18:55:20
Table 'RushAndCash3730588' 6-max Seat #1 is the button
Seat 1: ab94ecab ($13.81 in chips)
Seat 2: Hero ($8.97 in chips)
Seat 3: fbe231eb ($10.05 in chips)
Seat 4: 81f21357 ($28.52 in chips)
Seat 5: 8064075d ($11.95 in chips)
Seat 6: 979ebe36 ($11.7 in chips)
Hero: posts small blind $0.05
fbe231eb: posts big blind $0.1
*** HOLE CARDS ***
Dealt to ab94ecab 
Dealt to Hero [Jh 5d]
Dealt to fbe231eb 
Dealt to 81f21357 
Dealt to 8064075d 
Dealt to 979ebe36 
81f21357: raises $0.15 to $0.25
8064075d: folds
979ebe36: folds
ab94ecab: folds
Hero: folds
fbe231eb: folds
Uncalled bet ($0.15) returned to 81f21357
*** SHOWDOWN ***
81f21357 collected $0.25 from pot
*** SUMMARY ***
Total pot $0.25 | Rake $0 | Jackpot $0 | Bingo $0 | Fortune $0
Seat 1: ab94ecab (button) folded before Flop (didn't bet)
Seat 2: Hero (small blind) folded before Flop
Seat 3: fbe231eb (big blind) folded before Flop
Seat 4: 81f21357 collected ($0.25)
Seat 5: 8064075d folded before Flop (didn't bet)
Seat 6: 979ebe36 folded before Flop (didn't bet)


Poker Hand #RC1459745156: Hold'em No Limit  ($0.05/$0.1) - 2023/04/08 18:54:59
Table 'RushAndCash3730416' 6-max Seat #1 is the button
Seat 1: 70758680 ($18.17 in chips)
Seat 2: 54f59ada ($17.15 in chips)
Seat 3: Hero ($9.07 in chips)
Seat 4: c204d95e ($27.96 in chips)
Seat 5: d0a25f19 ($14 in chips)
Seat 6: 556685d2 ($30.39 in chips)
54f59ada: posts small blind $0.05
Hero: posts big blind $0.1
*** HOLE CARDS ***
Dealt to 70758680 
Dealt to 54f59ada 
Dealt to Hero [4c Th]
Dealt to c204d95e 
Dealt to d0a25f19 
Dealt to 556685d2 
c204d95e: folds
d0a25f19: folds
556685d2: folds
70758680: raises $0.15 to $0.25
54f59ada: folds
Hero: folds
Uncalled bet ($0.15) returned to 70758680
*** SHOWDOWN ***
70758680 collected $0.25 from pot
*** SUMMARY ***
Total pot $0.25 | Rake $0 | Jackpot $0 | Bingo $0 | Fortune $0
Seat 1: 70758680 (button) collected ($0.25)
Seat 2: 54f59ada (small blind) folded before Flop
Seat 3: Hero (big blind) folded before Flop
Seat 4: c204d95e folded before Flop (didn't bet)
Seat 5: d0a25f19 folded before Flop (didn't bet)
Seat 6: 556685d2 folded before Flop (didn't bet)


Poker Hand #RC1459745108: Hold'em No Limit  ($0.05/$0.1) - 2023/04/08 18:54:52
Table 'RushAndCash3730368' 6-max Seat #1 is the button
Seat 1: 94b6df17 ($11.34 in chips)
Seat 2: 8cd27809 ($10.42 in chips)
Seat 3: 3aa4de79 ($26.85 in chips)
Seat 4: 2ee0b364 ($17.73 in chips)
Seat 5: 179d97ea ($10 in chips)
Seat 6: Hero ($9.07 in chips)
8cd27809: posts small blind $0.05
3aa4de79: posts big blind $0.1
*** HOLE CARDS ***
Dealt to 94b6df17 
Dealt to 8cd27809 
Dealt to 3aa4de79 
Dealt to 2ee0b364 
Dealt to 179d97ea 
Dealt to Hero [8h Qc]
2ee0b364: raises $0.2 to $0.3
179d97ea: folds
Hero: folds
94b6df17: folds
8cd27809: calls $0.25
3aa4de79: folds
*** FLOP *** [9c Kd 7d]
8cd27809: checks
2ee0b364: checks
*** TURN *** [9c Kd 7d] [5d]
8cd27809: bets $0.36
2ee0b364: folds
Uncalled bet ($0.36) returned to 8cd27809
*** SHOWDOWN ***
8cd27809 collected $0.67 from pot
*** SUMMARY ***
Total pot $0.7 | Rake $0.03 | Jackpot $0 | Bingo $0 | Fortune $0
Board [9c Kd 7d 5d]
Seat 1: 94b6df17 (button) folded before Flop (didn't bet)
Seat 2: 8cd27809 (small blind) won ($0.67)
Seat 3: 3aa4de79 (big blind) folded before Flop
Seat 4: 2ee0b364 folded on the Turn
Seat 5: 179d97ea folded before Flop (didn't bet)
Seat 6: Hero folded before Flop (didn't bet)


Poker Hand #RC1459744999: Hold'em No Limit  ($0.05/$0.1) - 2023/04/08 18:54:38
Table 'RushAndCash3730259' 6-max Seat #1 is the button
Seat 1: 781ff059 ($29.76 in chips)
Seat 2: beb70f3a ($7.78 in chips)
Seat 3: 86a2bcda ($11.75 in chips)
Seat 4: 7bc72864 ($10 in chips)
Seat 5: Hero ($9.07 in chips)
Seat 6: 475fe736 ($10.1 in chips)
beb70f3a: posts small blind $0.05
86a2bcda: posts big blind $0.1
*** HOLE CARDS ***
Dealt to 781ff059 
Dealt to beb70f3a 
Dealt to 86a2bcda 
Dealt to 7bc72864 
Dealt to Hero [8c Kd]
Dealt to 475fe736 
7bc72864: folds
Hero: folds
475fe736: folds
781ff059: raises $0.13 to $0.23
beb70f3a: folds
86a2bcda: calls $0.13
*** FLOP *** [4h Tc Qc]
86a2bcda: checks
781ff059: bets $0.15
86a2bcda: calls $0.15
*** TURN *** [4h Tc Qc] [Td]
86a2bcda: bets $0.71
781ff059: calls $0.71
*** RIVER *** [4h Tc Qc Td] [Qd]
86a2bcda: checks
781ff059: bets $1.12
86a2bcda: calls $1.12
781ff059: shows [Jd Kc] (Pair of Queens and Pair of Tens)
86a2bcda: shows [Ac 9h] (Pair of Queens and Pair of Tens)
*** SHOWDOWN ***
86a2bcda collected $4.11 from pot
*** SUMMARY ***
Total pot $4.47 | Rake $0.21 | Jackpot $0.15 | Bingo $0 | Fortune $0
Board [4h Tc Qc Td Qd]
Seat 1: 781ff059 (button) showed [Jd Kc] and lost with Pair of Queens and Pair of Tens
Seat 2: beb70f3a (small blind) folded before Flop
Seat 3: 86a2bcda (big blind) showed [Ac 9h] and won ($4.11) with Pair of Queens and Pair of Tens
Seat 4: 7bc72864 folded before Flop (didn't bet)
Seat 5: Hero folded before Flop (didn't bet)
Seat 6: 475fe736 folded before Flop (didn't bet)


Poker Hand #RC1459704532: Hold'em No Limit  ($0.05/$0.1) - 2023/04/08 18:53:38
Table 'RushAndCash3729792' 6-max Seat #1 is the button
Seat 1: f2301105 ($11.75 in chips)
Seat 2: e0998ea0 ($11.17 in chips)
Seat 3: 6959ceb5 ($9.95 in chips)
Seat 4: Hero ($9.65 in chips)
Seat 5: 68f98051 ($13.47 in chips)
Seat 6: beb70f3a ($7.11 in chips)
e0998ea0: posts small blind $0.05
6959ceb5: posts big blind $0.1
*** HOLE CARDS ***
Dealt to f2301105 
Dealt to e0998ea0 
Dealt to 6959ceb5 
Dealt to Hero [Ah Kd]
Dealt to 68f98051 
Dealt to beb70f3a 
Hero: raises $0.15 to $0.25
68f98051: folds
beb70f3a: calls $0.25
f2301105: folds
e0998ea0: folds
6959ceb5: folds
*** FLOP *** [Td 6h 4d]
Hero: checks
beb70f3a: bets $0.33
Hero: calls $0.33
*** TURN *** [Td 6h 4d] [5s]
Hero: checks
beb70f3a: bets $0.66
Hero: folds
Uncalled bet ($0.66) returned to beb70f3a
*** SHOWDOWN ***
beb70f3a collected $1.25 from pot
*** SUMMARY ***
Total pot $1.31 | Rake $0.06 | Jackpot $0 | Bingo $0 | Fortune $0
Board [Td 6h 4d 5s]
Seat 1: f2301105 (button) folded before Flop (didn't bet)
Seat 2: e0998ea0 (small blind) folded before Flop
Seat 3: 6959ceb5 (big blind) folded before Flop
Seat 4: Hero folded on the Turn
Seat 5: 68f98051 folded before Flop (didn't bet)
Seat 6: beb70f3a won ($1.25)


Poker Hand #RC1459704497: Hold'em No Limit  ($0.05/$0.1) - 2023/04/08 18:53:33
Table 'RushAndCash3729757' 6-max Seat #1 is the button
Seat 1: Hero ($9.65 in chips)
Seat 2: eb2b2044 ($10 in chips)
Seat 3: 7801a09c ($9.91 in chips)
Seat 4: d5e7e96 ($21.64 in chips)
Seat 5: 6ffc727b ($57.43 in chips)
Seat 6: 898c27ab ($18.06 in chips)
eb2b2044: posts small blind $0.05
7801a09c: posts big blind $0.1
*** HOLE CARDS ***
Dealt to Hero [7d 3s]
Dealt to eb2b2044 
Dealt to 7801a09c 
Dealt to d5e7e96 
Dealt to 6ffc727b 
Dealt to 898c27ab 
d5e7e96: folds
6ffc727b: raises $0.15 to $0.25
898c27ab: folds
Hero: folds
eb2b2044: folds
7801a09c: calls $0.15
*** FLOP *** [As Ts 4s]
7801a09c: checks
6ffc727b: checks
*** TURN *** [As Ts 4s] [4c]
7801a09c: checks
6ffc727b: checks
*** RIVER *** [As Ts 4s 4c] [7c]
7801a09c: bets $0.55
6ffc727b: folds
Uncalled bet ($0.55) returned to 7801a09c
*** SHOWDOWN ***
7801a09c collected $0.53 from pot
*** SUMMARY ***
Total pot $0.55 | Rake $0.02 | Jackpot $0 | Bingo $0 | Fortune $0
Board [As Ts 4s 4c 7c]
Seat 1: Hero (button) folded before Flop (didn't bet)
Seat 2: eb2b2044 (small blind) folded before Flop
Seat 3: 7801a09c (big blind) won ($0.53)
Seat 4: d5e7e96 folded before Flop (didn't bet)
Seat 5: 6ffc727b folded on the River
Seat 6: 898c27ab folded before Flop (didn't bet)


Poker Hand #RC1459704396: Hold'em No Limit  ($0.05/$0.1) - 2023/04/08 18:53:20
Table 'RushAndCash3729656' 6-max Seat #1 is the button
Seat 1: f4ceca14 ($10 in chips)
Seat 2: c7de49a ($10.02 in chips)
Seat 3: Hero ($9.75 in chips)
Seat 4: 9b67e498 ($15.34 in chips)
Seat 5: 1ad38291 ($15.36 in chips)
Seat 6: 7f57e0f9 ($146.29 in chips)
c7de49a: posts small blind $0.05
Hero: posts big blind $0.1
*** HOLE CARDS ***
Dealt to f4ceca14 
Dealt to c7de49a 
Dealt to Hero [2c 4h]
Dealt to 9b67e498 
Dealt to 1ad38291 
Dealt to 7f57e0f9 
9b67e498: raises $0.1 to $0.2
1ad38291: folds
7f57e0f9: folds
f4ceca14: folds
c7de49a: folds
Hero: folds
Uncalled bet ($0.1) returned to 9b67e498
*** SHOWDOWN ***
9b67e498 collected $0.25 from pot
*** SUMMARY ***
Total pot $0.25 | Rake $0 | Jackpot $0 | Bingo $0 | Fortune $0
Seat 1: f4ceca14 (button) folded before Flop (didn't bet)
Seat 2: c7de49a (small blind) folded before Flop
Seat 3: Hero (big blind) folded before Flop
Seat 4: 9b67e498 collected ($0.25)
Seat 5: 1ad38291 folded before Flop (didn't bet)
Seat 6: 7f57e0f9 folded before Flop (didn't bet)


Poker Hand #RC1459704274: Hold'em No Limit  ($0.05/$0.1) - 2023/04/08 18:53:04
Table 'RushAndCash3729534' 6-max Seat #1 is the button
Seat 1: a81f2127 ($36.67 in chips)
Seat 2: Hero ($9.8 in chips)
Seat 3: a66705b8 ($14.45 in chips)
Seat 4: 95866cb2 ($20.79 in chips)
Seat 5: 49f14ae6 ($10.3 in chips)
Seat 6: eaf57a38 ($30.9 in chips)
Hero: posts small blind $0.05
a66705b8: posts big blind $0.1
*** HOLE CARDS ***
Dealt to a81f2127 
Dealt to Hero [2h 9c]
Dealt to a66705b8 
Dealt to 95866cb2 
Dealt to 49f14ae6 
Dealt to eaf57a38 
95866cb2: folds
49f14ae6: folds
eaf57a38: folds
a81f2127: folds
Hero: folds
Uncalled bet ($0.05) returned to a66705b8
*** SHOWDOWN ***
a66705b8 collected $0.1 from pot
*** SUMMARY ***
Total pot $0.1 | Rake $0 | Jackpot $0 | Bingo $0 | Fortune $0
Seat 1: a81f2127 (button) folded before Flop (didn't bet)
Seat 2: Hero (small blind) folded before Flop
Seat 3: a66705b8 (big blind) collected ($0.1)
Seat 4: 95866cb2 folded before Flop (didn't bet)
Seat 5: 49f14ae6 folded before Flop (didn't bet)
Seat 6: eaf57a38 folded before Flop (didn't bet)


Poker Hand #RC1459704155: Hold'em No Limit  ($0.05/$0.1) - 2023/04/08 18:52:46
Table 'RushAndCash3729415' 6-max Seat #1 is the button
Seat 1: 13c97bf5 ($12.67 in chips)
Seat 2: dbad0d95 ($12.82 in chips)
Seat 3: 945836ce ($10.2 in chips)
Seat 4: Hero ($9.65 in chips)
Seat 5: e8bebd0d ($11.9 in chips)
Seat 6: 9e7be7ac ($10 in chips)
dbad0d95: posts small blind $0.05
945836ce: posts big blind $0.1
*** HOLE CARDS ***
Dealt to 13c97bf5 
Dealt to dbad0d95 
Dealt to 945836ce 
Dealt to Hero [6c 7c]
Dealt to e8bebd0d 
Dealt to 9e7be7ac 
Hero: raises $0.15 to $0.25
e8bebd0d: folds
9e7be7ac: folds
13c97bf5: folds
dbad0d95: folds
945836ce: folds
Uncalled bet ($0.15) returned to Hero
*** SHOWDOWN ***
Hero collected $0.25 from pot
*** SUMMARY ***
Total pot $0.25 | Rake $0 | Jackpot $0 | Bingo $0 | Fortune $0
Seat 1: 13c97bf5 (button) folded before Flop (didn't bet)
Seat 2: dbad0d95 (small blind) folded before Flop
Seat 3: 945836ce (big blind) folded before Flop
Seat 4: Hero collected ($0.25)
Seat 5: e8bebd0d folded before Flop (didn't bet)
Seat 6: 9e7be7ac folded before Flop (didn't bet)


Poker Hand #RC1459704078: Hold'em No Limit  ($0.05/$0.1) - 2023/04/08 18:52:37
Table 'RushAndCash3729338' 6-max Seat #1 is the button
Seat 1: be59e6e3 ($10.39 in chips)
Seat 2: eb1dfdf ($19.78 in chips)
Seat 3: dabfa6fb ($15.53 in chips)
Seat 4: 17dfcb7c ($6.3 in chips)
Seat 5: 556685d2 ($32.24 in chips)
Seat 6: Hero ($9.65 in chips)
eb1dfdf: posts small blind $0.05
dabfa6fb: posts big blind $0.1
*** HOLE CARDS ***
Dealt to be59e6e3 
Dealt to eb1dfdf 
Dealt to dabfa6fb 
Dealt to 17dfcb7c 
Dealt to 556685d2 
Dealt to Hero [Qc 4d]
17dfcb7c: folds
556685d2: folds
Hero: folds
be59e6e3: folds
eb1dfdf: folds
Uncalled bet ($0.05) returned to dabfa6fb
*** SHOWDOWN ***
dabfa6fb collected $0.1 from pot
*** SUMMARY ***
Total pot $0.1 | Rake $0 | Jackpot $0 | Bingo $0 | Fortune $0
Seat 1: be59e6e3 (button) folded before Flop (didn't bet)
Seat 2: eb1dfdf (small blind) folded before Flop
Seat 3: dabfa6fb (big blind) collected ($0.1)
Seat 4: 17dfcb7c folded before Flop (didn't bet)
Seat 5: 556685d2 folded before Flop (didn't bet)
Seat 6: Hero folded before Flop (didn't bet)


Poker Hand #RC1459704046: Hold'em No Limit  ($0.05/$0.1) - 2023/04/08 18:52:33
Table 'RushAndCash3729306' 6-max Seat #1 is the button
Seat 1: 13c97bf5 ($12.67 in chips)
Seat 2: 7ab8be3b ($10.15 in chips)
Seat 3: 62e479b3 ($16.81 in chips)
Seat 4: Hero ($9.65 in chips)
Seat 5: 556685d2 ($32.24 in chips)
Seat 6: 9894759a ($21.99 in chips)
7ab8be3b: posts small blind $0.05
62e479b3: posts big blind $0.1
*** HOLE CARDS ***
Dealt to 13c97bf5 
Dealt to 7ab8be3b 
Dealt to 62e479b3 
Dealt to Hero [7h 6s]
Dealt to 556685d2 
Dealt to 9894759a 
Hero: folds
556685d2: folds
9894759a: folds
13c97bf5: folds
7ab8be3b: folds
Uncalled bet ($0.05) returned to 62e479b3
*** SHOWDOWN ***
62e479b3 collected $0.1 from pot
*** SUMMARY ***
Total pot $0.1 | Rake $0 | Jackpot $0 | Bingo $0 | Fortune $0
Seat 1: 13c97bf5 (button) folded before Flop (didn't bet)
Seat 2: 7ab8be3b (small blind) folded before Flop
Seat 3: 62e479b3 (big blind) collected ($0.1)
Seat 4: Hero folded before Flop (didn't bet)
Seat 5: 556685d2 folded before Flop (didn't bet)
Seat 6: 9894759a folded before Flop (didn't bet)


Poker Hand #RC1459703903: Hold'em No Limit  ($0.05/$0.1) - 2023/04/08 18:52:15
Table 'RushAndCash3729163' 6-max Seat #1 is the button
Seat 1: 774b5728 ($5.8 in chips)
Seat 2: 86a2bcda ($10.05 in chips)
Seat 3: Hero ($9.75 in chips)
Seat 4: 380ac1ef ($12.13 in chips)
Seat 5: 5f6e1d8f ($31.38 in chips)
Seat 6: 8e6b66ae ($20.82 in chips)
86a2bcda: posts small blind $0.05
Hero: posts big blind $0.1
*** HOLE CARDS ***
Dealt to 774b5728 
Dealt to 86a2bcda 
Dealt to Hero [7d 5h]
Dealt to 380ac1ef 
Dealt to 5f6e1d8f 
Dealt to 8e6b66ae 
380ac1ef: folds
5f6e1d8f: raises $0.15 to $0.25
8e6b66ae: folds
774b5728: folds
86a2bcda: folds
Hero: folds
Uncalled bet ($0.15) returned to 5f6e1d8f
*** SHOWDOWN ***
5f6e1d8f collected $0.25 from pot
*** SUMMARY ***
Total pot $0.25 | Rake $0 | Jackpot $0 | Bingo $0 | Fortune $0
Seat 1: 774b5728 (button) folded before Flop (didn't bet)
Seat 2: 86a2bcda (small blind) folded before Flop
Seat 3: Hero (big blind) folded before Flop
Seat 4: 380ac1ef folded before Flop (didn't bet)
Seat 5: 5f6e1d8f collected ($0.25)
Seat 6: 8e6b66ae folded before Flop (didn't bet)


Poker Hand #RC1459703567: Hold'em No Limit  ($0.05/$0.1) - 2023/04/08 18:51:32
Table 'RushAndCash3728827' 6-max Seat #1 is the button
Seat 1: Hero ($10 in chips)
Seat 2: 5f6e1d8f ($31.06 in chips)
Seat 3: 5787bfbe ($10.66 in chips)
Seat 4: 3ef67a70 ($10 in chips)
Seat 5: c74d87cd ($14.37 in chips)
Seat 6: 92f798e0 ($10 in chips)
5f6e1d8f: posts small blind $0.05
5787bfbe: posts big blind $0.1
*** HOLE CARDS ***
Dealt to Hero [8h Kh]
Dealt to 5f6e1d8f 
Dealt to 5787bfbe 
Dealt to 3ef67a70 
Dealt to c74d87cd 
Dealt to 92f798e0 
3ef67a70: folds
c74d87cd: folds
92f798e0: folds
Hero: raises $0.15 to $0.25
5f6e1d8f: raises $0.6 to $0.85
5787bfbe: folds
Hero: folds
Uncalled bet ($0.6) returned to 5f6e1d8f
*** SHOWDOWN ***
5f6e1d8f collected $0.57 from pot
*** SUMMARY ***
Total pot $0.6 | Rake $0.03 | Jackpot $0 | Bingo $0 | Fortune $0
Seat 1: Hero (button) folded before Flop
Seat 2: 5f6e1d8f (small blind) collected ($0.57)
Seat 3: 5787bfbe (big blind) folded before Flop
Seat 4: 3ef67a70 folded before Flop (didn't bet)
Seat 5: c74d87cd folded before Flop (didn't bet)
Seat 6: 92f798e0 folded before Flop (didn't bet)


Poker Hand #RC1459702822: Hold'em No Limit  ($0.05/$0.1) - 2023/04/08 18:49:52
Table 'RushAndCash3728082' 6-max Seat #1 is the button
Seat 1: c5dbf8cd ($10 in chips)
Seat 2: Hero ($8.5 in chips)
Seat 3: 7cf4a7e ($12.24 in chips)
Seat 4: 35a36cb9 ($10 in chips)
Seat 5: cda2a7bd ($16.25 in chips)
Seat 6: 10c83365 ($12.17 in chips)
Hero: posts small blind $0.05
7cf4a7e: posts big blind $0.1
*** HOLE CARDS ***
Dealt to c5dbf8cd 
Dealt to Hero [5s 5h]
Dealt to 7cf4a7e 
Dealt to 35a36cb9 
Dealt to cda2a7bd 
Dealt to 10c83365 
35a36cb9: folds
cda2a7bd: raises $0.14 to $0.24
10c83365: folds
c5dbf8cd: folds
Hero: calls $0.19
7cf4a7e: folds
*** FLOP *** [Ah 3c 5d]
Hero: checks
cda2a7bd: bets $0.2
Hero: calls $0.2
*** TURN *** [Ah 3c 5d] [2c]
Hero: checks
cda2a7bd: bets $0.49
Hero: raises $1.37 to $1.86
cda2a7bd: raises $13.95 to $15.81 and is all-in
Hero: calls $6.2 and is all-in
Uncalled bet ($7.75) returned to cda2a7bd
cda2a7bd: shows [4c Ac] (Fives-High Straight)
Hero: shows [5s 5h] (Three Fives)
*** RIVER *** [Ah 3c 5d 2c] [Qd]
*** SHOWDOWN ***
cda2a7bd collected $16.65 from pot
*** SUMMARY ***
Total pot $17.1 | Rake $0.3 | Jackpot $0.15 | Bingo $0 | Fortune $0
Board [Ah 3c 5d 2c Qd]
Seat 1: c5dbf8cd (button) folded before Flop (didn't bet)
Seat 2: Hero (small blind) showed [5s 5h] and lost with Three Fives
Seat 3: 7cf4a7e (big blind) folded before Flop
Seat 4: 35a36cb9 folded before Flop (didn't bet)
Seat 5: cda2a7bd showed [4c Ac] and won ($16.65) with Fives-High Straight
Seat 6: 10c83365 folded before Flop (didn't bet)


Poker Hand #RC1459701347: Hold'em No Limit  ($0.05/$0.1) - 2023/04/08 18:46:39
Table 'RushAndCash3726607' 6-max Seat #1 is the button
Seat 1: 62e479b3 ($19.38 in chips)
Seat 2: d9316075 ($16.93 in chips)
Seat 3: 3077b607 ($10 in chips)
Seat 4: fd29f300 ($11.02 in chips)
Seat 5: d0b73ea6 ($9.81 in chips)
Seat 6: Hero ($8.35 in chips)
d9316075: posts small blind $0.05
3077b607: posts big blind $0.1
*** HOLE CARDS ***
Dealt to 62e479b3 
Dealt to d9316075 
Dealt to 3077b607 
Dealt to fd29f300 
Dealt to d0b73ea6 
Dealt to Hero [Jh As]
fd29f300: folds
d0b73ea6: folds
Hero: raises $0.15 to $0.25
62e479b3: folds
d9316075: folds
3077b607: folds
Uncalled bet ($0.15) returned to Hero
*** SHOWDOWN ***
Hero collected $0.25 from pot
*** SUMMARY ***
Total pot $0.25 | Rake $0 | Jackpot $0 | Bingo $0 | Fortune $0
Seat 1: 62e479b3 (button) folded before Flop (didn't bet)
Seat 2: d9316075 (small blind) folded before Flop
Seat 3: 3077b607 (big blind) folded before Flop
Seat 4: fd29f300 folded before Flop (didn't bet)
Seat 5: d0b73ea6 folded before Flop (didn't bet)
Seat 6: Hero collected ($0.25)


Poker Hand #RC1459701300: Hold'em No Limit  ($0.05/$0.1) - 2023/04/08 18:46:33
Table 'RushAndCash3726560' 6-max Seat #1 is the button
Seat 1: 2745d6e6 ($19.83 in chips)
Seat 2: 11ef0c8 ($7.45 in chips)
Seat 3: c8f3d08 ($42.4 in chips)
Seat 4: Hero ($8.35 in chips)
Seat 5: 8733c35c ($11.91 in chips)
Seat 6: d0cf6228 ($10 in chips)
11ef0c8: posts small blind $0.05
c8f3d08: posts big blind $0.1
*** HOLE CARDS ***
Dealt to 2745d6e6 
Dealt to 11ef0c8 
Dealt to c8f3d08 
Dealt to Hero [4s 6h]
Dealt to 8733c35c 
Dealt to d0cf6228 
Hero: folds
8733c35c: folds
d0cf6228: folds
2745d6e6: folds
11ef0c8: folds
Uncalled bet ($0.05) returned to c8f3d08
*** SHOWDOWN ***
c8f3d08 collected $0.1 from pot
*** SUMMARY ***
Total pot $0.1 | Rake $0 | Jackpot $0 | Bingo $0 | Fortune $0
Seat 1: 2745d6e6 (button) folded before Flop (didn't bet)
Seat 2: 11ef0c8 (small blind) folded before Flop
Seat 3: c8f3d08 (big blind) collected ($0.1)
Seat 4: Hero folded before Flop (didn't bet)
Seat 5: 8733c35c folded before Flop (didn't bet)
Seat 6: d0cf6228 folded before Flop (didn't bet)


Poker Hand #RC1459701252: Hold'em No Limit  ($0.05/$0.1) - 2023/04/08 18:46:26
Table 'RushAndCash3726512' 6-max Seat #1 is the button
Seat 1: 8fa90c99 ($19.98 in chips)
Seat 2: 57060bd8 ($32.31 in chips)
Seat 3: 19b6a6c4 ($48.04 in chips)
Seat 4: b5896cd4 ($19.97 in chips)
Seat 5: Hero ($8.35 in chips)
Seat 6: d9316075 ($16.93 in chips)
57060bd8: posts small blind $0.05
19b6a6c4: posts big blind $0.1
*** HOLE CARDS ***
Dealt to 8fa90c99 
Dealt to 57060bd8 
Dealt to 19b6a6c4 
Dealt to b5896cd4 
Dealt to Hero [3s Qs]
Dealt to d9316075 
b5896cd4: folds
Hero: folds
d9316075: folds
8fa90c99: folds
57060bd8: folds
Uncalled bet ($0.05) returned to 19b6a6c4
*** SHOWDOWN ***
19b6a6c4 collected $0.1 from pot
*** SUMMARY ***
Total pot $0.1 | Rake $0 | Jackpot $0 | Bingo $0 | Fortune $0
Seat 1: 8fa90c99 (button) folded before Flop (didn't bet)
Seat 2: 57060bd8 (small blind) folded before Flop
Seat 3: 19b6a6c4 (big blind) collected ($0.1)
Seat 4: b5896cd4 folded before Flop (didn't bet)
Seat 5: Hero folded before Flop (didn't bet)
Seat 6: d9316075 folded before Flop (didn't bet)


Poker Hand #RC1459701166: Hold'em No Limit  ($0.05/$0.1) - 2023/04/08 18:46:14
Table 'RushAndCash3726426' 6-max Seat #1 is the button
Seat 1: b8f000db ($10 in chips)
Seat 2: c87b046f ($9.87 in chips)
Seat 3: a6fb6dc ($10.27 in chips)
Seat 4: 35f07908 ($13.56 in chips)
Seat 5: 43514f6c ($7 in chips)
Seat 6: Hero ($8.35 in chips)
c87b046f: posts small blind $0.05
a6fb6dc: posts big blind $0.1
*** HOLE CARDS ***
Dealt to b8f000db 
Dealt to c87b046f 
Dealt to a6fb6dc 
Dealt to 35f07908 
Dealt to 43514f6c 
Dealt to Hero [2d 9s]
35f07908: folds
43514f6c: folds
Hero: folds
b8f000db: folds
c87b046f: raises $0.3 to $0.4
a6fb6dc: raises $0.7 to $1.1
c87b046f: calls $0.7
*** FLOP *** [4c 3c Kc]
c87b046f: checks
a6fb6dc: bets $1.45
c87b046f: folds
Uncalled bet ($1.45) returned to a6fb6dc
*** SHOWDOWN ***
a6fb6dc collected $2.09 from pot
*** SUMMARY ***
Total pot $2.2 | Rake $0.11 | Jackpot $0 | Bingo $0 | Fortune $0
Board [4c 3c Kc]
Seat 1: b8f000db (button) folded before Flop (didn't bet)
Seat 2: c87b046f (small blind) folded on the Flop
Seat 3: a6fb6dc (big blind) won ($2.09)
Seat 4: 35f07908 folded before Flop (didn't bet)
Seat 5: 43514f6c folded before Flop (didn't bet)
Seat 6: Hero folded before Flop (didn't bet)


Poker Hand #RC1459701074: Hold'em No Limit  ($0.05/$0.1) - 2023/04/08 18:46:01
Table 'RushAndCash3726334' 6-max Seat #1 is the button
Seat 1: 4f813c73 ($15 in chips)
Seat 2: Hero ($8.4 in chips)
Seat 3: bb68e4fe ($5.42 in chips)
Seat 4: 13cf33e3 ($10.05 in chips)
Seat 5: 5e20bab2 ($13.83 in chips)
Seat 6: 56e251bc ($10.24 in chips)
Hero: posts small blind $0.05
bb68e4fe: posts big blind $0.1
*** HOLE CARDS ***
Dealt to 4f813c73 
Dealt to Hero [4d 3d]
Dealt to bb68e4fe 
Dealt to 13cf33e3 
Dealt to 5e20bab2 
Dealt to 56e251bc 
13cf33e3: raises $0.15 to $0.25
5e20bab2: folds
56e251bc: raises $0.65 to $0.9
4f813c73: raises $1.65 to $2.55
Hero: folds
bb68e4fe: folds
13cf33e3: folds
56e251bc: raises $7.69 to $10.24 and is all-in
4f813c73: calls $7.69
56e251bc: shows [Jd Js]
4f813c73: shows [Ac Kd]
*** FLOP *** [7s 2d Kc]
*** TURN *** [7s 2d Kc] [Ah]
*** RIVER *** [7s 2d Kc Ah] [4c]
*** SHOWDOWN ***
4f813c73 collected $20.43 from pot
*** SUMMARY ***
Total pot $20.88 | Rake $0.3 | Jackpot $0.15 | Bingo $0 | Fortune $0
Board [7s 2d Kc Ah 4c]
Seat 1: 4f813c73 (button) showed [Ac Kd] and won ($20.43) with Pair of Aces and Pair of Kings
Seat 2: Hero (small blind) folded before Flop
Seat 3: bb68e4fe (big blind) folded before Flop
Seat 4: 13cf33e3 folded before Flop
Seat 5: 5e20bab2 folded before Flop (didn't bet)
Seat 6: 56e251bc showed [Jd Js] and lost with Pair of Jacks


Poker Hand #RC1459700977: Hold'em No Limit  ($0.05/$0.1) - 2023/04/08 18:45:46
Table 'RushAndCash3726237' 6-max Seat #1 is the button
Seat 1: Hero ($8.4 in chips)
Seat 2: b7014311 ($9.46 in chips)
Seat 3: 4f04a08d ($10.55 in chips)
Seat 4: 62e479b3 ($19.68 in chips)
Seat 5: 8ff12852 ($16.01 in chips)
Seat 6: d1df2505 ($14.63 in chips)
b7014311: posts small blind $0.05
4f04a08d: posts big blind $0.1
*** HOLE CARDS ***
Dealt to Hero [3h Td]
Dealt to b7014311 
Dealt to 4f04a08d 
Dealt to 62e479b3 
Dealt to 8ff12852 
Dealt to d1df2505 
62e479b3: folds
8ff12852: raises $0.15 to $0.25
d1df2505: folds
Hero: folds
b7014311: folds
4f04a08d: folds
Uncalled bet ($0.15) returned to 8ff12852
*** SHOWDOWN ***
8ff12852 collected $0.25 from pot
*** SUMMARY ***
Total pot $0.25 | Rake $0 | Jackpot $0 | Bingo $0 | Fortune $0
Seat 1: Hero (button) folded before Flop (didn't bet)
Seat 2: b7014311 (small blind) folded before Flop
Seat 3: 4f04a08d (big blind) folded before Flop
Seat 4: 62e479b3 folded before Flop (didn't bet)
Seat 5: 8ff12852 collected ($0.25)
Seat 6: d1df2505 folded before Flop (didn't bet)


Poker Hand #RC1459700910: Hold'em No Limit  ($0.05/$0.1) - 2023/04/08 18:45:37
Table 'RushAndCash3726170' 6-max Seat #1 is the button
Seat 1: 335686d2 ($10.88 in chips)
Seat 2: 4d4b4f20 ($8.41 in chips)
Seat 3: Hero ($8.35 in chips)
Seat 4: c95ed675 ($10.15 in chips)
Seat 5: 8b024078 ($9.8 in chips)
Seat 6: 2d29227e ($6.96 in chips)
4d4b4f20: posts small blind $0.05
Hero: posts big blind $0.1
*** HOLE CARDS ***
Dealt to 335686d2 
Dealt to 4d4b4f20 
Dealt to Hero [7h Ah]
Dealt to c95ed675 
Dealt to 8b024078 
Dealt to 2d29227e 
c95ed675: folds
8b024078: folds
2d29227e: folds
335686d2: folds
4d4b4f20: folds
Uncalled bet ($0.05) returned to Hero
*** SHOWDOWN ***
Hero collected $0.1 from pot
*** SUMMARY ***
Total pot $0.1 | Rake $0 | Jackpot $0 | Bingo $0 | Fortune $0
Seat 1: 335686d2 (button) folded before Flop (didn't bet)
Seat 2: 4d4b4f20 (small blind) folded before Flop
Seat 3: Hero (big blind) collected ($0.1)
Seat 4: c95ed675 folded before Flop (didn't bet)
Seat 5: 8b024078 folded before Flop (didn't bet)
Seat 6: 2d29227e folded before Flop (didn't bet)


Poker Hand #RC1459700607: Hold'em No Limit  ($0.05/$0.1) - 2023/04/08 18:44:56
Table 'RushAndCash3725867' 6-max Seat #1 is the button
Seat 1: c59bc4d5 ($10.45 in chips)
Seat 2: d8df28f1 ($7.8 in chips)
Seat 3: c0e89a5e ($10.15 in chips)
Seat 4: Hero ($8.07 in chips)
Seat 5: a893ec2d ($8.68 in chips)
Seat 6: 245ee62b ($11.16 in chips)
d8df28f1: posts small blind $0.05
c0e89a5e: posts big blind $0.1
*** HOLE CARDS ***
Dealt to c59bc4d5 
Dealt to d8df28f1 
Dealt to c0e89a5e 
Dealt to Hero [Qh Kc]
Dealt to a893ec2d 
Dealt to 245ee62b 
Hero: raises $0.15 to $0.25
a893ec2d: folds
245ee62b: folds
c59bc4d5: folds
d8df28f1: folds
c0e89a5e: calls $0.15
*** FLOP *** [7d Ks Kd]
c0e89a5e: checks
Hero: bets $0.28
c0e89a5e: folds
Uncalled bet ($0.28) returned to Hero
*** SHOWDOWN ***
Hero collected $0.53 from pot
*** SUMMARY ***
Total pot $0.55 | Rake $0.02 | Jackpot $0 | Bingo $0 | Fortune $0
Board [7d Ks Kd]
Seat 1: c59bc4d5 (button) folded before Flop (didn't bet)
Seat 2: d8df28f1 (small blind) folded before Flop
Seat 3: c0e89a5e (big blind) folded on the Flop
Seat 4: Hero won ($0.53)
Seat 5: a893ec2d folded before Flop (didn't bet)
Seat 6: 245ee62b folded before Flop (didn't bet)


Poker Hand #RC1459700506: Hold'em No Limit  ($0.05/$0.1) - 2023/04/08 18:44:44
Table 'RushAndCash3725766' 6-max Seat #1 is the button
Seat 1: 39264201 ($9.88 in chips)
Seat 2: 20767e22 ($11.55 in chips)
Seat 3: 2be2e095 ($19.99 in chips)
Seat 4: 53fc3206 ($10.47 in chips)
Seat 5: c48b0f35 ($19.42 in chips)
Seat 6: Hero ($8.07 in chips)
20767e22: posts small blind $0.05
2be2e095: posts big blind $0.1
*** HOLE CARDS ***
Dealt to 39264201 
Dealt to 20767e22 
Dealt to 2be2e095 
Dealt to 53fc3206 
Dealt to c48b0f35 
Dealt to Hero [5d 6d]
53fc3206: folds
c48b0f35: raises $0.15 to $0.25
Hero: folds
39264201: folds
20767e22: folds
2be2e095: calls $0.15
*** FLOP *** [Jd 2c 7c]
2be2e095: checks
c48b0f35: bets $0.19
2be2e095: folds
Uncalled bet ($0.19) returned to c48b0f35
*** SHOWDOWN ***
c48b0f35 collected $0.53 from pot
*** SUMMARY ***
Total pot $0.55 | Rake $0.02 | Jackpot $0 | Bingo $0 | Fortune $0
Board [Jd 2c 7c]
Seat 1: 39264201 (button) folded before Flop (didn't bet)
Seat 2: 20767e22 (small blind) folded before Flop
Seat 3: 2be2e095 (big blind) folded on the Flop
Seat 4: 53fc3206 folded before Flop (didn't bet)
Seat 5: c48b0f35 won ($0.53)
Seat 6: Hero folded before Flop (didn't bet)


Poker Hand #RC1459700142: Hold'em No Limit  ($0.05/$0.1) - 2023/04/08 18:43:57
Table 'RushAndCash3725402' 6-max Seat #1 is the button
Seat 1: 2dce9a53 ($10.08 in chips)
Seat 2: b1ecb1a9 ($13.78 in chips)
Seat 3: 93dd5318 ($6.14 in chips)
Seat 4: 20767e22 ($12.32 in chips)
Seat 5: Hero ($7.23 in chips)
Seat 6: 60c9b2cd ($11.94 in chips)
b1ecb1a9: posts small blind $0.05
93dd5318: posts big blind $0.1
*** HOLE CARDS ***
Dealt to 2dce9a53 
Dealt to b1ecb1a9 
Dealt to 93dd5318 
Dealt to 20767e22 
Dealt to Hero [Qd Qc]
Dealt to 60c9b2cd 
20767e22: raises $0.16 to $0.26
Hero: raises $0.51 to $0.77
60c9b2cd: folds
2dce9a53: folds
b1ecb1a9: folds
93dd5318: folds
20767e22: calls $0.51
*** FLOP *** [9c 2h Jh]
20767e22: checks
Hero: bets $0.85
20767e22: folds
Uncalled bet ($0.85) returned to Hero
*** SHOWDOWN ***
Hero collected $1.61 from pot
*** SUMMARY ***
Total pot $1.69 | Rake $0.08 | Jackpot $0 | Bingo $0 | Fortune $0
Board [9c 2h Jh]
Seat 1: 2dce9a53 (button) folded before Flop (didn't bet)
Seat 2: b1ecb1a9 (small blind) folded before Flop
Seat 3: 93dd5318 (big blind) folded before Flop
Seat 4: 20767e22 folded on the Flop
Seat 5: Hero won ($1.61)
Seat 6: 60c9b2cd folded before Flop (didn't bet)


Poker Hand #RC1459700031: Hold'em No Limit  ($0.05/$0.1) - 2023/04/08 18:43:42
Table 'RushAndCash3725291' 6-max Seat #1 is the button
Seat 1: fbc401b8 ($10 in chips)
Seat 2: Hero ($7.28 in chips)
Seat 3: 7d3ddbed ($4.95 in chips)
Seat 4: b10b0984 ($15.81 in chips)
Seat 5: f17a54f7 ($12.23 in chips)
Seat 6: 43c7fa3b ($10.76 in chips)
Hero: posts small blind $0.05
7d3ddbed: posts big blind $0.1
*** HOLE CARDS ***
Dealt to fbc401b8 
Dealt to Hero [4c 7d]
Dealt to 7d3ddbed 
Dealt to b10b0984 
Dealt to f17a54f7 
Dealt to 43c7fa3b 
b10b0984: folds
f17a54f7: folds
43c7fa3b: folds
fbc401b8: folds
Hero: folds
Uncalled bet ($0.05) returned to 7d3ddbed
*** SHOWDOWN ***
7d3ddbed collected $0.1 from pot
*** SUMMARY ***
Total pot $0.1 | Rake $0 | Jackpot $0 | Bingo $0 | Fortune $0
Seat 1: fbc401b8 (button) folded before Flop (didn't bet)
Seat 2: Hero (small blind) folded before Flop
Seat 3: 7d3ddbed (big blind) collected ($0.1)
Seat 4: b10b0984 folded before Flop (didn't bet)
Seat 5: f17a54f7 folded before Flop (didn't bet)
Seat 6: 43c7fa3b folded before Flop (didn't bet)


Poker Hand #RC1459699932: Hold'em No Limit  ($0.05/$0.1) - 2023/04/08 18:43:29
Table 'RushAndCash3725192' 6-max Seat #1 is the button
Seat 1: eae94a73 ($3.76 in chips)
Seat 2: 187bd511 ($10.32 in chips)
Seat 3: Hero ($7.38 in chips)
Seat 4: 5ac9aac5 ($10.26 in chips)
Seat 5: bf9dc4c2 ($21.94 in chips)
Seat 6: 4c47b48b ($17.74 in chips)
187bd511: posts small blind $0.05
Hero: posts big blind $0.1
*** HOLE CARDS ***
Dealt to eae94a73 
Dealt to 187bd511 
Dealt to Hero [2d 9d]
Dealt to 5ac9aac5 
Dealt to bf9dc4c2 
Dealt to 4c47b48b 
5ac9aac5: folds
bf9dc4c2: folds
4c47b48b: folds
eae94a73: raises $0.2 to $0.3
187bd511: calls $0.25
Hero: folds
*** FLOP *** [2h Qh Jh]
187bd511: bets $0.35
eae94a73: calls $0.35
*** TURN *** [2h Qh Jh] [Kd]
187bd511: checks
eae94a73: bets $0.47
187bd511: calls $0.47
*** RIVER *** [2h Qh Jh Kd] [3s]
187bd511: checks
eae94a73: checks
187bd511: shows [7s Qs] (Pair of Queens)
eae94a73: shows [Tc Th] (Pair of Tens)
*** SHOWDOWN ***
187bd511 collected $2.23 from pot
*** SUMMARY ***
Total pot $2.34 | Rake $0.11 | Jackpot $0 | Bingo $0 | Fortune $0
Board [2h Qh Jh Kd 3s]
Seat 1: eae94a73 (button) showed [Tc Th] and lost with Pair of Tens
Seat 2: 187bd511 (small blind) showed [7s Qs] and won ($2.23) with Pair of Queens
Seat 3: Hero (big blind) folded before Flop
Seat 4: 5ac9aac5 folded before Flop (didn't bet)
Seat 5: bf9dc4c2 folded before Flop (didn't bet)
Seat 6: 4c47b48b folded before Flop (didn't bet)


Poker Hand #RC1459699863: Hold'em No Limit  ($0.05/$0.1) - 2023/04/08 18:43:20
Table 'RushAndCash3725123' 6-max Seat #1 is the button
Seat 1: Hero ($7.38 in chips)
Seat 2: deda7b86 ($6.78 in chips)
Seat 3: ca34ebc2 ($10.57 in chips)
Seat 4: 6f73fc65 ($18.42 in chips)
Seat 5: b7d3e2c6 ($11.86 in chips)
Seat 6: 359415cd ($13.91 in chips)
deda7b86: posts small blind $0.05
ca34ebc2: posts big blind $0.1
*** HOLE CARDS ***
Dealt to Hero [7d Kc]
Dealt to deda7b86 
Dealt to ca34ebc2 
Dealt to 6f73fc65 
Dealt to b7d3e2c6 
Dealt to 359415cd 
6f73fc65: raises $0.2 to $0.3
b7d3e2c6: folds
359415cd: folds
Hero: folds
deda7b86: folds
ca34ebc2: folds
Uncalled bet ($0.2) returned to 6f73fc65
*** SHOWDOWN ***
6f73fc65 collected $0.25 from pot
*** SUMMARY ***
Total pot $0.25 | Rake $0 | Jackpot $0 | Bingo $0 | Fortune $0
Seat 1: Hero (button) folded before Flop (didn't bet)
Seat 2: deda7b86 (small blind) folded before Flop
Seat 3: ca34ebc2 (big blind) folded before Flop
Seat 4: 6f73fc65 collected ($0.25)
Seat 5: b7d3e2c6 folded before Flop (didn't bet)
Seat 6: 359415cd folded before Flop (didn't bet)


Poker Hand #RC1459699785: Hold'em No Limit  ($0.05/$0.1) - 2023/04/08 18:43:10
Table 'RushAndCash3725045' 6-max Seat #1 is the button
Seat 1: a546356d ($9.17 in chips)
Seat 2: 2f88240a ($10.33 in chips)
Seat 3: 2eadf610 ($10 in chips)
Seat 4: 20ad9e7 ($12.34 in chips)
Seat 5: 86b3f5fd ($1.9 in chips)
Seat 6: Hero ($7.23 in chips)
2f88240a: posts small blind $0.05
2eadf610: posts big blind $0.1
*** HOLE CARDS ***
Dealt to a546356d 
Dealt to 2f88240a 
Dealt to 2eadf610 
Dealt to 20ad9e7 
Dealt to 86b3f5fd 
Dealt to Hero [8c Ah]
20ad9e7: folds
86b3f5fd: folds
Hero: raises $0.15 to $0.25
a546356d: folds
2f88240a: folds
2eadf610: folds
Uncalled bet ($0.15) returned to Hero
*** SHOWDOWN ***
Hero collected $0.25 from pot
*** SUMMARY ***
Total pot $0.25 | Rake $0 | Jackpot $0 | Bingo $0 | Fortune $0
Seat 1: a546356d (button) folded before Flop (didn't bet)
Seat 2: 2f88240a (small blind) folded before Flop
Seat 3: 2eadf610 (big blind) folded before Flop
Seat 4: 20ad9e7 folded before Flop (didn't bet)
Seat 5: 86b3f5fd folded before Flop (didn't bet)
Seat 6: Hero collected ($0.25)


Poker Hand #RC1459699749: Hold'em No Limit  ($0.05/$0.1) - 2023/04/08 18:43:05
Table 'RushAndCash3725009' 6-max Seat #1 is the button
Seat 1: 187bd511 ($10.17 in chips)
Seat 2: dd51b60a ($11.94 in chips)
Seat 3: a4a4271f ($15.8 in chips)
Seat 4: 42f7499e ($13.19 in chips)
Seat 5: Hero ($7.23 in chips)
Seat 6: cd592fdb ($10 in chips)
dd51b60a: posts small blind $0.05
a4a4271f: posts big blind $0.1
*** HOLE CARDS ***
Dealt to 187bd511 
Dealt to dd51b60a 
Dealt to a4a4271f 
Dealt to 42f7499e 
Dealt to Hero [4h 8s]
Dealt to cd592fdb 
42f7499e: folds
Hero: folds
cd592fdb: folds
187bd511: raises $0.2 to $0.3
dd51b60a: folds
a4a4271f: folds
Uncalled bet ($0.2) returned to 187bd511
*** SHOWDOWN ***
187bd511 collected $0.25 from pot
*** SUMMARY ***
Total pot $0.25 | Rake $0 | Jackpot $0 | Bingo $0 | Fortune $0
Seat 1: 187bd511 (button) collected ($0.25)
Seat 2: dd51b60a (small blind) folded before Flop
Seat 3: a4a4271f (big blind) folded before Flop
Seat 4: 42f7499e folded before Flop (didn't bet)
Seat 5: Hero folded before Flop (didn't bet)
Seat 6: cd592fdb folded before Flop (didn't bet)


Poker Hand #RC1459699687: Hold'em No Limit  ($0.05/$0.1) - 2023/04/08 18:42:57
Table 'RushAndCash3724947' 6-max Seat #1 is the button
Seat 1: Hero ($7.23 in chips)
Seat 2: 64c80375 ($16.85 in chips)
Seat 3: 42f7499e ($13.29 in chips)
Seat 4: f17a54f7 ($12.38 in chips)
Seat 5: b42073c4 ($8.89 in chips)
Seat 6: 96b23dd8 ($10 in chips)
64c80375: posts small blind $0.05
42f7499e: posts big blind $0.1
*** HOLE CARDS ***
Dealt to Hero [Qc 2c]
Dealt to 64c80375 
Dealt to 42f7499e 
Dealt to f17a54f7 
Dealt to b42073c4 
Dealt to 96b23dd8 
f17a54f7: folds
b42073c4: folds
96b23dd8: folds
Hero: folds
64c80375: folds
Uncalled bet ($0.05) returned to 42f7499e
*** SHOWDOWN ***
42f7499e collected $0.1 from pot
*** SUMMARY ***
Total pot $0.1 | Rake $0 | Jackpot $0 | Bingo $0 | Fortune $0
Seat 1: Hero (button) folded before Flop (didn't bet)
Seat 2: 64c80375 (small blind) folded before Flop
Seat 3: 42f7499e (big blind) collected ($0.1)
Seat 4: f17a54f7 folded before Flop (didn't bet)
Seat 5: b42073c4 folded before Flop (didn't bet)
Seat 6: 96b23dd8 folded before Flop (didn't bet)


Poker Hand #RC1459699571: Hold'em No Limit  ($0.05/$0.1) - 2023/04/08 18:42:43
Table 'RushAndCash3724831' 6-max Seat #1 is the button
Seat 1: 71e4f906 ($11.27 in chips)
Seat 2: Hero ($7.28 in chips)
Seat 3: 8fa90c99 ($9.8 in chips)
Seat 4: 44bf5f9d ($10.23 in chips)
Seat 5: b0ad0f76 ($11.52 in chips)
Seat 6: 781ff059 ($31.34 in chips)
Hero: posts small blind $0.05
8fa90c99: posts big blind $0.1
*** HOLE CARDS ***
Dealt to 71e4f906 
Dealt to Hero [2h Ad]
Dealt to 8fa90c99 
Dealt to 44bf5f9d 
Dealt to b0ad0f76 
Dealt to 781ff059 
44bf5f9d: folds
b0ad0f76: folds
781ff059: raises $0.13 to $0.23
71e4f906: folds
Hero: folds
8fa90c99: folds
Uncalled bet ($0.13) returned to 781ff059
*** SHOWDOWN ***
781ff059 collected $0.25 from pot
*** SUMMARY ***
Total pot $0.25 | Rake $0 | Jackpot $0 | Bingo $0 | Fortune $0
Seat 1: 71e4f906 (button) folded before Flop (didn't bet)
Seat 2: Hero (small blind) folded before Flop
Seat 3: 8fa90c99 (big blind) folded before Flop
Seat 4: 44bf5f9d folded before Flop (didn't bet)
Seat 5: b0ad0f76 folded before Flop (didn't bet)
Seat 6: 781ff059 collected ($0.25)


Poker Hand #RC1459699460: Hold'em No Limit  ($0.05/$0.1) - 2023/04/08 18:42:28
Table 'RushAndCash3724720' 6-max Seat #1 is the button
Seat 1: b5896cd4 ($18.88 in chips)
Seat 2: 25bcf459 ($11.44 in chips)
Seat 3: Hero ($7.38 in chips)
Seat 4: 500fa304 ($43.4 in chips)
Seat 5: 616fb43f ($14.27 in chips)
Seat 6: 327a053c ($3.09 in chips)
25bcf459: posts small blind $0.05
Hero: posts big blind $0.1
*** HOLE CARDS ***
Dealt to b5896cd4 
Dealt to 25bcf459 
Dealt to Hero [2d Qs]
Dealt to 500fa304 
Dealt to 616fb43f 
Dealt to 327a053c 
500fa304: folds
616fb43f: folds
327a053c: folds
b5896cd4: raises $0.1 to $0.2
25bcf459: folds
Hero: folds
Uncalled bet ($0.1) returned to b5896cd4
*** SHOWDOWN ***
b5896cd4 collected $0.25 from pot
*** SUMMARY ***
Total pot $0.25 | Rake $0 | Jackpot $0 | Bingo $0 | Fortune $0
Seat 1: b5896cd4 (button) collected ($0.25)
Seat 2: 25bcf459 (small blind) folded before Flop
Seat 3: Hero (big blind) folded before Flop
Seat 4: 500fa304 folded before Flop (didn't bet)
Seat 5: 616fb43f folded before Flop (didn't bet)
Seat 6: 327a053c folded before Flop (didn't bet)


Poker Hand #RC1459699430: Hold'em No Limit  ($0.05/$0.1) - 2023/04/08 18:42:24
Table 'RushAndCash3724690' 6-max Seat #1 is the button
Seat 1: 841ba27d ($9.87 in chips)
Seat 2: f869fc67 ($15.76 in chips)
Seat 3: eda2be39 ($13.42 in chips)
Seat 4: 8695c5ae ($6.91 in chips)
Seat 5: ccbd75bf ($11.08 in chips)
Seat 6: Hero ($7.38 in chips)
f869fc67: posts small blind $0.05
eda2be39: posts big blind $0.1
*** HOLE CARDS ***
Dealt to 841ba27d 
Dealt to f869fc67 
Dealt to eda2be39 
Dealt to 8695c5ae 
Dealt to ccbd75bf 
Dealt to Hero [9c 2d]
8695c5ae: raises $0.1 to $0.2
ccbd75bf: raises $0.42 to $0.62
Hero: folds
841ba27d: folds
f869fc67: calls $0.57
eda2be39: folds
8695c5ae: calls $0.42
*** FLOP *** [3d 8s 9d]
f869fc67: checks
8695c5ae: checks
ccbd75bf: bets $1.1
f869fc67: calls $1.1
8695c5ae: folds
*** TURN *** [3d 8s 9d] [4s]
f869fc67: checks
ccbd75bf: checks
*** RIVER *** [3d 8s 9d 4s] [Th]
f869fc67: bets $3.08
ccbd75bf: folds
Uncalled bet ($3.08) returned to f869fc67
*** SHOWDOWN ***
f869fc67 collected $3.81 from pot
*** SUMMARY ***
Total pot $4.16 | Rake $0.2 | Jackpot $0.15 | Bingo $0 | Fortune $0
Board [3d 8s 9d 4s Th]
Seat 1: 841ba27d (button) folded before Flop (didn't bet)
Seat 2: f869fc67 (small blind) won ($3.81)
Seat 3: eda2be39 (big blind) folded before Flop
Seat 4: 8695c5ae folded on the Flop
Seat 5: ccbd75bf folded on the River
Seat 6: Hero folded before Flop (didn't bet)


Poker Hand #RC1459699399: Hold'em No Limit  ($0.05/$0.1) - 2023/04/08 18:42:20
Table 'RushAndCash3724659' 6-max Seat #1 is the button
Seat 1: 1f161108 ($10 in chips)
Seat 2: 1c763e5f ($28.35 in chips)
Seat 3: 3e64e7bf ($9.28 in chips)
Seat 4: b10b0984 ($15.11 in chips)
Seat 5: d8df28f1 ($8.45 in chips)
Seat 6: Hero ($7.38 in chips)
1c763e5f: posts small blind $0.05
3e64e7bf: posts big blind $0.1
*** HOLE CARDS ***
Dealt to 1f161108 
Dealt to 1c763e5f 
Dealt to 3e64e7bf 
Dealt to b10b0984 
Dealt to d8df28f1 
Dealt to Hero [7h 4h]
b10b0984: raises $0.1 to $0.2
d8df28f1: folds
Hero: folds
1f161108: folds
1c763e5f: folds
3e64e7bf: calls $0.1
*** FLOP *** [Qc 3s As]
3e64e7bf: checks
b10b0984: bets $0.2
3e64e7bf: raises $0.43 to $0.63
b10b0984: raises $0.43 to $1.06
3e64e7bf: folds
Uncalled bet ($0.43) returned to b10b0984
*** SHOWDOWN ***
b10b0984 collected $1.63 from pot
*** SUMMARY ***
Total pot $1.71 | Rake $0.08 | Jackpot $0 | Bingo $0 | Fortune $0
Board [Qc 3s As]
Seat 1: 1f161108 (button) folded before Flop (didn't bet)
Seat 2: 1c763e5f (small blind) folded before Flop
Seat 3: 3e64e7bf (big blind) folded on the Flop
Seat 4: b10b0984 won ($1.63)
Seat 5: d8df28f1 folded before Flop (didn't bet)
Seat 6: Hero folded before Flop (didn't bet)


Poker Hand #RC1459699347: Hold'em No Limit  ($0.05/$0.1) - 2023/04/08 18:42:14
Table 'RushAndCash3724607' 6-max Seat #1 is the button
Seat 1: 4f813c73 ($15.08 in chips)
Seat 2: 280b7b ($28.82 in chips)
Seat 3: b188dd6c ($8.36 in chips)
Seat 4: 8b88c564 ($14.52 in chips)
Seat 5: Hero ($7.38 in chips)
Seat 6: 99453604 ($12.26 in chips)
280b7b: posts small blind $0.05
b188dd6c: posts big blind $0.1
*** HOLE CARDS ***
Dealt to 4f813c73 
Dealt to 280b7b 
Dealt to b188dd6c 
Dealt to 8b88c564 
Dealt to Hero [5d Tc]
Dealt to 99453604 
8b88c564: folds
Hero: folds
99453604: folds
4f813c73: raises $0.15 to $0.25
280b7b: folds
b188dd6c: folds
Uncalled bet ($0.15) returned to 4f813c73
*** SHOWDOWN ***
4f813c73 collected $0.25 from pot
*** SUMMARY ***
Total pot $0.25 | Rake $0 | Jackpot $0 | Bingo $0 | Fortune $0
Seat 1: 4f813c73 (button) collected ($0.25)
Seat 2: 280b7b (small blind) folded before Flop
Seat 3: b188dd6c (big blind) folded before Flop
Seat 4: 8b88c564 folded before Flop (didn't bet)
Seat 5: Hero folded before Flop (didn't bet)
Seat 6: 99453604 folded before Flop (didn't bet)


Poker Hand #RC1459699134: Hold'em No Limit  ($0.05/$0.1) - 2023/04/08 18:41:43
Table 'RushAndCash3724394' 6-max Seat #1 is the button
Seat 1: 2d4d4ebb ($9.16 in chips)
Seat 2: c4ad3f66 ($10 in chips)
Seat 3: 823e894f ($15.69 in chips)
Seat 4: 87719fca ($10 in chips)
Seat 5: e790267c ($12.21 in chips)
Seat 6: Hero ($7.1 in chips)
c4ad3f66: posts small blind $0.05
823e894f: posts big blind $0.1
*** HOLE CARDS ***
Dealt to 2d4d4ebb 
Dealt to c4ad3f66 
Dealt to 823e894f 
Dealt to 87719fca 
Dealt to e790267c 
Dealt to Hero [Qd Tc]
87719fca: folds
e790267c: folds
Hero: raises $0.15 to $0.25
2d4d4ebb: folds
c4ad3f66: folds
823e894f: calls $0.15
*** FLOP *** [Td Ts 6h]
823e894f: checks
Hero: bets $0.28
823e894f: folds
Uncalled bet ($0.28) returned to Hero
*** SHOWDOWN ***
Hero collected $0.53 from pot
*** SUMMARY ***
Total pot $0.55 | Rake $0.02 | Jackpot $0 | Bingo $0 | Fortune $0
Board [Td Ts 6h]
Seat 1: 2d4d4ebb (button) folded before Flop (didn't bet)
Seat 2: c4ad3f66 (small blind) folded before Flop
Seat 3: 823e894f (big blind) folded on the Flop
Seat 4: 87719fca folded before Flop (didn't bet)
Seat 5: e790267c folded before Flop (didn't bet)
Seat 6: Hero won ($0.53)


Poker Hand #RC1459699042: Hold'em No Limit  ($0.05/$0.1) - 2023/04/08 18:41:31
Table 'RushAndCash3724302' 6-max Seat #1 is the button
Seat 1: 35a10c37 ($11.77 in chips)
Seat 2: Hero ($7.15 in chips)
Seat 3: 49da03d9 ($17.08 in chips)
Seat 4: 4c892517 ($10 in chips)
Seat 5: af36f1be ($10.3 in chips)
Seat 6: d5b7594 ($12.18 in chips)
Hero: posts small blind $0.05
49da03d9: posts big blind $0.1
*** HOLE CARDS ***
Dealt to 35a10c37 
Dealt to Hero [Ks 9h]
Dealt to 49da03d9 
Dealt to 4c892517 
Dealt to af36f1be 
Dealt to d5b7594 
4c892517: folds
af36f1be: folds
d5b7594: raises $0.16 to $0.26
35a10c37: folds
Hero: folds
49da03d9: calls $0.16
*** FLOP *** [2c 4d Jh]
49da03d9: checks
d5b7594: checks
*** TURN *** [2c 4d Jh] [As]
49da03d9: checks
d5b7594: checks
*** RIVER *** [2c 4d Jh As] [Td]
49da03d9: bets $0.44
d5b7594: folds
Uncalled bet ($0.44) returned to 49da03d9
*** SHOWDOWN ***
49da03d9 collected $0.55 from pot
*** SUMMARY ***
Total pot $0.57 | Rake $0.02 | Jackpot $0 | Bingo $0 | Fortune $0
Board [2c 4d Jh As Td]
Seat 1: 35a10c37 (button) folded before Flop (didn't bet)
Seat 2: Hero (small blind) folded before Flop
Seat 3: 49da03d9 (big blind) won ($0.55)
Seat 4: 4c892517 folded before Flop (didn't bet)
Seat 5: af36f1be folded before Flop (didn't bet)
Seat 6: d5b7594 folded on the River


Poker Hand #RC1459699008: Hold'em No Limit  ($0.05/$0.1) - 2023/04/08 18:41:27
Table 'RushAndCash3724268' 6-max Seat #1 is the button
Seat 1: e42ef20a ($10 in chips)
Seat 2: b26865c7 ($10.41 in chips)
Seat 3: Hero ($7.25 in chips)
Seat 4: da9996a8 ($15.25 in chips)
Seat 5: 5aadc600 ($9.45 in chips)
Seat 6: 551d9a48 ($11.41 in chips)
b26865c7: posts small blind $0.05
Hero: posts big blind $0.1
*** HOLE CARDS ***
Dealt to e42ef20a 
Dealt to b26865c7 
Dealt to Hero [Qc 3c]
Dealt to da9996a8 
Dealt to 5aadc600 
Dealt to 551d9a48 
da9996a8: folds
5aadc600: folds
551d9a48: folds
e42ef20a: raises $0.14 to $0.24
b26865c7: folds
Hero: folds
Uncalled bet ($0.14) returned to e42ef20a
*** SHOWDOWN ***
e42ef20a collected $0.25 from pot
*** SUMMARY ***
Total pot $0.25 | Rake $0 | Jackpot $0 | Bingo $0 | Fortune $0
Seat 1: e42ef20a (button) collected ($0.25)
Seat 2: b26865c7 (small blind) folded before Flop
Seat 3: Hero (big blind) folded before Flop
Seat 4: da9996a8 folded before Flop (didn't bet)
Seat 5: 5aadc600 folded before Flop (didn't bet)
Seat 6: 551d9a48 folded before Flop (didn't bet)


Poker Hand #RC1459698950: Hold'em No Limit  ($0.05/$0.1) - 2023/04/08 18:41:19
Table 'RushAndCash3724210' 6-max Seat #1 is the button
Seat 1: Hero ($7.25 in chips)
Seat 2: a105d843 ($10.58 in chips)
Seat 3: f6f523c1 ($15.26 in chips)
Seat 4: 5ac9aac5 ($10.87 in chips)
Seat 5: 7ad6ead ($19.58 in chips)
Seat 6: 9dee7ae5 ($7.71 in chips)
a105d843: posts small blind $0.05
f6f523c1: posts big blind $0.1
*** HOLE CARDS ***
Dealt to Hero [Ts 3h]
Dealt to a105d843 
Dealt to f6f523c1 
Dealt to 5ac9aac5 
Dealt to 7ad6ead 
Dealt to 9dee7ae5 
5ac9aac5: folds
7ad6ead: folds
9dee7ae5: raises $0.2 to $0.3
Hero: folds
a105d843: folds
f6f523c1: folds
Uncalled bet ($0.2) returned to 9dee7ae5
*** SHOWDOWN ***
9dee7ae5 collected $0.25 from pot
*** SUMMARY ***
Total pot $0.25 | Rake $0 | Jackpot $0 | Bingo $0 | Fortune $0
Seat 1: Hero (button) folded before Flop (didn't bet)
Seat 2: a105d843 (small blind) folded before Flop
Seat 3: f6f523c1 (big blind) folded before Flop
Seat 4: 5ac9aac5 folded before Flop (didn't bet)
Seat 5: 7ad6ead folded before Flop (didn't bet)
Seat 6: 9dee7ae5 collected ($0.25)


Poker Hand #RC1459698856: Hold'em No Limit  ($0.05/$0.1) - 2023/04/08 18:41:06
Table 'RushAndCash3724116' 6-max Seat #1 is the button
Seat 1: 473b8bf3 ($10.11 in chips)
Seat 2: 9329c29c ($12.12 in chips)
Seat 3: 10a34642 ($10.9 in chips)
Seat 4: c94bb7ca ($15.59 in chips)
Seat 5: 2f04e900 ($10.65 in chips)
Seat 6: Hero ($7.1 in chips)
9329c29c: posts small blind $0.05
10a34642: posts big blind $0.1
*** HOLE CARDS ***
Dealt to 473b8bf3 
Dealt to 9329c29c 
Dealt to 10a34642 
Dealt to c94bb7ca 
Dealt to 2f04e900 
Dealt to Hero [Ad 8s]
c94bb7ca: folds
2f04e900: folds
Hero: raises $0.15 to $0.25
473b8bf3: folds
9329c29c: folds
10a34642: folds
Uncalled bet ($0.15) returned to Hero
*** SHOWDOWN ***
Hero collected $0.25 from pot
*** SUMMARY ***
Total pot $0.25 | Rake $0 | Jackpot $0 | Bingo $0 | Fortune $0
Seat 1: 473b8bf3 (button) folded before Flop (didn't bet)
Seat 2: 9329c29c (small blind) folded before Flop
Seat 3: 10a34642 (big blind) folded before Flop
Seat 4: c94bb7ca folded before Flop (didn't bet)
Seat 5: 2f04e900 folded before Flop (didn't bet)
Seat 6: Hero collected ($0.25)


Poker Hand #RC1459698800: Hold'em No Limit  ($0.05/$0.1) - 2023/04/08 18:40:59
Table 'RushAndCash3724060' 6-max Seat #1 is the button
Seat 1: 64ce4b63 ($10.33 in chips)
Seat 2: 2d29227e ($9.85 in chips)
Seat 3: 46b2eca6 ($9.06 in chips)
Seat 4: 723809a3 ($9.04 in chips)
Seat 5: Hero ($7.1 in chips)
Seat 6: 18e279a4 ($36.21 in chips)
2d29227e: posts small blind $0.05
46b2eca6: posts big blind $0.1
*** HOLE CARDS ***
Dealt to 64ce4b63 
Dealt to 2d29227e 
Dealt to 46b2eca6 
Dealt to 723809a3 
Dealt to Hero [Kh 9c]
Dealt to 18e279a4 
723809a3: folds
Hero: folds
18e279a4: folds
64ce4b63: folds
2d29227e: folds
Uncalled bet ($0.05) returned to 46b2eca6
*** SHOWDOWN ***
46b2eca6 collected $0.1 from pot
*** SUMMARY ***
Total pot $0.1 | Rake $0 | Jackpot $0 | Bingo $0 | Fortune $0
Seat 1: 64ce4b63 (button) folded before Flop (didn't bet)
Seat 2: 2d29227e (small blind) folded before Flop
Seat 3: 46b2eca6 (big blind) collected ($0.1)
Seat 4: 723809a3 folded before Flop (didn't bet)
Seat 5: Hero folded before Flop (didn't bet)
Seat 6: 18e279a4 folded before Flop (didn't bet)


Poker Hand #RC1459698747: Hold'em No Limit  ($0.05/$0.1) - 2023/04/08 18:40:51
Table 'RushAndCash3724007' 6-max Seat #1 is the button
Seat 1: 16679d4b ($43.1 in chips)
Seat 2: 610bd8fa ($26.37 in chips)
Seat 3: 43c7fa3b ($11.21 in chips)
Seat 4: 5f6e1d8f ($33.54 in chips)
Seat 5: 49da03d9 ($17.08 in chips)
Seat 6: Hero ($7.1 in chips)
610bd8fa: posts small blind $0.05
43c7fa3b: posts big blind $0.1
*** HOLE CARDS ***
Dealt to 16679d4b 
Dealt to 610bd8fa 
Dealt to 43c7fa3b 
Dealt to 5f6e1d8f 
Dealt to 49da03d9 
Dealt to Hero [Ts 2s]
5f6e1d8f: folds
49da03d9: folds
Hero: folds
16679d4b: raises $0.15 to $0.25
610bd8fa: raises $0.45 to $0.7
43c7fa3b: folds
16679d4b: folds
Uncalled bet ($0.45) returned to 610bd8fa
*** SHOWDOWN ***
610bd8fa collected $0.57 from pot
*** SUMMARY ***
Total pot $0.6 | Rake $0.03 | Jackpot $0 | Bingo $0 | Fortune $0
Seat 1: 16679d4b (button) folded before Flop
Seat 2: 610bd8fa (small blind) collected ($0.57)
Seat 3: 43c7fa3b (big blind) folded before Flop
Seat 4: 5f6e1d8f folded before Flop (didn't bet)
Seat 5: 49da03d9 folded before Flop (didn't bet)
Seat 6: Hero folded before Flop (didn't bet)


Poker Hand #RC1459698633: Hold'em No Limit  ($0.05/$0.1) - 2023/04/08 18:40:35
Table 'RushAndCash3723893' 6-max Seat #1 is the button
Seat 1: 69d34ba9 ($10 in chips)
Seat 2: Hero ($6.85 in chips)
Seat 3: 48603560 ($9.56 in chips)
Seat 4: b0c67a51 ($15.46 in chips)
Seat 5: 2ee0b364 ($24.39 in chips)
Seat 6: 21ff1977 ($10 in chips)
Hero: posts small blind $0.05
48603560: posts big blind $0.1
*** HOLE CARDS ***
Dealt to 69d34ba9 
Dealt to Hero [Jh Qs]
Dealt to 48603560 
Dealt to b0c67a51 
Dealt to 2ee0b364 
Dealt to 21ff1977 
b0c67a51: folds
2ee0b364: folds
21ff1977: folds
69d34ba9: folds
Hero: raises $0.2 to $0.3
48603560: folds
Uncalled bet ($0.2) returned to Hero
*** SHOWDOWN ***
Hero collected $0.2 from pot
*** SUMMARY ***
Total pot $0.2 | Rake $0 | Jackpot $0 | Bingo $0 | Fortune $0
Seat 1: 69d34ba9 (button) folded before Flop (didn't bet)
Seat 2: Hero (small blind) collected ($0.2)
Seat 3: 48603560 (big blind) folded before Flop
Seat 4: b0c67a51 folded before Flop (didn't bet)
Seat 5: 2ee0b364 folded before Flop (didn't bet)
Seat 6: 21ff1977 folded before Flop (didn't bet)


Poker Hand #RC1459698597: Hold'em No Limit  ($0.05/$0.1) - 2023/04/08 18:40:30
Table 'RushAndCash3723857' 6-max Seat #1 is the button
Seat 1: 1327922c ($10 in chips)
Seat 2: 54dcb36b ($17.98 in chips)
Seat 3: Hero ($6.95 in chips)
Seat 4: 845fb6fd ($14.28 in chips)
Seat 5: 280b7b ($29.32 in chips)
Seat 6: e3b1ef81 ($11.13 in chips)
54dcb36b: posts small blind $0.05
Hero: posts big blind $0.1
*** HOLE CARDS ***
Dealt to 1327922c 
Dealt to 54dcb36b 
Dealt to Hero [3c 9d]
Dealt to 845fb6fd 
Dealt to 280b7b 
Dealt to e3b1ef81 
845fb6fd: folds
280b7b: folds
e3b1ef81: folds
1327922c: folds
54dcb36b: folds
Uncalled bet ($0.05) returned to Hero
*** SHOWDOWN ***
Hero collected $0.1 from pot
*** SUMMARY ***
Total pot $0.1 | Rake $0 | Jackpot $0 | Bingo $0 | Fortune $0
Seat 1: 1327922c (button) folded before Flop (didn't bet)
Seat 2: 54dcb36b (small blind) folded before Flop
Seat 3: Hero (big blind) collected ($0.1)
Seat 4: 845fb6fd folded before Flop (didn't bet)
Seat 5: 280b7b folded before Flop (didn't bet)
Seat 6: e3b1ef81 folded before Flop (didn't bet)


Poker Hand #RC1459698538: Hold'em No Limit  ($0.05/$0.1) - 2023/04/08 18:40:23
Table 'RushAndCash3723798' 6-max Seat #1 is the button
Seat 1: Hero ($6.95 in chips)
Seat 2: b7d3e2c6 ($10 in chips)
Seat 3: 5b870df8 ($10.05 in chips)
Seat 4: b5896cd4 ($10.79 in chips)
Seat 5: 25bcf459 ($10.08 in chips)
Seat 6: b7a4a7aa ($12.92 in chips)
b7d3e2c6: posts small blind $0.05
5b870df8: posts big blind $0.1
*** HOLE CARDS ***
Dealt to Hero [9s 2d]
Dealt to b7d3e2c6 
Dealt to 5b870df8 
Dealt to b5896cd4 
Dealt to 25bcf459 
Dealt to b7a4a7aa 
b5896cd4: folds
25bcf459: folds
b7a4a7aa: folds
Hero: folds
b7d3e2c6: raises $0.2 to $0.3
5b870df8: folds
Uncalled bet ($0.2) returned to b7d3e2c6
*** SHOWDOWN ***
b7d3e2c6 collected $0.2 from pot
*** SUMMARY ***
Total pot $0.2 | Rake $0 | Jackpot $0 | Bingo $0 | Fortune $0
Seat 1: Hero (button) folded before Flop (didn't bet)
Seat 2: b7d3e2c6 (small blind) collected ($0.2)
Seat 3: 5b870df8 (big blind) folded before Flop
Seat 4: b5896cd4 folded before Flop (didn't bet)
Seat 5: 25bcf459 folded before Flop (didn't bet)
Seat 6: b7a4a7aa folded before Flop (didn't bet)


Poker Hand #RC1459698498: Hold'em No Limit  ($0.05/$0.1) - 2023/04/08 18:40:18
Table 'RushAndCash3723758' 6-max Seat #1 is the button
Seat 1: 7afcaabb ($37.5 in chips)
Seat 2: a4a4271f ($18.16 in chips)
Seat 3: b10b0984 ($12.14 in chips)
Seat 4: Hero ($6.95 in chips)
Seat 5: 5b870df8 ($10.05 in chips)
Seat 6: 42f7499e ($13.14 in chips)
a4a4271f: posts small blind $0.05
b10b0984: posts big blind $0.1
*** HOLE CARDS ***
Dealt to 7afcaabb 
Dealt to a4a4271f 
Dealt to b10b0984 
Dealt to Hero [9h 5h]
Dealt to 5b870df8 
Dealt to 42f7499e 
Hero: folds
5b870df8: folds
42f7499e: folds
7afcaabb: folds
a4a4271f: raises $0.1 to $0.2
b10b0984: calls $0.1
*** FLOP *** [4c 2d Kd]
a4a4271f: bets $0.14
b10b0984: calls $0.14
*** TURN *** [4c 2d Kd] [3h]
a4a4271f: bets $0.55
b10b0984: calls $0.55
*** RIVER *** [4c 2d Kd 3h] [7c]
a4a4271f: bets $1.3
b10b0984: calls $1.3
a4a4271f: shows [Kc Th] (Pair of Kings)
b10b0984: shows [Qd Kh] (Pair of Kings)
*** SHOWDOWN ***
b10b0984 collected $4.02 from pot
*** SUMMARY ***
Total pot $4.38 | Rake $0.21 | Jackpot $0.15 | Bingo $0 | Fortune $0
Board [4c 2d Kd 3h 7c]
Seat 1: 7afcaabb (button) folded before Flop (didn't bet)
Seat 2: a4a4271f (small blind) showed [Kc Th] and lost with Pair of Kings
Seat 3: b10b0984 (big blind) showed [Qd Kh] and won ($4.02) with Pair of Kings
Seat 4: Hero folded before Flop (didn't bet)
Seat 5: 5b870df8 folded before Flop (didn't bet)
Seat 6: 42f7499e folded before Flop (didn't bet)


Poker Hand #RC1459698465: Hold'em No Limit  ($0.05/$0.1) - 2023/04/08 18:40:14
Table 'RushAndCash3723725' 6-max Seat #1 is the button
Seat 1: 556685d2 ($36.15 in chips)
Seat 2: 7c90268 ($24.47 in chips)
Seat 3: 4d4b4f20 ($8.84 in chips)
Seat 4: Hero ($6.95 in chips)
Seat 5: dabfa6fb ($10.76 in chips)
Seat 6: 38af2554 ($10.15 in chips)
7c90268: posts small blind $0.05
4d4b4f20: posts big blind $0.1
*** HOLE CARDS ***
Dealt to 556685d2 
Dealt to 7c90268 
Dealt to 4d4b4f20 
Dealt to Hero [7h Ts]
Dealt to dabfa6fb 
Dealt to 38af2554 
Hero: folds
dabfa6fb: folds
38af2554: folds
556685d2: raises $0.15 to $0.25
7c90268: raises $0.85 to $1.1
4d4b4f20: folds
556685d2: folds
Uncalled bet ($0.85) returned to 7c90268
*** SHOWDOWN ***
7c90268 collected $0.57 from pot
*** SUMMARY ***
Total pot $0.6 | Rake $0.03 | Jackpot $0 | Bingo $0 | Fortune $0
Seat 1: 556685d2 (button) folded before Flop
Seat 2: 7c90268 (small blind) collected ($0.57)
Seat 3: 4d4b4f20 (big blind) folded before Flop
Seat 4: Hero folded before Flop (didn't bet)
Seat 5: dabfa6fb folded before Flop (didn't bet)
Seat 6: 38af2554 folded before Flop (didn't bet)


Poker Hand #RC1459698420: Hold'em No Limit  ($0.05/$0.1) - 2023/04/08 18:40:08
Table 'RushAndCash3723680' 6-max Seat #1 is the button
Seat 1: ccff2929 ($13.15 in chips)
Seat 2: c3c0fb7f ($10.05 in chips)
Seat 3: d875d5a8 ($17.59 in chips)
Seat 4: Hero ($6.95 in chips)
Seat 5: 2a6dcfd6 ($13.93 in chips)
Seat 6: 87a1d34 ($12.08 in chips)
c3c0fb7f: posts small blind $0.05
d875d5a8: posts big blind $0.1
*** HOLE CARDS ***
Dealt to ccff2929 
Dealt to c3c0fb7f 
Dealt to d875d5a8 
Dealt to Hero [7c Jh]
Dealt to 2a6dcfd6 
Dealt to 87a1d34 
Hero: folds
2a6dcfd6: folds
87a1d34: raises $0.2 to $0.3
ccff2929: calls $0.3
c3c0fb7f: folds
d875d5a8: folds
*** FLOP *** [Tc 2c 8d]
87a1d34: bets $0.75
ccff2929: folds
Uncalled bet ($0.75) returned to 87a1d34
*** SHOWDOWN ***
87a1d34 collected $0.72 from pot
*** SUMMARY ***
Total pot $0.75 | Rake $0.03 | Jackpot $0 | Bingo $0 | Fortune $0
Board [Tc 2c 8d]
Seat 1: ccff2929 (button) folded on the Flop
Seat 2: c3c0fb7f (small blind) folded before Flop
Seat 3: d875d5a8 (big blind) folded before Flop
Seat 4: Hero folded before Flop (didn't bet)
Seat 5: 2a6dcfd6 folded before Flop (didn't bet)
Seat 6: 87a1d34 won ($0.72)


Poker Hand #RC1459698309: Hold'em No Limit  ($0.05/$0.1) - 2023/04/08 18:39:53
Table 'RushAndCash3723569' 6-max Seat #1 is the button
Seat 1: Hero ($6.95 in chips)
Seat 2: 723809a3 ($7.42 in chips)
Seat 3: 87db6293 ($12.42 in chips)
Seat 4: 965cd401 ($11.04 in chips)
Seat 5: 774d1f3e ($13.74 in chips)
Seat 6: 27089392 ($14.33 in chips)
723809a3: posts small blind $0.05
87db6293: posts big blind $0.1
*** HOLE CARDS ***
Dealt to Hero [8d 9c]
Dealt to 723809a3 
Dealt to 87db6293 
Dealt to 965cd401 
Dealt to 774d1f3e 
Dealt to 27089392 
965cd401: calls $0.1
774d1f3e: folds
27089392: folds
Hero: folds
723809a3: folds
87db6293: checks
*** FLOP *** [Jh 4c 8h]
87db6293: checks
965cd401: checks
*** TURN *** [Jh 4c 8h] [Qd]
87db6293: bets $0.13
965cd401: folds
Uncalled bet ($0.13) returned to 87db6293
*** SHOWDOWN ***
87db6293 collected $0.24 from pot
*** SUMMARY ***
Total pot $0.25 | Rake $0.01 | Jackpot $0 | Bingo $0 | Fortune $0
Board [Jh 4c 8h Qd]
Seat 1: Hero (button) folded before Flop (didn't bet)
Seat 2: 723809a3 (small blind) folded before Flop
Seat 3: 87db6293 (big blind) won ($0.24)
Seat 4: 965cd401 folded on the Turn
Seat 5: 774d1f3e folded before Flop (didn't bet)
Seat 6: 27089392 folded before Flop (didn't bet)


Poker Hand #RC1459698177: Hold'em No Limit  ($0.05/$0.1) - 2023/04/08 18:39:33
Table 'RushAndCash3723437' 6-max Seat #1 is the button
Seat 1: bd7187c2 ($10.13 in chips)
Seat 2: Hero ($7 in chips)
Seat 3: f3ee4b79 ($16.25 in chips)
Seat 4: f0124f54 ($12.55 in chips)
Seat 5: efa65cf6 ($10.77 in chips)
Seat 6: 44db3358 ($17.07 in chips)
Hero: posts small blind $0.05
f3ee4b79: posts big blind $0.1
*** HOLE CARDS ***
Dealt to bd7187c2 
Dealt to Hero [Jd Qd]
Dealt to f3ee4b79 
Dealt to f0124f54 
Dealt to efa65cf6 
Dealt to 44db3358 
f0124f54: raises $0.14 to $0.24
efa65cf6: folds
44db3358: raises $0.48 to $0.72
bd7187c2: folds
Hero: folds
f3ee4b79: folds
f0124f54: raises $2.07 to $2.79
44db3358: calls $2.07
*** FLOP *** [5s Tc Qs]
f0124f54: bets $3.33
44db3358: calls $3.33
*** TURN *** [5s Tc Qs] [3s]
f0124f54: bets $6.43 and is all-in
44db3358: folds
Uncalled bet ($6.43) returned to f0124f54
*** SHOWDOWN ***
f0124f54 collected $11.94 from pot
*** SUMMARY ***
Total pot $12.39 | Rake $0.3 | Jackpot $0.15 | Bingo $0 | Fortune $0
Board [5s Tc Qs 3s]
Seat 1: bd7187c2 (button) folded before Flop (didn't bet)
Seat 2: Hero (small blind) folded before Flop
Seat 3: f3ee4b79 (big blind) folded before Flop
Seat 4: f0124f54 won ($11.94)
Seat 5: efa65cf6 folded before Flop (didn't bet)
Seat 6: 44db3358 folded on the Turn


Poker Hand #RC1459697589: Hold'em No Limit  ($0.05/$0.1) - 2023/04/08 18:38:16
Table 'RushAndCash3722849' 6-max Seat #1 is the button
Seat 1: d572f62 ($17.76 in chips)
Seat 2: 7cf4a7e ($10 in chips)
Seat 3: Hero ($10 in chips)
Seat 4: 84b71732 ($4.21 in chips)
Seat 5: 2f88240a ($9.7 in chips)
Seat 6: cd592fdb ($10 in chips)
7cf4a7e: posts small blind $0.05
Hero: posts big blind $0.1
*** HOLE CARDS ***
Dealt to d572f62 
Dealt to 7cf4a7e 
Dealt to Hero [Kh Ad]
Dealt to 84b71732 
Dealt to 2f88240a 
Dealt to cd592fdb 
84b71732: folds
2f88240a: folds
cd592fdb: folds
d572f62: folds
7cf4a7e: raises $0.2 to $0.3
Hero: raises $0.45 to $0.75
7cf4a7e: calls $0.45
*** FLOP *** [5d Qh 9d]
7cf4a7e: checks
Hero: checks
*** TURN *** [5d Qh 9d] [Kd]
7cf4a7e: bets $0.75
Hero: calls $0.75
*** RIVER *** [5d Qh 9d Kd] [7s]
7cf4a7e: bets $1.5
Hero: calls $1.5
7cf4a7e: shows [5s Ks] (Pair of Kings and Pair of Fives)
Hero: shows [Kh Ad] (Pair of Kings)
*** SHOWDOWN ***
7cf4a7e collected $5.56 from pot
*** SUMMARY ***
Total pot $6 | Rake $0.29 | Jackpot $0.15 | Bingo $0 | Fortune $0
Board [5d Qh 9d Kd 7s]
Seat 1: d572f62 (button) folded before Flop (didn't bet)
Seat 2: 7cf4a7e (small blind) showed [5s Ks] and won ($5.56) with Pair of Kings and Pair of Fives
Seat 3: Hero (big blind) showed [Kh Ad] and lost with Pair of Kings
Seat 4: 84b71732 folded before Flop (didn't bet)
Seat 5: 2f88240a folded before Flop (didn't bet)
Seat 6: cd592fdb folded before Flop (didn't bet)


