Poker Hand #RC1452555329: Hold'em No Limit  ($0.05/$0.1) - 2023/04/05 14:15:45
Table 'RushAndCash2210589' 6-max Seat #1 is the button
Seat 1: Hero ($24.02 in chips)
Seat 2: df695c35 ($13.45 in chips)
Seat 3: 72f9c123 ($15.87 in chips)
Seat 4: ce555ed9 ($12.86 in chips)
Seat 5: 6d446e53 ($34.74 in chips)
Seat 6: 9a6f7755 ($7.73 in chips)
df695c35: posts small blind $0.05
72f9c123: posts big blind $0.1
*** HOLE CARDS ***
Dealt to Hero [Jh Qs]
Dealt to df695c35 
Dealt to 72f9c123 
Dealt to ce555ed9 
Dealt to 6d446e53 
Dealt to 9a6f7755 
ce555ed9: folds
6d446e53: folds
9a6f7755: folds
Hero: raises $0.15 to $0.25
df695c35: calls $0.2
72f9c123: calls $0.15
*** FLOP *** [2c Ac 7c]
df695c35: checks
72f9c123: checks
Hero: bets $0.25
df695c35: calls $0.25
72f9c123: folds
*** TURN *** [2c Ac 7c] [9s]
df695c35: checks
Hero: bets $0.52
df695c35: calls $0.52
*** RIVER *** [2c Ac 7c 9s] [4d]
df695c35: checks
Hero: checks
df695c35: shows [5h Ad] (Pair of Aces)
Hero: shows [Jh Qs] (Ace-High)
*** SHOWDOWN ***
df695c35 collected $2.18 from pot
*** SUMMARY ***
Total pot $2.29 | Rake $0.11 | Jackpot $0 | Bingo $0 | Fortune $0
Board [2c Ac 7c 9s 4d]
Seat 1: Hero (button) showed [Jh Qs] and lost with Ace-High
Seat 2: df695c35 (small blind) showed [5h Ad] and won ($2.18) with Pair of Aces
Seat 3: 72f9c123 (big blind) folded on the Flop
Seat 4: ce555ed9 folded before Flop (didn't bet)
Seat 5: 6d446e53 folded before Flop (didn't bet)
Seat 6: 9a6f7755 folded before Flop (didn't bet)


Poker Hand #RC1452555259: Hold'em No Limit  ($0.05/$0.1) - 2023/04/05 14:15:33
Table 'RushAndCash2210519' 6-max Seat #1 is the button
Seat 1: 99eba33b ($10 in chips)
Seat 2: a20fe157 ($10.15 in chips)
Seat 3: 2c16c8c7 ($13.85 in chips)
Seat 4: f60dcbf ($23.86 in chips)
Seat 5: Hero ($24.02 in chips)
Seat 6: d313d273 ($15.82 in chips)
a20fe157: posts small blind $0.05
2c16c8c7: posts big blind $0.1
*** HOLE CARDS ***
Dealt to 99eba33b 
Dealt to a20fe157 
Dealt to 2c16c8c7 
Dealt to f60dcbf 
Dealt to Hero [Jd 6s]
Dealt to d313d273 
f60dcbf: folds
Hero: folds
d313d273: folds
99eba33b: raises $0.15 to $0.25
a20fe157: folds
2c16c8c7: raises $0.75 to $1
99eba33b: folds
Uncalled bet ($0.75) returned to 2c16c8c7
*** SHOWDOWN ***
2c16c8c7 collected $0.53 from pot
*** SUMMARY ***
Total pot $0.55 | Rake $0.02 | Jackpot $0 | Bingo $0 | Fortune $0
Seat 1: 99eba33b (button) folded before Flop
Seat 2: a20fe157 (small blind) folded before Flop
Seat 3: 2c16c8c7 (big blind) collected ($0.53)
Seat 4: f60dcbf folded before Flop (didn't bet)
Seat 5: Hero folded before Flop (didn't bet)
Seat 6: d313d273 folded before Flop (didn't bet)


Poker Hand #RC1452555219: Hold'em No Limit  ($0.05/$0.1) - 2023/04/05 14:15:26
Table 'RushAndCash2210479' 6-max Seat #1 is the button
Seat 1: 4318627e ($18.7 in chips)
Seat 2: 72f9c123 ($15.92 in chips)
Seat 3: 4f0680fd ($10.3 in chips)
Seat 4: Hero ($24.02 in chips)
Seat 5: f13c6007 ($12.47 in chips)
Seat 6: 94b4ff67 ($10 in chips)
72f9c123: posts small blind $0.05
4f0680fd: posts big blind $0.1
*** HOLE CARDS ***
Dealt to 4318627e 
Dealt to 72f9c123 
Dealt to 4f0680fd 
Dealt to Hero [Jc 2s]
Dealt to f13c6007 
Dealt to 94b4ff67 
Hero: folds
f13c6007: folds
94b4ff67: folds
4318627e: raises $0.12 to $0.22
72f9c123: folds
4f0680fd: folds
Uncalled bet ($0.12) returned to 4318627e
*** SHOWDOWN ***
4318627e collected $0.25 from pot
*** SUMMARY ***
Total pot $0.25 | Rake $0 | Jackpot $0 | Bingo $0 | Fortune $0
Seat 1: 4318627e (button) collected ($0.25)
Seat 2: 72f9c123 (small blind) folded before Flop
Seat 3: 4f0680fd (big blind) folded before Flop
Seat 4: Hero folded before Flop (didn't bet)
Seat 5: f13c6007 folded before Flop (didn't bet)
Seat 6: 94b4ff67 folded before Flop (didn't bet)


Poker Hand #RC1452555155: Hold'em No Limit  ($0.05/$0.1) - 2023/04/05 14:15:16
Table 'RushAndCash2210415' 6-max Seat #1 is the button
Seat 1: Hero ($24.02 in chips)
Seat 2: c6a2ac2d ($8.26 in chips)
Seat 3: 9bc971a7 ($13.26 in chips)
Seat 4: f7f7a2ec ($10 in chips)
Seat 5: afb70526 ($10.13 in chips)
Seat 6: a0eedb3b ($10 in chips)
c6a2ac2d: posts small blind $0.05
9bc971a7: posts big blind $0.1
*** HOLE CARDS ***
Dealt to Hero [Th Kd]
Dealt to c6a2ac2d 
Dealt to 9bc971a7 
Dealt to f7f7a2ec 
Dealt to afb70526 
Dealt to a0eedb3b 
f7f7a2ec: raises $0.15 to $0.25
afb70526: folds
a0eedb3b: calls $0.25
Hero: folds
c6a2ac2d: calls $0.2
9bc971a7: folds
*** FLOP *** [4h 9h Ah]
c6a2ac2d: checks
f7f7a2ec: bets $0.29
a0eedb3b: folds
c6a2ac2d: calls $0.29
*** TURN *** [4h 9h Ah] [6c]
c6a2ac2d: checks
f7f7a2ec: checks
*** RIVER *** [4h 9h Ah 6c] [5s]
c6a2ac2d: bets $0.82
f7f7a2ec: folds
Uncalled bet ($0.82) returned to c6a2ac2d
*** SHOWDOWN ***
c6a2ac2d collected $1.36 from pot
*** SUMMARY ***
Total pot $1.43 | Rake $0.07 | Jackpot $0 | Bingo $0 | Fortune $0
Board [4h 9h Ah 6c 5s]
Seat 1: Hero (button) folded before Flop (didn't bet)
Seat 2: c6a2ac2d (small blind) won ($1.36)
Seat 3: 9bc971a7 (big blind) folded before Flop
Seat 4: f7f7a2ec folded on the River
Seat 5: afb70526 folded before Flop (didn't bet)
Seat 6: a0eedb3b folded on the Flop


Poker Hand #RC1452554987: Hold'em No Limit  ($0.05/$0.1) - 2023/04/05 14:14:51
Table 'RushAndCash2210247' 6-max Seat #1 is the button
Seat 1: bb32e045 ($10.33 in chips)
Seat 2: 5d892f0b ($11.11 in chips)
Seat 3: Hero ($24.12 in chips)
Seat 4: 9534c9c6 ($10.57 in chips)
Seat 5: a06f6f5d ($10.13 in chips)
Seat 6: aaf813a3 ($10 in chips)
5d892f0b: posts small blind $0.05
Hero: posts big blind $0.1
*** HOLE CARDS ***
Dealt to bb32e045 
Dealt to 5d892f0b 
Dealt to Hero [5s Jc]
Dealt to 9534c9c6 
Dealt to a06f6f5d 
Dealt to aaf813a3 
9534c9c6: folds
a06f6f5d: calls $0.1
aaf813a3: calls $0.1
bb32e045: raises $0.45 to $0.55
5d892f0b: folds
Hero: folds
a06f6f5d: folds
aaf813a3: raises $1.85 to $2.4
bb32e045: folds
Uncalled bet ($1.85) returned to aaf813a3
*** SHOWDOWN ***
aaf813a3 collected $1.29 from pot
*** SUMMARY ***
Total pot $1.35 | Rake $0.06 | Jackpot $0 | Bingo $0 | Fortune $0
Seat 1: bb32e045 (button) folded before Flop
Seat 2: 5d892f0b (small blind) folded before Flop
Seat 3: Hero (big blind) folded before Flop
Seat 4: 9534c9c6 folded before Flop (didn't bet)
Seat 5: a06f6f5d folded before Flop
Seat 6: aaf813a3 collected ($1.29)


Poker Hand #RC1452554925: Hold'em No Limit  ($0.05/$0.1) - 2023/04/05 14:14:42
Table 'RushAndCash2210185' 6-max Seat #1 is the button
Seat 1: db34e1de ($13.36 in chips)
Seat 2: 2b9f1ac1 ($58.41 in chips)
Seat 3: a83d7912 ($10.55 in chips)
Seat 4: dc88b3f ($10 in chips)
Seat 5: 27b9463 ($31.11 in chips)
Seat 6: Hero ($24.12 in chips)
2b9f1ac1: posts small blind $0.05
a83d7912: posts big blind $0.1
*** HOLE CARDS ***
Dealt to db34e1de 
Dealt to 2b9f1ac1 
Dealt to a83d7912 
Dealt to dc88b3f 
Dealt to 27b9463 
Dealt to Hero [5d 9h]
dc88b3f: raises $0.1 to $0.2
27b9463: folds
Hero: folds
db34e1de: folds
2b9f1ac1: folds
a83d7912: folds
Uncalled bet ($0.1) returned to dc88b3f
*** SHOWDOWN ***
dc88b3f collected $0.25 from pot
*** SUMMARY ***
Total pot $0.25 | Rake $0 | Jackpot $0 | Bingo $0 | Fortune $0
Seat 1: db34e1de (button) folded before Flop (didn't bet)
Seat 2: 2b9f1ac1 (small blind) folded before Flop
Seat 3: a83d7912 (big blind) folded before Flop
Seat 4: dc88b3f collected ($0.25)
Seat 5: 27b9463 folded before Flop (didn't bet)
Seat 6: Hero folded before Flop (didn't bet)


Poker Hand #RC1452554789: Hold'em No Limit  ($0.05/$0.1) - 2023/04/05 14:14:20
Table 'RushAndCash2210049' 6-max Seat #1 is the button
Seat 1: 3515f9b ($8.98 in chips)
Seat 2: f2dcd8ac ($20.54 in chips)
Seat 3: 82a4cb36 ($47.73 in chips)
Seat 4: b034e33d ($36.36 in chips)
Seat 5: Hero ($24.12 in chips)
Seat 6: 46664599 ($28.07 in chips)
f2dcd8ac: posts small blind $0.05
82a4cb36: posts big blind $0.1
*** HOLE CARDS ***
Dealt to 3515f9b 
Dealt to f2dcd8ac 
Dealt to 82a4cb36 
Dealt to b034e33d 
Dealt to Hero [6d Qc]
Dealt to 46664599 
b034e33d: folds
Hero: folds
46664599: folds
3515f9b: raises $0.15 to $0.25
f2dcd8ac: folds
82a4cb36: raises $0.75 to $1
3515f9b: calls $0.75
*** FLOP *** [3s Kc 5h]
82a4cb36: bets $0.96
3515f9b: calls $0.96
*** TURN *** [3s Kc 5h] [3h]
82a4cb36: checks
3515f9b: checks
*** RIVER *** [3s Kc 5h 3h] [Jc]
82a4cb36: checks
3515f9b: checks
82a4cb36: shows [6c Ad] (Pair of Treys)
3515f9b: shows [4h Ah] (Pair of Treys)
*** SHOWDOWN ***
82a4cb36 collected $1.82 from pot
3515f9b collected $1.82 from pot
*** SUMMARY ***
Total pot $3.97 | Rake $0.18 | Jackpot $0.15 | Bingo $0 | Fortune $0
Board [3s Kc 5h 3h Jc]
Seat 1: 3515f9b (button) showed [4h Ah] and won ($1.82) with Pair of Treys
Seat 2: f2dcd8ac (small blind) folded before Flop
Seat 3: 82a4cb36 (big blind) showed [6c Ad] and won ($1.82) with Pair of Treys
Seat 4: b034e33d folded before Flop (didn't bet)
Seat 5: Hero folded before Flop (didn't bet)
Seat 6: 46664599 folded before Flop (didn't bet)


Poker Hand #RC1452514246: Hold'em No Limit  ($0.05/$0.1) - 2023/04/05 14:12:59
Table 'RushAndCash2209506' 6-max Seat #1 is the button
Seat 1: f8ac1c7f ($12.7 in chips)
Seat 2: Hero ($22.73 in chips)
Seat 3: 82a4cb36 ($49.43 in chips)
Seat 4: 4c27b028 ($11.08 in chips)
Seat 5: d833e158 ($20.45 in chips)
Seat 6: be2ee371 ($15.23 in chips)
Hero: posts small blind $0.05
82a4cb36: posts big blind $0.1
*** HOLE CARDS ***
Dealt to f8ac1c7f 
Dealt to Hero [Kd Js]
Dealt to 82a4cb36 
Dealt to 4c27b028 
Dealt to d833e158 
Dealt to be2ee371 
4c27b028: folds
d833e158: folds
be2ee371: folds
f8ac1c7f: folds
Hero: raises $0.2 to $0.3
82a4cb36: calls $0.2
*** FLOP *** [2d 4s Kh]
Hero: bets $0.2
82a4cb36: calls $0.2
*** TURN *** [2d 4s Kh] [6h]
Hero: bets $0.5
82a4cb36: raises $0.7 to $1.2
Hero: calls $0.7
*** RIVER *** [2d 4s Kh 6h] [3c]
Hero: checks
82a4cb36: checks
Hero: shows [Kd Js] (Pair of Kings)
82a4cb36: shows [9c Kc] (Pair of Kings)
*** SHOWDOWN ***
Hero collected $3.09 from pot
*** SUMMARY ***
Total pot $3.4 | Rake $0.16 | Jackpot $0.15 | Bingo $0 | Fortune $0
Board [2d 4s Kh 6h 3c]
Seat 1: f8ac1c7f (button) folded before Flop (didn't bet)
Seat 2: Hero (small blind) showed [Kd Js] and won ($3.09) with Pair of Kings
Seat 3: 82a4cb36 (big blind) showed [9c Kc] and lost with Pair of Kings
Seat 4: 4c27b028 folded before Flop (didn't bet)
Seat 5: d833e158 folded before Flop (didn't bet)
Seat 6: be2ee371 folded before Flop (didn't bet)


Poker Hand #RC1452514191: Hold'em No Limit  ($0.05/$0.1) - 2023/04/05 14:12:51
Table 'RushAndCash2209451' 6-max Seat #1 is the button
Seat 1: 3b2080be ($10.15 in chips)
Seat 2: 46664599 ($27.7 in chips)
Seat 3: 7febd80b ($28 in chips)
Seat 4: Hero ($22.73 in chips)
Seat 5: 7b5ec42f ($10.15 in chips)
Seat 6: 2b9f1ac1 ($58.17 in chips)
46664599: posts small blind $0.05
7febd80b: posts big blind $0.1
*** HOLE CARDS ***
Dealt to 3b2080be 
Dealt to 46664599 
Dealt to 7febd80b 
Dealt to Hero [Ks 2c]
Dealt to 7b5ec42f 
Dealt to 2b9f1ac1 
Hero: folds
7b5ec42f: folds
2b9f1ac1: folds
3b2080be: raises $0.1 to $0.2
46664599: folds
7febd80b: folds
Uncalled bet ($0.1) returned to 3b2080be
*** SHOWDOWN ***
3b2080be collected $0.25 from pot
*** SUMMARY ***
Total pot $0.25 | Rake $0 | Jackpot $0 | Bingo $0 | Fortune $0
Seat 1: 3b2080be (button) collected ($0.25)
Seat 2: 46664599 (small blind) folded before Flop
Seat 3: 7febd80b (big blind) folded before Flop
Seat 4: Hero folded before Flop (didn't bet)
Seat 5: 7b5ec42f folded before Flop (didn't bet)
Seat 6: 2b9f1ac1 folded before Flop (didn't bet)


Poker Hand #RC1452514147: Hold'em No Limit  ($0.05/$0.1) - 2023/04/05 14:12:44
Table 'RushAndCash2209407' 6-max Seat #1 is the button
Seat 1: be2ee371 ($15.23 in chips)
Seat 2: a57a3d9d ($11.9 in chips)
Seat 3: 20d8eb1d ($23.47 in chips)
Seat 4: Hero ($22.73 in chips)
Seat 5: e6fcd974 ($5.91 in chips)
Seat 6: 4318627e ($17.73 in chips)
a57a3d9d: posts small blind $0.05
20d8eb1d: posts big blind $0.1
*** HOLE CARDS ***
Dealt to be2ee371 
Dealt to a57a3d9d 
Dealt to 20d8eb1d 
Dealt to Hero [2s 4c]
Dealt to e6fcd974 
Dealt to 4318627e 
Hero: folds
e6fcd974: raises $0.15 to $0.25
4318627e: folds
be2ee371: folds
a57a3d9d: folds
20d8eb1d: folds
Uncalled bet ($0.15) returned to e6fcd974
*** SHOWDOWN ***
e6fcd974 collected $0.25 from pot
*** SUMMARY ***
Total pot $0.25 | Rake $0 | Jackpot $0 | Bingo $0 | Fortune $0
Seat 1: be2ee371 (button) folded before Flop (didn't bet)
Seat 2: a57a3d9d (small blind) folded before Flop
Seat 3: 20d8eb1d (big blind) folded before Flop
Seat 4: Hero folded before Flop (didn't bet)
Seat 5: e6fcd974 collected ($0.25)
Seat 6: 4318627e folded before Flop (didn't bet)


Poker Hand #RC1452514106: Hold'em No Limit  ($0.05/$0.1) - 2023/04/05 14:12:38
Table 'RushAndCash2209366' 6-max Seat #1 is the button
Seat 1: 5ded43ce ($9.85 in chips)
Seat 2: Hero ($22.78 in chips)
Seat 3: f613f888 ($13.99 in chips)
Seat 4: 12176177 ($17.89 in chips)
Seat 5: c467c69c ($7.45 in chips)
Seat 6: 16a27d53 ($15.11 in chips)
Hero: posts small blind $0.05
f613f888: posts big blind $0.1
*** HOLE CARDS ***
Dealt to 5ded43ce 
Dealt to Hero [2h 5h]
Dealt to f613f888 
Dealt to 12176177 
Dealt to c467c69c 
Dealt to 16a27d53 
12176177: folds
c467c69c: folds
16a27d53: folds
5ded43ce: folds
Hero: folds
Uncalled bet ($0.05) returned to f613f888
*** SHOWDOWN ***
f613f888 collected $0.1 from pot
*** SUMMARY ***
Total pot $0.1 | Rake $0 | Jackpot $0 | Bingo $0 | Fortune $0
Seat 1: 5ded43ce (button) folded before Flop (didn't bet)
Seat 2: Hero (small blind) folded before Flop
Seat 3: f613f888 (big blind) collected ($0.1)
Seat 4: 12176177 folded before Flop (didn't bet)
Seat 5: c467c69c folded before Flop (didn't bet)
Seat 6: 16a27d53 folded before Flop (didn't bet)


Poker Hand #RC1452513970: Hold'em No Limit  ($0.05/$0.1) - 2023/04/05 14:12:15
Table 'RushAndCash2209230' 6-max Seat #1 is the button
Seat 1: dcb5ac90 ($10.66 in chips)
Seat 2: 6b1661e6 ($13.62 in chips)
Seat 3: Hero ($22.88 in chips)
Seat 4: be7df6c0 ($10.53 in chips)
Seat 5: 8895fd41 ($11.39 in chips)
Seat 6: de9c4f76 ($10.15 in chips)
6b1661e6: posts small blind $0.05
Hero: posts big blind $0.1
*** HOLE CARDS ***
Dealt to dcb5ac90 
Dealt to 6b1661e6 
Dealt to Hero [4h Jh]
Dealt to be7df6c0 
Dealt to 8895fd41 
Dealt to de9c4f76 
be7df6c0: folds
8895fd41: folds
de9c4f76: raises $0.15 to $0.25
dcb5ac90: folds
6b1661e6: folds
Hero: folds
Uncalled bet ($0.15) returned to de9c4f76
*** SHOWDOWN ***
de9c4f76 collected $0.25 from pot
*** SUMMARY ***
Total pot $0.25 | Rake $0 | Jackpot $0 | Bingo $0 | Fortune $0
Seat 1: dcb5ac90 (button) folded before Flop (didn't bet)
Seat 2: 6b1661e6 (small blind) folded before Flop
Seat 3: Hero (big blind) folded before Flop
Seat 4: be7df6c0 folded before Flop (didn't bet)
Seat 5: 8895fd41 folded before Flop (didn't bet)
Seat 6: de9c4f76 collected ($0.25)


Poker Hand #RC1452513938: Hold'em No Limit  ($0.05/$0.1) - 2023/04/05 14:12:10
Table 'RushAndCash2209198' 6-max Seat #1 is the button
Seat 1: fb74c442 ($15.14 in chips)
Seat 2: 4475a667 ($10 in chips)
Seat 3: 3d56be3d ($13.94 in chips)
Seat 4: cdd18ab7 ($10.34 in chips)
Seat 5: Hero ($22.88 in chips)
Seat 6: 4692d41d ($38.65 in chips)
4475a667: posts small blind $0.05
3d56be3d: posts big blind $0.1
*** HOLE CARDS ***
Dealt to fb74c442 
Dealt to 4475a667 
Dealt to 3d56be3d 
Dealt to cdd18ab7 
Dealt to Hero [Kc 8d]
Dealt to 4692d41d 
cdd18ab7: folds
Hero: folds
4692d41d: folds
fb74c442: raises $0.15 to $0.25
4475a667: folds
3d56be3d: folds
Uncalled bet ($0.15) returned to fb74c442
*** SHOWDOWN ***
fb74c442 collected $0.25 from pot
*** SUMMARY ***
Total pot $0.25 | Rake $0 | Jackpot $0 | Bingo $0 | Fortune $0
Seat 1: fb74c442 (button) collected ($0.25)
Seat 2: 4475a667 (small blind) folded before Flop
Seat 3: 3d56be3d (big blind) folded before Flop
Seat 4: cdd18ab7 folded before Flop (didn't bet)
Seat 5: Hero folded before Flop (didn't bet)
Seat 6: 4692d41d folded before Flop (didn't bet)


Poker Hand #RC1452513839: Hold'em No Limit  ($0.05/$0.1) - 2023/04/05 14:11:55
Table 'RushAndCash2209099' 6-max Seat #1 is the button
Seat 1: Hero ($22.73 in chips)
Seat 2: 4c27b028 ($11.33 in chips)
Seat 3: 8c2ff887 ($20.36 in chips)
Seat 4: 1526a93d ($10.15 in chips)
Seat 5: 9550a503 ($11.33 in chips)
Seat 6: 58952c3f ($15.4 in chips)
4c27b028: posts small blind $0.05
8c2ff887: posts big blind $0.1
*** HOLE CARDS ***
Dealt to Hero [Qd Ad]
Dealt to 4c27b028 
Dealt to 8c2ff887 
Dealt to 1526a93d 
Dealt to 9550a503 
Dealt to 58952c3f 
1526a93d: folds
9550a503: folds
58952c3f: folds
Hero: raises $0.15 to $0.25
4c27b028: folds
8c2ff887: folds
Uncalled bet ($0.15) returned to Hero
*** SHOWDOWN ***
Hero collected $0.25 from pot
*** SUMMARY ***
Total pot $0.25 | Rake $0 | Jackpot $0 | Bingo $0 | Fortune $0
Seat 1: Hero (button) collected ($0.25)
Seat 2: 4c27b028 (small blind) folded before Flop
Seat 3: 8c2ff887 (big blind) folded before Flop
Seat 4: 1526a93d folded before Flop (didn't bet)
Seat 5: 9550a503 folded before Flop (didn't bet)
Seat 6: 58952c3f folded before Flop (didn't bet)


Poker Hand #RC1452513708: Hold'em No Limit  ($0.05/$0.1) - 2023/04/05 14:11:37
Table 'RushAndCash2208968' 6-max Seat #1 is the button
Seat 1: b57bf5b8 ($25.6 in chips)
Seat 2: 5ade404 ($11.57 in chips)
Seat 3: 36e1f6fd ($10.25 in chips)
Seat 4: 2e03632f ($8.75 in chips)
Seat 5: Hero ($22.58 in chips)
Seat 6: 41dd08cf ($10.61 in chips)
5ade404: posts small blind $0.05
36e1f6fd: posts big blind $0.1
*** HOLE CARDS ***
Dealt to b57bf5b8 
Dealt to 5ade404 
Dealt to 36e1f6fd 
Dealt to 2e03632f 
Dealt to Hero [Jd Ks]
Dealt to 41dd08cf 
2e03632f: folds
Hero: raises $0.15 to $0.25
41dd08cf: folds
b57bf5b8: folds
5ade404: folds
36e1f6fd: folds
Uncalled bet ($0.15) returned to Hero
*** SHOWDOWN ***
Hero collected $0.25 from pot
*** SUMMARY ***
Total pot $0.25 | Rake $0 | Jackpot $0 | Bingo $0 | Fortune $0
Seat 1: b57bf5b8 (button) folded before Flop (didn't bet)
Seat 2: 5ade404 (small blind) folded before Flop
Seat 3: 36e1f6fd (big blind) folded before Flop
Seat 4: 2e03632f folded before Flop (didn't bet)
Seat 5: Hero collected ($0.25)
Seat 6: 41dd08cf folded before Flop (didn't bet)


Poker Hand #RC1452513667: Hold'em No Limit  ($0.05/$0.1) - 2023/04/05 14:11:31
Table 'RushAndCash2208927' 6-max Seat #1 is the button
Seat 1: ba94e6b7 ($10.05 in chips)
Seat 2: 651051e1 ($12.02 in chips)
Seat 3: 32a1b5e1 ($14.47 in chips)
Seat 4: Hero ($22.58 in chips)
Seat 5: d52ee192 ($10.45 in chips)
Seat 6: 64ea5b40 ($16.81 in chips)
651051e1: posts small blind $0.05
32a1b5e1: posts big blind $0.1
*** HOLE CARDS ***
Dealt to ba94e6b7 
Dealt to 651051e1 
Dealt to 32a1b5e1 
Dealt to Hero [8c Tc]
Dealt to d52ee192 
Dealt to 64ea5b40 
Hero: folds
d52ee192: folds
64ea5b40: folds
ba94e6b7: raises $0.13 to $0.23
651051e1: folds
32a1b5e1: folds
Uncalled bet ($0.13) returned to ba94e6b7
*** SHOWDOWN ***
ba94e6b7 collected $0.25 from pot
*** SUMMARY ***
Total pot $0.25 | Rake $0 | Jackpot $0 | Bingo $0 | Fortune $0
Seat 1: ba94e6b7 (button) collected ($0.25)
Seat 2: 651051e1 (small blind) folded before Flop
Seat 3: 32a1b5e1 (big blind) folded before Flop
Seat 4: Hero folded before Flop (didn't bet)
Seat 5: d52ee192 folded before Flop (didn't bet)
Seat 6: 64ea5b40 folded before Flop (didn't bet)


Poker Hand #RC1452513545: Hold'em No Limit  ($0.05/$0.1) - 2023/04/05 14:11:14
Table 'RushAndCash2208805' 6-max Seat #1 is the button
Seat 1: Hero ($22.58 in chips)
Seat 2: 4ceb413a ($17.47 in chips)
Seat 3: 8fab2ce9 ($16.21 in chips)
Seat 4: 3195e48b ($22.35 in chips)
Seat 5: d313d273 ($14.61 in chips)
Seat 6: 619d2d53 ($11.04 in chips)
4ceb413a: posts small blind $0.05
8fab2ce9: posts big blind $0.1
*** HOLE CARDS ***
Dealt to Hero [5s 2h]
Dealt to 4ceb413a 
Dealt to 8fab2ce9 
Dealt to 3195e48b 
Dealt to d313d273 
Dealt to 619d2d53 
3195e48b: folds
d313d273: folds
619d2d53: folds
Hero: folds
4ceb413a: folds
Uncalled bet ($0.05) returned to 8fab2ce9
*** SHOWDOWN ***
8fab2ce9 collected $0.1 from pot
*** SUMMARY ***
Total pot $0.1 | Rake $0 | Jackpot $0 | Bingo $0 | Fortune $0
Seat 1: Hero (button) folded before Flop (didn't bet)
Seat 2: 4ceb413a (small blind) folded before Flop
Seat 3: 8fab2ce9 (big blind) collected ($0.1)
Seat 4: 3195e48b folded before Flop (didn't bet)
Seat 5: d313d273 folded before Flop (didn't bet)
Seat 6: 619d2d53 folded before Flop (didn't bet)


Poker Hand #RC1452513496: Hold'em No Limit  ($0.05/$0.1) - 2023/04/05 14:11:06
Table 'RushAndCash2208756' 6-max Seat #1 is the button
Seat 1: 6f3c9961 ($9.85 in chips)
Seat 2: 261329f6 ($11.61 in chips)
Seat 3: Hero ($22.68 in chips)
Seat 4: 69f75b8a ($23.19 in chips)
Seat 5: afd369e3 ($10 in chips)
Seat 6: d833e158 ($10 in chips)
261329f6: posts small blind $0.05
Hero: posts big blind $0.1
*** HOLE CARDS ***
Dealt to 6f3c9961 
Dealt to 261329f6 
Dealt to Hero [Jh 5d]
Dealt to 69f75b8a 
Dealt to afd369e3 
Dealt to d833e158 
69f75b8a: raises $0.15 to $0.25
afd369e3: folds
d833e158: raises $0.5 to $0.75
6f3c9961: folds
261329f6: folds
Hero: folds
69f75b8a: folds
Uncalled bet ($0.5) returned to d833e158
*** SHOWDOWN ***
d833e158 collected $0.62 from pot
*** SUMMARY ***
Total pot $0.65 | Rake $0.03 | Jackpot $0 | Bingo $0 | Fortune $0
Seat 1: 6f3c9961 (button) folded before Flop (didn't bet)
Seat 2: 261329f6 (small blind) folded before Flop
Seat 3: Hero (big blind) folded before Flop
Seat 4: 69f75b8a folded before Flop
Seat 5: afd369e3 folded before Flop (didn't bet)
Seat 6: d833e158 collected ($0.62)


Poker Hand #RC1452513418: Hold'em No Limit  ($0.05/$0.1) - 2023/04/05 14:10:55
Table 'RushAndCash2208678' 6-max Seat #1 is the button
Seat 1: 72f9c123 ($16.6 in chips)
Seat 2: Hero ($22.73 in chips)
Seat 3: eb85b57b ($10 in chips)
Seat 4: e2579595 ($19.92 in chips)
Seat 5: 54c0c3de ($1.08 in chips)
Seat 6: ce736e8a ($10.15 in chips)
Hero: posts small blind $0.05
eb85b57b: posts big blind $0.1
*** HOLE CARDS ***
Dealt to 72f9c123 
Dealt to Hero [Ks 7s]
Dealt to eb85b57b 
Dealt to e2579595 
Dealt to 54c0c3de 
Dealt to ce736e8a 
e2579595: folds
54c0c3de: folds
ce736e8a: raises $0.15 to $0.25
72f9c123: folds
Hero: folds
eb85b57b: folds
Uncalled bet ($0.15) returned to ce736e8a
*** SHOWDOWN ***
ce736e8a collected $0.25 from pot
*** SUMMARY ***
Total pot $0.25 | Rake $0 | Jackpot $0 | Bingo $0 | Fortune $0
Seat 1: 72f9c123 (button) folded before Flop (didn't bet)
Seat 2: Hero (small blind) folded before Flop
Seat 3: eb85b57b (big blind) folded before Flop
Seat 4: e2579595 folded before Flop (didn't bet)
Seat 5: 54c0c3de folded before Flop (didn't bet)
Seat 6: ce736e8a collected ($0.25)


Poker Hand #RC1452513355: Hold'em No Limit  ($0.05/$0.1) - 2023/04/05 14:10:46
Table 'RushAndCash2208615' 6-max Seat #1 is the button
Seat 1: 1dc9431a ($34.1 in chips)
Seat 2: d9c6f21b ($13.49 in chips)
Seat 3: 41b9640a ($10 in chips)
Seat 4: b1a59cbb ($9.51 in chips)
Seat 5: Hero ($22.73 in chips)
Seat 6: ee5727d3 ($10 in chips)
d9c6f21b: posts small blind $0.05
41b9640a: posts big blind $0.1
*** HOLE CARDS ***
Dealt to 1dc9431a 
Dealt to d9c6f21b 
Dealt to 41b9640a 
Dealt to b1a59cbb 
Dealt to Hero [9h 5s]
Dealt to ee5727d3 
b1a59cbb: folds
Hero: folds
ee5727d3: folds
1dc9431a: raises $0.2 to $0.3
d9c6f21b: raises $0.88 to $1.18
41b9640a: folds
1dc9431a: calls $0.88
*** FLOP *** [3d 2h Kc]
d9c6f21b: checks
1dc9431a: checks
*** TURN *** [3d 2h Kc] [7s]
d9c6f21b: checks
1dc9431a: bets $1.23
d9c6f21b: calls $1.23
*** RIVER *** [3d 2h Kc 7s] [Qs]
d9c6f21b: checks
1dc9431a: bets $31.69 and is all-in
d9c6f21b: folds
Uncalled bet ($31.69) returned to 1dc9431a
*** SHOWDOWN ***
1dc9431a collected $4.54 from pot
*** SUMMARY ***
Total pot $4.92 | Rake $0.23 | Jackpot $0.15 | Bingo $0 | Fortune $0
Board [3d 2h Kc 7s Qs]
Seat 1: 1dc9431a (button) won ($4.54)
Seat 2: d9c6f21b (small blind) folded on the River
Seat 3: 41b9640a (big blind) folded before Flop
Seat 4: b1a59cbb folded before Flop (didn't bet)
Seat 5: Hero folded before Flop (didn't bet)
Seat 6: ee5727d3 folded before Flop (didn't bet)


Poker Hand #RC1452513269: Hold'em No Limit  ($0.05/$0.1) - 2023/04/05 14:10:34
Table 'RushAndCash2208529' 6-max Seat #1 is the button
Seat 1: 72f9c123 ($16.75 in chips)
Seat 2: cd93d621 ($10.9 in chips)
Seat 3: 8b640ccd ($14.26 in chips)
Seat 4: 3b0d8197 ($22.59 in chips)
Seat 5: Hero ($22.73 in chips)
Seat 6: 5f1f500b ($16.76 in chips)
cd93d621: posts small blind $0.05
8b640ccd: posts big blind $0.1
*** HOLE CARDS ***
Dealt to 72f9c123 
Dealt to cd93d621 
Dealt to 8b640ccd 
Dealt to 3b0d8197 
Dealt to Hero [6s Kd]
Dealt to 5f1f500b 
3b0d8197: folds
Hero: folds
5f1f500b: raises $0.13 to $0.23
72f9c123: folds
cd93d621: folds
8b640ccd: folds
Uncalled bet ($0.13) returned to 5f1f500b
*** SHOWDOWN ***
5f1f500b collected $0.25 from pot
*** SUMMARY ***
Total pot $0.25 | Rake $0 | Jackpot $0 | Bingo $0 | Fortune $0
Seat 1: 72f9c123 (button) folded before Flop (didn't bet)
Seat 2: cd93d621 (small blind) folded before Flop
Seat 3: 8b640ccd (big blind) folded before Flop
Seat 4: 3b0d8197 folded before Flop (didn't bet)
Seat 5: Hero folded before Flop (didn't bet)
Seat 6: 5f1f500b collected ($0.25)


Poker Hand #RC1452513199: Hold'em No Limit  ($0.05/$0.1) - 2023/04/05 14:10:23
Table 'RushAndCash2208459' 6-max Seat #1 is the button
Seat 1: Hero ($22.58 in chips)
Seat 2: 83527647 ($14.02 in chips)
Seat 3: e5e62705 ($12.42 in chips)
Seat 4: df87b5ec ($13.32 in chips)
Seat 5: 8aa666fa ($14.57 in chips)
Seat 6: b505c65 ($9.85 in chips)
83527647: posts small blind $0.05
e5e62705: posts big blind $0.1
*** HOLE CARDS ***
Dealt to Hero [Ad 2d]
Dealt to 83527647 
Dealt to e5e62705 
Dealt to df87b5ec 
Dealt to 8aa666fa 
Dealt to b505c65 
df87b5ec: folds
8aa666fa: folds
b505c65: folds
Hero: raises $0.15 to $0.25
83527647: folds
e5e62705: folds
Uncalled bet ($0.15) returned to Hero
*** SHOWDOWN ***
Hero collected $0.25 from pot
*** SUMMARY ***
Total pot $0.25 | Rake $0 | Jackpot $0 | Bingo $0 | Fortune $0
Seat 1: Hero (button) collected ($0.25)
Seat 2: 83527647 (small blind) folded before Flop
Seat 3: e5e62705 (big blind) folded before Flop
Seat 4: df87b5ec folded before Flop (didn't bet)
Seat 5: 8aa666fa folded before Flop (didn't bet)
Seat 6: b505c65 folded before Flop (didn't bet)


Poker Hand #RC1452513125: Hold'em No Limit  ($0.05/$0.1) - 2023/04/05 14:10:11
Table 'RushAndCash2208385' 6-max Seat #1 is the button
Seat 1: ff1848cb ($12.37 in chips)
Seat 2: c2ee58e1 ($10.05 in chips)
Seat 3: 923d611a ($13.91 in chips)
Seat 4: 8ece89d ($24.75 in chips)
Seat 5: 5d892f0b ($10 in chips)
Seat 6: Hero ($22.58 in chips)
c2ee58e1: posts small blind $0.05
923d611a: posts big blind $0.1
*** HOLE CARDS ***
Dealt to ff1848cb 
Dealt to c2ee58e1 
Dealt to 923d611a 
Dealt to 8ece89d 
Dealt to 5d892f0b 
Dealt to Hero [9s Ac]
8ece89d: raises $0.15 to $0.25
5d892f0b: folds
Hero: folds
ff1848cb: raises $0.49 to $0.74
c2ee58e1: folds
923d611a: folds
8ece89d: folds
Uncalled bet ($0.49) returned to ff1848cb
*** SHOWDOWN ***
ff1848cb collected $0.62 from pot
*** SUMMARY ***
Total pot $0.65 | Rake $0.03 | Jackpot $0 | Bingo $0 | Fortune $0
Seat 1: ff1848cb (button) collected ($0.62)
Seat 2: c2ee58e1 (small blind) folded before Flop
Seat 3: 923d611a (big blind) folded before Flop
Seat 4: 8ece89d folded before Flop
Seat 5: 5d892f0b folded before Flop (didn't bet)
Seat 6: Hero folded before Flop (didn't bet)


Poker Hand #RC1452512983: Hold'em No Limit  ($0.05/$0.1) - 2023/04/05 14:09:48
Table 'RushAndCash2208243' 6-max Seat #1 is the button
Seat 1: b982af16 ($19.34 in chips)
Seat 2: Hero ($22.63 in chips)
Seat 3: 5e0dfb65 ($11.48 in chips)
Seat 4: fc633c5b ($10.98 in chips)
Seat 5: 70bf7f7a ($39.66 in chips)
Seat 6: ce17024f ($10.32 in chips)
Hero: posts small blind $0.05
5e0dfb65: posts big blind $0.1
*** HOLE CARDS ***
Dealt to b982af16 
Dealt to Hero [9d 2s]
Dealt to 5e0dfb65 
Dealt to fc633c5b 
Dealt to 70bf7f7a 
Dealt to ce17024f 
fc633c5b: folds
70bf7f7a: folds
ce17024f: folds
b982af16: raises $0.14 to $0.24
Hero: folds
5e0dfb65: folds
Uncalled bet ($0.14) returned to b982af16
*** SHOWDOWN ***
b982af16 collected $0.25 from pot
*** SUMMARY ***
Total pot $0.25 | Rake $0 | Jackpot $0 | Bingo $0 | Fortune $0
Seat 1: b982af16 (button) collected ($0.25)
Seat 2: Hero (small blind) folded before Flop
Seat 3: 5e0dfb65 (big blind) folded before Flop
Seat 4: fc633c5b folded before Flop (didn't bet)
Seat 5: 70bf7f7a folded before Flop (didn't bet)
Seat 6: ce17024f folded before Flop (didn't bet)


Poker Hand #RC1452512868: Hold'em No Limit  ($0.05/$0.1) - 2023/04/05 14:09:29
Table 'RushAndCash2208128' 6-max Seat #1 is the button
Seat 1: e6fcd974 ($4.87 in chips)
Seat 2: e3b3cff1 ($10.05 in chips)
Seat 3: Hero ($22.73 in chips)
Seat 4: 5f1f500b ($17.01 in chips)
Seat 5: 28ecf119 ($19.76 in chips)
Seat 6: 43accfe2 ($26.92 in chips)
e3b3cff1: posts small blind $0.05
Hero: posts big blind $0.1
*** HOLE CARDS ***
Dealt to e6fcd974 
Dealt to e3b3cff1 
Dealt to Hero [8h Qc]
Dealt to 5f1f500b 
Dealt to 28ecf119 
Dealt to 43accfe2 
5f1f500b: folds
28ecf119: folds
43accfe2: folds
e6fcd974: folds
e3b3cff1: raises $0.2 to $0.3
Hero: folds
Uncalled bet ($0.2) returned to e3b3cff1
*** SHOWDOWN ***
e3b3cff1 collected $0.2 from pot
*** SUMMARY ***
Total pot $0.2 | Rake $0 | Jackpot $0 | Bingo $0 | Fortune $0
Seat 1: e6fcd974 (button) folded before Flop (didn't bet)
Seat 2: e3b3cff1 (small blind) collected ($0.2)
Seat 3: Hero (big blind) folded before Flop
Seat 4: 5f1f500b folded before Flop (didn't bet)
Seat 5: 28ecf119 folded before Flop (didn't bet)
Seat 6: 43accfe2 folded before Flop (didn't bet)


Poker Hand #RC1452512844: Hold'em No Limit  ($0.05/$0.1) - 2023/04/05 14:09:25
Table 'RushAndCash2208104' 6-max Seat #1 is the button
Seat 1: a83d7912 ($10.5 in chips)
Seat 2: 47e90b31 ($34.55 in chips)
Seat 3: 9bc971a7 ($11.04 in chips)
Seat 4: fd58be84 ($12.21 in chips)
Seat 5: Hero ($22.73 in chips)
Seat 6: 5f1f500b ($17.01 in chips)
47e90b31: posts small blind $0.05
9bc971a7: posts big blind $0.1
*** HOLE CARDS ***
Dealt to a83d7912 
Dealt to 47e90b31 
Dealt to 9bc971a7 
Dealt to fd58be84 
Dealt to Hero [7s 6d]
Dealt to 5f1f500b 
fd58be84: folds
Hero: folds
5f1f500b: folds
a83d7912: folds
47e90b31: folds
Uncalled bet ($0.05) returned to 9bc971a7
*** SHOWDOWN ***
9bc971a7 collected $0.1 from pot
*** SUMMARY ***
Total pot $0.1 | Rake $0 | Jackpot $0 | Bingo $0 | Fortune $0
Seat 1: a83d7912 (button) folded before Flop (didn't bet)
Seat 2: 47e90b31 (small blind) folded before Flop
Seat 3: 9bc971a7 (big blind) collected ($0.1)
Seat 4: fd58be84 folded before Flop (didn't bet)
Seat 5: Hero folded before Flop (didn't bet)
Seat 6: 5f1f500b folded before Flop (didn't bet)


Poker Hand #RC1452512464: Hold'em No Limit  ($0.05/$0.1) - 2023/04/05 14:08:22
Table 'RushAndCash2207724' 6-max Seat #1 is the button
Seat 1: cdf7bae4 ($9.5 in chips)
Seat 2: 7e3a9b95 ($44.11 in chips)
Seat 3: bc610cdc ($11.23 in chips)
Seat 4: Hero ($23.47 in chips)
Seat 5: 25edc198 ($38.13 in chips)
Seat 6: 5f1f500b ($16.2 in chips)
7e3a9b95: posts small blind $0.05
bc610cdc: posts big blind $0.1
*** HOLE CARDS ***
Dealt to cdf7bae4 
Dealt to 7e3a9b95 
Dealt to bc610cdc 
Dealt to Hero [8h 8d]
Dealt to 25edc198 
Dealt to 5f1f500b 
Hero: raises $0.15 to $0.25
25edc198: folds
5f1f500b: raises $0.49 to $0.74
cdf7bae4: folds
7e3a9b95: folds
bc610cdc: folds
Hero: calls $0.49
*** FLOP *** [Tc 9c 5d]
Hero: checks
5f1f500b: checks
*** TURN *** [Tc 9c 5d] [Jd]
Hero: checks
5f1f500b: checks
*** RIVER *** [Tc 9c 5d Jd] [Kc]
Hero: checks
5f1f500b: bets $1.23
Hero: folds
Uncalled bet ($1.23) returned to 5f1f500b
*** SHOWDOWN ***
5f1f500b collected $1.55 from pot
*** SUMMARY ***
Total pot $1.63 | Rake $0.08 | Jackpot $0 | Bingo $0 | Fortune $0
Board [Tc 9c 5d Jd Kc]
Seat 1: cdf7bae4 (button) folded before Flop (didn't bet)
Seat 2: 7e3a9b95 (small blind) folded before Flop
Seat 3: bc610cdc (big blind) folded before Flop
Seat 4: Hero folded on the River
Seat 5: 25edc198 folded before Flop (didn't bet)
Seat 6: 5f1f500b won ($1.55)


Poker Hand #RC1452512422: Hold'em No Limit  ($0.05/$0.1) - 2023/04/05 14:08:16
Table 'RushAndCash2207682' 6-max Seat #1 is the button
Seat 1: 7cef76bf ($10.62 in chips)
Seat 2: Hero ($23.52 in chips)
Seat 3: 63db930a ($9.81 in chips)
Seat 4: b360f60a ($5.04 in chips)
Seat 5: 9d02b34c ($9.88 in chips)
Seat 6: 47951ecc ($9.41 in chips)
Hero: posts small blind $0.05
63db930a: posts big blind $0.1
*** HOLE CARDS ***
Dealt to 7cef76bf 
Dealt to Hero [3d Qc]
Dealt to 63db930a 
Dealt to b360f60a 
Dealt to 9d02b34c 
Dealt to 47951ecc 
b360f60a: folds
9d02b34c: folds
47951ecc: folds
7cef76bf: folds
Hero: folds
Uncalled bet ($0.05) returned to 63db930a
*** SHOWDOWN ***
63db930a collected $0.1 from pot
*** SUMMARY ***
Total pot $0.1 | Rake $0 | Jackpot $0 | Bingo $0 | Fortune $0
Seat 1: 7cef76bf (button) folded before Flop (didn't bet)
Seat 2: Hero (small blind) folded before Flop
Seat 3: 63db930a (big blind) collected ($0.1)
Seat 4: b360f60a folded before Flop (didn't bet)
Seat 5: 9d02b34c folded before Flop (didn't bet)
Seat 6: 47951ecc folded before Flop (didn't bet)


Poker Hand #RC1452512383: Hold'em No Limit  ($0.05/$0.1) - 2023/04/05 14:08:11
Table 'RushAndCash2207643' 6-max Seat #1 is the button
Seat 1: 9bc971a7 ($8.51 in chips)
Seat 2: c8b8ac61 ($13.13 in chips)
Seat 3: fec90b55 ($11.21 in chips)
Seat 4: fff9b8f0 ($20.81 in chips)
Seat 5: 93dab03 ($12.17 in chips)
Seat 6: Hero ($23.52 in chips)
c8b8ac61: posts small blind $0.05
fec90b55: posts big blind $0.1
*** HOLE CARDS ***
Dealt to 9bc971a7 
Dealt to c8b8ac61 
Dealt to fec90b55 
Dealt to fff9b8f0 
Dealt to 93dab03 
Dealt to Hero [2s 7s]
fff9b8f0: folds
93dab03: folds
Hero: folds
9bc971a7: folds
c8b8ac61: folds
Uncalled bet ($0.05) returned to fec90b55
*** SHOWDOWN ***
fec90b55 collected $0.1 from pot
*** SUMMARY ***
Total pot $0.1 | Rake $0 | Jackpot $0 | Bingo $0 | Fortune $0
Seat 1: 9bc971a7 (button) folded before Flop (didn't bet)
Seat 2: c8b8ac61 (small blind) folded before Flop
Seat 3: fec90b55 (big blind) collected ($0.1)
Seat 4: fff9b8f0 folded before Flop (didn't bet)
Seat 5: 93dab03 folded before Flop (didn't bet)
Seat 6: Hero folded before Flop (didn't bet)


Poker Hand #RC1452512335: Hold'em No Limit  ($0.05/$0.1) - 2023/04/05 14:08:03
Table 'RushAndCash2207595' 6-max Seat #1 is the button
Seat 1: 62728c1a ($16.37 in chips)
Seat 2: 670ae3eb ($10 in chips)
Seat 3: e0754709 ($10.1 in chips)
Seat 4: c95cf605 ($10.19 in chips)
Seat 5: Hero ($23.52 in chips)
Seat 6: c62178c5 ($12.3 in chips)
670ae3eb: posts small blind $0.05
e0754709: posts big blind $0.1
*** HOLE CARDS ***
Dealt to 62728c1a 
Dealt to 670ae3eb 
Dealt to e0754709 
Dealt to c95cf605 
Dealt to Hero [Js 7h]
Dealt to c62178c5 
c95cf605: raises $0.15 to $0.25
Hero: folds
c62178c5: folds
62728c1a: folds
670ae3eb: folds
e0754709: folds
Uncalled bet ($0.15) returned to c95cf605
*** SHOWDOWN ***
c95cf605 collected $0.25 from pot
*** SUMMARY ***
Total pot $0.25 | Rake $0 | Jackpot $0 | Bingo $0 | Fortune $0
Seat 1: 62728c1a (button) folded before Flop (didn't bet)
Seat 2: 670ae3eb (small blind) folded before Flop
Seat 3: e0754709 (big blind) folded before Flop
Seat 4: c95cf605 collected ($0.25)
Seat 5: Hero folded before Flop (didn't bet)
Seat 6: c62178c5 folded before Flop (didn't bet)


Poker Hand #RC1452512217: Hold'em No Limit  ($0.05/$0.1) - 2023/04/05 14:07:44
Table 'RushAndCash2207477' 6-max Seat #1 is the button
Seat 1: d1a39d20 ($11.5 in chips)
Seat 2: bc5f245c ($10.25 in chips)
Seat 3: Hero ($23.62 in chips)
Seat 4: 11cfb94a ($11.65 in chips)
Seat 5: 6a17e321 ($10 in chips)
Seat 6: c249dcd4 ($20.56 in chips)
bc5f245c: posts small blind $0.05
Hero: posts big blind $0.1
*** HOLE CARDS ***
Dealt to d1a39d20 
Dealt to bc5f245c 
Dealt to Hero [Jd 3d]
Dealt to 11cfb94a 
Dealt to 6a17e321 
Dealt to c249dcd4 
11cfb94a: folds
6a17e321: folds
c249dcd4: folds
d1a39d20: raises $0.15 to $0.25
bc5f245c: folds
Hero: folds
Uncalled bet ($0.15) returned to d1a39d20
*** SHOWDOWN ***
d1a39d20 collected $0.25 from pot
*** SUMMARY ***
Total pot $0.25 | Rake $0 | Jackpot $0 | Bingo $0 | Fortune $0
Seat 1: d1a39d20 (button) collected ($0.25)
Seat 2: bc5f245c (small blind) folded before Flop
Seat 3: Hero (big blind) folded before Flop
Seat 4: 11cfb94a folded before Flop (didn't bet)
Seat 5: 6a17e321 folded before Flop (didn't bet)
Seat 6: c249dcd4 folded before Flop (didn't bet)


Poker Hand #RC1452512174: Hold'em No Limit  ($0.05/$0.1) - 2023/04/05 14:07:38
Table 'RushAndCash2207434' 6-max Seat #1 is the button
Seat 1: Hero ($23.62 in chips)
Seat 2: 30f6429f ($12.11 in chips)
Seat 3: 4a881e06 ($10.9 in chips)
Seat 4: 60b8ff49 ($22.59 in chips)
Seat 5: 8ab8363f ($9.29 in chips)
Seat 6: 43ad394 ($11.94 in chips)
30f6429f: posts small blind $0.05
4a881e06: posts big blind $0.1
*** HOLE CARDS ***
Dealt to Hero [Jc 3h]
Dealt to 30f6429f 
Dealt to 4a881e06 
Dealt to 60b8ff49 
Dealt to 8ab8363f 
Dealt to 43ad394 
60b8ff49: folds
8ab8363f: folds
43ad394: folds
Hero: folds
30f6429f: folds
Uncalled bet ($0.05) returned to 4a881e06
*** SHOWDOWN ***
4a881e06 collected $0.1 from pot
*** SUMMARY ***
Total pot $0.1 | Rake $0 | Jackpot $0 | Bingo $0 | Fortune $0
Seat 1: Hero (button) folded before Flop (didn't bet)
Seat 2: 30f6429f (small blind) folded before Flop
Seat 3: 4a881e06 (big blind) collected ($0.1)
Seat 4: 60b8ff49 folded before Flop (didn't bet)
Seat 5: 8ab8363f folded before Flop (didn't bet)
Seat 6: 43ad394 folded before Flop (didn't bet)


Poker Hand #RC1452512096: Hold'em No Limit  ($0.05/$0.1) - 2023/04/05 14:07:25
Table 'RushAndCash2207356' 6-max Seat #1 is the button
Seat 1: c218a9eb ($11.26 in chips)
Seat 2: db34e1de ($12.01 in chips)
Seat 3: d8ef97d1 ($11.58 in chips)
Seat 4: f2dcd8ac ($12.14 in chips)
Seat 5: f0fe0a30 ($17.3 in chips)
Seat 6: Hero ($23.62 in chips)
db34e1de: posts small blind $0.05
d8ef97d1: posts big blind $0.1
*** HOLE CARDS ***
Dealt to c218a9eb 
Dealt to db34e1de 
Dealt to d8ef97d1 
Dealt to f2dcd8ac 
Dealt to f0fe0a30 
Dealt to Hero [2s 6h]
f2dcd8ac: raises $0.11 to $0.21
f0fe0a30: calls $0.21
Hero: folds
c218a9eb: folds
db34e1de: folds
d8ef97d1: calls $0.11
*** FLOP *** [As 2c 8h]
d8ef97d1: checks
f2dcd8ac: checks
f0fe0a30: checks
*** TURN *** [As 2c 8h] [9s]
d8ef97d1: checks
f2dcd8ac: checks
f0fe0a30: checks
*** RIVER *** [As 2c 8h 9s] [Qh]
d8ef97d1: checks
f2dcd8ac: checks
f0fe0a30: checks
d8ef97d1: shows [Js Qs] (Pair of Queens)
f2dcd8ac: shows [5c 5s] (Pair of Fives)
f0fe0a30: shows [Th 9h] (Pair of Nines)
*** SHOWDOWN ***
d8ef97d1 collected $0.65 from pot
*** SUMMARY ***
Total pot $0.68 | Rake $0.03 | Jackpot $0 | Bingo $0 | Fortune $0
Board [As 2c 8h 9s Qh]
Seat 1: c218a9eb (button) folded before Flop (didn't bet)
Seat 2: db34e1de (small blind) folded before Flop
Seat 3: d8ef97d1 (big blind) showed [Js Qs] and won ($0.65) with Pair of Queens
Seat 4: f2dcd8ac showed [5c 5s] and lost with Pair of Fives
Seat 5: f0fe0a30 showed [Th 9h] and lost with Pair of Nines
Seat 6: Hero folded before Flop (didn't bet)


Poker Hand #RC1452512054: Hold'em No Limit  ($0.05/$0.1) - 2023/04/05 14:07:19
Table 'RushAndCash2207314' 6-max Seat #1 is the button
Seat 1: cbe3a0b4 ($14.91 in chips)
Seat 2: Hero ($23.67 in chips)
Seat 3: e1e4388f ($12.96 in chips)
Seat 4: 8922b294 ($13.89 in chips)
Seat 5: aff17128 ($10.83 in chips)
Seat 6: 3c81b5b5 ($10 in chips)
Hero: posts small blind $0.05
e1e4388f: posts big blind $0.1
*** HOLE CARDS ***
Dealt to cbe3a0b4 
Dealt to Hero [6d 4h]
Dealt to e1e4388f 
Dealt to 8922b294 
Dealt to aff17128 
Dealt to 3c81b5b5 
8922b294: folds
aff17128: folds
3c81b5b5: folds
cbe3a0b4: folds
Hero: folds
Uncalled bet ($0.05) returned to e1e4388f
*** SHOWDOWN ***
e1e4388f collected $0.1 from pot
*** SUMMARY ***
Total pot $0.1 | Rake $0 | Jackpot $0 | Bingo $0 | Fortune $0
Seat 1: cbe3a0b4 (button) folded before Flop (didn't bet)
Seat 2: Hero (small blind) folded before Flop
Seat 3: e1e4388f (big blind) collected ($0.1)
Seat 4: 8922b294 folded before Flop (didn't bet)
Seat 5: aff17128 folded before Flop (didn't bet)
Seat 6: 3c81b5b5 folded before Flop (didn't bet)


Poker Hand #RC1452512011: Hold'em No Limit  ($0.05/$0.1) - 2023/04/05 14:07:12
Table 'RushAndCash2207271' 6-max Seat #1 is the button
Seat 1: 3c292862 ($33.45 in chips)
Seat 2: fc633c5b ($10 in chips)
Seat 3: 3ae2ea89 ($10.64 in chips)
Seat 4: Hero ($23.67 in chips)
Seat 5: e6e289b1 ($32 in chips)
Seat 6: bb0cc8c5 ($11.83 in chips)
fc633c5b: posts small blind $0.05
3ae2ea89: posts big blind $0.1
*** HOLE CARDS ***
Dealt to 3c292862 
Dealt to fc633c5b 
Dealt to 3ae2ea89 
Dealt to Hero [4c 3h]
Dealt to e6e289b1 
Dealt to bb0cc8c5 
Hero: folds
e6e289b1: folds
bb0cc8c5: folds
3c292862: folds
fc633c5b: raises $0.2 to $0.3
3ae2ea89: folds
Uncalled bet ($0.2) returned to fc633c5b
*** SHOWDOWN ***
fc633c5b collected $0.2 from pot
*** SUMMARY ***
Total pot $0.2 | Rake $0 | Jackpot $0 | Bingo $0 | Fortune $0
Seat 1: 3c292862 (button) folded before Flop (didn't bet)
Seat 2: fc633c5b (small blind) collected ($0.2)
Seat 3: 3ae2ea89 (big blind) folded before Flop
Seat 4: Hero folded before Flop (didn't bet)
Seat 5: e6e289b1 folded before Flop (didn't bet)
Seat 6: bb0cc8c5 folded before Flop (didn't bet)


Poker Hand #RC1452511934: Hold'em No Limit  ($0.05/$0.1) - 2023/04/05 14:06:57
Table 'RushAndCash2207194' 6-max Seat #1 is the button
Seat 1: f8ac1c7f ($12.95 in chips)
Seat 2: c6e29035 ($16.49 in chips)
Seat 3: Hero ($23.77 in chips)
Seat 4: 474ac677 ($20.63 in chips)
Seat 5: c62178c5 ($12.6 in chips)
Seat 6: 52514570 ($10.69 in chips)
c6e29035: posts small blind $0.05
Hero: posts big blind $0.1
*** HOLE CARDS ***
Dealt to f8ac1c7f 
Dealt to c6e29035 
Dealt to Hero [Jh 7c]
Dealt to 474ac677 
Dealt to c62178c5 
Dealt to 52514570 
474ac677: folds
c62178c5: folds
52514570: raises $0.1 to $0.2
f8ac1c7f: folds
c6e29035: raises $0.6 to $0.8
Hero: folds
52514570: calls $0.6
*** FLOP *** [6s 8s 2h]
c6e29035: checks
52514570: checks
*** TURN *** [6s 8s 2h] [4d]
c6e29035: checks
52514570: checks
*** RIVER *** [6s 8s 2h 4d] [Kc]
c6e29035: checks
52514570: checks
c6e29035: shows [Qh Ad] (Ace-High)
52514570: shows [Kh Th] (Pair of Kings)
*** SHOWDOWN ***
52514570 collected $1.62 from pot
*** SUMMARY ***
Total pot $1.7 | Rake $0.08 | Jackpot $0 | Bingo $0 | Fortune $0
Board [6s 8s 2h 4d Kc]
Seat 1: f8ac1c7f (button) folded before Flop (didn't bet)
Seat 2: c6e29035 (small blind) showed [Qh Ad] and lost with Ace-High
Seat 3: Hero (big blind) folded before Flop
Seat 4: 474ac677 folded before Flop (didn't bet)
Seat 5: c62178c5 folded before Flop (didn't bet)
Seat 6: 52514570 showed [Kh Th] and won ($1.62) with Pair of Kings


Poker Hand #RC1452511910: Hold'em No Limit  ($0.05/$0.1) - 2023/04/05 14:06:53
Table 'RushAndCash2207170' 6-max Seat #1 is the button
Seat 1: 5ae4eb12 ($8.79 in chips)
Seat 2: ffe7e835 ($10 in chips)
Seat 3: c62178c5 ($12.7 in chips)
Seat 4: Hero ($23.77 in chips)
Seat 5: 83527647 ($14.52 in chips)
Seat 6: 9a6f7755 ($9.45 in chips)
ffe7e835: posts small blind $0.05
c62178c5: posts big blind $0.1
*** HOLE CARDS ***
Dealt to 5ae4eb12 
Dealt to ffe7e835 
Dealt to c62178c5 
Dealt to Hero [Qc 9c]
Dealt to 83527647 
Dealt to 9a6f7755 
Hero: folds
83527647: folds
9a6f7755: folds
5ae4eb12: folds
ffe7e835: folds
Uncalled bet ($0.05) returned to c62178c5
*** SHOWDOWN ***
c62178c5 collected $0.1 from pot
*** SUMMARY ***
Total pot $0.1 | Rake $0 | Jackpot $0 | Bingo $0 | Fortune $0
Seat 1: 5ae4eb12 (button) folded before Flop (didn't bet)
Seat 2: ffe7e835 (small blind) folded before Flop
Seat 3: c62178c5 (big blind) collected ($0.1)
Seat 4: Hero folded before Flop (didn't bet)
Seat 5: 83527647 folded before Flop (didn't bet)
Seat 6: 9a6f7755 folded before Flop (didn't bet)


Poker Hand #RC1452511873: Hold'em No Limit  ($0.05/$0.1) - 2023/04/05 14:06:48
Table 'RushAndCash2207133' 6-max Seat #1 is the button
Seat 1: Hero ($23.77 in chips)
Seat 2: 2727b2cb ($27.64 in chips)
Seat 3: 8b640ccd ($14.04 in chips)
Seat 4: 169a1dc5 ($27.82 in chips)
Seat 5: f613f888 ($16.41 in chips)
Seat 6: 25e0a02 ($22.63 in chips)
2727b2cb: posts small blind $0.05
8b640ccd: posts big blind $0.1
*** HOLE CARDS ***
Dealt to Hero [2c 6c]
Dealt to 2727b2cb 
Dealt to 8b640ccd 
Dealt to 169a1dc5 
Dealt to f613f888 
Dealt to 25e0a02 
169a1dc5: folds
f613f888: raises $0.15 to $0.25
25e0a02: folds
Hero: folds
2727b2cb: folds
8b640ccd: folds
Uncalled bet ($0.15) returned to f613f888
*** SHOWDOWN ***
f613f888 collected $0.25 from pot
*** SUMMARY ***
Total pot $0.25 | Rake $0 | Jackpot $0 | Bingo $0 | Fortune $0
Seat 1: Hero (button) folded before Flop (didn't bet)
Seat 2: 2727b2cb (small blind) folded before Flop
Seat 3: 8b640ccd (big blind) folded before Flop
Seat 4: 169a1dc5 folded before Flop (didn't bet)
Seat 5: f613f888 collected ($0.25)
Seat 6: 25e0a02 folded before Flop (didn't bet)


Poker Hand #RC1452511830: Hold'em No Limit  ($0.05/$0.1) - 2023/04/05 14:06:41
Table 'RushAndCash2207090' 6-max Seat #1 is the button
Seat 1: c8b8ac61 ($12.86 in chips)
Seat 2: 58952c3f ($15.13 in chips)
Seat 3: be7df6c0 ($8.36 in chips)
Seat 4: 1cd2b980 ($12.74 in chips)
Seat 5: Hero ($23.77 in chips)
Seat 6: 82b62c23 ($13.3 in chips)
58952c3f: posts small blind $0.05
be7df6c0: posts big blind $0.1
*** HOLE CARDS ***
Dealt to c8b8ac61 
Dealt to 58952c3f 
Dealt to be7df6c0 
Dealt to 1cd2b980 
Dealt to Hero [Qc 2d]
Dealt to 82b62c23 
1cd2b980: folds
Hero: folds
82b62c23: raises $0.15 to $0.25
c8b8ac61: raises $0.49 to $0.74
58952c3f: folds
be7df6c0: folds
82b62c23: folds
Uncalled bet ($0.49) returned to c8b8ac61
*** SHOWDOWN ***
c8b8ac61 collected $0.62 from pot
*** SUMMARY ***
Total pot $0.65 | Rake $0.03 | Jackpot $0 | Bingo $0 | Fortune $0
Seat 1: c8b8ac61 (button) collected ($0.62)
Seat 2: 58952c3f (small blind) folded before Flop
Seat 3: be7df6c0 (big blind) folded before Flop
Seat 4: 1cd2b980 folded before Flop (didn't bet)
Seat 5: Hero folded before Flop (didn't bet)
Seat 6: 82b62c23 folded before Flop


Poker Hand #RC1452511765: Hold'em No Limit  ($0.05/$0.1) - 2023/04/05 14:06:29
Table 'RushAndCash2207025' 6-max Seat #1 is the button
Seat 1: 43accfe2 ($27.27 in chips)
Seat 2: Hero ($23.82 in chips)
Seat 3: 79a3ce08 ($26.01 in chips)
Seat 4: c27cc52e ($11.79 in chips)
Seat 5: cafe1238 ($17.37 in chips)
Seat 6: 81569488 ($10.55 in chips)
Hero: posts small blind $0.05
79a3ce08: posts big blind $0.1
*** HOLE CARDS ***
Dealt to 43accfe2 
Dealt to Hero [Qh 3h]
Dealt to 79a3ce08 
Dealt to c27cc52e 
Dealt to cafe1238 
Dealt to 81569488 
c27cc52e: folds
cafe1238: folds
81569488: folds
43accfe2: raises $0.1 to $0.2
Hero: folds
79a3ce08: calls $0.1
*** FLOP *** [4d 7c 8h]
79a3ce08: checks
43accfe2: checks
*** TURN *** [4d 7c 8h] [6h]
79a3ce08: checks
43accfe2: checks
*** RIVER *** [4d 7c 8h 6h] [Kc]
79a3ce08: checks
43accfe2: checks
79a3ce08: shows [Kd Ts] (Pair of Kings)
43accfe2: shows [Ac Td] (Ace-High)
*** SHOWDOWN ***
79a3ce08 collected $0.43 from pot
*** SUMMARY ***
Total pot $0.45 | Rake $0.02 | Jackpot $0 | Bingo $0 | Fortune $0
Board [4d 7c 8h 6h Kc]
Seat 1: 43accfe2 (button) showed [Ac Td] and lost with Ace-High
Seat 2: Hero (small blind) folded before Flop
Seat 3: 79a3ce08 (big blind) showed [Kd Ts] and won ($0.43) with Pair of Kings
Seat 4: c27cc52e folded before Flop (didn't bet)
Seat 5: cafe1238 folded before Flop (didn't bet)
Seat 6: 81569488 folded before Flop (didn't bet)


Poker Hand #RC1452511708: Hold'em No Limit  ($0.05/$0.1) - 2023/04/05 14:06:19
Table 'RushAndCash2206968' 6-max Seat #1 is the button
Seat 1: 8c73f4d4 ($36.23 in chips)
Seat 2: 2c72a402 ($10.92 in chips)
Seat 3: Hero ($23.77 in chips)
Seat 4: d995e7aa ($10.49 in chips)
Seat 5: 7781aed2 ($10.73 in chips)
Seat 6: a83d7912 ($10.05 in chips)
2c72a402: posts small blind $0.05
Hero: posts big blind $0.1
*** HOLE CARDS ***
Dealt to 8c73f4d4 
Dealt to 2c72a402 
Dealt to Hero [8d Qs]
Dealt to d995e7aa 
Dealt to 7781aed2 
Dealt to a83d7912 
d995e7aa: folds
7781aed2: folds
a83d7912: folds
8c73f4d4: folds
2c72a402: folds
Uncalled bet ($0.05) returned to Hero
*** SHOWDOWN ***
Hero collected $0.1 from pot
*** SUMMARY ***
Total pot $0.1 | Rake $0 | Jackpot $0 | Bingo $0 | Fortune $0
Seat 1: 8c73f4d4 (button) folded before Flop (didn't bet)
Seat 2: 2c72a402 (small blind) folded before Flop
Seat 3: Hero (big blind) collected ($0.1)
Seat 4: d995e7aa folded before Flop (didn't bet)
Seat 5: 7781aed2 folded before Flop (didn't bet)
Seat 6: a83d7912 folded before Flop (didn't bet)


Poker Hand #RC1452511668: Hold'em No Limit  ($0.05/$0.1) - 2023/04/05 14:06:13
Table 'RushAndCash2206928' 6-max Seat #1 is the button
Seat 1: aef6bbf9 ($11.04 in chips)
Seat 2: 3c94d40a ($5.03 in chips)
Seat 3: cdf7bae4 ($10 in chips)
Seat 4: 3c4d44a7 ($10 in chips)
Seat 5: 5e3a8211 ($13.51 in chips)
Seat 6: Hero ($23.77 in chips)
3c94d40a: posts small blind $0.05
cdf7bae4: posts big blind $0.1
*** HOLE CARDS ***
Dealt to aef6bbf9 
Dealt to 3c94d40a 
Dealt to cdf7bae4 
Dealt to 3c4d44a7 
Dealt to 5e3a8211 
Dealt to Hero [4c As]
3c4d44a7: folds
5e3a8211: raises $0.14 to $0.24
Hero: folds
aef6bbf9: folds
3c94d40a: folds
cdf7bae4: folds
Uncalled bet ($0.14) returned to 5e3a8211
*** SHOWDOWN ***
5e3a8211 collected $0.25 from pot
*** SUMMARY ***
Total pot $0.25 | Rake $0 | Jackpot $0 | Bingo $0 | Fortune $0
Seat 1: aef6bbf9 (button) folded before Flop (didn't bet)
Seat 2: 3c94d40a (small blind) folded before Flop
Seat 3: cdf7bae4 (big blind) folded before Flop
Seat 4: 3c4d44a7 folded before Flop (didn't bet)
Seat 5: 5e3a8211 collected ($0.25)
Seat 6: Hero folded before Flop (didn't bet)


Poker Hand #RC1452511641: Hold'em No Limit  ($0.05/$0.1) - 2023/04/05 14:06:08
Table 'RushAndCash2206901' 6-max Seat #1 is the button
Seat 1: 861d60c2 ($6.67 in chips)
Seat 2: 7a9cae18 ($4.53 in chips)
Seat 3: 683531bd ($11.45 in chips)
Seat 4: f329cbef ($14.13 in chips)
Seat 5: fe03b251 ($10.67 in chips)
Seat 6: Hero ($23.77 in chips)
7a9cae18: posts small blind $0.05
683531bd: posts big blind $0.1
*** HOLE CARDS ***
Dealt to 861d60c2 
Dealt to 7a9cae18 
Dealt to 683531bd 
Dealt to f329cbef 
Dealt to fe03b251 
Dealt to Hero [Qs 8c]
f329cbef: raises $0.12 to $0.22
fe03b251: folds
Hero: folds
861d60c2: folds
7a9cae18: folds
683531bd: folds
Uncalled bet ($0.12) returned to f329cbef
*** SHOWDOWN ***
f329cbef collected $0.25 from pot
*** SUMMARY ***
Total pot $0.25 | Rake $0 | Jackpot $0 | Bingo $0 | Fortune $0
Seat 1: 861d60c2 (button) folded before Flop (didn't bet)
Seat 2: 7a9cae18 (small blind) folded before Flop
Seat 3: 683531bd (big blind) folded before Flop
Seat 4: f329cbef collected ($0.25)
Seat 5: fe03b251 folded before Flop (didn't bet)
Seat 6: Hero folded before Flop (didn't bet)


Poker Hand #RC1452511461: Hold'em No Limit  ($0.05/$0.1) - 2023/04/05 14:05:38
Table 'RushAndCash2206721' 6-max Seat #1 is the button
Seat 1: Hero ($24.02 in chips)
Seat 2: 29891f1b ($6.01 in chips)
Seat 3: 7a9cae18 ($4.25 in chips)
Seat 4: 296ea736 ($10 in chips)
Seat 5: 5d892f0b ($10 in chips)
Seat 6: eba38528 ($11.72 in chips)
29891f1b: posts small blind $0.05
7a9cae18: posts big blind $0.1
*** HOLE CARDS ***
Dealt to Hero [5s 4s]
Dealt to 29891f1b 
Dealt to 7a9cae18 
Dealt to 296ea736 
Dealt to 5d892f0b 
Dealt to eba38528 
296ea736: folds
5d892f0b: folds
eba38528: folds
Hero: raises $0.15 to $0.25
29891f1b: folds
7a9cae18: raises $0.55 to $0.8
Hero: folds
Uncalled bet ($0.55) returned to 7a9cae18
*** SHOWDOWN ***
7a9cae18 collected $0.53 from pot
*** SUMMARY ***
Total pot $0.55 | Rake $0.02 | Jackpot $0 | Bingo $0 | Fortune $0
Seat 1: Hero (button) folded before Flop
Seat 2: 29891f1b (small blind) folded before Flop
Seat 3: 7a9cae18 (big blind) collected ($0.53)
Seat 4: 296ea736 folded before Flop (didn't bet)
Seat 5: 5d892f0b folded before Flop (didn't bet)
Seat 6: eba38528 folded before Flop (didn't bet)


Poker Hand #RC1452511432: Hold'em No Limit  ($0.05/$0.1) - 2023/04/05 14:05:32
Table 'RushAndCash2206692' 6-max Seat #1 is the button
Seat 1: 37ffea43 ($10 in chips)
Seat 2: 2e03632f ($9.58 in chips)
Seat 3: 19aad671 ($17.73 in chips)
Seat 4: Hero ($24.02 in chips)
Seat 5: 8aa666fa ($15.23 in chips)
Seat 6: ebc7e9ed ($13.9 in chips)
2e03632f: posts small blind $0.05
19aad671: posts big blind $0.1
*** HOLE CARDS ***
Dealt to 37ffea43 
Dealt to 2e03632f 
Dealt to 19aad671 
Dealt to Hero [8s 4c]
Dealt to 8aa666fa 
Dealt to ebc7e9ed 
Hero: folds
8aa666fa: folds
ebc7e9ed: folds
37ffea43: raises $0.15 to $0.25
2e03632f: folds
19aad671: folds
Uncalled bet ($0.15) returned to 37ffea43
*** SHOWDOWN ***
37ffea43 collected $0.25 from pot
*** SUMMARY ***
Total pot $0.25 | Rake $0 | Jackpot $0 | Bingo $0 | Fortune $0
Seat 1: 37ffea43 (button) collected ($0.25)
Seat 2: 2e03632f (small blind) folded before Flop
Seat 3: 19aad671 (big blind) folded before Flop
Seat 4: Hero folded before Flop (didn't bet)
Seat 5: 8aa666fa folded before Flop (didn't bet)
Seat 6: ebc7e9ed folded before Flop (didn't bet)


Poker Hand #RC1452510567: Hold'em No Limit  ($0.05/$0.1) - 2023/04/05 14:03:06
Table 'RushAndCash2205827' 6-max Seat #1 is the button
Seat 1: e1f4ae0 ($10 in chips)
Seat 2: 4a881e06 ($10.28 in chips)
Seat 3: 47951ecc ($9.85 in chips)
Seat 4: 651051e1 ($10.88 in chips)
Seat 5: fb7bdda0 ($10.19 in chips)
Seat 6: Hero ($14.32 in chips)
4a881e06: posts small blind $0.05
47951ecc: posts big blind $0.1
*** HOLE CARDS ***
Dealt to e1f4ae0 
Dealt to 4a881e06 
Dealt to 47951ecc 
Dealt to 651051e1 
Dealt to fb7bdda0 
Dealt to Hero [8d 8c]
651051e1: folds
fb7bdda0: folds
Hero: raises $0.15 to $0.25
e1f4ae0: calls $0.25
4a881e06: folds
47951ecc: raises $0.5 to $0.75
Hero: calls $0.5
e1f4ae0: folds
*** FLOP *** [2d 8s Tc]
47951ecc: bets $0.6
Hero: calls $0.6
*** TURN *** [2d 8s Tc] [5h]
47951ecc: bets $2.25
Hero: raises $7.75 to $10
47951ecc: calls $6.25 and is all-in
Uncalled bet ($1.5) returned to Hero
Hero: shows [8d 8c] (Three Eights)
47951ecc: shows [Ts Ad] (Pair of Tens)
*** RIVER *** [2d 8s Tc 5h] [4s]
*** SHOWDOWN ***
Hero collected $19.55 from pot
*** SUMMARY ***
Total pot $20 | Rake $0.3 | Jackpot $0.15 | Bingo $0 | Fortune $0
Board [2d 8s Tc 5h 4s]
Seat 1: e1f4ae0 (button) folded before Flop
Seat 2: 4a881e06 (small blind) folded before Flop
Seat 3: 47951ecc (big blind) showed [Ts Ad] and lost with Pair of Tens
Seat 4: 651051e1 folded before Flop (didn't bet)
Seat 5: fb7bdda0 folded before Flop (didn't bet)
Seat 6: Hero showed [8d 8c] and won ($19.55) with Three Eights


Poker Hand #RC1452510542: Hold'em No Limit  ($0.05/$0.1) - 2023/04/05 14:03:00
Table 'RushAndCash2205802' 6-max Seat #1 is the button
Seat 1: 4318627e ($16.39 in chips)
Seat 2: cdd18ab7 ($10.77 in chips)
Seat 3: 4692d41d ($41.04 in chips)
Seat 4: b0804ea1 ($11.41 in chips)
Seat 5: c2d07061 ($11.5 in chips)
Seat 6: Hero ($14.32 in chips)
cdd18ab7: posts small blind $0.05
4692d41d: posts big blind $0.1
*** HOLE CARDS ***
Dealt to 4318627e 
Dealt to cdd18ab7 
Dealt to 4692d41d 
Dealt to b0804ea1 
Dealt to c2d07061 
Dealt to Hero [Qd 3c]
b0804ea1: folds
c2d07061: raises $0.15 to $0.25
Hero: folds
4318627e: folds
cdd18ab7: folds
4692d41d: folds
Uncalled bet ($0.15) returned to c2d07061
*** SHOWDOWN ***
c2d07061 collected $0.25 from pot
*** SUMMARY ***
Total pot $0.25 | Rake $0 | Jackpot $0 | Bingo $0 | Fortune $0
Seat 1: 4318627e (button) folded before Flop (didn't bet)
Seat 2: cdd18ab7 (small blind) folded before Flop
Seat 3: 4692d41d (big blind) folded before Flop
Seat 4: b0804ea1 folded before Flop (didn't bet)
Seat 5: c2d07061 collected ($0.25)
Seat 6: Hero folded before Flop (didn't bet)


Poker Hand #RC1452510512: Hold'em No Limit  ($0.05/$0.1) - 2023/04/05 14:02:55
Table 'RushAndCash2205772' 6-max Seat #1 is the button
Seat 1: Hero ($14.32 in chips)
Seat 2: 4318627e ($16.44 in chips)
Seat 3: 629306a ($10.1 in chips)
Seat 4: 82a4cb36 ($48.13 in chips)
Seat 5: e10c9940 ($16.87 in chips)
Seat 6: 69a44e3b ($12.96 in chips)
4318627e: posts small blind $0.05
629306a: posts big blind $0.1
*** HOLE CARDS ***
Dealt to Hero [5h 9h]
Dealt to 4318627e 
Dealt to 629306a 
Dealt to 82a4cb36 
Dealt to e10c9940 
Dealt to 69a44e3b 
82a4cb36: folds
e10c9940: folds
69a44e3b: folds
Hero: folds
4318627e: folds
Uncalled bet ($0.05) returned to 629306a
*** SHOWDOWN ***
629306a collected $0.1 from pot
*** SUMMARY ***
Total pot $0.1 | Rake $0 | Jackpot $0 | Bingo $0 | Fortune $0
Seat 1: Hero (button) folded before Flop (didn't bet)
Seat 2: 4318627e (small blind) folded before Flop
Seat 3: 629306a (big blind) collected ($0.1)
Seat 4: 82a4cb36 folded before Flop (didn't bet)
Seat 5: e10c9940 folded before Flop (didn't bet)
Seat 6: 69a44e3b folded before Flop (didn't bet)


Poker Hand #RC1452510468: Hold'em No Limit  ($0.05/$0.1) - 2023/04/05 14:02:47
Table 'RushAndCash2205728' 6-max Seat #1 is the button
Seat 1: 571e53f5 ($14.85 in chips)
Seat 2: Hero ($14.37 in chips)
Seat 3: 383f98eb ($17.43 in chips)
Seat 4: b1e5a0a3 ($17.68 in chips)
Seat 5: 4c1998a8 ($20.86 in chips)
Seat 6: dcb5ac90 ($11.63 in chips)
Hero: posts small blind $0.05
383f98eb: posts big blind $0.1
*** HOLE CARDS ***
Dealt to 571e53f5 
Dealt to Hero [3d 8s]
Dealt to 383f98eb 
Dealt to b1e5a0a3 
Dealt to 4c1998a8 
Dealt to dcb5ac90 
b1e5a0a3: folds
4c1998a8: raises $0.1 to $0.2
dcb5ac90: folds
571e53f5: folds
Hero: folds
383f98eb: folds
Uncalled bet ($0.1) returned to 4c1998a8
*** SHOWDOWN ***
4c1998a8 collected $0.25 from pot
*** SUMMARY ***
Total pot $0.25 | Rake $0 | Jackpot $0 | Bingo $0 | Fortune $0
Seat 1: 571e53f5 (button) folded before Flop (didn't bet)
Seat 2: Hero (small blind) folded before Flop
Seat 3: 383f98eb (big blind) folded before Flop
Seat 4: b1e5a0a3 folded before Flop (didn't bet)
Seat 5: 4c1998a8 collected ($0.25)
Seat 6: dcb5ac90 folded before Flop (didn't bet)


Poker Hand #RC1452510421: Hold'em No Limit  ($0.05/$0.1) - 2023/04/05 14:02:39
Table 'RushAndCash2205681' 6-max Seat #1 is the button
Seat 1: f60dcbf ($15.51 in chips)
Seat 2: 9a580e21 ($13.7 in chips)
Seat 3: Hero ($14.47 in chips)
Seat 4: 79187a76 ($11.54 in chips)
Seat 5: b360f60a ($5.99 in chips)
Seat 6: b8c559df ($10 in chips)
9a580e21: posts small blind $0.05
Hero: posts big blind $0.1
*** HOLE CARDS ***
Dealt to f60dcbf 
Dealt to 9a580e21 
Dealt to Hero [5h 7s]
Dealt to 79187a76 
Dealt to b360f60a 
Dealt to b8c559df 
79187a76: raises $0.2 to $0.3
b360f60a: folds
b8c559df: folds
f60dcbf: folds
9a580e21: folds
Hero: folds
Uncalled bet ($0.2) returned to 79187a76
*** SHOWDOWN ***
79187a76 collected $0.25 from pot
*** SUMMARY ***
Total pot $0.25 | Rake $0 | Jackpot $0 | Bingo $0 | Fortune $0
Seat 1: f60dcbf (button) folded before Flop (didn't bet)
Seat 2: 9a580e21 (small blind) folded before Flop
Seat 3: Hero (big blind) folded before Flop
Seat 4: 79187a76 collected ($0.25)
Seat 5: b360f60a folded before Flop (didn't bet)
Seat 6: b8c559df folded before Flop (didn't bet)


Poker Hand #RC1452510396: Hold'em No Limit  ($0.05/$0.1) - 2023/04/05 14:02:34
Table 'RushAndCash2205656' 6-max Seat #1 is the button
Seat 1: 72750c29 ($32.84 in chips)
Seat 2: dd2fe26c ($14.43 in chips)
Seat 3: 58f8110e ($10.67 in chips)
Seat 4: Hero ($14.47 in chips)
Seat 5: a942ef4d ($15.77 in chips)
Seat 6: c2c868b2 ($9.51 in chips)
dd2fe26c: posts small blind $0.05
58f8110e: posts big blind $0.1
*** HOLE CARDS ***
Dealt to 72750c29 
Dealt to dd2fe26c 
Dealt to 58f8110e 
Dealt to Hero [3d 5d]
Dealt to a942ef4d 
Dealt to c2c868b2 
Hero: folds
a942ef4d: folds
c2c868b2: raises $0.1 to $0.2
72750c29: folds
dd2fe26c: folds
58f8110e: folds
Uncalled bet ($0.1) returned to c2c868b2
*** SHOWDOWN ***
c2c868b2 collected $0.25 from pot
*** SUMMARY ***
Total pot $0.25 | Rake $0 | Jackpot $0 | Bingo $0 | Fortune $0
Seat 1: 72750c29 (button) folded before Flop (didn't bet)
Seat 2: dd2fe26c (small blind) folded before Flop
Seat 3: 58f8110e (big blind) folded before Flop
Seat 4: Hero folded before Flop (didn't bet)
Seat 5: a942ef4d folded before Flop (didn't bet)
Seat 6: c2c868b2 collected ($0.25)


Poker Hand #RC1452510341: Hold'em No Limit  ($0.05/$0.1) - 2023/04/05 14:02:25
Table 'RushAndCash2205601' 6-max Seat #1 is the button
Seat 1: 80c7eb0e ($11.8 in chips)
Seat 2: d3e52379 ($11.44 in chips)
Seat 3: 81569488 ($10.5 in chips)
Seat 4: Hero ($14.32 in chips)
Seat 5: 1b66ed34 ($8.39 in chips)
Seat 6: 58f8110e ($10.67 in chips)
d3e52379: posts small blind $0.05
81569488: posts big blind $0.1
*** HOLE CARDS ***
Dealt to 80c7eb0e 
Dealt to d3e52379 
Dealt to 81569488 
Dealt to Hero [As Tc]
Dealt to 1b66ed34 
Dealt to 58f8110e 
Hero: raises $0.15 to $0.25
1b66ed34: folds
58f8110e: folds
80c7eb0e: folds
d3e52379: folds
81569488: folds
Uncalled bet ($0.15) returned to Hero
*** SHOWDOWN ***
Hero collected $0.25 from pot
*** SUMMARY ***
Total pot $0.25 | Rake $0 | Jackpot $0 | Bingo $0 | Fortune $0
Seat 1: 80c7eb0e (button) folded before Flop (didn't bet)
Seat 2: d3e52379 (small blind) folded before Flop
Seat 3: 81569488 (big blind) folded before Flop
Seat 4: Hero collected ($0.25)
Seat 5: 1b66ed34 folded before Flop (didn't bet)
Seat 6: 58f8110e folded before Flop (didn't bet)


Poker Hand #RC1452510299: Hold'em No Limit  ($0.05/$0.1) - 2023/04/05 14:02:18
Table 'RushAndCash2205559' 6-max Seat #1 is the button
Seat 1: Hero ($14.32 in chips)
Seat 2: cd93d621 ($14.42 in chips)
Seat 3: 520250c1 ($5.23 in chips)
Seat 4: 5ade404 ($10.11 in chips)
Seat 5: 91e5b927 ($15.81 in chips)
Seat 6: 2ba6b4eb ($37.5 in chips)
cd93d621: posts small blind $0.05
520250c1: posts big blind $0.1
*** HOLE CARDS ***
Dealt to Hero [5c 2d]
Dealt to cd93d621 
Dealt to 520250c1 
Dealt to 5ade404 
Dealt to 91e5b927 
Dealt to 2ba6b4eb 
5ade404: folds
91e5b927: folds
2ba6b4eb: folds
Hero: folds
cd93d621: raises $0.2 to $0.3
520250c1: folds
Uncalled bet ($0.2) returned to cd93d621
*** SHOWDOWN ***
cd93d621 collected $0.2 from pot
*** SUMMARY ***
Total pot $0.2 | Rake $0 | Jackpot $0 | Bingo $0 | Fortune $0
Seat 1: Hero (button) folded before Flop (didn't bet)
Seat 2: cd93d621 (small blind) collected ($0.2)
Seat 3: 520250c1 (big blind) folded before Flop
Seat 4: 5ade404 folded before Flop (didn't bet)
Seat 5: 91e5b927 folded before Flop (didn't bet)
Seat 6: 2ba6b4eb folded before Flop (didn't bet)


Poker Hand #RC1452510065: Hold'em No Limit  ($0.05/$0.1) - 2023/04/05 14:01:39
Table 'RushAndCash2205325' 6-max Seat #1 is the button
Seat 1: c62178c5 ($11.46 in chips)
Seat 2: bbf740a3 ($18.44 in chips)
Seat 3: 9bc971a7 ($10.75 in chips)
Seat 4: Hero ($14.57 in chips)
Seat 5: 520250c1 ($4.86 in chips)
Seat 6: da1133c4 ($8.63 in chips)
bbf740a3: posts small blind $0.05
9bc971a7: posts big blind $0.1
*** HOLE CARDS ***
Dealt to c62178c5 
Dealt to bbf740a3 
Dealt to 9bc971a7 
Dealt to Hero [Jd Ad]
Dealt to 520250c1 
Dealt to da1133c4 
Hero: raises $0.15 to $0.25
520250c1: calls $0.25
da1133c4: folds
c62178c5: folds
bbf740a3: folds
9bc971a7: folds
*** FLOP *** [2c 3s 9h]
Hero: checks
520250c1: bets $0.65
Hero: folds
Uncalled bet ($0.65) returned to 520250c1
*** SHOWDOWN ***
520250c1 collected $0.62 from pot
*** SUMMARY ***
Total pot $0.65 | Rake $0.03 | Jackpot $0 | Bingo $0 | Fortune $0
Board [2c 3s 9h]
Seat 1: c62178c5 (button) folded before Flop (didn't bet)
Seat 2: bbf740a3 (small blind) folded before Flop
Seat 3: 9bc971a7 (big blind) folded before Flop
Seat 4: Hero folded on the Flop
Seat 5: 520250c1 won ($0.62)
Seat 6: da1133c4 folded before Flop (didn't bet)


Poker Hand #RC1452509570: Hold'em No Limit  ($0.05/$0.1) - 2023/04/05 14:00:14
Table 'RushAndCash2204830' 6-max Seat #1 is the button
Seat 1: 520250c1 ($5.49 in chips)
Seat 2: ede9f3a5 ($22.97 in chips)
Seat 3: Hero ($13.95 in chips)
Seat 4: 8f934c7f ($53.02 in chips)
Seat 5: d9c6f21b ($8.05 in chips)
Seat 6: e5780d1a ($14.18 in chips)
ede9f3a5: posts small blind $0.05
Hero: posts big blind $0.1
*** HOLE CARDS ***
Dealt to 520250c1 
Dealt to ede9f3a5 
Dealt to Hero [6d 6h]
Dealt to 8f934c7f 
Dealt to d9c6f21b 
Dealt to e5780d1a 
8f934c7f: folds
d9c6f21b: folds
e5780d1a: folds
520250c1: raises $0.2 to $0.3
ede9f3a5: folds
Hero: calls $0.2
*** FLOP *** [Ad Qd 5s]
Hero: checks
520250c1: bets $0.33
Hero: calls $0.33
*** TURN *** [Ad Qd 5s] [7h]
Hero: checks
520250c1: checks
*** RIVER *** [Ad Qd 5s 7h] [3c]
Hero: checks
520250c1: checks
Hero: shows [6d 6h] (Pair of Sixes)
520250c1: shows [2d Td] (Ace-High)
*** SHOWDOWN ***
Hero collected $1.25 from pot
*** SUMMARY ***
Total pot $1.31 | Rake $0.06 | Jackpot $0 | Bingo $0 | Fortune $0
Board [Ad Qd 5s 7h 3c]
Seat 1: 520250c1 (button) showed [2d Td] and lost with Ace-High
Seat 2: ede9f3a5 (small blind) folded before Flop
Seat 3: Hero (big blind) showed [6d 6h] and won ($1.25) with Pair of Sixes
Seat 4: 8f934c7f folded before Flop (didn't bet)
Seat 5: d9c6f21b folded before Flop (didn't bet)
Seat 6: e5780d1a folded before Flop (didn't bet)


Poker Hand #RC1452509537: Hold'em No Limit  ($0.05/$0.1) - 2023/04/05 14:00:08
Table 'RushAndCash2204797' 6-max Seat #1 is the button
Seat 1: ce17024f ($10 in chips)
Seat 2: Hero ($14 in chips)
Seat 3: bc3b4899 ($11.41 in chips)
Seat 4: 8aa666fa ($14.87 in chips)
Seat 5: 88e0d8a3 ($22.4 in chips)
Seat 6: c2c868b2 ($10.09 in chips)
Hero: posts small blind $0.05
bc3b4899: posts big blind $0.1
*** HOLE CARDS ***
Dealt to ce17024f 
Dealt to Hero [8h Td]
Dealt to bc3b4899 
Dealt to 8aa666fa 
Dealt to 88e0d8a3 
Dealt to c2c868b2 
8aa666fa: folds
88e0d8a3: folds
c2c868b2: folds
ce17024f: raises $0.15 to $0.25
Hero: folds
bc3b4899: folds
Uncalled bet ($0.15) returned to ce17024f
*** SHOWDOWN ***
ce17024f collected $0.25 from pot
*** SUMMARY ***
Total pot $0.25 | Rake $0 | Jackpot $0 | Bingo $0 | Fortune $0
Seat 1: ce17024f (button) collected ($0.25)
Seat 2: Hero (small blind) folded before Flop
Seat 3: bc3b4899 (big blind) folded before Flop
Seat 4: 8aa666fa folded before Flop (didn't bet)
Seat 5: 88e0d8a3 folded before Flop (didn't bet)
Seat 6: c2c868b2 folded before Flop (didn't bet)


Poker Hand #RC1452509485: Hold'em No Limit  ($0.05/$0.1) - 2023/04/05 13:59:59
Table 'RushAndCash2204745' 6-max Seat #1 is the button
Seat 1: c2d07061 ($10.15 in chips)
Seat 2: 1cd2b980 ($10 in chips)
Seat 3: 85dbe83a ($10 in chips)
Seat 4: 22fe1119 ($10 in chips)
Seat 5: 34f8eac5 ($8.22 in chips)
Seat 6: Hero ($14 in chips)
1cd2b980: posts small blind $0.05
85dbe83a: posts big blind $0.1
*** HOLE CARDS ***
Dealt to c2d07061 
Dealt to 1cd2b980 
Dealt to 85dbe83a 
Dealt to 22fe1119 
Dealt to 34f8eac5 
Dealt to Hero [4d Jd]
22fe1119: folds
34f8eac5: raises $0.15 to $0.25
Hero: folds
c2d07061: calls $0.25
1cd2b980: raises $0.64 to $0.89
85dbe83a: folds
34f8eac5: raises $2.13 to $3.02
c2d07061: folds
1cd2b980: folds
Uncalled bet ($2.13) returned to 34f8eac5
*** SHOWDOWN ***
34f8eac5 collected $2.03 from pot
*** SUMMARY ***
Total pot $2.13 | Rake $0.1 | Jackpot $0 | Bingo $0 | Fortune $0
Seat 1: c2d07061 (button) folded before Flop
Seat 2: 1cd2b980 (small blind) folded before Flop
Seat 3: 85dbe83a (big blind) folded before Flop
Seat 4: 22fe1119 folded before Flop (didn't bet)
Seat 5: 34f8eac5 collected ($2.03)
Seat 6: Hero folded before Flop (didn't bet)


Poker Hand #RC1452509442: Hold'em No Limit  ($0.05/$0.1) - 2023/04/05 13:59:53
Table 'RushAndCash2204702' 6-max Seat #1 is the button
Seat 1: Hero ($14 in chips)
Seat 2: 507397ec ($10 in chips)
Seat 3: 1f32012b ($11.56 in chips)
Seat 4: 8e3a536f ($12.84 in chips)
Seat 5: b1e5a0a3 ($19.23 in chips)
Seat 6: 2b4c75aa ($10.15 in chips)
507397ec: posts small blind $0.05
1f32012b: posts big blind $0.1
*** HOLE CARDS ***
Dealt to Hero [3d 9d]
Dealt to 507397ec 
Dealt to 1f32012b 
Dealt to 8e3a536f 
Dealt to b1e5a0a3 
Dealt to 2b4c75aa 
8e3a536f: folds
b1e5a0a3: folds
2b4c75aa: folds
Hero: folds
507397ec: folds
Uncalled bet ($0.05) returned to 1f32012b
*** SHOWDOWN ***
1f32012b collected $0.1 from pot
*** SUMMARY ***
Total pot $0.1 | Rake $0 | Jackpot $0 | Bingo $0 | Fortune $0
Seat 1: Hero (button) folded before Flop (didn't bet)
Seat 2: 507397ec (small blind) folded before Flop
Seat 3: 1f32012b (big blind) collected ($0.1)
Seat 4: 8e3a536f folded before Flop (didn't bet)
Seat 5: b1e5a0a3 folded before Flop (didn't bet)
Seat 6: 2b4c75aa folded before Flop (didn't bet)


Poker Hand #RC1452509403: Hold'em No Limit  ($0.05/$0.1) - 2023/04/05 13:59:46
Table 'RushAndCash2204663' 6-max Seat #1 is the button
Seat 1: 629306a ($11.09 in chips)
Seat 2: a19a7c1e ($11.21 in chips)
Seat 3: 9bc971a7 ($10.94 in chips)
Seat 4: Hero ($14 in chips)
Seat 5: 46664599 ($18.86 in chips)
Seat 6: b1e5a0a3 ($19.23 in chips)
a19a7c1e: posts small blind $0.05
9bc971a7: posts big blind $0.1
*** HOLE CARDS ***
Dealt to 629306a 
Dealt to a19a7c1e 
Dealt to 9bc971a7 
Dealt to Hero [7c Js]
Dealt to 46664599 
Dealt to b1e5a0a3 
Hero: folds
46664599: raises $0.12 to $0.22
b1e5a0a3: folds
629306a: folds
a19a7c1e: folds
9bc971a7: calls $0.12
*** FLOP *** [5s Kh Kd]
9bc971a7: checks
46664599: checks
*** TURN *** [5s Kh Kd] [4s]
9bc971a7: bets $0.25
46664599: calls $0.25
*** RIVER *** [5s Kh Kd 4s] [Qh]
9bc971a7: checks
46664599: bets $0.5
9bc971a7: folds
Uncalled bet ($0.5) returned to 46664599
*** SHOWDOWN ***
46664599 collected $0.94 from pot
*** SUMMARY ***
Total pot $0.99 | Rake $0.05 | Jackpot $0 | Bingo $0 | Fortune $0
Board [5s Kh Kd 4s Qh]
Seat 1: 629306a (button) folded before Flop (didn't bet)
Seat 2: a19a7c1e (small blind) folded before Flop
Seat 3: 9bc971a7 (big blind) folded on the River
Seat 4: Hero folded before Flop (didn't bet)
Seat 5: 46664599 won ($0.94)
Seat 6: b1e5a0a3 folded before Flop (didn't bet)


Poker Hand #RC1452509333: Hold'em No Limit  ($0.05/$0.1) - 2023/04/05 13:59:37
Table 'RushAndCash2204593' 6-max Seat #1 is the button
Seat 1: 78be7c84 ($10 in chips)
Seat 2: 651051e1 ($10.85 in chips)
Seat 3: 7fe289ff ($13.93 in chips)
Seat 4: 43c9b82 ($16.15 in chips)
Seat 5: Hero ($14 in chips)
Seat 6: 9a494706 ($14.2 in chips)
651051e1: posts small blind $0.05
7fe289ff: posts big blind $0.1
*** HOLE CARDS ***
Dealt to 78be7c84 
Dealt to 651051e1 
Dealt to 7fe289ff 
Dealt to 43c9b82 
Dealt to Hero [Jd 9h]
Dealt to 9a494706 
43c9b82: folds
Hero: folds
9a494706: folds
78be7c84: raises $0.15 to $0.25
651051e1: folds
7fe289ff: calls $0.15
*** FLOP *** [2h As Qc]
7fe289ff: checks
78be7c84: bets $0.19
7fe289ff: calls $0.19
*** TURN *** [2h As Qc] [3d]
7fe289ff: checks
78be7c84: checks
*** RIVER *** [2h As Qc 3d] [Td]
7fe289ff: bets $0.64
78be7c84: folds
Uncalled bet ($0.64) returned to 7fe289ff
*** SHOWDOWN ***
7fe289ff collected $0.89 from pot
*** SUMMARY ***
Total pot $0.93 | Rake $0.04 | Jackpot $0 | Bingo $0 | Fortune $0
Board [2h As Qc 3d Td]
Seat 1: 78be7c84 (button) folded on the River
Seat 2: 651051e1 (small blind) folded before Flop
Seat 3: 7fe289ff (big blind) won ($0.89)
Seat 4: 43c9b82 folded before Flop (didn't bet)
Seat 5: Hero folded before Flop (didn't bet)
Seat 6: 9a494706 folded before Flop (didn't bet)


Poker Hand #RC1452509279: Hold'em No Limit  ($0.05/$0.1) - 2023/04/05 13:59:28
Table 'RushAndCash2204539' 6-max Seat #1 is the button
Seat 1: be8b07ca ($12.54 in chips)
Seat 2: Hero ($14.05 in chips)
Seat 3: 5eb956f9 ($12.71 in chips)
Seat 4: a588e40f ($31.3 in chips)
Seat 5: 5bc13908 ($8.6 in chips)
Seat 6: 4b677518 ($25.2 in chips)
Hero: posts small blind $0.05
5eb956f9: posts big blind $0.1
*** HOLE CARDS ***
Dealt to be8b07ca 
Dealt to Hero [Ac 5c]
Dealt to 5eb956f9 
Dealt to a588e40f 
Dealt to 5bc13908 
Dealt to 4b677518 
a588e40f: raises $0.16 to $0.26
5bc13908: folds
4b677518: folds
be8b07ca: folds
Hero: folds
5eb956f9: calls $0.16
*** FLOP *** [Kh 7s Kc]
5eb956f9: checks
a588e40f: checks
*** TURN *** [Kh 7s Kc] [7d]
5eb956f9: bets $0.29
a588e40f: calls $0.29
*** RIVER *** [Kh 7s Kc 7d] [2d]
5eb956f9: bets $0.8
a588e40f: calls $0.8
5eb956f9: shows [Js 9c] (Pair of Kings and Pair of Sevens)
a588e40f: shows [Qc Qd] (Pair of Kings and Pair of Queens)
*** SHOWDOWN ***
a588e40f collected $2.62 from pot
*** SUMMARY ***
Total pot $2.75 | Rake $0.13 | Jackpot $0 | Bingo $0 | Fortune $0
Board [Kh 7s Kc 7d 2d]
Seat 1: be8b07ca (button) folded before Flop (didn't bet)
Seat 2: Hero (small blind) folded before Flop
Seat 3: 5eb956f9 (big blind) showed [Js 9c] and lost with Pair of Kings and Pair of Sevens
Seat 4: a588e40f showed [Qc Qd] and won ($2.62) with Pair of Kings and Pair of Queens
Seat 5: 5bc13908 folded before Flop (didn't bet)
Seat 6: 4b677518 folded before Flop (didn't bet)


Poker Hand #RC1452508747: Hold'em No Limit  ($0.05/$0.1) - 2023/04/05 13:57:59
Table 'RushAndCash2204007' 6-max Seat #1 is the button
Seat 1: 4e0562b4 ($17.86 in chips)
Seat 2: 5eb956f9 ($14.51 in chips)
Seat 3: Hero ($11.62 in chips)
Seat 4: 5bc13908 ($9.6 in chips)
Seat 5: 6d4d5e4c ($10 in chips)
Seat 6: 80c7eb0e ($10 in chips)
5eb956f9: posts small blind $0.05
Hero: posts big blind $0.1
*** HOLE CARDS ***
Dealt to 4e0562b4 
Dealt to 5eb956f9 
Dealt to Hero [Th Ts]
Dealt to 5bc13908 
Dealt to 6d4d5e4c 
Dealt to 80c7eb0e 
5bc13908: raises $0.12 to $0.22
6d4d5e4c: folds
80c7eb0e: folds
4e0562b4: folds
5eb956f9: calls $0.17
Hero: raises $0.78 to $1
5bc13908: calls $0.78
5eb956f9: calls $0.78
*** FLOP *** [Kh 5s Tc]
5eb956f9: checks
Hero: bets $0.8
5bc13908: folds
5eb956f9: calls $0.8
*** TURN *** [Kh 5s Tc] [4s]
5eb956f9: checks
Hero: bets $1.9
5eb956f9: folds
Uncalled bet ($1.9) returned to Hero
*** SHOWDOWN ***
Hero collected $4.23 from pot
*** SUMMARY ***
Total pot $4.6 | Rake $0.22 | Jackpot $0.15 | Bingo $0 | Fortune $0
Board [Kh 5s Tc 4s]
Seat 1: 4e0562b4 (button) folded before Flop (didn't bet)
Seat 2: 5eb956f9 (small blind) folded on the Turn
Seat 3: Hero (big blind) won ($4.23)
Seat 4: 5bc13908 folded on the Flop
Seat 5: 6d4d5e4c folded before Flop (didn't bet)
Seat 6: 80c7eb0e folded before Flop (didn't bet)


Poker Hand #RC1452508711: Hold'em No Limit  ($0.05/$0.1) - 2023/04/05 13:57:52
Table 'RushAndCash2203971' 6-max Seat #1 is the button
Seat 1: 3bec71ac ($14.16 in chips)
Seat 2: cbe3a0b4 ($14.67 in chips)
Seat 3: 1a4a6eda ($10.1 in chips)
Seat 4: 8b640ccd ($12.07 in chips)
Seat 5: Hero ($11.62 in chips)
Seat 6: c02952de ($16.3 in chips)
cbe3a0b4: posts small blind $0.05
1a4a6eda: posts big blind $0.1
*** HOLE CARDS ***
Dealt to 3bec71ac 
Dealt to cbe3a0b4 
Dealt to 1a4a6eda 
Dealt to 8b640ccd 
Dealt to Hero [9s 5d]
Dealt to c02952de 
8b640ccd: folds
Hero: folds
c02952de: folds
3bec71ac: folds
cbe3a0b4: folds
Uncalled bet ($0.05) returned to 1a4a6eda
*** SHOWDOWN ***
1a4a6eda collected $0.1 from pot
*** SUMMARY ***
Total pot $0.1 | Rake $0 | Jackpot $0 | Bingo $0 | Fortune $0
Seat 1: 3bec71ac (button) folded before Flop (didn't bet)
Seat 2: cbe3a0b4 (small blind) folded before Flop
Seat 3: 1a4a6eda (big blind) collected ($0.1)
Seat 4: 8b640ccd folded before Flop (didn't bet)
Seat 5: Hero folded before Flop (didn't bet)
Seat 6: c02952de folded before Flop (didn't bet)


Poker Hand #RC1452508584: Hold'em No Limit  ($0.05/$0.1) - 2023/04/05 13:57:30
Table 'RushAndCash2203844' 6-max Seat #1 is the button
Seat 1: 676e8f2e ($16.73 in chips)
Seat 2: c22fd09f ($10 in chips)
Seat 3: 3b0d8197 ($20.14 in chips)
Seat 4: 2c16c8c7 ($20.38 in chips)
Seat 5: Hero ($11.47 in chips)
Seat 6: 72aad492 ($10.49 in chips)
c22fd09f: posts small blind $0.05
3b0d8197: posts big blind $0.1
*** HOLE CARDS ***
Dealt to 676e8f2e 
Dealt to c22fd09f 
Dealt to 3b0d8197 
Dealt to 2c16c8c7 
Dealt to Hero [9s Ad]
Dealt to 72aad492 
2c16c8c7: folds
Hero: raises $0.15 to $0.25
72aad492: folds
676e8f2e: folds
c22fd09f: folds
3b0d8197: folds
Uncalled bet ($0.15) returned to Hero
*** SHOWDOWN ***
Hero collected $0.25 from pot
*** SUMMARY ***
Total pot $0.25 | Rake $0 | Jackpot $0 | Bingo $0 | Fortune $0
Seat 1: 676e8f2e (button) folded before Flop (didn't bet)
Seat 2: c22fd09f (small blind) folded before Flop
Seat 3: 3b0d8197 (big blind) folded before Flop
Seat 4: 2c16c8c7 folded before Flop (didn't bet)
Seat 5: Hero collected ($0.25)
Seat 6: 72aad492 folded before Flop (didn't bet)


Poker Hand #RC1452508487: Hold'em No Limit  ($0.05/$0.1) - 2023/04/05 13:57:14
Table 'RushAndCash2203747' 6-max Seat #1 is the button
Seat 1: d29ab526 ($15.09 in chips)
Seat 2: 1c0430cf ($12.84 in chips)
Seat 3: Hero ($11.57 in chips)
Seat 4: b7daf3cc ($13.37 in chips)
Seat 5: 409cb610 ($20.82 in chips)
Seat 6: 67d37346 ($10.19 in chips)
1c0430cf: posts small blind $0.05
Hero: posts big blind $0.1
*** HOLE CARDS ***
Dealt to d29ab526 
Dealt to 1c0430cf 
Dealt to Hero [2s 3c]
Dealt to b7daf3cc 
Dealt to 409cb610 
Dealt to 67d37346 
b7daf3cc: folds
409cb610: folds
67d37346: folds
d29ab526: raises $0.14 to $0.24
1c0430cf: folds
Hero: folds
Uncalled bet ($0.14) returned to d29ab526
*** SHOWDOWN ***
d29ab526 collected $0.25 from pot
*** SUMMARY ***
Total pot $0.25 | Rake $0 | Jackpot $0 | Bingo $0 | Fortune $0
Seat 1: d29ab526 (button) collected ($0.25)
Seat 2: 1c0430cf (small blind) folded before Flop
Seat 3: Hero (big blind) folded before Flop
Seat 4: b7daf3cc folded before Flop (didn't bet)
Seat 5: 409cb610 folded before Flop (didn't bet)
Seat 6: 67d37346 folded before Flop (didn't bet)


Poker Hand #RC1452508429: Hold'em No Limit  ($0.05/$0.1) - 2023/04/05 13:57:05
Table 'RushAndCash2203689' 6-max Seat #1 is the button
Seat 1: Hero ($11.57 in chips)
Seat 2: 5a03533f ($7.98 in chips)
Seat 3: 325744eb ($10 in chips)
Seat 4: 83527647 ($10.32 in chips)
Seat 5: b2964b7b ($45.46 in chips)
Seat 6: 945f78d ($14.46 in chips)
5a03533f: posts small blind $0.05
325744eb: posts big blind $0.1
*** HOLE CARDS ***
Dealt to Hero [Qs 7c]
Dealt to 5a03533f 
Dealt to 325744eb 
Dealt to 83527647 
Dealt to b2964b7b 
Dealt to 945f78d 
83527647: raises $0.2 to $0.3
b2964b7b: folds
945f78d: folds
Hero: folds
5a03533f: folds
325744eb: folds
Uncalled bet ($0.2) returned to 83527647
*** SHOWDOWN ***
83527647 collected $0.25 from pot
*** SUMMARY ***
Total pot $0.25 | Rake $0 | Jackpot $0 | Bingo $0 | Fortune $0
Seat 1: Hero (button) folded before Flop (didn't bet)
Seat 2: 5a03533f (small blind) folded before Flop
Seat 3: 325744eb (big blind) folded before Flop
Seat 4: 83527647 collected ($0.25)
Seat 5: b2964b7b folded before Flop (didn't bet)
Seat 6: 945f78d folded before Flop (didn't bet)


Poker Hand #RC1452508401: Hold'em No Limit  ($0.05/$0.1) - 2023/04/05 13:57:01
Table 'RushAndCash2203661' 6-max Seat #1 is the button
Seat 1: f60dcbf ($16.81 in chips)
Seat 2: Hero ($11.62 in chips)
Seat 3: 4c74a599 ($13.51 in chips)
Seat 4: 8ece89d ($22.11 in chips)
Seat 5: 4b745cb1 ($10 in chips)
Seat 6: f4440ff6 ($24.65 in chips)
Hero: posts small blind $0.05
4c74a599: posts big blind $0.1
*** HOLE CARDS ***
Dealt to f60dcbf 
Dealt to Hero [7h Qc]
Dealt to 4c74a599 
Dealt to 8ece89d 
Dealt to 4b745cb1 
Dealt to f4440ff6 
8ece89d: raises $0.15 to $0.25
4b745cb1: folds
f4440ff6: folds
f60dcbf: folds
Hero: folds
4c74a599: folds
Uncalled bet ($0.15) returned to 8ece89d
*** SHOWDOWN ***
8ece89d collected $0.25 from pot
*** SUMMARY ***
Total pot $0.25 | Rake $0 | Jackpot $0 | Bingo $0 | Fortune $0
Seat 1: f60dcbf (button) folded before Flop (didn't bet)
Seat 2: Hero (small blind) folded before Flop
Seat 3: 4c74a599 (big blind) folded before Flop
Seat 4: 8ece89d collected ($0.25)
Seat 5: 4b745cb1 folded before Flop (didn't bet)
Seat 6: f4440ff6 folded before Flop (didn't bet)


Poker Hand #RC1452508361: Hold'em No Limit  ($0.05/$0.1) - 2023/04/05 13:56:55
Table 'RushAndCash2203621' 6-max Seat #1 is the button
Seat 1: 5ff8e826 ($17.01 in chips)
Seat 2: 844a97bc ($15.28 in chips)
Seat 3: 5f1f500b ($10 in chips)
Seat 4: Hero ($11.62 in chips)
Seat 5: b16414c5 ($10.56 in chips)
Seat 6: 35dd38df ($10 in chips)
844a97bc: posts small blind $0.05
5f1f500b: posts big blind $0.1
*** HOLE CARDS ***
Dealt to 5ff8e826 
Dealt to 844a97bc 
Dealt to 5f1f500b 
Dealt to Hero [4h 3d]
Dealt to b16414c5 
Dealt to 35dd38df 
Hero: folds
b16414c5: raises $0.15 to $0.25
35dd38df: folds
5ff8e826: folds
844a97bc: folds
5f1f500b: folds
Uncalled bet ($0.15) returned to b16414c5
*** SHOWDOWN ***
b16414c5 collected $0.25 from pot
*** SUMMARY ***
Total pot $0.25 | Rake $0 | Jackpot $0 | Bingo $0 | Fortune $0
Seat 1: 5ff8e826 (button) folded before Flop (didn't bet)
Seat 2: 844a97bc (small blind) folded before Flop
Seat 3: 5f1f500b (big blind) folded before Flop
Seat 4: Hero folded before Flop (didn't bet)
Seat 5: b16414c5 collected ($0.25)
Seat 6: 35dd38df folded before Flop (didn't bet)


Poker Hand #RC1452508320: Hold'em No Limit  ($0.05/$0.1) - 2023/04/05 13:56:47
Table 'RushAndCash2203580' 6-max Seat #1 is the button
Seat 1: 7b5ec42f ($10 in chips)
Seat 2: 72aad492 ($10.69 in chips)
Seat 3: 41e3204f ($9.92 in chips)
Seat 4: 6d4d5e4c ($10 in chips)
Seat 5: c02952de ($17.02 in chips)
Seat 6: Hero ($11.62 in chips)
72aad492: posts small blind $0.05
41e3204f: posts big blind $0.1
*** HOLE CARDS ***
Dealt to 7b5ec42f 
Dealt to 72aad492 
Dealt to 41e3204f 
Dealt to 6d4d5e4c 
Dealt to c02952de 
Dealt to Hero [Jd 2h]
6d4d5e4c: folds
c02952de: folds
Hero: folds
7b5ec42f: folds
72aad492: folds
Uncalled bet ($0.05) returned to 41e3204f
*** SHOWDOWN ***
41e3204f collected $0.1 from pot
*** SUMMARY ***
Total pot $0.1 | Rake $0 | Jackpot $0 | Bingo $0 | Fortune $0
Seat 1: 7b5ec42f (button) folded before Flop (didn't bet)
Seat 2: 72aad492 (small blind) folded before Flop
Seat 3: 41e3204f (big blind) collected ($0.1)
Seat 4: 6d4d5e4c folded before Flop (didn't bet)
Seat 5: c02952de folded before Flop (didn't bet)
Seat 6: Hero folded before Flop (didn't bet)


Poker Hand #RC1452508282: Hold'em No Limit  ($0.05/$0.1) - 2023/04/05 13:56:41
Table 'RushAndCash2203542' 6-max Seat #1 is the button
Seat 1: c8b8ac61 ($10.34 in chips)
Seat 2: 3b0d8197 ($20.14 in chips)
Seat 3: d227494e ($14.67 in chips)
Seat 4: Hero ($11.62 in chips)
Seat 5: 34f8eac5 ($8.95 in chips)
Seat 6: 9b8b2d31 ($12.32 in chips)
3b0d8197: posts small blind $0.05
d227494e: posts big blind $0.1
*** HOLE CARDS ***
Dealt to c8b8ac61 
Dealt to 3b0d8197 
Dealt to d227494e 
Dealt to Hero [9d Jh]
Dealt to 34f8eac5 
Dealt to 9b8b2d31 
Hero: folds
34f8eac5: folds
9b8b2d31: folds
c8b8ac61: raises $0.25 to $0.35
3b0d8197: folds
d227494e: calls $0.25
*** FLOP *** [7c 3h 7h]
d227494e: checks
c8b8ac61: bets $0.38
d227494e: calls $0.38
*** TURN *** [7c 3h 7h] [Kc]
d227494e: checks
c8b8ac61: bets $1.14
d227494e: folds
Uncalled bet ($1.14) returned to c8b8ac61
*** SHOWDOWN ***
c8b8ac61 collected $1.44 from pot
*** SUMMARY ***
Total pot $1.51 | Rake $0.07 | Jackpot $0 | Bingo $0 | Fortune $0
Board [7c 3h 7h Kc]
Seat 1: c8b8ac61 (button) won ($1.44)
Seat 2: 3b0d8197 (small blind) folded before Flop
Seat 3: d227494e (big blind) folded on the Turn
Seat 4: Hero folded before Flop (didn't bet)
Seat 5: 34f8eac5 folded before Flop (didn't bet)
Seat 6: 9b8b2d31 folded before Flop (didn't bet)


Poker Hand #RC1452508249: Hold'em No Limit  ($0.05/$0.1) - 2023/04/05 13:56:36
Table 'RushAndCash2203509' 6-max Seat #1 is the button
Seat 1: Hero ($11.62 in chips)
Seat 2: 30a5572e ($8.35 in chips)
Seat 3: b16414c5 ($10.71 in chips)
Seat 4: a52079d8 ($12.46 in chips)
Seat 5: 6cdc21ca ($4.39 in chips)
Seat 6: 6b1661e6 ($19.05 in chips)
30a5572e: posts small blind $0.05
b16414c5: posts big blind $0.1
*** HOLE CARDS ***
Dealt to Hero [5c 6s]
Dealt to 30a5572e 
Dealt to b16414c5 
Dealt to a52079d8 
Dealt to 6cdc21ca 
Dealt to 6b1661e6 
a52079d8: raises $0.1 to $0.2
6cdc21ca: folds
6b1661e6: folds
Hero: folds
30a5572e: folds
b16414c5: folds
Uncalled bet ($0.1) returned to a52079d8
*** SHOWDOWN ***
a52079d8 collected $0.25 from pot
*** SUMMARY ***
Total pot $0.25 | Rake $0 | Jackpot $0 | Bingo $0 | Fortune $0
Seat 1: Hero (button) folded before Flop (didn't bet)
Seat 2: 30a5572e (small blind) folded before Flop
Seat 3: b16414c5 (big blind) folded before Flop
Seat 4: a52079d8 collected ($0.25)
Seat 5: 6cdc21ca folded before Flop (didn't bet)
Seat 6: 6b1661e6 folded before Flop (didn't bet)


Poker Hand #RC1452508119: Hold'em No Limit  ($0.05/$0.1) - 2023/04/05 13:56:16
Table 'RushAndCash2203379' 6-max Seat #1 is the button
Seat 1: 9ee20be7 ($10.28 in chips)
Seat 2: Hero ($11.67 in chips)
Seat 3: eba38528 ($12.18 in chips)
Seat 4: f60dcbf ($16.81 in chips)
Seat 5: 9ca4b5be ($14.13 in chips)
Seat 6: e5780d1a ($15.08 in chips)
Hero: posts small blind $0.05
eba38528: posts big blind $0.1
*** HOLE CARDS ***
Dealt to 9ee20be7 
Dealt to Hero [Qc 4s]
Dealt to eba38528 
Dealt to f60dcbf 
Dealt to 9ca4b5be 
Dealt to e5780d1a 
f60dcbf: folds
9ca4b5be: folds
e5780d1a: raises $0.1 to $0.2
9ee20be7: folds
Hero: folds
eba38528: folds
Uncalled bet ($0.1) returned to e5780d1a
*** SHOWDOWN ***
e5780d1a collected $0.25 from pot
*** SUMMARY ***
Total pot $0.25 | Rake $0 | Jackpot $0 | Bingo $0 | Fortune $0
Seat 1: 9ee20be7 (button) folded before Flop (didn't bet)
Seat 2: Hero (small blind) folded before Flop
Seat 3: eba38528 (big blind) folded before Flop
Seat 4: f60dcbf folded before Flop (didn't bet)
Seat 5: 9ca4b5be folded before Flop (didn't bet)
Seat 6: e5780d1a collected ($0.25)


Poker Hand #RC1452508044: Hold'em No Limit  ($0.05/$0.1) - 2023/04/05 13:56:03
Table 'RushAndCash2203304' 6-max Seat #1 is the button
Seat 1: 93dab03 ($12.29 in chips)
Seat 2: 9f2061d0 ($10.1 in chips)
Seat 3: Hero ($11.77 in chips)
Seat 4: 6e8bd6b4 ($8.43 in chips)
Seat 5: a45fef87 ($15.42 in chips)
Seat 6: 87aa2f17 ($24.32 in chips)
9f2061d0: posts small blind $0.05
Hero: posts big blind $0.1
*** HOLE CARDS ***
Dealt to 93dab03 
Dealt to 9f2061d0 
Dealt to Hero [3s 4h]
Dealt to 6e8bd6b4 
Dealt to a45fef87 
Dealt to 87aa2f17 
6e8bd6b4: folds
a45fef87: folds
87aa2f17: raises $0.15 to $0.25
93dab03: folds
9f2061d0: folds
Hero: folds
Uncalled bet ($0.15) returned to 87aa2f17
*** SHOWDOWN ***
87aa2f17 collected $0.25 from pot
*** SUMMARY ***
Total pot $0.25 | Rake $0 | Jackpot $0 | Bingo $0 | Fortune $0
Seat 1: 93dab03 (button) folded before Flop (didn't bet)
Seat 2: 9f2061d0 (small blind) folded before Flop
Seat 3: Hero (big blind) folded before Flop
Seat 4: 6e8bd6b4 folded before Flop (didn't bet)
Seat 5: a45fef87 folded before Flop (didn't bet)
Seat 6: 87aa2f17 collected ($0.25)


Poker Hand #RC1452507883: Hold'em No Limit  ($0.05/$0.1) - 2023/04/05 13:55:39
Table 'RushAndCash2203143' 6-max Seat #1 is the button
Seat 1: 7a9cae18 ($9.96 in chips)
Seat 2: c59f4b9 ($8.95 in chips)
Seat 3: da1133c4 ($8.67 in chips)
Seat 4: 9a494706 ($10.66 in chips)
Seat 5: 16934c31 ($30.73 in chips)
Seat 6: Hero ($11.62 in chips)
c59f4b9: posts small blind $0.05
da1133c4: posts big blind $0.1
*** HOLE CARDS ***
Dealt to 7a9cae18 
Dealt to c59f4b9 
Dealt to da1133c4 
Dealt to 9a494706 
Dealt to 16934c31 
Dealt to Hero [Jh Kh]
9a494706: folds
16934c31: folds
Hero: raises $0.15 to $0.25
7a9cae18: folds
c59f4b9: folds
da1133c4: folds
Uncalled bet ($0.15) returned to Hero
*** SHOWDOWN ***
Hero collected $0.25 from pot
*** SUMMARY ***
Total pot $0.25 | Rake $0 | Jackpot $0 | Bingo $0 | Fortune $0
Seat 1: 7a9cae18 (button) folded before Flop (didn't bet)
Seat 2: c59f4b9 (small blind) folded before Flop
Seat 3: da1133c4 (big blind) folded before Flop
Seat 4: 9a494706 folded before Flop (didn't bet)
Seat 5: 16934c31 folded before Flop (didn't bet)
Seat 6: Hero collected ($0.25)


Poker Hand #RC1452507786: Hold'em No Limit  ($0.05/$0.1) - 2023/04/05 13:55:22
Table 'RushAndCash2203046' 6-max Seat #1 is the button
Seat 1: 523529b5 ($11.06 in chips)
Seat 2: Hero ($11.52 in chips)
Seat 3: 66111971 ($13.28 in chips)
Seat 4: d9214a36 ($17.02 in chips)
Seat 5: 4318627e ($9.45 in chips)
Seat 6: a9ff1325 ($10.15 in chips)
Hero: posts small blind $0.05
66111971: posts big blind $0.1
*** HOLE CARDS ***
Dealt to 523529b5 
Dealt to Hero [Qd As]
Dealt to 66111971 
Dealt to d9214a36 
Dealt to 4318627e 
Dealt to a9ff1325 
d9214a36: folds
4318627e: folds
a9ff1325: folds
523529b5: folds
Hero: raises $0.2 to $0.3
66111971: folds
Uncalled bet ($0.2) returned to Hero
*** SHOWDOWN ***
Hero collected $0.2 from pot
*** SUMMARY ***
Total pot $0.2 | Rake $0 | Jackpot $0 | Bingo $0 | Fortune $0
Seat 1: 523529b5 (button) folded before Flop (didn't bet)
Seat 2: Hero (small blind) collected ($0.2)
Seat 3: 66111971 (big blind) folded before Flop
Seat 4: d9214a36 folded before Flop (didn't bet)
Seat 5: 4318627e folded before Flop (didn't bet)
Seat 6: a9ff1325 folded before Flop (didn't bet)


Poker Hand #RC1452507732: Hold'em No Limit  ($0.05/$0.1) - 2023/04/05 13:55:14
Table 'RushAndCash2202992' 6-max Seat #1 is the button
Seat 1: Hero ($11.52 in chips)
Seat 2: 1480afcf ($10 in chips)
Seat 3: 66f9b8be ($20.24 in chips)
Seat 4: a944a75b ($10.6 in chips)
Seat 5: 45a68577 ($10.39 in chips)
Seat 6: b7daf3cc ($14.2 in chips)
1480afcf: posts small blind $0.05
66f9b8be: posts big blind $0.1
*** HOLE CARDS ***
Dealt to Hero [6d 9d]
Dealt to 1480afcf 
Dealt to 66f9b8be 
Dealt to a944a75b 
Dealt to 45a68577 
Dealt to b7daf3cc 
a944a75b: folds
45a68577: raises $0.1 to $0.2
b7daf3cc: folds
Hero: folds
1480afcf: raises $0.85 to $1.05
66f9b8be: folds
45a68577: folds
Uncalled bet ($0.85) returned to 1480afcf
*** SHOWDOWN ***
1480afcf collected $0.48 from pot
*** SUMMARY ***
Total pot $0.5 | Rake $0.02 | Jackpot $0 | Bingo $0 | Fortune $0
Seat 1: Hero (button) folded before Flop (didn't bet)
Seat 2: 1480afcf (small blind) collected ($0.48)
Seat 3: 66f9b8be (big blind) folded before Flop
Seat 4: a944a75b folded before Flop (didn't bet)
Seat 5: 45a68577 folded before Flop
Seat 6: b7daf3cc folded before Flop (didn't bet)


Poker Hand #RC1452507597: Hold'em No Limit  ($0.05/$0.1) - 2023/04/05 13:54:54
Table 'RushAndCash2202857' 6-max Seat #1 is the button
Seat 1: 39025222 ($22.09 in chips)
Seat 2: 4cfe2085 ($11.22 in chips)
Seat 3: aec1c28d ($9.44 in chips)
Seat 4: 7f680ce3 ($34.77 in chips)
Seat 5: 8ece89d ($23.44 in chips)
Seat 6: Hero ($11.15 in chips)
4cfe2085: posts small blind $0.05
aec1c28d: posts big blind $0.1
*** HOLE CARDS ***
Dealt to 39025222 
Dealt to 4cfe2085 
Dealt to aec1c28d 
Dealt to 7f680ce3 
Dealt to 8ece89d 
Dealt to Hero [9c Ac]
7f680ce3: folds
8ece89d: raises $0.15 to $0.25
Hero: raises $0.55 to $0.8
39025222: folds
4cfe2085: folds
aec1c28d: folds
8ece89d: folds
Uncalled bet ($0.55) returned to Hero
*** SHOWDOWN ***
Hero collected $0.62 from pot
*** SUMMARY ***
Total pot $0.65 | Rake $0.03 | Jackpot $0 | Bingo $0 | Fortune $0
Seat 1: 39025222 (button) folded before Flop (didn't bet)
Seat 2: 4cfe2085 (small blind) folded before Flop
Seat 3: aec1c28d (big blind) folded before Flop
Seat 4: 7f680ce3 folded before Flop (didn't bet)
Seat 5: 8ece89d folded before Flop
Seat 6: Hero collected ($0.62)


Poker Hand #RC1452507549: Hold'em No Limit  ($0.05/$0.1) - 2023/04/05 13:54:46
Table 'RushAndCash2202809' 6-max Seat #1 is the button
Seat 1: d4cabbf6 ($10.65 in chips)
Seat 2: 757aece3 ($11.27 in chips)
Seat 3: Hero ($11.25 in chips)
Seat 4: ce555ed9 ($11.63 in chips)
Seat 5: 881f785d ($17.96 in chips)
Seat 6: 79201ae0 ($10.3 in chips)
757aece3: posts small blind $0.05
Hero: posts big blind $0.1
*** HOLE CARDS ***
Dealt to d4cabbf6 
Dealt to 757aece3 
Dealt to Hero [Jd 2s]
Dealt to ce555ed9 
Dealt to 881f785d 
Dealt to 79201ae0 
ce555ed9: folds
881f785d: raises $0.15 to $0.25
79201ae0: folds
d4cabbf6: folds
757aece3: folds
Hero: folds
Uncalled bet ($0.15) returned to 881f785d
*** SHOWDOWN ***
881f785d collected $0.25 from pot
*** SUMMARY ***
Total pot $0.25 | Rake $0 | Jackpot $0 | Bingo $0 | Fortune $0
Seat 1: d4cabbf6 (button) folded before Flop (didn't bet)
Seat 2: 757aece3 (small blind) folded before Flop
Seat 3: Hero (big blind) folded before Flop
Seat 4: ce555ed9 folded before Flop (didn't bet)
Seat 5: 881f785d collected ($0.25)
Seat 6: 79201ae0 folded before Flop (didn't bet)


Poker Hand #RC1452507523: Hold'em No Limit  ($0.05/$0.1) - 2023/04/05 13:54:42
Table 'RushAndCash2202783' 6-max Seat #1 is the button
Seat 1: c62178c5 ($11.53 in chips)
Seat 2: 4b2e18f4 ($12.92 in chips)
Seat 3: 9bc971a7 ($10.1 in chips)
Seat 4: 881f785d ($17.96 in chips)
Seat 5: e603798a ($10 in chips)
Seat 6: Hero ($11.25 in chips)
4b2e18f4: posts small blind $0.05
9bc971a7: posts big blind $0.1
*** HOLE CARDS ***
Dealt to c62178c5 
Dealt to 4b2e18f4 
Dealt to 9bc971a7 
Dealt to 881f785d 
Dealt to e603798a 
Dealt to Hero [5c Td]
881f785d: folds
e603798a: folds
Hero: folds
c62178c5: folds
4b2e18f4: raises $0.2 to $0.3
9bc971a7: folds
Uncalled bet ($0.2) returned to 4b2e18f4
*** SHOWDOWN ***
4b2e18f4 collected $0.2 from pot
*** SUMMARY ***
Total pot $0.2 | Rake $0 | Jackpot $0 | Bingo $0 | Fortune $0
Seat 1: c62178c5 (button) folded before Flop (didn't bet)
Seat 2: 4b2e18f4 (small blind) collected ($0.2)
Seat 3: 9bc971a7 (big blind) folded before Flop
Seat 4: 881f785d folded before Flop (didn't bet)
Seat 5: e603798a folded before Flop (didn't bet)
Seat 6: Hero folded before Flop (didn't bet)


Poker Hand #RC1452507487: Hold'em No Limit  ($0.05/$0.1) - 2023/04/05 13:54:36
Table 'RushAndCash2202747' 6-max Seat #1 is the button
Seat 1: b1c1f07e ($13.88 in chips)
Seat 2: 1d019a90 ($28.13 in chips)
Seat 3: 7f680ce3 ($34.82 in chips)
Seat 4: 7f0c6026 ($17.41 in chips)
Seat 5: 245597af ($10.3 in chips)
Seat 6: Hero ($11.25 in chips)
1d019a90: posts small blind $0.05
7f680ce3: posts big blind $0.1
*** HOLE CARDS ***
Dealt to b1c1f07e 
Dealt to 1d019a90 
Dealt to 7f680ce3 
Dealt to 7f0c6026 
Dealt to 245597af 
Dealt to Hero [6s 8d]
7f0c6026: folds
245597af: folds
Hero: folds
b1c1f07e: folds
1d019a90: folds
Uncalled bet ($0.05) returned to 7f680ce3
*** SHOWDOWN ***
7f680ce3 collected $0.1 from pot
*** SUMMARY ***
Total pot $0.1 | Rake $0 | Jackpot $0 | Bingo $0 | Fortune $0
Seat 1: b1c1f07e (button) folded before Flop (didn't bet)
Seat 2: 1d019a90 (small blind) folded before Flop
Seat 3: 7f680ce3 (big blind) collected ($0.1)
Seat 4: 7f0c6026 folded before Flop (didn't bet)
Seat 5: 245597af folded before Flop (didn't bet)
Seat 6: Hero folded before Flop (didn't bet)


Poker Hand #RC1452507104: Hold'em No Limit  ($0.05/$0.1) - 2023/04/05 13:53:32
Table 'RushAndCash2202364' 6-max Seat #1 is the button
Seat 1: d70c330e ($10 in chips)
Seat 2: b1c1f07e ($12.47 in chips)
Seat 3: 731d9b47 ($18.52 in chips)
Seat 4: ea56966b ($10.35 in chips)
Seat 5: 863b5091 ($7.07 in chips)
Seat 6: Hero ($12.86 in chips)
b1c1f07e: posts small blind $0.05
731d9b47: posts big blind $0.1
*** HOLE CARDS ***
Dealt to d70c330e 
Dealt to b1c1f07e 
Dealt to 731d9b47 
Dealt to ea56966b 
Dealt to 863b5091 
Dealt to Hero [Kd 7d]
ea56966b: folds
863b5091: folds
Hero: raises $0.15 to $0.25
d70c330e: folds
b1c1f07e: raises $0.2 to $0.45
731d9b47: folds
Hero: calls $0.2
*** FLOP *** [7h 9d 2s]
b1c1f07e: bets $0.33
Hero: calls $0.33
*** TURN *** [7h 9d 2s] [6c]
b1c1f07e: bets $0.83
Hero: calls $0.83
*** RIVER *** [7h 9d 2s 6c] [Ad]
b1c1f07e: checks
Hero: checks
b1c1f07e: shows [Js Jd] (Pair of Jacks)
Hero: shows [Kd 7d] (Pair of Sevens)
*** SHOWDOWN ***
b1c1f07e collected $3.02 from pot
*** SUMMARY ***
Total pot $3.32 | Rake $0.15 | Jackpot $0.15 | Bingo $0 | Fortune $0
Board [7h 9d 2s 6c Ad]
Seat 1: d70c330e (button) folded before Flop (didn't bet)
Seat 2: b1c1f07e (small blind) showed [Js Jd] and won ($3.02) with Pair of Jacks
Seat 3: 731d9b47 (big blind) folded before Flop
Seat 4: ea56966b folded before Flop (didn't bet)
Seat 5: 863b5091 folded before Flop (didn't bet)
Seat 6: Hero showed [Kd 7d] and lost with Pair of Sevens


Poker Hand #RC1452506056: Hold'em No Limit  ($0.05/$0.1) - 2023/04/05 13:50:42
Table 'RushAndCash2201316' 6-max Seat #1 is the button
Seat 1: be8b07ca ($10 in chips)
Seat 2: 9219b48 ($10 in chips)
Seat 3: 17dba31a ($22.96 in chips)
Seat 4: 67d37346 ($10.89 in chips)
Seat 5: Hero ($12.86 in chips)
Seat 6: c2d07061 ($10.57 in chips)
9219b48: posts small blind $0.05
17dba31a: posts big blind $0.1
*** HOLE CARDS ***
Dealt to be8b07ca 
Dealt to 9219b48 
Dealt to 17dba31a 
Dealt to 67d37346 
Dealt to Hero [7c Kd]
Dealt to c2d07061 
67d37346: folds
Hero: folds
c2d07061: folds
be8b07ca: raises $0.15 to $0.25
9219b48: folds
17dba31a: folds
Uncalled bet ($0.15) returned to be8b07ca
*** SHOWDOWN ***
be8b07ca collected $0.25 from pot
*** SUMMARY ***
Total pot $0.25 | Rake $0 | Jackpot $0 | Bingo $0 | Fortune $0
Seat 1: be8b07ca (button) collected ($0.25)
Seat 2: 9219b48 (small blind) folded before Flop
Seat 3: 17dba31a (big blind) folded before Flop
Seat 4: 67d37346 folded before Flop (didn't bet)
Seat 5: Hero folded before Flop (didn't bet)
Seat 6: c2d07061 folded before Flop (didn't bet)


Poker Hand #RC1452506019: Hold'em No Limit  ($0.05/$0.1) - 2023/04/05 13:50:36
Table 'RushAndCash2201279' 6-max Seat #1 is the button
Seat 1: b5d740f7 ($11.17 in chips)
Seat 2: f9979ea0 ($17.63 in chips)
Seat 3: dcfcc17c ($10.28 in chips)
Seat 4: Hero ($12.86 in chips)
Seat 5: 9ca4b5be ($14.28 in chips)
Seat 6: a3d593b3 ($17.73 in chips)
f9979ea0: posts small blind $0.05
dcfcc17c: posts big blind $0.1
*** HOLE CARDS ***
Dealt to b5d740f7 
Dealt to f9979ea0 
Dealt to dcfcc17c 
Dealt to Hero [Td 3d]
Dealt to 9ca4b5be 
Dealt to a3d593b3 
Hero: folds
9ca4b5be: folds
a3d593b3: folds
b5d740f7: raises $0.15 to $0.25
f9979ea0: folds
dcfcc17c: folds
Uncalled bet ($0.15) returned to b5d740f7
*** SHOWDOWN ***
b5d740f7 collected $0.25 from pot
*** SUMMARY ***
Total pot $0.25 | Rake $0 | Jackpot $0 | Bingo $0 | Fortune $0
Seat 1: b5d740f7 (button) collected ($0.25)
Seat 2: f9979ea0 (small blind) folded before Flop
Seat 3: dcfcc17c (big blind) folded before Flop
Seat 4: Hero folded before Flop (didn't bet)
Seat 5: 9ca4b5be folded before Flop (didn't bet)
Seat 6: a3d593b3 folded before Flop (didn't bet)


Poker Hand #RC1452505920: Hold'em No Limit  ($0.05/$0.1) - 2023/04/05 13:50:19
Table 'RushAndCash2201180' 6-max Seat #1 is the button
Seat 1: a588e40f ($32.86 in chips)
Seat 2: aa54f26 ($10.14 in chips)
Seat 3: Hero ($12.96 in chips)
Seat 4: 907bdf43 ($5.75 in chips)
Seat 5: 4692d41d ($27.86 in chips)
Seat 6: 677fc609 ($13.73 in chips)
aa54f26: posts small blind $0.05
Hero: posts big blind $0.1
*** HOLE CARDS ***
Dealt to a588e40f 
Dealt to aa54f26 
Dealt to Hero [7s Qc]
Dealt to 907bdf43 
Dealt to 4692d41d 
Dealt to 677fc609 
907bdf43: folds
4692d41d: folds
677fc609: raises $0.25 to $0.35
a588e40f: folds
aa54f26: folds
Hero: folds
Uncalled bet ($0.25) returned to 677fc609
*** SHOWDOWN ***
677fc609 collected $0.25 from pot
*** SUMMARY ***
Total pot $0.25 | Rake $0 | Jackpot $0 | Bingo $0 | Fortune $0
Seat 1: a588e40f (button) folded before Flop (didn't bet)
Seat 2: aa54f26 (small blind) folded before Flop
Seat 3: Hero (big blind) folded before Flop
Seat 4: 907bdf43 folded before Flop (didn't bet)
Seat 5: 4692d41d folded before Flop (didn't bet)
Seat 6: 677fc609 collected ($0.25)


Poker Hand #RC1452505866: Hold'em No Limit  ($0.05/$0.1) - 2023/04/05 13:50:10
Table 'RushAndCash2201126' 6-max Seat #1 is the button
Seat 1: 91e5b927 ($13.92 in chips)
Seat 2: Hero ($13.01 in chips)
Seat 3: f8c870ba ($5.31 in chips)
Seat 4: f4440ff6 ($17.08 in chips)
Seat 5: 7b84fec ($12.78 in chips)
Seat 6: 6a44f690 ($8.49 in chips)
Hero: posts small blind $0.05
f8c870ba: posts big blind $0.1
*** HOLE CARDS ***
Dealt to 91e5b927 
Dealt to Hero [Qs 7h]
Dealt to f8c870ba 
Dealt to f4440ff6 
Dealt to 7b84fec 
Dealt to 6a44f690 
f4440ff6: folds
7b84fec: folds
6a44f690: folds
91e5b927: raises $0.15 to $0.25
Hero: folds
f8c870ba: folds
Uncalled bet ($0.15) returned to 91e5b927
*** SHOWDOWN ***
91e5b927 collected $0.25 from pot
*** SUMMARY ***
Total pot $0.25 | Rake $0 | Jackpot $0 | Bingo $0 | Fortune $0
Seat 1: 91e5b927 (button) collected ($0.25)
Seat 2: Hero (small blind) folded before Flop
Seat 3: f8c870ba (big blind) folded before Flop
Seat 4: f4440ff6 folded before Flop (didn't bet)
Seat 5: 7b84fec folded before Flop (didn't bet)
Seat 6: 6a44f690 folded before Flop (didn't bet)


Poker Hand #RC1452505834: Hold'em No Limit  ($0.05/$0.1) - 2023/04/05 13:50:05
Table 'RushAndCash2201094' 6-max Seat #1 is the button
Seat 1: Hero ($13.01 in chips)
Seat 2: 97161b5a ($11.29 in chips)
Seat 3: d227494e ($10.37 in chips)
Seat 4: 65283177 ($7.07 in chips)
Seat 5: 2818609d ($11.09 in chips)
Seat 6: a1de689e ($13.4 in chips)
97161b5a: posts small blind $0.05
d227494e: posts big blind $0.1
*** HOLE CARDS ***
Dealt to Hero [6h Tc]
Dealt to 97161b5a 
Dealt to d227494e 
Dealt to 65283177 
Dealt to 2818609d 
Dealt to a1de689e 
65283177: raises $0.15 to $0.25
2818609d: raises $0.49 to $0.74
a1de689e: folds
Hero: folds
97161b5a: calls $0.69
d227494e: folds
65283177: calls $0.49
*** FLOP *** [6s 5s 6d]
97161b5a: checks
65283177: checks
2818609d: bets $0.77
97161b5a: folds
65283177: calls $0.77
*** TURN *** [6s 5s 6d] [7h]
65283177: checks
2818609d: bets $2.9
65283177: folds
Uncalled bet ($2.9) returned to 2818609d
*** SHOWDOWN ***
2818609d collected $3.53 from pot
*** SUMMARY ***
Total pot $3.86 | Rake $0.18 | Jackpot $0.15 | Bingo $0 | Fortune $0
Board [6s 5s 6d 7h]
Seat 1: Hero (button) folded before Flop (didn't bet)
Seat 2: 97161b5a (small blind) folded on the Flop
Seat 3: d227494e (big blind) folded before Flop
Seat 4: 65283177 folded on the Turn
Seat 5: 2818609d won ($3.53)
Seat 6: a1de689e folded before Flop (didn't bet)


Poker Hand #RC1452505793: Hold'em No Limit  ($0.05/$0.1) - 2023/04/05 13:49:59
Table 'RushAndCash2201053' 6-max Seat #1 is the button
Seat 1: 220a809d ($16.35 in chips)
Seat 2: a18b3539 ($10.37 in chips)
Seat 3: de1f9b9e ($10 in chips)
Seat 4: Hero ($13.01 in chips)
Seat 5: 9550a503 ($10 in chips)
Seat 6: 111629e7 ($10 in chips)
a18b3539: posts small blind $0.05
de1f9b9e: posts big blind $0.1
*** HOLE CARDS ***
Dealt to 220a809d 
Dealt to a18b3539 
Dealt to de1f9b9e 
Dealt to Hero [7h Ac]
Dealt to 9550a503 
Dealt to 111629e7 
Hero: folds
9550a503: folds
111629e7: raises $0.15 to $0.25
220a809d: folds
a18b3539: folds
de1f9b9e: calls $0.15
*** FLOP *** [Qd Kc 4c]
de1f9b9e: checks
111629e7: checks
*** TURN *** [Qd Kc 4c] [Qc]
de1f9b9e: bets $0.45
111629e7: folds
Uncalled bet ($0.45) returned to de1f9b9e
*** SHOWDOWN ***
de1f9b9e collected $0.53 from pot
*** SUMMARY ***
Total pot $0.55 | Rake $0.02 | Jackpot $0 | Bingo $0 | Fortune $0
Board [Qd Kc 4c Qc]
Seat 1: 220a809d (button) folded before Flop (didn't bet)
Seat 2: a18b3539 (small blind) folded before Flop
Seat 3: de1f9b9e (big blind) won ($0.53)
Seat 4: Hero folded before Flop (didn't bet)
Seat 5: 9550a503 folded before Flop (didn't bet)
Seat 6: 111629e7 folded on the Turn


Poker Hand #RC1452505747: Hold'em No Limit  ($0.05/$0.1) - 2023/04/05 13:49:53
Table 'RushAndCash2201007' 6-max Seat #1 is the button
Seat 1: a8edb84b ($20.31 in chips)
Seat 2: cc04e1b1 ($9.93 in chips)
Seat 3: a944a75b ($10.15 in chips)
Seat 4: d9725f87 ($10 in chips)
Seat 5: 3c81b5b5 ($12.53 in chips)
Seat 6: Hero ($13.01 in chips)
cc04e1b1: posts small blind $0.05
a944a75b: posts big blind $0.1
*** HOLE CARDS ***
Dealt to a8edb84b 
Dealt to cc04e1b1 
Dealt to a944a75b 
Dealt to d9725f87 
Dealt to 3c81b5b5 
Dealt to Hero [4c 9h]
d9725f87: folds
3c81b5b5: raises $0.25 to $0.35
Hero: folds
a8edb84b: calls $0.35
cc04e1b1: folds
a944a75b: folds
*** FLOP *** [Kc 5h 5s]
3c81b5b5: bets $0.94
a8edb84b: calls $0.94
*** TURN *** [Kc 5h 5s] [8c]
3c81b5b5: bets $3.01
a8edb84b: raises $16.01 to $19.02 and is all-in
3c81b5b5: folds
Uncalled bet ($16.01) returned to a8edb84b
*** SHOWDOWN ***
a8edb84b collected $8.3 from pot
*** SUMMARY ***
Total pot $8.75 | Rake $0.3 | Jackpot $0.15 | Bingo $0 | Fortune $0
Board [Kc 5h 5s 8c]
Seat 1: a8edb84b (button) won ($8.3)
Seat 2: cc04e1b1 (small blind) folded before Flop
Seat 3: a944a75b (big blind) folded before Flop
Seat 4: d9725f87 folded before Flop (didn't bet)
Seat 5: 3c81b5b5 folded on the Turn
Seat 6: Hero folded before Flop (didn't bet)


Poker Hand #RC1452505702: Hold'em No Limit  ($0.05/$0.1) - 2023/04/05 13:49:47
Table 'RushAndCash2200962' 6-max Seat #1 is the button
Seat 1: dcfcc17c ($10.43 in chips)
Seat 2: dd2fe26c ($12.51 in chips)
Seat 3: f2f88871 ($11.38 in chips)
Seat 4: Hero ($13.01 in chips)
Seat 5: b789e67d ($13.18 in chips)
Seat 6: bdf922ae ($11.06 in chips)
dd2fe26c: posts small blind $0.05
f2f88871: posts big blind $0.1
*** HOLE CARDS ***
Dealt to dcfcc17c 
Dealt to dd2fe26c 
Dealt to f2f88871 
Dealt to Hero [7h 2c]
Dealt to b789e67d 
Dealt to bdf922ae 
Hero: folds
b789e67d: folds
bdf922ae: raises $0.13 to $0.23
dcfcc17c: folds
dd2fe26c: folds
f2f88871: folds
Uncalled bet ($0.13) returned to bdf922ae
*** SHOWDOWN ***
bdf922ae collected $0.25 from pot
*** SUMMARY ***
Total pot $0.25 | Rake $0 | Jackpot $0 | Bingo $0 | Fortune $0
Seat 1: dcfcc17c (button) folded before Flop (didn't bet)
Seat 2: dd2fe26c (small blind) folded before Flop
Seat 3: f2f88871 (big blind) folded before Flop
Seat 4: Hero folded before Flop (didn't bet)
Seat 5: b789e67d folded before Flop (didn't bet)
Seat 6: bdf922ae collected ($0.25)


Poker Hand #RC1452505669: Hold'em No Limit  ($0.05/$0.1) - 2023/04/05 13:49:41
Table 'RushAndCash2200929' 6-max Seat #1 is the button
Seat 1: 69a44e3b ($14.06 in chips)
Seat 2: e53a518c ($10.23 in chips)
Seat 3: d510c912 ($10.53 in chips)
Seat 4: Hero ($13.01 in chips)
Seat 5: 7b5ec42f ($10 in chips)
Seat 6: 507397ec ($10 in chips)
e53a518c: posts small blind $0.05
d510c912: posts big blind $0.1
*** HOLE CARDS ***
Dealt to 69a44e3b 
Dealt to e53a518c 
Dealt to d510c912 
Dealt to Hero [6h Jh]
Dealt to 7b5ec42f 
Dealt to 507397ec 
Hero: folds
7b5ec42f: raises $0.15 to $0.25
507397ec: folds
69a44e3b: folds
e53a518c: calls $0.2
d510c912: folds
*** FLOP *** [2h Td Kd]
e53a518c: bets $0.2
7b5ec42f: calls $0.2
*** TURN *** [2h Td Kd] [2c]
e53a518c: bets $0.75
7b5ec42f: calls $0.75
*** RIVER *** [2h Td Kd 2c] [9s]
e53a518c: bets $2.5
7b5ec42f: folds
Uncalled bet ($2.5) returned to e53a518c
*** SHOWDOWN ***
e53a518c collected $2.38 from pot
*** SUMMARY ***
Total pot $2.5 | Rake $0.12 | Jackpot $0 | Bingo $0 | Fortune $0
Board [2h Td Kd 2c 9s]
Seat 1: 69a44e3b (button) folded before Flop (didn't bet)
Seat 2: e53a518c (small blind) won ($2.38)
Seat 3: d510c912 (big blind) folded before Flop
Seat 4: Hero folded before Flop (didn't bet)
Seat 5: 7b5ec42f folded on the River
Seat 6: 507397ec folded before Flop (didn't bet)


Poker Hand #RC1452505596: Hold'em No Limit  ($0.05/$0.1) - 2023/04/05 13:49:30
Table 'RushAndCash2200856' 6-max Seat #1 is the button
Seat 1: Hero ($13.01 in chips)
Seat 2: bdf922ae ($11.11 in chips)
Seat 3: 28ffd8b0 ($13.65 in chips)
Seat 4: d5e21080 ($10.91 in chips)
Seat 5: e0112bcc ($11.07 in chips)
Seat 6: 4b868523 ($24.22 in chips)
bdf922ae: posts small blind $0.05
28ffd8b0: posts big blind $0.1
*** HOLE CARDS ***
Dealt to Hero [Ad 2s]
Dealt to bdf922ae 
Dealt to 28ffd8b0 
Dealt to d5e21080 
Dealt to e0112bcc 
Dealt to 4b868523 
d5e21080: raises $0.13 to $0.23
e0112bcc: folds
4b868523: folds
Hero: folds
bdf922ae: folds
28ffd8b0: folds
Uncalled bet ($0.13) returned to d5e21080
*** SHOWDOWN ***
d5e21080 collected $0.25 from pot
*** SUMMARY ***
Total pot $0.25 | Rake $0 | Jackpot $0 | Bingo $0 | Fortune $0
Seat 1: Hero (button) folded before Flop (didn't bet)
Seat 2: bdf922ae (small blind) folded before Flop
Seat 3: 28ffd8b0 (big blind) folded before Flop
Seat 4: d5e21080 collected ($0.25)
Seat 5: e0112bcc folded before Flop (didn't bet)
Seat 6: 4b868523 folded before Flop (didn't bet)


Poker Hand #RC1452505524: Hold'em No Limit  ($0.05/$0.1) - 2023/04/05 13:49:17
Table 'RushAndCash2200784' 6-max Seat #1 is the button
Seat 1: 549a879b ($14.42 in chips)
Seat 2: Hero ($12.91 in chips)
Seat 3: 593a7b39 ($10.07 in chips)
Seat 4: 61c12100 ($11 in chips)
Seat 5: 1069bfb8 ($10 in chips)
Seat 6: 88a28435 ($10.22 in chips)
Hero: posts small blind $0.05
593a7b39: posts big blind $0.1
*** HOLE CARDS ***
Dealt to 549a879b 
Dealt to Hero [Qs As]
Dealt to 593a7b39 
Dealt to 61c12100 
Dealt to 1069bfb8 
Dealt to 88a28435 
61c12100: folds
1069bfb8: folds
88a28435: folds
549a879b: folds
Hero: raises $0.2 to $0.3
593a7b39: folds
Uncalled bet ($0.2) returned to Hero
*** SHOWDOWN ***
Hero collected $0.2 from pot
*** SUMMARY ***
Total pot $0.2 | Rake $0 | Jackpot $0 | Bingo $0 | Fortune $0
Seat 1: 549a879b (button) folded before Flop (didn't bet)
Seat 2: Hero (small blind) collected ($0.2)
Seat 3: 593a7b39 (big blind) folded before Flop
Seat 4: 61c12100 folded before Flop (didn't bet)
Seat 5: 1069bfb8 folded before Flop (didn't bet)
Seat 6: 88a28435 folded before Flop (didn't bet)


Poker Hand #RC1452472030: Hold'em No Limit  ($0.05/$0.1) - 2023/04/05 13:39:36
Table 'RushAndCash2197290' 6-max Seat #1 is the button
Seat 1: 42af2dab ($17.28 in chips)
Seat 2: 9e7f8fca ($60.77 in chips)
Seat 3: Hero ($12.89 in chips)
Seat 4: 258fe54b ($19.25 in chips)
Seat 5: 93c87259 ($11.09 in chips)
Seat 6: 4d3c4ab2 ($10.07 in chips)
9e7f8fca: posts small blind $0.05
Hero: posts big blind $0.1
*** HOLE CARDS ***
Dealt to 42af2dab 
Dealt to 9e7f8fca 
Dealt to Hero [5d Ah]
Dealt to 258fe54b 
Dealt to 93c87259 
Dealt to 4d3c4ab2 
258fe54b: folds
93c87259: raises $0.15 to $0.25
4d3c4ab2: folds
42af2dab: folds
9e7f8fca: folds
Hero: calls $0.15
*** FLOP *** [Kd 7c 7s]
Hero: checks
93c87259: checks
*** TURN *** [Kd 7c 7s] [Tc]
Hero: checks
93c87259: checks
*** RIVER *** [Kd 7c 7s Tc] [6c]
Hero: checks
93c87259: checks
Hero: shows [5d Ah] (Pair of Sevens)
93c87259: shows [9d Ac] (Pair of Sevens)
*** SHOWDOWN ***
Hero collected $0.27 from pot
93c87259 collected $0.26 from pot
*** SUMMARY ***
Total pot $0.55 | Rake $0.02 | Jackpot $0 | Bingo $0 | Fortune $0
Board [Kd 7c 7s Tc 6c]
Seat 1: 42af2dab (button) folded before Flop (didn't bet)
Seat 2: 9e7f8fca (small blind) folded before Flop
Seat 3: Hero (big blind) showed [5d Ah] and won ($0.27) with Pair of Sevens
Seat 4: 258fe54b folded before Flop (didn't bet)
Seat 5: 93c87259 showed [9d Ac] and won ($0.26) with Pair of Sevens
Seat 6: 4d3c4ab2 folded before Flop (didn't bet)


Poker Hand #RC1452471935: Hold'em No Limit  ($0.05/$0.1) - 2023/04/05 13:39:22
Table 'RushAndCash2197195' 6-max Seat #1 is the button
Seat 1: 58f140fa ($22.15 in chips)
Seat 2: bdce5bda ($13.25 in chips)
Seat 3: b61899fb ($10.17 in chips)
Seat 4: ea2b688 ($10 in chips)
Seat 5: Hero ($12.89 in chips)
Seat 6: 568f2c73 ($11.88 in chips)
bdce5bda: posts small blind $0.05
b61899fb: posts big blind $0.1
*** HOLE CARDS ***
Dealt to 58f140fa 
Dealt to bdce5bda 
Dealt to b61899fb 
Dealt to ea2b688 
Dealt to Hero [Td Ah]
Dealt to 568f2c73 
ea2b688: raises $0.1 to $0.2
Hero: folds
568f2c73: raises $0.4 to $0.6
58f140fa: folds
bdce5bda: folds
b61899fb: folds
ea2b688: folds
Uncalled bet ($0.4) returned to 568f2c73
*** SHOWDOWN ***
568f2c73 collected $0.53 from pot
*** SUMMARY ***
Total pot $0.55 | Rake $0.02 | Jackpot $0 | Bingo $0 | Fortune $0
Seat 1: 58f140fa (button) folded before Flop (didn't bet)
Seat 2: bdce5bda (small blind) folded before Flop
Seat 3: b61899fb (big blind) folded before Flop
Seat 4: ea2b688 folded before Flop
Seat 5: Hero folded before Flop (didn't bet)
Seat 6: 568f2c73 collected ($0.53)


Poker Hand #RC1452471893: Hold'em No Limit  ($0.05/$0.1) - 2023/04/05 13:39:17
Table 'RushAndCash2197153' 6-max Seat #1 is the button
Seat 1: caa4567d ($9.78 in chips)
Seat 2: b7341a15 ($19.31 in chips)
Seat 3: 123e48c6 ($10.76 in chips)
Seat 4: 651051e1 ($12.85 in chips)
Seat 5: f8758cd2 ($10.41 in chips)
Seat 6: Hero ($12.89 in chips)
b7341a15: posts small blind $0.05
123e48c6: posts big blind $0.1
*** HOLE CARDS ***
Dealt to caa4567d 
Dealt to b7341a15 
Dealt to 123e48c6 
Dealt to 651051e1 
Dealt to f8758cd2 
Dealt to Hero [Jc 2d]
651051e1: folds
f8758cd2: folds
Hero: folds
caa4567d: folds
b7341a15: raises $0.1 to $0.2
123e48c6: calls $0.1
*** FLOP *** [5h 8h Ts]
b7341a15: checks
123e48c6: checks
*** TURN *** [5h 8h Ts] [Td]
b7341a15: bets $0.2
123e48c6: folds
Uncalled bet ($0.2) returned to b7341a15
*** SHOWDOWN ***
b7341a15 collected $0.38 from pot
*** SUMMARY ***
Total pot $0.4 | Rake $0.02 | Jackpot $0 | Bingo $0 | Fortune $0
Board [5h 8h Ts Td]
Seat 1: caa4567d (button) folded before Flop (didn't bet)
Seat 2: b7341a15 (small blind) won ($0.38)
Seat 3: 123e48c6 (big blind) folded on the Turn
Seat 4: 651051e1 folded before Flop (didn't bet)
Seat 5: f8758cd2 folded before Flop (didn't bet)
Seat 6: Hero folded before Flop (didn't bet)


Poker Hand #RC1452471858: Hold'em No Limit  ($0.05/$0.1) - 2023/04/05 13:39:10
Table 'RushAndCash2197118' 6-max Seat #1 is the button
Seat 1: ef1980ee ($11.63 in chips)
Seat 2: af03a8ba ($12.06 in chips)
Seat 3: 3ffee9bd ($9.79 in chips)
Seat 4: Hero ($12.89 in chips)
Seat 5: 89dd126a ($11.23 in chips)
Seat 6: 844a97bc ($18.29 in chips)
af03a8ba: posts small blind $0.05
3ffee9bd: posts big blind $0.1
*** HOLE CARDS ***
Dealt to ef1980ee 
Dealt to af03a8ba 
Dealt to 3ffee9bd 
Dealt to Hero [8s 2s]
Dealt to 89dd126a 
Dealt to 844a97bc 
Hero: folds
89dd126a: folds
844a97bc: raises $0.1 to $0.2
ef1980ee: folds
af03a8ba: folds
3ffee9bd: folds
Uncalled bet ($0.1) returned to 844a97bc
*** SHOWDOWN ***
844a97bc collected $0.25 from pot
*** SUMMARY ***
Total pot $0.25 | Rake $0 | Jackpot $0 | Bingo $0 | Fortune $0
Seat 1: ef1980ee (button) folded before Flop (didn't bet)
Seat 2: af03a8ba (small blind) folded before Flop
Seat 3: 3ffee9bd (big blind) folded before Flop
Seat 4: Hero folded before Flop (didn't bet)
Seat 5: 89dd126a folded before Flop (didn't bet)
Seat 6: 844a97bc collected ($0.25)


Poker Hand #RC1452471800: Hold'em No Limit  ($0.05/$0.1) - 2023/04/05 13:39:00
Table 'RushAndCash2197060' 6-max Seat #1 is the button
Seat 1: 4ab63686 ($7.89 in chips)
Seat 2: cec8daf4 ($7.93 in chips)
Seat 3: Hero ($12.99 in chips)
Seat 4: 651051e1 ($12.75 in chips)
Seat 5: fec90b55 ($11.54 in chips)
Seat 6: 16934c31 ($25.64 in chips)
cec8daf4: posts small blind $0.05
Hero: posts big blind $0.1
*** HOLE CARDS ***
Dealt to 4ab63686 
Dealt to cec8daf4 
Dealt to Hero [Ks 2d]
Dealt to 651051e1 
Dealt to fec90b55 
Dealt to 16934c31 
651051e1: raises $0.15 to $0.25
fec90b55: folds
16934c31: folds
4ab63686: folds
cec8daf4: folds
Hero: folds
Uncalled bet ($0.15) returned to 651051e1
*** SHOWDOWN ***
651051e1 collected $0.25 from pot
*** SUMMARY ***
Total pot $0.25 | Rake $0 | Jackpot $0 | Bingo $0 | Fortune $0
Seat 1: 4ab63686 (button) folded before Flop (didn't bet)
Seat 2: cec8daf4 (small blind) folded before Flop
Seat 3: Hero (big blind) folded before Flop
Seat 4: 651051e1 collected ($0.25)
Seat 5: fec90b55 folded before Flop (didn't bet)
Seat 6: 16934c31 folded before Flop (didn't bet)


Poker Hand #RC1452471764: Hold'em No Limit  ($0.05/$0.1) - 2023/04/05 13:38:55
Table 'RushAndCash2197024' 6-max Seat #1 is the button
Seat 1: Hero ($12.99 in chips)
Seat 2: df695c35 ($4.93 in chips)
Seat 3: 6e3d1ba6 ($28.14 in chips)
Seat 4: c592d5df ($10.98 in chips)
Seat 5: e1d341fb ($9.65 in chips)
Seat 6: aa54f26 ($8.84 in chips)
df695c35: posts small blind $0.05
6e3d1ba6: posts big blind $0.1
*** HOLE CARDS ***
Dealt to Hero [2s 8d]
Dealt to df695c35 
Dealt to 6e3d1ba6 
Dealt to c592d5df 
Dealt to e1d341fb 
Dealt to aa54f26 
c592d5df: folds
e1d341fb: folds
aa54f26: folds
Hero: folds
df695c35: folds
Uncalled bet ($0.05) returned to 6e3d1ba6
*** SHOWDOWN ***
6e3d1ba6 collected $0.1 from pot
*** SUMMARY ***
Total pot $0.1 | Rake $0 | Jackpot $0 | Bingo $0 | Fortune $0
Seat 1: Hero (button) folded before Flop (didn't bet)
Seat 2: df695c35 (small blind) folded before Flop
Seat 3: 6e3d1ba6 (big blind) collected ($0.1)
Seat 4: c592d5df folded before Flop (didn't bet)
Seat 5: e1d341fb folded before Flop (didn't bet)
Seat 6: aa54f26 folded before Flop (didn't bet)


Poker Hand #RC1452471583: Hold'em No Limit  ($0.05/$0.1) - 2023/04/05 13:38:21
Table 'RushAndCash2196843' 6-max Seat #1 is the button
Seat 1: aa54f26 ($9.09 in chips)
Seat 2: Hero ($12.67 in chips)
Seat 3: d503e0bb ($19.79 in chips)
Seat 4: 24aa3751 ($13.61 in chips)
Seat 5: 42af2dab ($17.43 in chips)
Seat 6: dcb5ac90 ($13.1 in chips)
Hero: posts small blind $0.05
d503e0bb: posts big blind $0.1
*** HOLE CARDS ***
Dealt to aa54f26 
Dealt to Hero [Qs Js]
Dealt to d503e0bb 
Dealt to 24aa3751 
Dealt to 42af2dab 
Dealt to dcb5ac90 
24aa3751: folds
42af2dab: folds
dcb5ac90: folds
aa54f26: raises $0.15 to $0.25
Hero: raises $0.75 to $1
d503e0bb: folds
aa54f26: folds
Uncalled bet ($0.75) returned to Hero
*** SHOWDOWN ***
Hero collected $0.57 from pot
*** SUMMARY ***
Total pot $0.6 | Rake $0.03 | Jackpot $0 | Bingo $0 | Fortune $0
Seat 1: aa54f26 (button) folded before Flop
Seat 2: Hero (small blind) collected ($0.57)
Seat 3: d503e0bb (big blind) folded before Flop
Seat 4: 24aa3751 folded before Flop (didn't bet)
Seat 5: 42af2dab folded before Flop (didn't bet)
Seat 6: dcb5ac90 folded before Flop (didn't bet)


Poker Hand #RC1452471558: Hold'em No Limit  ($0.05/$0.1) - 2023/04/05 13:38:17
Table 'RushAndCash2196818' 6-max Seat #1 is the button
Seat 1: 2892e581 ($10 in chips)
Seat 2: 2e3d4baf ($11.05 in chips)
Seat 3: 78da1041 ($10 in chips)
Seat 4: f5e20904 ($10 in chips)
Seat 5: Hero ($12.67 in chips)
Seat 6: 87aa2f17 ($22.75 in chips)
2e3d4baf: posts small blind $0.05
78da1041: posts big blind $0.1
*** HOLE CARDS ***
Dealt to 2892e581 
Dealt to 2e3d4baf 
Dealt to 78da1041 
Dealt to f5e20904 
Dealt to Hero [Js 2c]
Dealt to 87aa2f17 
f5e20904: folds
Hero: folds
87aa2f17: folds
2892e581: raises $0.1 to $0.2
2e3d4baf: folds
78da1041: folds
Uncalled bet ($0.1) returned to 2892e581
*** SHOWDOWN ***
2892e581 collected $0.25 from pot
*** SUMMARY ***
Total pot $0.25 | Rake $0 | Jackpot $0 | Bingo $0 | Fortune $0
Seat 1: 2892e581 (button) collected ($0.25)
Seat 2: 2e3d4baf (small blind) folded before Flop
Seat 3: 78da1041 (big blind) folded before Flop
Seat 4: f5e20904 folded before Flop (didn't bet)
Seat 5: Hero folded before Flop (didn't bet)
Seat 6: 87aa2f17 folded before Flop (didn't bet)


Poker Hand #RC1452471526: Hold'em No Limit  ($0.05/$0.1) - 2023/04/05 13:38:12
Table 'RushAndCash2196786' 6-max Seat #1 is the button
Seat 1: Hero ($12.67 in chips)
Seat 2: 8c7ced36 ($23.96 in chips)
Seat 3: f16f75b6 ($11.91 in chips)
Seat 4: 1e57ef29 ($19.85 in chips)
Seat 5: 963c7de ($16.22 in chips)
Seat 6: 5f7b3cce ($10.16 in chips)
8c7ced36: posts small blind $0.05
f16f75b6: posts big blind $0.1
*** HOLE CARDS ***
Dealt to Hero [6h 5s]
Dealt to 8c7ced36 
Dealt to f16f75b6 
Dealt to 1e57ef29 
Dealt to 963c7de 
Dealt to 5f7b3cce 
1e57ef29: folds
963c7de: folds
5f7b3cce: raises $0.15 to $0.25
Hero: folds
8c7ced36: folds
f16f75b6: folds
Uncalled bet ($0.15) returned to 5f7b3cce
*** SHOWDOWN ***
5f7b3cce collected $0.25 from pot
*** SUMMARY ***
Total pot $0.25 | Rake $0 | Jackpot $0 | Bingo $0 | Fortune $0
Seat 1: Hero (button) folded before Flop (didn't bet)
Seat 2: 8c7ced36 (small blind) folded before Flop
Seat 3: f16f75b6 (big blind) folded before Flop
Seat 4: 1e57ef29 folded before Flop (didn't bet)
Seat 5: 963c7de folded before Flop (didn't bet)
Seat 6: 5f7b3cce collected ($0.25)


Poker Hand #RC1452471446: Hold'em No Limit  ($0.05/$0.1) - 2023/04/05 13:37:59
Table 'RushAndCash2196706' 6-max Seat #1 is the button
Seat 1: 1e2fb3a7 ($9.85 in chips)
Seat 2: Hero ($12.72 in chips)
Seat 3: 66111971 ($10 in chips)
Seat 4: 32a1b5e1 ($15.56 in chips)
Seat 5: 26e5d8fc ($11.89 in chips)
Seat 6: 60766ed5 ($22.9 in chips)
Hero: posts small blind $0.05
66111971: posts big blind $0.1
*** HOLE CARDS ***
Dealt to 1e2fb3a7 
Dealt to Hero [3c As]
Dealt to 66111971 
Dealt to 32a1b5e1 
Dealt to 26e5d8fc 
Dealt to 60766ed5 
32a1b5e1: raises $0.2 to $0.3
26e5d8fc: folds
60766ed5: folds
1e2fb3a7: folds
Hero: folds
66111971: folds
Uncalled bet ($0.2) returned to 32a1b5e1
*** SHOWDOWN ***
32a1b5e1 collected $0.25 from pot
*** SUMMARY ***
Total pot $0.25 | Rake $0 | Jackpot $0 | Bingo $0 | Fortune $0
Seat 1: 1e2fb3a7 (button) folded before Flop (didn't bet)
Seat 2: Hero (small blind) folded before Flop
Seat 3: 66111971 (big blind) folded before Flop
Seat 4: 32a1b5e1 collected ($0.25)
Seat 5: 26e5d8fc folded before Flop (didn't bet)
Seat 6: 60766ed5 folded before Flop (didn't bet)


Poker Hand #RC1452471004: Hold'em No Limit  ($0.05/$0.1) - 2023/04/05 13:36:47
Table 'RushAndCash2196264' 6-max Seat #1 is the button
Seat 1: 4efac24a ($11.4 in chips)
Seat 2: d9c6f21b ($9.36 in chips)
Seat 3: f0638e1d ($26 in chips)
Seat 4: 13fc22f1 ($10 in chips)
Seat 5: f4440ff6 ($13.09 in chips)
Seat 6: Hero ($12.72 in chips)
d9c6f21b: posts small blind $0.05
f0638e1d: posts big blind $0.1
*** HOLE CARDS ***
Dealt to 4efac24a 
Dealt to d9c6f21b 
Dealt to f0638e1d 
Dealt to 13fc22f1 
Dealt to f4440ff6 
Dealt to Hero [Qd 6c]
13fc22f1: folds
f4440ff6: folds
Hero: folds
4efac24a: raises $0.15 to $0.25
d9c6f21b: folds
f0638e1d: folds
Uncalled bet ($0.15) returned to 4efac24a
*** SHOWDOWN ***
4efac24a collected $0.25 from pot
*** SUMMARY ***
Total pot $0.25 | Rake $0 | Jackpot $0 | Bingo $0 | Fortune $0
Seat 1: 4efac24a (button) collected ($0.25)
Seat 2: d9c6f21b (small blind) folded before Flop
Seat 3: f0638e1d (big blind) folded before Flop
Seat 4: 13fc22f1 folded before Flop (didn't bet)
Seat 5: f4440ff6 folded before Flop (didn't bet)
Seat 6: Hero folded before Flop (didn't bet)


Poker Hand #RC1452470665: Hold'em No Limit  ($0.05/$0.1) - 2023/04/05 13:35:51
Table 'RushAndCash2195925' 6-max Seat #1 is the button
Seat 1: be84629 ($9.95 in chips)
Seat 2: 4efac24a ($10.45 in chips)
Seat 3: Hero ($13.77 in chips)
Seat 4: e16ebd93 ($9.69 in chips)
Seat 5: bbf740a3 ($10 in chips)
Seat 6: cf47f5b7 ($10 in chips)
4efac24a: posts small blind $0.05
Hero: posts big blind $0.1
*** HOLE CARDS ***
Dealt to be84629 
Dealt to 4efac24a 
Dealt to Hero [8s Ah]
Dealt to e16ebd93 
Dealt to bbf740a3 
Dealt to cf47f5b7 
e16ebd93: folds
bbf740a3: folds
cf47f5b7: folds
be84629: folds
4efac24a: raises $0.15 to $0.25
Hero: calls $0.15
*** FLOP *** [Td 6s 4h]
4efac24a: bets $0.17
Hero: calls $0.17
*** TURN *** [Td 6s 4h] [Js]
4efac24a: checks
Hero: checks
*** RIVER *** [Td 6s 4h Js] [4d]
4efac24a: bets $0.63
Hero: calls $0.63
4efac24a: shows [Tc As] (Pair of Tens and Pair of Fours)
Hero: shows [8s Ah] (Pair of Fours)
*** SHOWDOWN ***
4efac24a collected $2 from pot
*** SUMMARY ***
Total pot $2.1 | Rake $0.1 | Jackpot $0 | Bingo $0 | Fortune $0
Board [Td 6s 4h Js 4d]
Seat 1: be84629 (button) folded before Flop (didn't bet)
Seat 2: 4efac24a (small blind) showed [Tc As] and won ($2) with Pair of Tens and Pair of Fours
Seat 3: Hero (big blind) showed [8s Ah] and lost with Pair of Fours
Seat 4: e16ebd93 folded before Flop (didn't bet)
Seat 5: bbf740a3 folded before Flop (didn't bet)
Seat 6: cf47f5b7 folded before Flop (didn't bet)


Poker Hand #RC1452470470: Hold'em No Limit  ($0.05/$0.1) - 2023/04/05 13:35:23
Table 'RushAndCash2195730' 6-max Seat #1 is the button
Seat 1: c5f6b91a ($8.31 in chips)
Seat 2: fdb01f4b ($19.73 in chips)
Seat 3: 70bf7f7a ($21.12 in chips)
Seat 4: Hero ($13.62 in chips)
Seat 5: b57bf5b8 ($18.34 in chips)
Seat 6: d8ef97d1 ($12.94 in chips)
fdb01f4b: posts small blind $0.05
70bf7f7a: posts big blind $0.1
*** HOLE CARDS ***
Dealt to c5f6b91a 
Dealt to fdb01f4b 
Dealt to 70bf7f7a 
Dealt to Hero [5h 5s]
Dealt to b57bf5b8 
Dealt to d8ef97d1 
Hero: raises $0.15 to $0.25
b57bf5b8: folds
d8ef97d1: folds
c5f6b91a: folds
fdb01f4b: folds
70bf7f7a: folds
Uncalled bet ($0.15) returned to Hero
*** SHOWDOWN ***
Hero collected $0.25 from pot
*** SUMMARY ***
Total pot $0.25 | Rake $0 | Jackpot $0 | Bingo $0 | Fortune $0
Seat 1: c5f6b91a (button) folded before Flop (didn't bet)
Seat 2: fdb01f4b (small blind) folded before Flop
Seat 3: 70bf7f7a (big blind) folded before Flop
Seat 4: Hero collected ($0.25)
Seat 5: b57bf5b8 folded before Flop (didn't bet)
Seat 6: d8ef97d1 folded before Flop (didn't bet)


Poker Hand #RC1452470436: Hold'em No Limit  ($0.05/$0.1) - 2023/04/05 13:35:19
Table 'RushAndCash2195696' 6-max Seat #1 is the button
Seat 1: 6e8bd6b4 ($3.33 in chips)
Seat 2: a4b857aa ($10 in chips)
Seat 3: c11fa96d ($10.43 in chips)
Seat 4: Hero ($13.62 in chips)
Seat 5: a414e2e5 ($11.95 in chips)
Seat 6: 8e3a536f ($12.91 in chips)
a4b857aa: posts small blind $0.05
c11fa96d: posts big blind $0.1
*** HOLE CARDS ***
Dealt to 6e8bd6b4 
Dealt to a4b857aa 
Dealt to c11fa96d 
Dealt to Hero [Th 7s]
Dealt to a414e2e5 
Dealt to 8e3a536f 
Hero: folds
a414e2e5: folds
8e3a536f: raises $0.15 to $0.25
6e8bd6b4: calls $0.25
a4b857aa: folds
c11fa96d: folds
*** FLOP *** [3h Ks 8d]
8e3a536f: checks
6e8bd6b4: bets $0.33
8e3a536f: calls $0.33
*** TURN *** [3h Ks 8d] [7h]
8e3a536f: checks
6e8bd6b4: checks
*** RIVER *** [3h Ks 8d 7h] [Qc]
8e3a536f: bets $0.99
6e8bd6b4: calls $0.99
8e3a536f: shows [As 2s] (Ace-High)
6e8bd6b4: shows [Js Kc] (Pair of Kings)
*** SHOWDOWN ***
6e8bd6b4 collected $2.99 from pot
*** SUMMARY ***
Total pot $3.29 | Rake $0.15 | Jackpot $0.15 | Bingo $0 | Fortune $0
Board [3h Ks 8d 7h Qc]
Seat 1: 6e8bd6b4 (button) showed [Js Kc] and won ($2.99) with Pair of Kings
Seat 2: a4b857aa (small blind) folded before Flop
Seat 3: c11fa96d (big blind) folded before Flop
Seat 4: Hero folded before Flop (didn't bet)
Seat 5: a414e2e5 folded before Flop (didn't bet)
Seat 6: 8e3a536f showed [As 2s] and lost with Ace-High


Poker Hand #RC1452470385: Hold'em No Limit  ($0.05/$0.1) - 2023/04/05 13:35:12
Table 'RushAndCash2195645' 6-max Seat #1 is the button
Seat 1: d210303a ($10.7 in chips)
Seat 2: 474c8e61 ($1.55 in chips)
Seat 3: c1f81140 ($10.15 in chips)
Seat 4: fff6a112 ($7.2 in chips)
Seat 5: Hero ($13.62 in chips)
Seat 6: 54adfeef ($24.14 in chips)
474c8e61: posts small blind $0.05
c1f81140: posts big blind $0.1
*** HOLE CARDS ***
Dealt to d210303a 
Dealt to 474c8e61 
Dealt to c1f81140 
Dealt to fff6a112 
Dealt to Hero [Ah 7c]
Dealt to 54adfeef 
fff6a112: folds
Hero: folds
54adfeef: folds
d210303a: raises $0.15 to $0.25
474c8e61: folds
c1f81140: calls $0.15
*** FLOP *** [6h 8c 4d]
c1f81140: checks
d210303a: checks
*** TURN *** [6h 8c 4d] [8s]
c1f81140: bets $0.42
d210303a: calls $0.42
*** RIVER *** [6h 8c 4d 8s] [3h]
c1f81140: bets $1.05
d210303a: calls $1.05
c1f81140: shows [Ac 8d] (Three Eights)
d210303a: shows [4c Jc] (Pair of Eights and Pair of Fours)
*** SHOWDOWN ***
c1f81140 collected $3.18 from pot
*** SUMMARY ***
Total pot $3.49 | Rake $0.16 | Jackpot $0.15 | Bingo $0 | Fortune $0
Board [6h 8c 4d 8s 3h]
Seat 1: d210303a (button) showed [4c Jc] and lost with Pair of Eights and Pair of Fours
Seat 2: 474c8e61 (small blind) folded before Flop
Seat 3: c1f81140 (big blind) showed [Ac 8d] and won ($3.18) with Three Eights
Seat 4: fff6a112 folded before Flop (didn't bet)
Seat 5: Hero folded before Flop (didn't bet)
Seat 6: 54adfeef folded before Flop (didn't bet)


Poker Hand #RC1452470354: Hold'em No Limit  ($0.05/$0.1) - 2023/04/05 13:35:07
Table 'RushAndCash2195614' 6-max Seat #1 is the button
Seat 1: Hero ($13.62 in chips)
Seat 2: 29be666f ($8.75 in chips)
Seat 3: 1e2fb3a7 ($9.95 in chips)
Seat 4: 16950427 ($5.78 in chips)
Seat 5: 6f990d8 ($13.81 in chips)
Seat 6: 1d21e2d5 ($10.1 in chips)
29be666f: posts small blind $0.05
1e2fb3a7: posts big blind $0.1
*** HOLE CARDS ***
Dealt to Hero [2h Jh]
Dealt to 29be666f 
Dealt to 1e2fb3a7 
Dealt to 16950427 
Dealt to 6f990d8 
Dealt to 1d21e2d5 
16950427: folds
6f990d8: folds
1d21e2d5: raises $0.15 to $0.25
Hero: folds
29be666f: folds
1e2fb3a7: folds
Uncalled bet ($0.15) returned to 1d21e2d5
*** SHOWDOWN ***
1d21e2d5 collected $0.25 from pot
*** SUMMARY ***
Total pot $0.25 | Rake $0 | Jackpot $0 | Bingo $0 | Fortune $0
Seat 1: Hero (button) folded before Flop (didn't bet)
Seat 2: 29be666f (small blind) folded before Flop
Seat 3: 1e2fb3a7 (big blind) folded before Flop
Seat 4: 16950427 folded before Flop (didn't bet)
Seat 5: 6f990d8 folded before Flop (didn't bet)
Seat 6: 1d21e2d5 collected ($0.25)


Poker Hand #RC1452469852: Hold'em No Limit  ($0.05/$0.1) - 2023/04/05 13:33:50
Table 'RushAndCash2195112' 6-max Seat #1 is the button
Seat 1: 5c7c3c48 ($12.45 in chips)
Seat 2: deebb6c ($10 in chips)
Seat 3: Hero ($14.14 in chips)
Seat 4: 6f990d8 ($13.29 in chips)
Seat 5: c5f6b91a ($8.41 in chips)
Seat 6: 570f1ad2 ($11.35 in chips)
deebb6c: posts small blind $0.05
Hero: posts big blind $0.1
*** HOLE CARDS ***
Dealt to 5c7c3c48 
Dealt to deebb6c 
Dealt to Hero [2h 2c]
Dealt to 6f990d8 
Dealt to c5f6b91a 
Dealt to 570f1ad2 
6f990d8: raises $0.2 to $0.3
c5f6b91a: folds
570f1ad2: folds
5c7c3c48: folds
deebb6c: folds
Hero: calls $0.2
*** FLOP *** [5s 5h 4s]
Hero: checks
6f990d8: bets $0.22
Hero: calls $0.22
*** TURN *** [5s 5h 4s] [Ad]
Hero: checks
6f990d8: bets $0.82
Hero: folds
Uncalled bet ($0.82) returned to 6f990d8
*** SHOWDOWN ***
6f990d8 collected $1.04 from pot
*** SUMMARY ***
Total pot $1.09 | Rake $0.05 | Jackpot $0 | Bingo $0 | Fortune $0
Board [5s 5h 4s Ad]
Seat 1: 5c7c3c48 (button) folded before Flop (didn't bet)
Seat 2: deebb6c (small blind) folded before Flop
Seat 3: Hero (big blind) folded on the Turn
Seat 4: 6f990d8 won ($1.04)
Seat 5: c5f6b91a folded before Flop (didn't bet)
Seat 6: 570f1ad2 folded before Flop (didn't bet)


Poker Hand #RC1452469372: Hold'em No Limit  ($0.05/$0.1) - 2023/04/05 13:32:35
Table 'RushAndCash2194632' 6-max Seat #1 is the button
Seat 1: 28ffd8b0 ($11.45 in chips)
Seat 2: Hero ($15.14 in chips)
Seat 3: 5c7c3c48 ($11.55 in chips)
Seat 4: 83433f60 ($10 in chips)
Seat 5: f28fcd1d ($12.88 in chips)
Seat 6: 13da12a2 ($10.98 in chips)
Hero: posts small blind $0.05
5c7c3c48: posts big blind $0.1
*** HOLE CARDS ***
Dealt to 28ffd8b0 
Dealt to Hero [Ah 9c]
Dealt to 5c7c3c48 
Dealt to 83433f60 
Dealt to f28fcd1d 
Dealt to 13da12a2 
83433f60: folds
f28fcd1d: folds
13da12a2: folds
28ffd8b0: folds
Hero: raises $0.2 to $0.3
5c7c3c48: calls $0.2
*** FLOP *** [Kd 2s As]
Hero: checks
5c7c3c48: bets $0.2
Hero: calls $0.2
*** TURN *** [Kd 2s As] [2c]
Hero: checks
5c7c3c48: checks
*** RIVER *** [Kd 2s As 2c] [Td]
Hero: bets $0.5
5c7c3c48: calls $0.5
Hero: shows [Ah 9c] (Pair of Aces and Pair of Twos)
5c7c3c48: shows [Qd Js] (Aces-High Straight)
*** SHOWDOWN ***
5c7c3c48 collected $1.9 from pot
*** SUMMARY ***
Total pot $2 | Rake $0.1 | Jackpot $0 | Bingo $0 | Fortune $0
Board [Kd 2s As 2c Td]
Seat 1: 28ffd8b0 (button) folded before Flop (didn't bet)
Seat 2: Hero (small blind) showed [Ah 9c] and lost with Pair of Aces and Pair of Twos
Seat 3: 5c7c3c48 (big blind) showed [Qd Js] and won ($1.9) with Aces-High Straight
Seat 4: 83433f60 folded before Flop (didn't bet)
Seat 5: f28fcd1d folded before Flop (didn't bet)
Seat 6: 13da12a2 folded before Flop (didn't bet)


Poker Hand #RC1452469339: Hold'em No Limit  ($0.05/$0.1) - 2023/04/05 13:32:31
Table 'RushAndCash2194599' 6-max Seat #1 is the button
Seat 1: 169a1dc5 ($16.53 in chips)
Seat 2: ae2f2b54 ($9.87 in chips)
Seat 3: 111629e7 ($10.3 in chips)
Seat 4: Hero ($15.14 in chips)
Seat 5: f0638e1d ($27.37 in chips)
Seat 6: ce4417fe ($7.6 in chips)
ae2f2b54: posts small blind $0.05
111629e7: posts big blind $0.1
*** HOLE CARDS ***
Dealt to 169a1dc5 
Dealt to ae2f2b54 
Dealt to 111629e7 
Dealt to Hero [9d 6d]
Dealt to f0638e1d 
Dealt to ce4417fe 
Hero: folds
f0638e1d: raises $0.2 to $0.3
ce4417fe: folds
169a1dc5: folds
ae2f2b54: folds
111629e7: folds
Uncalled bet ($0.2) returned to f0638e1d
*** SHOWDOWN ***
f0638e1d collected $0.25 from pot
*** SUMMARY ***
Total pot $0.25 | Rake $0 | Jackpot $0 | Bingo $0 | Fortune $0
Seat 1: 169a1dc5 (button) folded before Flop (didn't bet)
Seat 2: ae2f2b54 (small blind) folded before Flop
Seat 3: 111629e7 (big blind) folded before Flop
Seat 4: Hero folded before Flop (didn't bet)
Seat 5: f0638e1d collected ($0.25)
Seat 6: ce4417fe folded before Flop (didn't bet)


Poker Hand #RC1452469311: Hold'em No Limit  ($0.05/$0.1) - 2023/04/05 13:32:26
Table 'RushAndCash2194571' 6-max Seat #1 is the button
Seat 1: 8ab8363f ($11.32 in chips)
Seat 2: 25610c92 ($13.49 in chips)
Seat 3: 8ab72fdd ($10.64 in chips)
Seat 4: Hero ($15.14 in chips)
Seat 5: 23aace79 ($11.41 in chips)
Seat 6: 5020825d ($10 in chips)
25610c92: posts small blind $0.05
8ab72fdd: posts big blind $0.1
*** HOLE CARDS ***
Dealt to 8ab8363f 
Dealt to 25610c92 
Dealt to 8ab72fdd 
Dealt to Hero [Th 3c]
Dealt to 23aace79 
Dealt to 5020825d 
Hero: folds
23aace79: folds
5020825d: raises $0.1 to $0.2
8ab8363f: folds
25610c92: folds
8ab72fdd: folds
Uncalled bet ($0.1) returned to 5020825d
*** SHOWDOWN ***
5020825d collected $0.25 from pot
*** SUMMARY ***
Total pot $0.25 | Rake $0 | Jackpot $0 | Bingo $0 | Fortune $0
Seat 1: 8ab8363f (button) folded before Flop (didn't bet)
Seat 2: 25610c92 (small blind) folded before Flop
Seat 3: 8ab72fdd (big blind) folded before Flop
Seat 4: Hero folded before Flop (didn't bet)
Seat 5: 23aace79 folded before Flop (didn't bet)
Seat 6: 5020825d collected ($0.25)


Poker Hand #RC1452469256: Hold'em No Limit  ($0.05/$0.1) - 2023/04/05 13:32:16
Table 'RushAndCash2194516' 6-max Seat #1 is the button
Seat 1: f44247e0 ($12.36 in chips)
Seat 2: c249dcd4 ($10 in chips)
Seat 3: 570f1ad2 ($11.33 in chips)
Seat 4: dd2fe26c ($11.48 in chips)
Seat 5: Hero ($15.14 in chips)
Seat 6: f89b650b ($10 in chips)
c249dcd4: posts small blind $0.05
570f1ad2: posts big blind $0.1
*** HOLE CARDS ***
Dealt to f44247e0 
Dealt to c249dcd4 
Dealt to 570f1ad2 
Dealt to dd2fe26c 
Dealt to Hero [2d 9c]
Dealt to f89b650b 
dd2fe26c: folds
Hero: folds
f89b650b: raises $0.15 to $0.25
f44247e0: folds
c249dcd4: folds
570f1ad2: folds
Uncalled bet ($0.15) returned to f89b650b
*** SHOWDOWN ***
f89b650b collected $0.25 from pot
*** SUMMARY ***
Total pot $0.25 | Rake $0 | Jackpot $0 | Bingo $0 | Fortune $0
Seat 1: f44247e0 (button) folded before Flop (didn't bet)
Seat 2: c249dcd4 (small blind) folded before Flop
Seat 3: 570f1ad2 (big blind) folded before Flop
Seat 4: dd2fe26c folded before Flop (didn't bet)
Seat 5: Hero folded before Flop (didn't bet)
Seat 6: f89b650b collected ($0.25)


Poker Hand #RC1452469192: Hold'em No Limit  ($0.05/$0.1) - 2023/04/05 13:32:06
Table 'RushAndCash2194452' 6-max Seat #1 is the button
Seat 1: 2b9f1ac1 ($28.59 in chips)
Seat 2: a0b0b7e6 ($13.16 in chips)
Seat 3: 619d2d53 ($17.22 in chips)
Seat 4: Hero ($15.14 in chips)
Seat 5: ada2aece ($10.86 in chips)
Seat 6: 96698d05 ($10.3 in chips)
a0b0b7e6: posts small blind $0.05
619d2d53: posts big blind $0.1
*** HOLE CARDS ***
Dealt to 2b9f1ac1 
Dealt to a0b0b7e6 
Dealt to 619d2d53 
Dealt to Hero [9s 2s]
Dealt to ada2aece 
Dealt to 96698d05 
Hero: folds
ada2aece: raises $0.14 to $0.24
96698d05: folds
2b9f1ac1: folds
a0b0b7e6: raises $0.86 to $1.1
619d2d53: folds
ada2aece: folds
Uncalled bet ($0.86) returned to a0b0b7e6
*** SHOWDOWN ***
a0b0b7e6 collected $0.56 from pot
*** SUMMARY ***
Total pot $0.58 | Rake $0.02 | Jackpot $0 | Bingo $0 | Fortune $0
Seat 1: 2b9f1ac1 (button) folded before Flop (didn't bet)
Seat 2: a0b0b7e6 (small blind) collected ($0.56)
Seat 3: 619d2d53 (big blind) folded before Flop
Seat 4: Hero folded before Flop (didn't bet)
Seat 5: ada2aece folded before Flop
Seat 6: 96698d05 folded before Flop (didn't bet)


Poker Hand #RC1452469156: Hold'em No Limit  ($0.05/$0.1) - 2023/04/05 13:32:00
Table 'RushAndCash2194416' 6-max Seat #1 is the button
Seat 1: 97d763 ($9.6 in chips)
Seat 2: Hero ($15.19 in chips)
Seat 3: 2ba1c1d ($9.79 in chips)
Seat 4: 287c0c58 ($13.2 in chips)
Seat 5: 47a267b8 ($9.45 in chips)
Seat 6: 7e3a9b95 ($46.75 in chips)
Hero: posts small blind $0.05
2ba1c1d: posts big blind $0.1
*** HOLE CARDS ***
Dealt to 97d763 
Dealt to Hero [8d 5h]
Dealt to 2ba1c1d 
Dealt to 287c0c58 
Dealt to 47a267b8 
Dealt to 7e3a9b95 
287c0c58: folds
47a267b8: raises $0.15 to $0.25
7e3a9b95: folds
97d763: folds
Hero: folds
2ba1c1d: folds
Uncalled bet ($0.15) returned to 47a267b8
*** SHOWDOWN ***
47a267b8 collected $0.25 from pot
*** SUMMARY ***
Total pot $0.25 | Rake $0 | Jackpot $0 | Bingo $0 | Fortune $0
Seat 1: 97d763 (button) folded before Flop (didn't bet)
Seat 2: Hero (small blind) folded before Flop
Seat 3: 2ba1c1d (big blind) folded before Flop
Seat 4: 287c0c58 folded before Flop (didn't bet)
Seat 5: 47a267b8 collected ($0.25)
Seat 6: 7e3a9b95 folded before Flop (didn't bet)


Poker Hand #RC1452468678: Hold'em No Limit  ($0.05/$0.1) - 2023/04/05 13:30:46
Table 'RushAndCash2193938' 6-max Seat #1 is the button
Seat 1: 75bd2c8b ($9.52 in chips)
Seat 2: 881f785d ($10 in chips)
Seat 3: Hero ($15.39 in chips)
Seat 4: 97d763 ($9.2 in chips)
Seat 5: 651051e1 ($17.18 in chips)
Seat 6: 945f78d ($9.81 in chips)
881f785d: posts small blind $0.05
Hero: posts big blind $0.1
*** HOLE CARDS ***
Dealt to 75bd2c8b 
Dealt to 881f785d 
Dealt to Hero [9s Td]
Dealt to 97d763 
Dealt to 651051e1 
Dealt to 945f78d 
97d763: folds
651051e1: folds
945f78d: raises $0.1 to $0.2
75bd2c8b: calls $0.2
881f785d: folds
Hero: calls $0.1
*** FLOP *** [Qc Qs 4s]
Hero: checks
945f78d: checks
75bd2c8b: bets $0.22
Hero: folds
945f78d: calls $0.22
*** TURN *** [Qc Qs 4s] [2c]
945f78d: checks
75bd2c8b: checks
*** RIVER *** [Qc Qs 4s 2c] [7d]
945f78d: checks
75bd2c8b: checks
945f78d: shows [3d 3c] (Pair of Queens and Pair of Treys)
75bd2c8b: shows [Ah 3h] (Pair of Queens)
*** SHOWDOWN ***
945f78d collected $1.04 from pot
*** SUMMARY ***
Total pot $1.09 | Rake $0.05 | Jackpot $0 | Bingo $0 | Fortune $0
Board [Qc Qs 4s 2c 7d]
Seat 1: 75bd2c8b (button) showed [Ah 3h] and lost with Pair of Queens
Seat 2: 881f785d (small blind) folded before Flop
Seat 3: Hero (big blind) folded on the Flop
Seat 4: 97d763 folded before Flop (didn't bet)
Seat 5: 651051e1 folded before Flop (didn't bet)
Seat 6: 945f78d showed [3d 3c] and won ($1.04) with Pair of Queens and Pair of Treys


Poker Hand #RC1452468605: Hold'em No Limit  ($0.05/$0.1) - 2023/04/05 13:30:35
Table 'RushAndCash2193865' 6-max Seat #1 is the button
Seat 1: Hero ($15.39 in chips)
Seat 2: f44247e0 ($13.01 in chips)
Seat 3: 43c9b82 ($9.27 in chips)
Seat 4: 419d34d7 ($13.29 in chips)
Seat 5: 79201ae0 ($9.06 in chips)
Seat 6: b3b03753 ($10.12 in chips)
f44247e0: posts small blind $0.05
43c9b82: posts big blind $0.1
*** HOLE CARDS ***
Dealt to Hero [2c Jc]
Dealt to f44247e0 
Dealt to 43c9b82 
Dealt to 419d34d7 
Dealt to 79201ae0 
Dealt to b3b03753 
419d34d7: folds
79201ae0: folds
b3b03753: raises $0.15 to $0.25
Hero: folds
f44247e0: folds
43c9b82: calls $0.15
*** FLOP *** [5h 7s 5c]
43c9b82: checks
b3b03753: bets $0.28
43c9b82: folds
Uncalled bet ($0.28) returned to b3b03753
*** SHOWDOWN ***
b3b03753 collected $0.53 from pot
*** SUMMARY ***
Total pot $0.55 | Rake $0.02 | Jackpot $0 | Bingo $0 | Fortune $0
Board [5h 7s 5c]
Seat 1: Hero (button) folded before Flop (didn't bet)
Seat 2: f44247e0 (small blind) folded before Flop
Seat 3: 43c9b82 (big blind) folded on the Flop
Seat 4: 419d34d7 folded before Flop (didn't bet)
Seat 5: 79201ae0 folded before Flop (didn't bet)
Seat 6: b3b03753 won ($0.53)


Poker Hand #RC1452468579: Hold'em No Limit  ($0.05/$0.1) - 2023/04/05 13:30:31
Table 'RushAndCash2193839' 6-max Seat #1 is the button
Seat 1: 47e90b31 ($32.33 in chips)
Seat 2: 2818609d ($10 in chips)
Seat 3: fd58be84 ($10.25 in chips)
Seat 4: Hero ($15.39 in chips)
Seat 5: 1c0b292d ($14.72 in chips)
Seat 6: f02f86c ($8.54 in chips)
2818609d: posts small blind $0.05
fd58be84: posts big blind $0.1
*** HOLE CARDS ***
Dealt to 47e90b31 
Dealt to 2818609d 
Dealt to fd58be84 
Dealt to Hero [Qh 4h]
Dealt to 1c0b292d 
Dealt to f02f86c 
Hero: folds
1c0b292d: raises $0.15 to $0.25
f02f86c: folds
47e90b31: folds
2818609d: raises $0.85 to $1.1
fd58be84: folds
1c0b292d: folds
Uncalled bet ($0.85) returned to 2818609d
*** SHOWDOWN ***
2818609d collected $0.57 from pot
*** SUMMARY ***
Total pot $0.6 | Rake $0.03 | Jackpot $0 | Bingo $0 | Fortune $0
Seat 1: 47e90b31 (button) folded before Flop (didn't bet)
Seat 2: 2818609d (small blind) collected ($0.57)
Seat 3: fd58be84 (big blind) folded before Flop
Seat 4: Hero folded before Flop (didn't bet)
Seat 5: 1c0b292d folded before Flop
Seat 6: f02f86c folded before Flop (didn't bet)


Poker Hand #RC1452468488: Hold'em No Limit  ($0.05/$0.1) - 2023/04/05 13:30:16
Table 'RushAndCash2193748' 6-max Seat #1 is the button
Seat 1: de4397cd ($24.95 in chips)
Seat 2: eb1e7940 ($8.23 in chips)
Seat 3: c592d5df ($14.28 in chips)
Seat 4: 96468d49 ($42.67 in chips)
Seat 5: f44247e0 ($13.11 in chips)
Seat 6: Hero ($15.39 in chips)
eb1e7940: posts small blind $0.05
c592d5df: posts big blind $0.1
*** HOLE CARDS ***
Dealt to de4397cd 
Dealt to eb1e7940 
Dealt to c592d5df 
Dealt to 96468d49 
Dealt to f44247e0 
Dealt to Hero [Jh 2d]
96468d49: folds
f44247e0: folds
Hero: folds
de4397cd: raises $0.15 to $0.25
eb1e7940: folds
c592d5df: folds
Uncalled bet ($0.15) returned to de4397cd
*** SHOWDOWN ***
de4397cd collected $0.25 from pot
*** SUMMARY ***
Total pot $0.25 | Rake $0 | Jackpot $0 | Bingo $0 | Fortune $0
Seat 1: de4397cd (button) collected ($0.25)
Seat 2: eb1e7940 (small blind) folded before Flop
Seat 3: c592d5df (big blind) folded before Flop
Seat 4: 96468d49 folded before Flop (didn't bet)
Seat 5: f44247e0 folded before Flop (didn't bet)
Seat 6: Hero folded before Flop (didn't bet)


Poker Hand #RC1452468381: Hold'em No Limit  ($0.05/$0.1) - 2023/04/05 13:30:00
Table 'RushAndCash2193641' 6-max Seat #1 is the button
Seat 1: 6ceb58be ($18.05 in chips)
Seat 2: Hero ($15.44 in chips)
Seat 3: 4c74a599 ($11.21 in chips)
Seat 4: ff92cdd7 ($7.76 in chips)
Seat 5: 1a08324c ($11.98 in chips)
Seat 6: d75f26bf ($10.26 in chips)
Hero: posts small blind $0.05
4c74a599: posts big blind $0.1
*** HOLE CARDS ***
Dealt to 6ceb58be 
Dealt to Hero [9h Qd]
Dealt to 4c74a599 
Dealt to ff92cdd7 
Dealt to 1a08324c 
Dealt to d75f26bf 
ff92cdd7: folds
1a08324c: raises $0.15 to $0.25
d75f26bf: folds
6ceb58be: folds
Hero: folds
4c74a599: folds
Uncalled bet ($0.15) returned to 1a08324c
*** SHOWDOWN ***
1a08324c collected $0.25 from pot
*** SUMMARY ***
Total pot $0.25 | Rake $0 | Jackpot $0 | Bingo $0 | Fortune $0
Seat 1: 6ceb58be (button) folded before Flop (didn't bet)
Seat 2: Hero (small blind) folded before Flop
Seat 3: 4c74a599 (big blind) folded before Flop
Seat 4: ff92cdd7 folded before Flop (didn't bet)
Seat 5: 1a08324c collected ($0.25)
Seat 6: d75f26bf folded before Flop (didn't bet)


Poker Hand #RC1452468302: Hold'em No Limit  ($0.05/$0.1) - 2023/04/05 13:29:49
Table 'RushAndCash2193562' 6-max Seat #1 is the button
Seat 1: c5f6b91a ($9.82 in chips)
Seat 2: cf867dc9 ($8.36 in chips)
Seat 3: Hero ($15.54 in chips)
Seat 4: 14abe6f0 ($12.58 in chips)
Seat 5: f44247e0 ($13.16 in chips)
Seat 6: 84c65ab6 ($11.81 in chips)
cf867dc9: posts small blind $0.05
Hero: posts big blind $0.1
*** HOLE CARDS ***
Dealt to c5f6b91a 
Dealt to cf867dc9 
Dealt to Hero [Jc 7c]
Dealt to 14abe6f0 
Dealt to f44247e0 
Dealt to 84c65ab6 
14abe6f0: folds
f44247e0: folds
84c65ab6: folds
c5f6b91a: raises $0.2 to $0.3
cf867dc9: folds
Hero: folds
Uncalled bet ($0.2) returned to c5f6b91a
*** SHOWDOWN ***
c5f6b91a collected $0.25 from pot
*** SUMMARY ***
Total pot $0.25 | Rake $0 | Jackpot $0 | Bingo $0 | Fortune $0
Seat 1: c5f6b91a (button) collected ($0.25)
Seat 2: cf867dc9 (small blind) folded before Flop
Seat 3: Hero (big blind) folded before Flop
Seat 4: 14abe6f0 folded before Flop (didn't bet)
Seat 5: f44247e0 folded before Flop (didn't bet)
Seat 6: 84c65ab6 folded before Flop (didn't bet)


Poker Hand #RC1452468260: Hold'em No Limit  ($0.05/$0.1) - 2023/04/05 13:29:43
Table 'RushAndCash2193520' 6-max Seat #1 is the button
Seat 1: edb79f78 ($3.02 in chips)
Seat 2: e9b62ec0 ($12.57 in chips)
Seat 3: ec73bd59 ($9.65 in chips)
Seat 4: Hero ($15.54 in chips)
Seat 5: 29335ac ($10.54 in chips)
Seat 6: 735fc7d1 ($9.13 in chips)
e9b62ec0: posts small blind $0.05
ec73bd59: posts big blind $0.1
*** HOLE CARDS ***
Dealt to edb79f78 
Dealt to e9b62ec0 
Dealt to ec73bd59 
Dealt to Hero [Qd 8h]
Dealt to 29335ac 
Dealt to 735fc7d1 
Hero: folds
29335ac: folds
735fc7d1: folds
edb79f78: folds
e9b62ec0: folds
Uncalled bet ($0.05) returned to ec73bd59
*** SHOWDOWN ***
ec73bd59 collected $0.1 from pot
*** SUMMARY ***
Total pot $0.1 | Rake $0 | Jackpot $0 | Bingo $0 | Fortune $0
Seat 1: edb79f78 (button) folded before Flop (didn't bet)
Seat 2: e9b62ec0 (small blind) folded before Flop
Seat 3: ec73bd59 (big blind) collected ($0.1)
Seat 4: Hero folded before Flop (didn't bet)
Seat 5: 29335ac folded before Flop (didn't bet)
Seat 6: 735fc7d1 folded before Flop (didn't bet)


Poker Hand #RC1452468221: Hold'em No Limit  ($0.05/$0.1) - 2023/04/05 13:29:37
Table 'RushAndCash2193481' 6-max Seat #1 is the button
Seat 1: f329cbef ($10.33 in chips)
Seat 2: f95f472a ($10.05 in chips)
Seat 3: 1294b59f ($21.52 in chips)
Seat 4: 5020825d ($10 in chips)
Seat 5: Hero ($15.54 in chips)
Seat 6: 62728c1a ($19.66 in chips)
f95f472a: posts small blind $0.05
1294b59f: posts big blind $0.1
*** HOLE CARDS ***
Dealt to f329cbef 
Dealt to f95f472a 
Dealt to 1294b59f 
Dealt to 5020825d 
Dealt to Hero [Qs 8s]
Dealt to 62728c1a 
5020825d: folds
Hero: folds
62728c1a: folds
f329cbef: folds
f95f472a: folds
Uncalled bet ($0.05) returned to 1294b59f
*** SHOWDOWN ***
1294b59f collected $0.1 from pot
*** SUMMARY ***
Total pot $0.1 | Rake $0 | Jackpot $0 | Bingo $0 | Fortune $0
Seat 1: f329cbef (button) folded before Flop (didn't bet)
Seat 2: f95f472a (small blind) folded before Flop
Seat 3: 1294b59f (big blind) collected ($0.1)
Seat 4: 5020825d folded before Flop (didn't bet)
Seat 5: Hero folded before Flop (didn't bet)
Seat 6: 62728c1a folded before Flop (didn't bet)


Poker Hand #RC1452468162: Hold'em No Limit  ($0.05/$0.1) - 2023/04/05 13:29:29
Table 'RushAndCash2193422' 6-max Seat #1 is the button
Seat 1: 5ff8e826 ($23.56 in chips)
Seat 2: 60343243 ($12.07 in chips)
Seat 3: 967aa4ac ($12.32 in chips)
Seat 4: 474ac677 ($14.07 in chips)
Seat 5: 65d79189 ($3.67 in chips)
Seat 6: Hero ($15.54 in chips)
60343243: posts small blind $0.05
967aa4ac: posts big blind $0.1
*** HOLE CARDS ***
Dealt to 5ff8e826 
Dealt to 60343243 
Dealt to 967aa4ac 
Dealt to 474ac677 
Dealt to 65d79189 
Dealt to Hero [Jd 4c]
474ac677: folds
65d79189: folds
Hero: folds
5ff8e826: folds
60343243: folds
Uncalled bet ($0.05) returned to 967aa4ac
*** SHOWDOWN ***
967aa4ac collected $0.1 from pot
*** SUMMARY ***
Total pot $0.1 | Rake $0 | Jackpot $0 | Bingo $0 | Fortune $0
Seat 1: 5ff8e826 (button) folded before Flop (didn't bet)
Seat 2: 60343243 (small blind) folded before Flop
Seat 3: 967aa4ac (big blind) collected ($0.1)
Seat 4: 474ac677 folded before Flop (didn't bet)
Seat 5: 65d79189 folded before Flop (didn't bet)
Seat 6: Hero folded before Flop (didn't bet)


Poker Hand #RC1452468132: Hold'em No Limit  ($0.05/$0.1) - 2023/04/05 13:29:24
Table 'RushAndCash2193392' 6-max Seat #1 is the button
Seat 1: Hero ($15.54 in chips)
Seat 2: 74becec2 ($12.41 in chips)
Seat 3: 59332acd ($10.24 in chips)
Seat 4: 4fd641a4 ($11.35 in chips)
Seat 5: 39131b05 ($11.32 in chips)
Seat 6: 17576e10 ($14.42 in chips)
74becec2: posts small blind $0.05
59332acd: posts big blind $0.1
*** HOLE CARDS ***
Dealt to Hero [Ts 3d]
Dealt to 74becec2 
Dealt to 59332acd 
Dealt to 4fd641a4 
Dealt to 39131b05 
Dealt to 17576e10 
4fd641a4: folds
39131b05: folds
17576e10: folds
Hero: folds
74becec2: folds
Uncalled bet ($0.05) returned to 59332acd
*** SHOWDOWN ***
59332acd collected $0.1 from pot
*** SUMMARY ***
Total pot $0.1 | Rake $0 | Jackpot $0 | Bingo $0 | Fortune $0
Seat 1: Hero (button) folded before Flop (didn't bet)
Seat 2: 74becec2 (small blind) folded before Flop
Seat 3: 59332acd (big blind) collected ($0.1)
Seat 4: 4fd641a4 folded before Flop (didn't bet)
Seat 5: 39131b05 folded before Flop (didn't bet)
Seat 6: 17576e10 folded before Flop (didn't bet)


Poker Hand #RC1452467983: Hold'em No Limit  ($0.05/$0.1) - 2023/04/05 13:29:01
Table 'RushAndCash2193243' 6-max Seat #1 is the button
Seat 1: Hero ($15.79 in chips)
Seat 2: 39131b05 ($11 in chips)
Seat 3: 673bd289 ($10.32 in chips)
Seat 4: 5c982a57 ($24.25 in chips)
Seat 5: 8588fd8b ($15.22 in chips)
Seat 6: 673d9a9f ($8.38 in chips)
39131b05: posts small blind $0.05
673bd289: posts big blind $0.1
*** HOLE CARDS ***
Dealt to Hero [9h 7h]
Dealt to 39131b05 
Dealt to 673bd289 
Dealt to 5c982a57 
Dealt to 8588fd8b 
Dealt to 673d9a9f 
5c982a57: folds
8588fd8b: folds
673d9a9f: folds
Hero: raises $0.15 to $0.25
39131b05: raises $0.9 to $1.15
673bd289: folds
Hero: folds
Uncalled bet ($0.9) returned to 39131b05
*** SHOWDOWN ***
39131b05 collected $0.57 from pot
*** SUMMARY ***
Total pot $0.6 | Rake $0.03 | Jackpot $0 | Bingo $0 | Fortune $0
Seat 1: Hero (button) folded before Flop
Seat 2: 39131b05 (small blind) collected ($0.57)
Seat 3: 673bd289 (big blind) folded before Flop
Seat 4: 5c982a57 folded before Flop (didn't bet)
Seat 5: 8588fd8b folded before Flop (didn't bet)
Seat 6: 673d9a9f folded before Flop (didn't bet)


Poker Hand #RC1452467832: Hold'em No Limit  ($0.05/$0.1) - 2023/04/05 13:28:37
Table 'RushAndCash2193092' 6-max Seat #1 is the button
Seat 1: 38932da4 ($9.23 in chips)
Seat 2: Hero ($16.09 in chips)
Seat 3: 39131b05 ($10.73 in chips)
Seat 4: 1d21e2d5 ($10 in chips)
Seat 5: bf496dfd ($10.17 in chips)
Seat 6: b59c4d95 ($15.85 in chips)
Hero: posts small blind $0.05
39131b05: posts big blind $0.1
*** HOLE CARDS ***
Dealt to 38932da4 
Dealt to Hero [Qs 7s]
Dealt to 39131b05 
Dealt to 1d21e2d5 
Dealt to bf496dfd 
Dealt to b59c4d95 
1d21e2d5: folds
bf496dfd: folds
b59c4d95: folds
38932da4: folds
Hero: raises $0.2 to $0.3
39131b05: raises $0.6 to $0.9
Hero: folds
Uncalled bet ($0.6) returned to 39131b05
*** SHOWDOWN ***
39131b05 collected $0.57 from pot
*** SUMMARY ***
Total pot $0.6 | Rake $0.03 | Jackpot $0 | Bingo $0 | Fortune $0
Seat 1: 38932da4 (button) folded before Flop (didn't bet)
Seat 2: Hero (small blind) folded before Flop
Seat 3: 39131b05 (big blind) collected ($0.57)
Seat 4: 1d21e2d5 folded before Flop (didn't bet)
Seat 5: bf496dfd folded before Flop (didn't bet)
Seat 6: b59c4d95 folded before Flop (didn't bet)


Poker Hand #RC1452467796: Hold'em No Limit  ($0.05/$0.1) - 2023/04/05 13:28:33
Table 'RushAndCash2193056' 6-max Seat #1 is the button
Seat 1: 5f1f500b ($12.98 in chips)
Seat 2: a6525cbc ($10.25 in chips)
Seat 3: Hero ($16.19 in chips)
Seat 4: feb8062f ($17.34 in chips)
Seat 5: a5736c69 ($10.79 in chips)
Seat 6: bce49022 ($19.58 in chips)
a6525cbc: posts small blind $0.05
Hero: posts big blind $0.1
*** HOLE CARDS ***
Dealt to 5f1f500b 
Dealt to a6525cbc 
Dealt to Hero [8s 2c]
Dealt to feb8062f 
Dealt to a5736c69 
Dealt to bce49022 
feb8062f: raises $0.15 to $0.25
a5736c69: raises $0.55 to $0.8
bce49022: folds
5f1f500b: folds
a6525cbc: folds
Hero: folds
feb8062f: calls $0.55
*** FLOP *** [9d 5s 7d]
feb8062f: checks
a5736c69: bets $0.48
feb8062f: calls $0.48
*** TURN *** [9d 5s 7d] [5d]
feb8062f: checks
a5736c69: checks
*** RIVER *** [9d 5s 7d 5d] [7h]
feb8062f: checks
a5736c69: checks
feb8062f: shows [As Qc] (Pair of Sevens and Pair of Fives)
a5736c69: shows [Js Jc] (Pair of Jacks and Pair of Sevens)
*** SHOWDOWN ***
a5736c69 collected $2.55 from pot
*** SUMMARY ***
Total pot $2.71 | Rake $0.16 | Jackpot $0 | Bingo $0 | Fortune $0
Board [9d 5s 7d 5d 7h]
Seat 1: 5f1f500b (button) folded before Flop (didn't bet)
Seat 2: a6525cbc (small blind) folded before Flop
Seat 3: Hero (big blind) folded before Flop
Seat 4: feb8062f showed [As Qc] and lost with Pair of Sevens and Pair of Fives
Seat 5: a5736c69 showed [Js Jc] and won ($2.55) with Pair of Jacks and Pair of Sevens
Seat 6: bce49022 folded before Flop (didn't bet)


Poker Hand #RC1452467647: Hold'em No Limit  ($0.05/$0.1) - 2023/04/05 13:28:10
Table 'RushAndCash2192907' 6-max Seat #1 is the button
Seat 1: 5ba82ca1 ($15.53 in chips)
Seat 2: f95f472a ($10.05 in chips)
Seat 3: 25674484 ($11.73 in chips)
Seat 4: Hero ($16.04 in chips)
Seat 5: 6ceb58be ($18.08 in chips)
Seat 6: fd58be84 ($10.89 in chips)
f95f472a: posts small blind $0.05
25674484: posts big blind $0.1
*** HOLE CARDS ***
Dealt to 5ba82ca1 
Dealt to f95f472a 
Dealt to 25674484 
Dealt to Hero [Ks Qd]
Dealt to 6ceb58be 
Dealt to fd58be84 
Hero: raises $0.15 to $0.25
6ceb58be: folds
fd58be84: folds
5ba82ca1: folds
f95f472a: folds
25674484: folds
Uncalled bet ($0.15) returned to Hero
*** SHOWDOWN ***
Hero collected $0.25 from pot
*** SUMMARY ***
Total pot $0.25 | Rake $0 | Jackpot $0 | Bingo $0 | Fortune $0
Seat 1: 5ba82ca1 (button) folded before Flop (didn't bet)
Seat 2: f95f472a (small blind) folded before Flop
Seat 3: 25674484 (big blind) folded before Flop
Seat 4: Hero collected ($0.25)
Seat 5: 6ceb58be folded before Flop (didn't bet)
Seat 6: fd58be84 folded before Flop (didn't bet)


Poker Hand #RC1452467612: Hold'em No Limit  ($0.05/$0.1) - 2023/04/05 13:28:04
Table 'RushAndCash2192872' 6-max Seat #1 is the button
Seat 1: 24a52eb3 ($10 in chips)
Seat 2: ef5d946e ($10 in chips)
Seat 3: e10c9940 ($13.5 in chips)
Seat 4: 25edc198 ($26.3 in chips)
Seat 5: Hero ($16.04 in chips)
Seat 6: 619d2d53 ($19.47 in chips)
ef5d946e: posts small blind $0.05
e10c9940: posts big blind $0.1
*** HOLE CARDS ***
Dealt to 24a52eb3 
Dealt to ef5d946e 
Dealt to e10c9940 
Dealt to 25edc198 
Dealt to Hero [9d 3d]
Dealt to 619d2d53 
25edc198: raises $0.11 to $0.21
Hero: folds
619d2d53: folds
24a52eb3: folds
ef5d946e: folds
e10c9940: folds
Uncalled bet ($0.11) returned to 25edc198
*** SHOWDOWN ***
25edc198 collected $0.25 from pot
*** SUMMARY ***
Total pot $0.25 | Rake $0 | Jackpot $0 | Bingo $0 | Fortune $0
Seat 1: 24a52eb3 (button) folded before Flop (didn't bet)
Seat 2: ef5d946e (small blind) folded before Flop
Seat 3: e10c9940 (big blind) folded before Flop
Seat 4: 25edc198 collected ($0.25)
Seat 5: Hero folded before Flop (didn't bet)
Seat 6: 619d2d53 folded before Flop (didn't bet)


Poker Hand #RC1452467376: Hold'em No Limit  ($0.05/$0.1) - 2023/04/05 13:27:27
Table 'RushAndCash2192636' 6-max Seat #1 is the button
Seat 1: Hero ($15.32 in chips)
Seat 2: f9979ea0 ($12.49 in chips)
Seat 3: 374b47df ($10 in chips)
Seat 4: 19cebab4 ($10.34 in chips)
Seat 5: 24a52eb3 ($10 in chips)
Seat 6: 7ae98bfa ($15.07 in chips)
f9979ea0: posts small blind $0.05
374b47df: posts big blind $0.1
*** HOLE CARDS ***
Dealt to Hero [Th Jh]
Dealt to f9979ea0 
Dealt to 374b47df 
Dealt to 19cebab4 
Dealt to 24a52eb3 
Dealt to 7ae98bfa 
19cebab4: folds
24a52eb3: raises $0.11 to $0.21
7ae98bfa: folds
Hero: raises $0.43 to $0.64
f9979ea0: folds
374b47df: folds
24a52eb3: calls $0.43
*** FLOP *** [6s 5c 5d]
24a52eb3: checks
Hero: bets $0.53
24a52eb3: folds
Uncalled bet ($0.53) returned to Hero
*** SHOWDOWN ***
Hero collected $1.36 from pot
*** SUMMARY ***
Total pot $1.43 | Rake $0.07 | Jackpot $0 | Bingo $0 | Fortune $0
Board [6s 5c 5d]
Seat 1: Hero (button) won ($1.36)
Seat 2: f9979ea0 (small blind) folded before Flop
Seat 3: 374b47df (big blind) folded before Flop
Seat 4: 19cebab4 folded before Flop (didn't bet)
Seat 5: 24a52eb3 folded on the Flop
Seat 6: 7ae98bfa folded before Flop (didn't bet)


Poker Hand #RC1452467282: Hold'em No Limit  ($0.05/$0.1) - 2023/04/05 13:27:13
Table 'RushAndCash2192542' 6-max Seat #1 is the button
Seat 1: 2f921ca9 ($10 in chips)
Seat 2: Hero ($15.37 in chips)
Seat 3: cd014bee ($10.7 in chips)
Seat 4: 6b869ca7 ($22.24 in chips)
Seat 5: 11f8c03e ($10.1 in chips)
Seat 6: 44c10bfb ($7.12 in chips)
Hero: posts small blind $0.05
cd014bee: posts big blind $0.1
*** HOLE CARDS ***
Dealt to 2f921ca9 
Dealt to Hero [7h 8s]
Dealt to cd014bee 
Dealt to 6b869ca7 
Dealt to 11f8c03e 
Dealt to 44c10bfb 
6b869ca7: folds
11f8c03e: folds
44c10bfb: raises $0.15 to $0.25
2f921ca9: folds
Hero: folds
cd014bee: folds
Uncalled bet ($0.15) returned to 44c10bfb
*** SHOWDOWN ***
44c10bfb collected $0.25 from pot
*** SUMMARY ***
Total pot $0.25 | Rake $0 | Jackpot $0 | Bingo $0 | Fortune $0
Seat 1: 2f921ca9 (button) folded before Flop (didn't bet)
Seat 2: Hero (small blind) folded before Flop
Seat 3: cd014bee (big blind) folded before Flop
Seat 4: 6b869ca7 folded before Flop (didn't bet)
Seat 5: 11f8c03e folded before Flop (didn't bet)
Seat 6: 44c10bfb collected ($0.25)


Poker Hand #RC1452467194: Hold'em No Limit  ($0.05/$0.1) - 2023/04/05 13:27:00
Table 'RushAndCash2192454' 6-max Seat #1 is the button
Seat 1: 2c951c2f ($10.5 in chips)
Seat 2: cf867dc9 ($8.26 in chips)
Seat 3: d561c468 ($31.41 in chips)
Seat 4: Hero ($15.37 in chips)
Seat 5: 8f9c559d ($10.82 in chips)
Seat 6: a204d02d ($18.47 in chips)
cf867dc9: posts small blind $0.05
d561c468: posts big blind $0.1
*** HOLE CARDS ***
Dealt to 2c951c2f 
Dealt to cf867dc9 
Dealt to d561c468 
Dealt to Hero [Qs 6s]
Dealt to 8f9c559d 
Dealt to a204d02d 
Hero: folds
8f9c559d: folds
a204d02d: folds
2c951c2f: folds
cf867dc9: folds
Uncalled bet ($0.05) returned to d561c468
*** SHOWDOWN ***
d561c468 collected $0.1 from pot
*** SUMMARY ***
Total pot $0.1 | Rake $0 | Jackpot $0 | Bingo $0 | Fortune $0
Seat 1: 2c951c2f (button) folded before Flop (didn't bet)
Seat 2: cf867dc9 (small blind) folded before Flop
Seat 3: d561c468 (big blind) collected ($0.1)
Seat 4: Hero folded before Flop (didn't bet)
Seat 5: 8f9c559d folded before Flop (didn't bet)
Seat 6: a204d02d folded before Flop (didn't bet)


Poker Hand #RC1452467154: Hold'em No Limit  ($0.05/$0.1) - 2023/04/05 13:26:52
Table 'RushAndCash2192414' 6-max Seat #1 is the button
Seat 1: 3bec71ac ($16.28 in chips)
Seat 2: 11f8c03e ($10 in chips)
Seat 3: Hero ($15.47 in chips)
Seat 4: 39131b05 ($10 in chips)
Seat 5: 7dad6652 ($12.11 in chips)
Seat 6: be84629 ($9.73 in chips)
11f8c03e: posts small blind $0.05
Hero: posts big blind $0.1
*** HOLE CARDS ***
Dealt to 3bec71ac 
Dealt to 11f8c03e 
Dealt to Hero [3s 6d]
Dealt to 39131b05 
Dealt to 7dad6652 
Dealt to be84629 
39131b05: folds
7dad6652: folds
be84629: folds
3bec71ac: folds
11f8c03e: raises $0.2 to $0.3
Hero: folds
Uncalled bet ($0.2) returned to 11f8c03e
*** SHOWDOWN ***
11f8c03e collected $0.2 from pot
*** SUMMARY ***
Total pot $0.2 | Rake $0 | Jackpot $0 | Bingo $0 | Fortune $0
Seat 1: 3bec71ac (button) folded before Flop (didn't bet)
Seat 2: 11f8c03e (small blind) collected ($0.2)
Seat 3: Hero (big blind) folded before Flop
Seat 4: 39131b05 folded before Flop (didn't bet)
Seat 5: 7dad6652 folded before Flop (didn't bet)
Seat 6: be84629 folded before Flop (didn't bet)


Poker Hand #RC1452467128: Hold'em No Limit  ($0.05/$0.1) - 2023/04/05 13:26:48
Table 'RushAndCash2192388' 6-max Seat #1 is the button
Seat 1: d313d273 ($10.67 in chips)
Seat 2: 93c87259 ($10 in chips)
Seat 3: 1ce5c0f4 ($11.47 in chips)
Seat 4: Hero ($15.47 in chips)
Seat 5: 893ce251 ($11.35 in chips)
Seat 6: 419d34d7 ($11.24 in chips)
93c87259: posts small blind $0.05
1ce5c0f4: posts big blind $0.1
*** HOLE CARDS ***
Dealt to d313d273 
Dealt to 93c87259 
Dealt to 1ce5c0f4 
Dealt to Hero [5s 8s]
Dealt to 893ce251 
Dealt to 419d34d7 
Hero: folds
893ce251: folds
419d34d7: folds
d313d273: raises $0.15 to $0.25
93c87259: folds
1ce5c0f4: folds
Uncalled bet ($0.15) returned to d313d273
*** SHOWDOWN ***
d313d273 collected $0.25 from pot
*** SUMMARY ***
Total pot $0.25 | Rake $0 | Jackpot $0 | Bingo $0 | Fortune $0
Seat 1: d313d273 (button) collected ($0.25)
Seat 2: 93c87259 (small blind) folded before Flop
Seat 3: 1ce5c0f4 (big blind) folded before Flop
Seat 4: Hero folded before Flop (didn't bet)
Seat 5: 893ce251 folded before Flop (didn't bet)
Seat 6: 419d34d7 folded before Flop (didn't bet)


Poker Hand #RC1452467030: Hold'em No Limit  ($0.05/$0.1) - 2023/04/05 13:26:33
Table 'RushAndCash2192290' 6-max Seat #1 is the button
Seat 1: 6866240c ($13.42 in chips)
Seat 2: 853e3099 ($15.34 in chips)
Seat 3: 5006b20e ($6.96 in chips)
Seat 4: 1eee3bd9 ($10 in chips)
Seat 5: 11f8c03e ($10 in chips)
Seat 6: Hero ($15.32 in chips)
853e3099: posts small blind $0.05
5006b20e: posts big blind $0.1
*** HOLE CARDS ***
Dealt to 6866240c 
Dealt to 853e3099 
Dealt to 5006b20e 
Dealt to 1eee3bd9 
Dealt to 11f8c03e 
Dealt to Hero [Th Jh]
1eee3bd9: folds
11f8c03e: folds
Hero: raises $0.15 to $0.25
6866240c: folds
853e3099: folds
5006b20e: folds
Uncalled bet ($0.15) returned to Hero
*** SHOWDOWN ***
Hero collected $0.25 from pot
*** SUMMARY ***
Total pot $0.25 | Rake $0 | Jackpot $0 | Bingo $0 | Fortune $0
Seat 1: 6866240c (button) folded before Flop (didn't bet)
Seat 2: 853e3099 (small blind) folded before Flop
Seat 3: 5006b20e (big blind) folded before Flop
Seat 4: 1eee3bd9 folded before Flop (didn't bet)
Seat 5: 11f8c03e folded before Flop (didn't bet)
Seat 6: Hero collected ($0.25)


Poker Hand #RC1452466800: Hold'em No Limit  ($0.05/$0.1) - 2023/04/05 13:25:55
Table 'RushAndCash2192060' 6-max Seat #1 is the button
Seat 1: bdac7f09 ($10.1 in chips)
Seat 2: 6866240c ($13.1 in chips)
Seat 3: 4b868523 ($23.11 in chips)
Seat 4: 94c1da85 ($7.54 in chips)
Seat 5: 7ae98bfa ($14.29 in chips)
Seat 6: Hero ($15.57 in chips)
6866240c: posts small blind $0.05
4b868523: posts big blind $0.1
*** HOLE CARDS ***
Dealt to bdac7f09 
Dealt to 6866240c 
Dealt to 4b868523 
Dealt to 94c1da85 
Dealt to 7ae98bfa 
Dealt to Hero [Jc Ah]
94c1da85: folds
7ae98bfa: folds
Hero: raises $0.15 to $0.25
bdac7f09: folds
6866240c: calls $0.2
4b868523: folds
*** FLOP *** [2c 5d 5h]
6866240c: bets $0.45
Hero: folds
Uncalled bet ($0.45) returned to 6866240c
*** SHOWDOWN ***
6866240c collected $0.57 from pot
*** SUMMARY ***
Total pot $0.6 | Rake $0.03 | Jackpot $0 | Bingo $0 | Fortune $0
Board [2c 5d 5h]
Seat 1: bdac7f09 (button) folded before Flop (didn't bet)
Seat 2: 6866240c (small blind) won ($0.57)
Seat 3: 4b868523 (big blind) folded before Flop
Seat 4: 94c1da85 folded before Flop (didn't bet)
Seat 5: 7ae98bfa folded before Flop (didn't bet)
Seat 6: Hero folded on the Flop


Poker Hand #RC1452466624: Hold'em No Limit  ($0.05/$0.1) - 2023/04/05 13:25:28
Table 'RushAndCash2191884' 6-max Seat #1 is the button
Seat 1: d8ef97d1 ($12.5 in chips)
Seat 2: 5ff8e826 ($23.55 in chips)
Seat 3: Hero ($15.67 in chips)
Seat 4: 25674484 ($11.09 in chips)
Seat 5: 5350c7b7 ($10 in chips)
Seat 6: 4b677518 ($15.65 in chips)
5ff8e826: posts small blind $0.05
Hero: posts big blind $0.1
*** HOLE CARDS ***
Dealt to d8ef97d1 
Dealt to 5ff8e826 
Dealt to Hero [4c 7s]
Dealt to 25674484 
Dealt to 5350c7b7 
Dealt to 4b677518 
25674484: folds
5350c7b7: folds
4b677518: folds
d8ef97d1: raises $0.1 to $0.2
5ff8e826: raises $0.74 to $0.94
Hero: folds
d8ef97d1: raises $1.36 to $2.3
5ff8e826: folds
Uncalled bet ($1.36) returned to d8ef97d1
*** SHOWDOWN ***
d8ef97d1 collected $1.89 from pot
*** SUMMARY ***
Total pot $1.98 | Rake $0.09 | Jackpot $0 | Bingo $0 | Fortune $0
Seat 1: d8ef97d1 (button) collected ($1.89)
Seat 2: 5ff8e826 (small blind) folded before Flop
Seat 3: Hero (big blind) folded before Flop
Seat 4: 25674484 folded before Flop (didn't bet)
Seat 5: 5350c7b7 folded before Flop (didn't bet)
Seat 6: 4b677518 folded before Flop (didn't bet)


Poker Hand #RC1452466490: Hold'em No Limit  ($0.05/$0.1) - 2023/04/05 13:25:08
Table 'RushAndCash2191750' 6-max Seat #1 is the button
Seat 1: Hero ($15.67 in chips)
Seat 2: 5a7676dd ($19.32 in chips)
Seat 3: c5110137 ($11.51 in chips)
Seat 4: 38f74161 ($12.17 in chips)
Seat 5: c434d32d ($10.29 in chips)
Seat 6: 6b0a51ad ($29.7 in chips)
5a7676dd: posts small blind $0.05
c5110137: posts big blind $0.1
*** HOLE CARDS ***
Dealt to Hero [Ac 4s]
Dealt to 5a7676dd 
Dealt to c5110137 
Dealt to 38f74161 
Dealt to c434d32d 
Dealt to 6b0a51ad 
38f74161: raises $0.12 to $0.22
c434d32d: folds
6b0a51ad: folds
Hero: folds
5a7676dd: folds
c5110137: folds
Uncalled bet ($0.12) returned to 38f74161
*** SHOWDOWN ***
38f74161 collected $0.25 from pot
*** SUMMARY ***
Total pot $0.25 | Rake $0 | Jackpot $0 | Bingo $0 | Fortune $0
Seat 1: Hero (button) folded before Flop (didn't bet)
Seat 2: 5a7676dd (small blind) folded before Flop
Seat 3: c5110137 (big blind) folded before Flop
Seat 4: 38f74161 collected ($0.25)
Seat 5: c434d32d folded before Flop (didn't bet)
Seat 6: 6b0a51ad folded before Flop (didn't bet)


Poker Hand #RC1452466362: Hold'em No Limit  ($0.05/$0.1) - 2023/04/05 13:24:48
Table 'RushAndCash2191622' 6-max Seat #1 is the button
Seat 1: 8c1881f3 ($13.94 in chips)
Seat 2: Hero ($15.57 in chips)
Seat 3: af807c52 ($17.99 in chips)
Seat 4: 715b251e ($10.75 in chips)
Seat 5: c273dccc ($15.78 in chips)
Seat 6: 4e567705 ($18.89 in chips)
Hero: posts small blind $0.05
af807c52: posts big blind $0.1
*** HOLE CARDS ***
Dealt to 8c1881f3 
Dealt to Hero [As 8d]
Dealt to af807c52 
Dealt to 715b251e 
Dealt to c273dccc 
Dealt to 4e567705 
715b251e: folds
c273dccc: folds
4e567705: folds
8c1881f3: folds
Hero: raises $0.2 to $0.3
af807c52: folds
Uncalled bet ($0.2) returned to Hero
*** SHOWDOWN ***
Hero collected $0.2 from pot
*** SUMMARY ***
Total pot $0.2 | Rake $0 | Jackpot $0 | Bingo $0 | Fortune $0
Seat 1: 8c1881f3 (button) folded before Flop (didn't bet)
Seat 2: Hero (small blind) collected ($0.2)
Seat 3: af807c52 (big blind) folded before Flop
Seat 4: 715b251e folded before Flop (didn't bet)
Seat 5: c273dccc folded before Flop (didn't bet)
Seat 6: 4e567705 folded before Flop (didn't bet)


Poker Hand #RC1452466311: Hold'em No Limit  ($0.05/$0.1) - 2023/04/05 13:24:39
Table 'RushAndCash2191571' 6-max Seat #1 is the button
Seat 1: 97593ea0 ($10.42 in chips)
Seat 2: 24a52eb3 ($10 in chips)
Seat 3: 95eb117d ($20.76 in chips)
Seat 4: d4ddbac7 ($9.8 in chips)
Seat 5: Hero ($15.57 in chips)
Seat 6: 66f9b8be ($33.77 in chips)
24a52eb3: posts small blind $0.05
95eb117d: posts big blind $0.1
*** HOLE CARDS ***
Dealt to 97593ea0 
Dealt to 24a52eb3 
Dealt to 95eb117d 
Dealt to d4ddbac7 
Dealt to Hero [6c 3s]
Dealt to 66f9b8be 
d4ddbac7: raises $0.12 to $0.22
Hero: folds
66f9b8be: folds
97593ea0: folds
24a52eb3: folds
95eb117d: calls $0.12
*** FLOP *** [9s 6s 6d]
95eb117d: checks
d4ddbac7: checks
*** TURN *** [9s 6s 6d] [3d]
95eb117d: checks
d4ddbac7: checks
*** RIVER *** [9s 6s 6d 3d] [4c]
95eb117d: checks
d4ddbac7: checks
95eb117d: shows [Kc Jh] (Pair of Sixes)
d4ddbac7: shows [Ah Qh] (Pair of Sixes)
*** SHOWDOWN ***
d4ddbac7 collected $0.47 from pot
*** SUMMARY ***
Total pot $0.49 | Rake $0.02 | Jackpot $0 | Bingo $0 | Fortune $0
Board [9s 6s 6d 3d 4c]
Seat 1: 97593ea0 (button) folded before Flop (didn't bet)
Seat 2: 24a52eb3 (small blind) folded before Flop
Seat 3: 95eb117d (big blind) showed [Kc Jh] and lost with Pair of Sixes
Seat 4: d4ddbac7 showed [Ah Qh] and won ($0.47) with Pair of Sixes
Seat 5: Hero folded before Flop (didn't bet)
Seat 6: 66f9b8be folded before Flop (didn't bet)


Poker Hand #RC1452466280: Hold'em No Limit  ($0.05/$0.1) - 2023/04/05 13:24:34
Table 'RushAndCash2191540' 6-max Seat #1 is the button
Seat 1: d65cc4f6 ($9.33 in chips)
Seat 2: 9d33822e ($10.78 in chips)
Seat 3: ce4417fe ($23.33 in chips)
Seat 4: Hero ($15.57 in chips)
Seat 5: 22fe1119 ($10.22 in chips)
Seat 6: 79a3ce08 ($5.22 in chips)
9d33822e: posts small blind $0.05
ce4417fe: posts big blind $0.1
*** HOLE CARDS ***
Dealt to d65cc4f6 
Dealt to 9d33822e 
Dealt to ce4417fe 
Dealt to Hero [4h 3s]
Dealt to 22fe1119 
Dealt to 79a3ce08 
Hero: folds
22fe1119: raises $0.2 to $0.3
79a3ce08: folds
d65cc4f6: folds
9d33822e: folds
ce4417fe: folds
Uncalled bet ($0.2) returned to 22fe1119
*** SHOWDOWN ***
22fe1119 collected $0.25 from pot
*** SUMMARY ***
Total pot $0.25 | Rake $0 | Jackpot $0 | Bingo $0 | Fortune $0
Seat 1: d65cc4f6 (button) folded before Flop (didn't bet)
Seat 2: 9d33822e (small blind) folded before Flop
Seat 3: ce4417fe (big blind) folded before Flop
Seat 4: Hero folded before Flop (didn't bet)
Seat 5: 22fe1119 collected ($0.25)
Seat 6: 79a3ce08 folded before Flop (didn't bet)


Poker Hand #RC1452466248: Hold'em No Limit  ($0.05/$0.1) - 2023/04/05 13:24:29
Table 'RushAndCash2191508' 6-max Seat #1 is the button
Seat 1: d2d1b844 ($10 in chips)
Seat 2: 60b8ff49 ($11.74 in chips)
Seat 3: 22fe1119 ($10.32 in chips)
Seat 4: Hero ($15.57 in chips)
Seat 5: 1511d049 ($10 in chips)
Seat 6: 715b251e ($10.75 in chips)
60b8ff49: posts small blind $0.05
22fe1119: posts big blind $0.1
*** HOLE CARDS ***
Dealt to d2d1b844 
Dealt to 60b8ff49 
Dealt to 22fe1119 
Dealt to Hero [5d 2h]
Dealt to 1511d049 
Dealt to 715b251e 
Hero: folds
1511d049: folds
715b251e: folds
d2d1b844: folds
60b8ff49: folds
Uncalled bet ($0.05) returned to 22fe1119
*** SHOWDOWN ***
22fe1119 collected $0.1 from pot
*** SUMMARY ***
Total pot $0.1 | Rake $0 | Jackpot $0 | Bingo $0 | Fortune $0
Seat 1: d2d1b844 (button) folded before Flop (didn't bet)
Seat 2: 60b8ff49 (small blind) folded before Flop
Seat 3: 22fe1119 (big blind) collected ($0.1)
Seat 4: Hero folded before Flop (didn't bet)
Seat 5: 1511d049 folded before Flop (didn't bet)
Seat 6: 715b251e folded before Flop (didn't bet)


Poker Hand #RC1452465856: Hold'em No Limit  ($0.05/$0.1) - 2023/04/05 13:23:34
Table 'RushAndCash2191116' 6-max Seat #1 is the button
Seat 1: d79eaec1 ($8.26 in chips)
Seat 2: 3dbe1ff2 ($10.93 in chips)
Seat 3: 520250c1 ($7.31 in chips)
Seat 4: 29be666f ($9.5 in chips)
Seat 5: fe3bd2c7 ($18.36 in chips)
Seat 6: Hero ($13.66 in chips)
3dbe1ff2: posts small blind $0.05
520250c1: posts big blind $0.1
*** HOLE CARDS ***
Dealt to d79eaec1 
Dealt to 3dbe1ff2 
Dealt to 520250c1 
Dealt to 29be666f 
Dealt to fe3bd2c7 
Dealt to Hero [Qh Kd]
29be666f: raises $0.15 to $0.25
fe3bd2c7: calls $0.25
Hero: raises $0.78 to $1.03
d79eaec1: folds
3dbe1ff2: folds
520250c1: folds
29be666f: calls $0.78
fe3bd2c7: calls $0.78
*** FLOP *** [9h 2d 2h]
29be666f: checks
fe3bd2c7: checks
Hero: bets $1.07
29be666f: folds
fe3bd2c7: folds
Uncalled bet ($1.07) returned to Hero
*** SHOWDOWN ***
Hero collected $2.94 from pot
*** SUMMARY ***
Total pot $3.24 | Rake $0.15 | Jackpot $0.15 | Bingo $0 | Fortune $0
Board [9h 2d 2h]
Seat 1: d79eaec1 (button) folded before Flop (didn't bet)
Seat 2: 3dbe1ff2 (small blind) folded before Flop
Seat 3: 520250c1 (big blind) folded before Flop
Seat 4: 29be666f folded on the Flop
Seat 5: fe3bd2c7 folded on the Flop
Seat 6: Hero won ($2.94)


Poker Hand #RC1452465790: Hold'em No Limit  ($0.05/$0.1) - 2023/04/05 13:23:25
Table 'RushAndCash2191050' 6-max Seat #1 is the button
Seat 1: bd0fd3a4 ($2.55 in chips)
Seat 2: 318f9cd6 ($10.27 in chips)
Seat 3: Hero ($13.76 in chips)
Seat 4: e5e62705 ($11.09 in chips)
Seat 5: 5fef1b5 ($10.2 in chips)
Seat 6: db804c42 ($10.65 in chips)
318f9cd6: posts small blind $0.05
Hero: posts big blind $0.1
*** HOLE CARDS ***
Dealt to bd0fd3a4 
Dealt to 318f9cd6 
Dealt to Hero [8h Qs]
Dealt to e5e62705 
Dealt to 5fef1b5 
Dealt to db804c42 
e5e62705: folds
5fef1b5: folds
db804c42: folds
bd0fd3a4: folds
318f9cd6: raises $0.2 to $0.3
Hero: folds
Uncalled bet ($0.2) returned to 318f9cd6
*** SHOWDOWN ***
318f9cd6 collected $0.2 from pot
*** SUMMARY ***
Total pot $0.2 | Rake $0 | Jackpot $0 | Bingo $0 | Fortune $0
Seat 1: bd0fd3a4 (button) folded before Flop (didn't bet)
Seat 2: 318f9cd6 (small blind) collected ($0.2)
Seat 3: Hero (big blind) folded before Flop
Seat 4: e5e62705 folded before Flop (didn't bet)
Seat 5: 5fef1b5 folded before Flop (didn't bet)
Seat 6: db804c42 folded before Flop (didn't bet)


Poker Hand #RC1452465506: Hold'em No Limit  ($0.05/$0.1) - 2023/04/05 13:22:43
Table 'RushAndCash2190766' 6-max Seat #1 is the button
Seat 1: Hero ($13.23 in chips)
Seat 2: ddc85a41 ($6.9 in chips)
Seat 3: bd0fd3a4 ($3.08 in chips)
Seat 4: dca99cdb ($10.42 in chips)
Seat 5: f89b650b ($11.62 in chips)
Seat 6: 72750c29 ($41.37 in chips)
ddc85a41: posts small blind $0.05
bd0fd3a4: posts big blind $0.1
*** HOLE CARDS ***
Dealt to Hero [Qs Qc]
Dealt to ddc85a41 
Dealt to bd0fd3a4 
Dealt to dca99cdb 
Dealt to f89b650b 
Dealt to 72750c29 
dca99cdb: folds
f89b650b: folds
72750c29: folds
Hero: raises $0.15 to $0.25
ddc85a41: folds
bd0fd3a4: calls $0.15
*** FLOP *** [Ad Jc 7s]
bd0fd3a4: checks
Hero: checks
*** TURN *** [Ad Jc 7s] [7c]
bd0fd3a4: checks
Hero: checks
*** RIVER *** [Ad Jc 7s 7c] [3c]
bd0fd3a4: bets $0.28
Hero: calls $0.28
bd0fd3a4: shows [Kd 8s] (Pair of Sevens)
Hero: shows [Qs Qc] (Pair of Queens and Pair of Sevens)
*** SHOWDOWN ***
Hero collected $1.06 from pot
*** SUMMARY ***
Total pot $1.11 | Rake $0.05 | Jackpot $0 | Bingo $0 | Fortune $0
Board [Ad Jc 7s 7c 3c]
Seat 1: Hero (button) showed [Qs Qc] and won ($1.06) with Pair of Queens and Pair of Sevens
Seat 2: ddc85a41 (small blind) folded before Flop
Seat 3: bd0fd3a4 (big blind) showed [Kd 8s] and lost with Pair of Sevens
Seat 4: dca99cdb folded before Flop (didn't bet)
Seat 5: f89b650b folded before Flop (didn't bet)
Seat 6: 72750c29 folded before Flop (didn't bet)


Poker Hand #RC1452465341: Hold'em No Limit  ($0.05/$0.1) - 2023/04/05 13:22:17
Table 'RushAndCash2190601' 6-max Seat #1 is the button
Seat 1: 4d43a4d ($18.77 in chips)
Seat 2: Hero ($13.13 in chips)
Seat 3: 2ba1c1d ($10.88 in chips)
Seat 4: 5dbe567f ($19.4 in chips)
Seat 5: 38f74161 ($13.05 in chips)
Seat 6: d79eaec1 ($8.88 in chips)
Hero: posts small blind $0.05
2ba1c1d: posts big blind $0.1
*** HOLE CARDS ***
Dealt to 4d43a4d 
Dealt to Hero [Jd Qd]
Dealt to 2ba1c1d 
Dealt to 5dbe567f 
Dealt to 38f74161 
Dealt to d79eaec1 
5dbe567f: folds
38f74161: folds
d79eaec1: folds
4d43a4d: folds
Hero: raises $0.2 to $0.3
2ba1c1d: folds
Uncalled bet ($0.2) returned to Hero
*** SHOWDOWN ***
Hero collected $0.2 from pot
*** SUMMARY ***
Total pot $0.2 | Rake $0 | Jackpot $0 | Bingo $0 | Fortune $0
Seat 1: 4d43a4d (button) folded before Flop (didn't bet)
Seat 2: Hero (small blind) collected ($0.2)
Seat 3: 2ba1c1d (big blind) folded before Flop
Seat 4: 5dbe567f folded before Flop (didn't bet)
Seat 5: 38f74161 folded before Flop (didn't bet)
Seat 6: d79eaec1 folded before Flop (didn't bet)


Poker Hand #RC1452465305: Hold'em No Limit  ($0.05/$0.1) - 2023/04/05 13:22:12
Table 'RushAndCash2190565' 6-max Seat #1 is the button
Seat 1: 3f9a8578 ($12.55 in chips)
Seat 2: aec1c28d ($10.05 in chips)
Seat 3: 180cd083 ($10.3 in chips)
Seat 4: cec8daf4 ($7.68 in chips)
Seat 5: 1eee3bd9 ($10.7 in chips)
Seat 6: Hero ($13.13 in chips)
aec1c28d: posts small blind $0.05
180cd083: posts big blind $0.1
*** HOLE CARDS ***
Dealt to 3f9a8578 
Dealt to aec1c28d 
Dealt to 180cd083 
Dealt to cec8daf4 
Dealt to 1eee3bd9 
Dealt to Hero [Qc Th]
cec8daf4: folds
1eee3bd9: folds
Hero: folds
3f9a8578: folds
aec1c28d: folds
Uncalled bet ($0.05) returned to 180cd083
*** SHOWDOWN ***
180cd083 collected $0.1 from pot
*** SUMMARY ***
Total pot $0.1 | Rake $0 | Jackpot $0 | Bingo $0 | Fortune $0
Seat 1: 3f9a8578 (button) folded before Flop (didn't bet)
Seat 2: aec1c28d (small blind) folded before Flop
Seat 3: 180cd083 (big blind) collected ($0.1)
Seat 4: cec8daf4 folded before Flop (didn't bet)
Seat 5: 1eee3bd9 folded before Flop (didn't bet)
Seat 6: Hero folded before Flop (didn't bet)


Poker Hand #RC1452464806: Hold'em No Limit  ($0.05/$0.1) - 2023/04/05 13:20:58
Table 'RushAndCash2190066' 6-max Seat #1 is the button
Seat 1: 1511d049 ($10.84 in chips)
Seat 2: 33c63b6d ($11.23 in chips)
Seat 3: e9a50769 ($10.3 in chips)
Seat 4: 6e3d1ba6 ($28.25 in chips)
Seat 5: Hero ($10.32 in chips)
Seat 6: 16ed58a9 ($10.25 in chips)
Cash Drop to Pot : total $1 
33c63b6d: posts small blind $0.05
e9a50769: posts big blind $0.1
*** HOLE CARDS ***
Dealt to 1511d049 
Dealt to 33c63b6d 
Dealt to e9a50769 
Dealt to 6e3d1ba6 
Dealt to Hero [Kc As]
Dealt to 16ed58a9 
6e3d1ba6: folds
Hero: raises $0.65 to $0.75
16ed58a9: folds
1511d049: folds
33c63b6d: calls $0.7
e9a50769: folds
*** FLOP *** [6h Jh 5c]
33c63b6d: checks
Hero: checks
*** TURN *** [6h Jh 5c] [8d]
33c63b6d: bets $1.36
Hero: calls $1.36
*** RIVER *** [6h Jh 5c 8d] [Qd]
33c63b6d: checks
Hero: checks
33c63b6d: shows [Tc Ks] (King-High)
Hero: shows [Kc As] (Ace-High)
*** SHOWDOWN ***
Hero collected $4.92 from pot
*** SUMMARY ***
Total pot $5.32 | Rake $0.25 | Jackpot $0.15 | Bingo $0 | Fortune $0
Board [6h Jh 5c 8d Qd]
Seat 1: 1511d049 (button) folded before Flop (didn't bet)
Seat 2: 33c63b6d (small blind) showed [Tc Ks] and lost with King-High
Seat 3: e9a50769 (big blind) folded before Flop
Seat 4: 6e3d1ba6 folded before Flop (didn't bet)
Seat 5: Hero showed [Kc As] and won ($4.92) with Ace-High
Seat 6: 16ed58a9 folded before Flop (didn't bet)


Poker Hand #RC1452434621: Hold'em No Limit  ($0.05/$0.1) - 2023/04/05 13:20:31
Table 'RushAndCash2189881' 6-max Seat #1 is the button
Seat 1: Hero ($10.17 in chips)
Seat 2: a3dcc247 ($10.05 in chips)
Seat 3: 419d34d7 ($11.33 in chips)
Seat 4: 93dab03 ($13.63 in chips)
Seat 5: 3c81b5b5 ($15.14 in chips)
Seat 6: d637b1d1 ($24.09 in chips)
a3dcc247: posts small blind $0.05
419d34d7: posts big blind $0.1
*** HOLE CARDS ***
Dealt to Hero [Kh Td]
Dealt to a3dcc247 
Dealt to 419d34d7 
Dealt to 93dab03 
Dealt to 3c81b5b5 
Dealt to d637b1d1 
93dab03: folds
3c81b5b5: folds
d637b1d1: folds
Hero: raises $0.15 to $0.25
a3dcc247: folds
419d34d7: folds
Uncalled bet ($0.15) returned to Hero
*** SHOWDOWN ***
Hero collected $0.25 from pot
*** SUMMARY ***
Total pot $0.25 | Rake $0 | Jackpot $0 | Bingo $0 | Fortune $0
Seat 1: Hero (button) collected ($0.25)
Seat 2: a3dcc247 (small blind) folded before Flop
Seat 3: 419d34d7 (big blind) folded before Flop
Seat 4: 93dab03 folded before Flop (didn't bet)
Seat 5: 3c81b5b5 folded before Flop (didn't bet)
Seat 6: d637b1d1 folded before Flop (didn't bet)


Poker Hand #RC1452434434: Hold'em No Limit  ($0.05/$0.1) - 2023/04/05 13:20:02
Table 'RushAndCash2189694' 6-max Seat #1 is the button
Seat 1: 7f0c6026 ($21.01 in chips)
Seat 2: Hero ($9.9 in chips)
Seat 3: 3c81b5b5 ($15.44 in chips)
Seat 4: 47e90b31 ($40.37 in chips)
Seat 5: d637b1d1 ($23.99 in chips)
Seat 6: b59c4d95 ($17.37 in chips)
Hero: posts small blind $0.05
3c81b5b5: posts big blind $0.1
*** HOLE CARDS ***
Dealt to 7f0c6026 
Dealt to Hero [Qs Kd]
Dealt to 3c81b5b5 
Dealt to 47e90b31 
Dealt to d637b1d1 
Dealt to b59c4d95 
47e90b31: folds
d637b1d1: folds
b59c4d95: folds
7f0c6026: folds
Hero: raises $0.2 to $0.3
3c81b5b5: calls $0.2
*** FLOP *** [Kh 2c 3h]
Hero: bets $0.2
3c81b5b5: folds
Uncalled bet ($0.2) returned to Hero
*** SHOWDOWN ***
Hero collected $0.57 from pot
*** SUMMARY ***
Total pot $0.6 | Rake $0.03 | Jackpot $0 | Bingo $0 | Fortune $0
Board [Kh 2c 3h]
Seat 1: 7f0c6026 (button) folded before Flop (didn't bet)
Seat 2: Hero (small blind) won ($0.57)
Seat 3: 3c81b5b5 (big blind) folded on the Flop
Seat 4: 47e90b31 folded before Flop (didn't bet)
Seat 5: d637b1d1 folded before Flop (didn't bet)
Seat 6: b59c4d95 folded before Flop (didn't bet)


Poker Hand #RC1452434361: Hold'em No Limit  ($0.05/$0.1) - 2023/04/05 13:19:50
Table 'RushAndCash2189621' 6-max Seat #1 is the button
Seat 1: cec8daf4 ($7.69 in chips)
Seat 2: 5a7676dd ($13.54 in chips)
Seat 3: Hero ($10 in chips)
Seat 4: b4b99f8f ($6.87 in chips)
Seat 5: b9432768 ($9.62 in chips)
Seat 6: 8e3f17f ($9.85 in chips)
5a7676dd: posts small blind $0.05
Hero: posts big blind $0.1
*** HOLE CARDS ***
Dealt to cec8daf4 
Dealt to 5a7676dd 
Dealt to Hero [Jc 7d]
Dealt to b4b99f8f 
Dealt to b9432768 
Dealt to 8e3f17f 
b4b99f8f: folds
b9432768: raises $0.1 to $0.2
8e3f17f: folds
cec8daf4: folds
5a7676dd: folds
Hero: folds
Uncalled bet ($0.1) returned to b9432768
*** SHOWDOWN ***
b9432768 collected $0.25 from pot
*** SUMMARY ***
Total pot $0.25 | Rake $0 | Jackpot $0 | Bingo $0 | Fortune $0
Seat 1: cec8daf4 (button) folded before Flop (didn't bet)
Seat 2: 5a7676dd (small blind) folded before Flop
Seat 3: Hero (big blind) folded before Flop
Seat 4: b4b99f8f folded before Flop (didn't bet)
Seat 5: b9432768 collected ($0.25)
Seat 6: 8e3f17f folded before Flop (didn't bet)


Poker Hand #RC1452434332: Hold'em No Limit  ($0.05/$0.1) - 2023/04/05 13:19:46
Table 'RushAndCash2189592' 6-max Seat #1 is the button
Seat 1: f89b650b ($10.15 in chips)
Seat 2: 12176177 ($22.08 in chips)
Seat 3: a0b0b7e6 ($13.2 in chips)
Seat 4: 66f9b8be ($30.95 in chips)
Seat 5: Hero ($10 in chips)
Seat 6: 8b9de425 ($19.03 in chips)
12176177: posts small blind $0.05
a0b0b7e6: posts big blind $0.1
*** HOLE CARDS ***
Dealt to f89b650b 
Dealt to 12176177 
Dealt to a0b0b7e6 
Dealt to 66f9b8be 
Dealt to Hero [4c Th]
Dealt to 8b9de425 
66f9b8be: raises $0.12 to $0.22
Hero: folds
8b9de425: folds
f89b650b: folds
12176177: raises $0.68 to $0.9
a0b0b7e6: folds
66f9b8be: calls $0.68
*** FLOP *** [5h Ts 8h]
12176177: checks
66f9b8be: checks
*** TURN *** [5h Ts 8h] [9h]
12176177: checks
66f9b8be: bets $1.1
12176177: calls $1.1
*** RIVER *** [5h Ts 8h 9h] [2s]
12176177: checks
66f9b8be: bets $3.08
12176177: folds
Uncalled bet ($3.08) returned to 66f9b8be
*** SHOWDOWN ***
66f9b8be collected $3.76 from pot
*** SUMMARY ***
Total pot $4.1 | Rake $0.19 | Jackpot $0.15 | Bingo $0 | Fortune $0
Board [5h Ts 8h 9h 2s]
Seat 1: f89b650b (button) folded before Flop (didn't bet)
Seat 2: 12176177 (small blind) folded on the River
Seat 3: a0b0b7e6 (big blind) folded before Flop
Seat 4: 66f9b8be won ($3.76)
Seat 5: Hero folded before Flop (didn't bet)
Seat 6: 8b9de425 folded before Flop (didn't bet)


Poker Hand #RC1452433722: Hold'em No Limit  ($0.05/$0.1) - 2023/04/05 13:18:13
Table 'RushAndCash2188982' 6-max Seat #1 is the button
Seat 1: 103ce21f ($10.27 in chips)
Seat 2: b574ec5a ($13.41 in chips)
Seat 3: 17715e43 ($10.97 in chips)
Seat 4: 8ab72fdd ($10.12 in chips)
Seat 5: Hero ($10.31 in chips)
Seat 6: c119e17b ($7.96 in chips)
b574ec5a: posts small blind $0.05
17715e43: posts big blind $0.1
*** HOLE CARDS ***
Dealt to 103ce21f 
Dealt to b574ec5a 
Dealt to 17715e43 
Dealt to 8ab72fdd 
Dealt to Hero [Qh 9h]
Dealt to c119e17b 
8ab72fdd: folds
Hero: raises $0.15 to $0.25
c119e17b: folds
103ce21f: calls $0.25
b574ec5a: folds
17715e43: calls $0.15
*** FLOP *** [Js Kh 3h]
17715e43: checks
Hero: bets $0.5
103ce21f: raises $1.15 to $1.65
17715e43: folds
Hero: raises $8.41 to $10.06 and is all-in
103ce21f: calls $8.37 and is all-in
Uncalled bet ($0.04) returned to Hero
Hero: shows [Qh 9h] (King-High)
103ce21f: shows [3s 3c] (Three Treys)
*** TURN *** [Js Kh 3h] [Jc]
*** RIVER *** [Js Kh 3h Jc] [Ks]
*** SHOWDOWN ***
103ce21f collected $20.39 from pot
*** SUMMARY ***
Total pot $20.84 | Rake $0.3 | Jackpot $0.15 | Bingo $0 | Fortune $0
Board [Js Kh 3h Jc Ks]
Seat 1: 103ce21f (button) showed [3s 3c] and won ($20.39) with Treys Full over Kings
Seat 2: b574ec5a (small blind) folded before Flop
Seat 3: 17715e43 (big blind) folded on the Flop
Seat 4: 8ab72fdd folded before Flop (didn't bet)
Seat 5: Hero showed [Qh 9h] and lost with Pair of Kings and Pair of Jacks
Seat 6: c119e17b folded before Flop (didn't bet)


Poker Hand #RC1452433649: Hold'em No Limit  ($0.05/$0.1) - 2023/04/05 13:18:03
Table 'RushAndCash2188909' 6-max Seat #1 is the button
Seat 1: 1d21e2d5 ($12.24 in chips)
Seat 2: 958f7db8 ($12.44 in chips)
Seat 3: 853e3099 ($10.1 in chips)
Seat 4: f7c0db98 ($3.83 in chips)
Seat 5: Hero ($10.31 in chips)
Seat 6: 8b11292f ($19.65 in chips)
958f7db8: posts small blind $0.05
853e3099: posts big blind $0.1
*** HOLE CARDS ***
Dealt to 1d21e2d5 
Dealt to 958f7db8 
Dealt to 853e3099 
Dealt to f7c0db98 
Dealt to Hero [Qd 2c]
Dealt to 8b11292f 
f7c0db98: folds
Hero: folds
8b11292f: raises $0.1 to $0.2
1d21e2d5: raises $0.5 to $0.7
958f7db8: folds
853e3099: folds
8b11292f: calls $0.5
*** FLOP *** [Th 6h Qs]
8b11292f: checks
1d21e2d5: bets $0.78
8b11292f: calls $0.78
*** TURN *** [Th 6h Qs] [Ac]
8b11292f: checks
1d21e2d5: bets $2.05
8b11292f: folds
Uncalled bet ($2.05) returned to 1d21e2d5
*** SHOWDOWN ***
1d21e2d5 collected $2.82 from pot
*** SUMMARY ***
Total pot $3.11 | Rake $0.14 | Jackpot $0.15 | Bingo $0 | Fortune $0
Board [Th 6h Qs Ac]
Seat 1: 1d21e2d5 (button) won ($2.82)
Seat 2: 958f7db8 (small blind) folded before Flop
Seat 3: 853e3099 (big blind) folded before Flop
Seat 4: f7c0db98 folded before Flop (didn't bet)
Seat 5: Hero folded before Flop (didn't bet)
Seat 6: 8b11292f folded on the Turn


Poker Hand #RC1452433419: Hold'em No Limit  ($0.05/$0.1) - 2023/04/05 13:17:28
Table 'RushAndCash2188679' 6-max Seat #1 is the button
Seat 1: Hero ($10.56 in chips)
Seat 2: 1d21e2d5 ($11.92 in chips)
Seat 3: 4604614a ($13.61 in chips)
Seat 4: c0c8a2e5 ($10.15 in chips)
Seat 5: bc0c31ed ($15.63 in chips)
Seat 6: 619d2d53 ($18.71 in chips)
1d21e2d5: posts small blind $0.05
4604614a: posts big blind $0.1
*** HOLE CARDS ***
Dealt to Hero [4s Kh]
Dealt to 1d21e2d5 
Dealt to 4604614a 
Dealt to c0c8a2e5 
Dealt to bc0c31ed 
Dealt to 619d2d53 
c0c8a2e5: folds
bc0c31ed: folds
619d2d53: folds
Hero: raises $0.15 to $0.25
1d21e2d5: raises $0.77 to $1.02
4604614a: folds
Hero: folds
Uncalled bet ($0.77) returned to 1d21e2d5
*** SHOWDOWN ***
1d21e2d5 collected $0.57 from pot
*** SUMMARY ***
Total pot $0.6 | Rake $0.03 | Jackpot $0 | Bingo $0 | Fortune $0
Seat 1: Hero (button) folded before Flop
Seat 2: 1d21e2d5 (small blind) collected ($0.57)
Seat 3: 4604614a (big blind) folded before Flop
Seat 4: c0c8a2e5 folded before Flop (didn't bet)
Seat 5: bc0c31ed folded before Flop (didn't bet)
Seat 6: 619d2d53 folded before Flop (didn't bet)


Poker Hand #RC1452433365: Hold'em No Limit  ($0.05/$0.1) - 2023/04/05 13:17:20
Table 'RushAndCash2188625' 6-max Seat #1 is the button
Seat 1: ae8aae04 ($33.91 in chips)
Seat 2: Hero ($10.61 in chips)
Seat 3: c7b64f55 ($8.61 in chips)
Seat 4: 733de302 ($19.38 in chips)
Seat 5: 6b0a51ad ($29.82 in chips)
Seat 6: 97593ea0 ($11.18 in chips)
Hero: posts small blind $0.05
c7b64f55: posts big blind $0.1
*** HOLE CARDS ***
Dealt to ae8aae04 
Dealt to Hero [Td 9s]
Dealt to c7b64f55 
Dealt to 733de302 
Dealt to 6b0a51ad 
Dealt to 97593ea0 
733de302: folds
6b0a51ad: folds
97593ea0: raises $0.1 to $0.2
ae8aae04: folds
Hero: folds
c7b64f55: calls $0.1
*** FLOP *** [Th 2d 2c]
c7b64f55: checks
97593ea0: bets $0.15
c7b64f55: folds
Uncalled bet ($0.15) returned to 97593ea0
*** SHOWDOWN ***
97593ea0 collected $0.43 from pot
*** SUMMARY ***
Total pot $0.45 | Rake $0.02 | Jackpot $0 | Bingo $0 | Fortune $0
Board [Th 2d 2c]
Seat 1: ae8aae04 (button) folded before Flop (didn't bet)
Seat 2: Hero (small blind) folded before Flop
Seat 3: c7b64f55 (big blind) folded on the Flop
Seat 4: 733de302 folded before Flop (didn't bet)
Seat 5: 6b0a51ad folded before Flop (didn't bet)
Seat 6: 97593ea0 won ($0.43)


Poker Hand #RC1452433271: Hold'em No Limit  ($0.05/$0.1) - 2023/04/05 13:17:06
Table 'RushAndCash2188531' 6-max Seat #1 is the button
Seat 1: eb1160a2 ($8.12 in chips)
Seat 2: e6f7e80e ($12.32 in chips)
Seat 3: Hero ($10.71 in chips)
Seat 4: 436d479c ($10.63 in chips)
Seat 5: 17715e43 ($11.12 in chips)
Seat 6: ff92cdd7 ($6.79 in chips)
e6f7e80e: posts small blind $0.05
Hero: posts big blind $0.1
*** HOLE CARDS ***
Dealt to eb1160a2 
Dealt to e6f7e80e 
Dealt to Hero [Th 8c]
Dealt to 436d479c 
Dealt to 17715e43 
Dealt to ff92cdd7 
436d479c: folds
17715e43: folds
ff92cdd7: folds
eb1160a2: raises $0.1 to $0.2
e6f7e80e: folds
Hero: folds
Uncalled bet ($0.1) returned to eb1160a2
*** SHOWDOWN ***
eb1160a2 collected $0.25 from pot
*** SUMMARY ***
Total pot $0.25 | Rake $0 | Jackpot $0 | Bingo $0 | Fortune $0
Seat 1: eb1160a2 (button) collected ($0.25)
Seat 2: e6f7e80e (small blind) folded before Flop
Seat 3: Hero (big blind) folded before Flop
Seat 4: 436d479c folded before Flop (didn't bet)
Seat 5: 17715e43 folded before Flop (didn't bet)
Seat 6: ff92cdd7 folded before Flop (didn't bet)


Poker Hand #RC1452433225: Hold'em No Limit  ($0.05/$0.1) - 2023/04/05 13:16:58
Table 'RushAndCash2188485' 6-max Seat #1 is the button
Seat 1: 25edc198 ($26.47 in chips)
Seat 2: 627d95f8 ($14.59 in chips)
Seat 3: ff92cdd7 ($6.94 in chips)
Seat 4: Hero ($10.71 in chips)
Seat 5: 6216e0df ($23.13 in chips)
Seat 6: 73da5b2f ($13.08 in chips)
627d95f8: posts small blind $0.05
ff92cdd7: posts big blind $0.1
*** HOLE CARDS ***
Dealt to 25edc198 
Dealt to 627d95f8 
Dealt to ff92cdd7 
Dealt to Hero [8c Qs]
Dealt to 6216e0df 
Dealt to 73da5b2f 
Hero: folds
6216e0df: folds
73da5b2f: folds
25edc198: folds
627d95f8: folds
Uncalled bet ($0.05) returned to ff92cdd7
*** SHOWDOWN ***
ff92cdd7 collected $0.1 from pot
*** SUMMARY ***
Total pot $0.1 | Rake $0 | Jackpot $0 | Bingo $0 | Fortune $0
Seat 1: 25edc198 (button) folded before Flop (didn't bet)
Seat 2: 627d95f8 (small blind) folded before Flop
Seat 3: ff92cdd7 (big blind) collected ($0.1)
Seat 4: Hero folded before Flop (didn't bet)
Seat 5: 6216e0df folded before Flop (didn't bet)
Seat 6: 73da5b2f folded before Flop (didn't bet)


Poker Hand #RC1452433194: Hold'em No Limit  ($0.05/$0.1) - 2023/04/05 13:16:53
Table 'RushAndCash2188454' 6-max Seat #1 is the button
Seat 1: 832753a5 ($10.59 in chips)
Seat 2: 3b0d8197 ($29.03 in chips)
Seat 3: 3b73950f ($17.81 in chips)
Seat 4: 318f9cd6 ($10 in chips)
Seat 5: Hero ($10.71 in chips)
Seat 6: 960ba9d6 ($20.1 in chips)
3b0d8197: posts small blind $0.05
3b73950f: posts big blind $0.1
*** HOLE CARDS ***
Dealt to 832753a5 
Dealt to 3b0d8197 
Dealt to 3b73950f 
Dealt to 318f9cd6 
Dealt to Hero [4s 6s]
Dealt to 960ba9d6 
318f9cd6: folds
Hero: folds
960ba9d6: folds
832753a5: raises $0.15 to $0.25
3b0d8197: folds
3b73950f: folds
Uncalled bet ($0.15) returned to 832753a5
*** SHOWDOWN ***
832753a5 collected $0.25 from pot
*** SUMMARY ***
Total pot $0.25 | Rake $0 | Jackpot $0 | Bingo $0 | Fortune $0
Seat 1: 832753a5 (button) collected ($0.25)
Seat 2: 3b0d8197 (small blind) folded before Flop
Seat 3: 3b73950f (big blind) folded before Flop
Seat 4: 318f9cd6 folded before Flop (didn't bet)
Seat 5: Hero folded before Flop (didn't bet)
Seat 6: 960ba9d6 folded before Flop (didn't bet)


Poker Hand #RC1452433141: Hold'em No Limit  ($0.05/$0.1) - 2023/04/05 13:16:44
Table 'RushAndCash2188401' 6-max Seat #1 is the button
Seat 1: Hero ($10.71 in chips)
Seat 2: 5f1f500b ($10.05 in chips)
Seat 3: f7c0db98 ($4 in chips)
Seat 4: 103ce21f ($10 in chips)
Seat 5: e20b99c6 ($11.81 in chips)
Seat 6: 3c81b5b5 ($15.84 in chips)
5f1f500b: posts small blind $0.05
f7c0db98: posts big blind $0.1
*** HOLE CARDS ***
Dealt to Hero [2h 7s]
Dealt to 5f1f500b 
Dealt to f7c0db98 
Dealt to 103ce21f 
Dealt to e20b99c6 
Dealt to 3c81b5b5 
103ce21f: raises $0.1 to $0.2
e20b99c6: folds
3c81b5b5: folds
Hero: folds
5f1f500b: folds
f7c0db98: calls $0.1
*** FLOP *** [8h As 8d]
f7c0db98: bets $0.15
103ce21f: raises $0.25 to $0.4
f7c0db98: folds
Uncalled bet ($0.25) returned to 103ce21f
*** SHOWDOWN ***
103ce21f collected $0.72 from pot
*** SUMMARY ***
Total pot $0.75 | Rake $0.03 | Jackpot $0 | Bingo $0 | Fortune $0
Board [8h As 8d]
Seat 1: Hero (button) folded before Flop (didn't bet)
Seat 2: 5f1f500b (small blind) folded before Flop
Seat 3: f7c0db98 (big blind) folded on the Flop
Seat 4: 103ce21f won ($0.72)
Seat 5: e20b99c6 folded before Flop (didn't bet)
Seat 6: 3c81b5b5 folded before Flop (didn't bet)


Poker Hand #RC1452433119: Hold'em No Limit  ($0.05/$0.1) - 2023/04/05 13:16:40
Table 'RushAndCash2188379' 6-max Seat #1 is the button
Seat 1: 13be7e67 ($10.28 in chips)
Seat 2: c6e29035 ($18.42 in chips)
Seat 3: 1a2e021f ($10 in chips)
Seat 4: Hero ($10.71 in chips)
Seat 5: dcb5ac90 ($10.15 in chips)
Seat 6: bc0c31ed ($15.36 in chips)
c6e29035: posts small blind $0.05
1a2e021f: posts big blind $0.1
*** HOLE CARDS ***
Dealt to 13be7e67 
Dealt to c6e29035 
Dealt to 1a2e021f 
Dealt to Hero [7d Kd]
Dealt to dcb5ac90 
Dealt to bc0c31ed 
Hero: folds
dcb5ac90: folds
bc0c31ed: folds
13be7e67: folds
c6e29035: raises $0.2 to $0.3
1a2e021f: calls $0.2
*** FLOP *** [8h 8s Th]
c6e29035: bets $0.2
1a2e021f: calls $0.2
*** TURN *** [8h 8s Th] [Td]
c6e29035: checks
1a2e021f: checks
*** RIVER *** [8h 8s Th Td] [7h]
c6e29035: checks
1a2e021f: checks
c6e29035: shows [Ts As] (Tens Full over Eights)
1a2e021f: shows [5s 5d] (Pair of Tens and Pair of Eights)
*** SHOWDOWN ***
c6e29035 collected $0.95 from pot
*** SUMMARY ***
Total pot $1 | Rake $0.05 | Jackpot $0 | Bingo $0 | Fortune $0
Board [8h 8s Th Td 7h]
Seat 1: 13be7e67 (button) folded before Flop (didn't bet)
Seat 2: c6e29035 (small blind) showed [Ts As] and won ($0.95) with Tens Full over Eights
Seat 3: 1a2e021f (big blind) showed [5s 5d] and lost with Pair of Tens and Pair of Eights
Seat 4: Hero folded before Flop (didn't bet)
Seat 5: dcb5ac90 folded before Flop (didn't bet)
Seat 6: bc0c31ed folded before Flop (didn't bet)


Poker Hand #RC1452433056: Hold'em No Limit  ($0.05/$0.1) - 2023/04/05 13:16:29
Table 'RushAndCash2188316' 6-max Seat #1 is the button
Seat 1: da422675 ($15.87 in chips)
Seat 2: Hero ($10.76 in chips)
Seat 3: 6c03f971 ($27.88 in chips)
Seat 4: 6a26d243 ($10.17 in chips)
Seat 5: 8c7ced36 ($26 in chips)
Seat 6: e20b99c6 ($11.66 in chips)
Hero: posts small blind $0.05
6c03f971: posts big blind $0.1
*** HOLE CARDS ***
Dealt to da422675 
Dealt to Hero [Ah 6c]
Dealt to 6c03f971 
Dealt to 6a26d243 
Dealt to 8c7ced36 
Dealt to e20b99c6 
6a26d243: folds
8c7ced36: folds
e20b99c6: raises $0.2 to $0.3
da422675: folds
Hero: folds
6c03f971: folds
Uncalled bet ($0.2) returned to e20b99c6
*** SHOWDOWN ***
e20b99c6 collected $0.25 from pot
*** SUMMARY ***
Total pot $0.25 | Rake $0 | Jackpot $0 | Bingo $0 | Fortune $0
Seat 1: da422675 (button) folded before Flop (didn't bet)
Seat 2: Hero (small blind) folded before Flop
Seat 3: 6c03f971 (big blind) folded before Flop
Seat 4: 6a26d243 folded before Flop (didn't bet)
Seat 5: 8c7ced36 folded before Flop (didn't bet)
Seat 6: e20b99c6 collected ($0.25)


Poker Hand #RC1452433023: Hold'em No Limit  ($0.05/$0.1) - 2023/04/05 13:16:24
Table 'RushAndCash2188283' 6-max Seat #1 is the button
Seat 1: bc0c31ed ($15.36 in chips)
Seat 2: 733de302 ($19.63 in chips)
Seat 3: Hero ($10.86 in chips)
Seat 4: a0b0b7e6 ($13.1 in chips)
Seat 5: 8c73f4d4 ($15.09 in chips)
Seat 6: 4ceb413a ($16.92 in chips)
733de302: posts small blind $0.05
Hero: posts big blind $0.1
*** HOLE CARDS ***
Dealt to bc0c31ed 
Dealt to 733de302 
Dealt to Hero [4h 5d]
Dealt to a0b0b7e6 
Dealt to 8c73f4d4 
Dealt to 4ceb413a 
a0b0b7e6: folds
8c73f4d4: folds
4ceb413a: folds
bc0c31ed: folds
733de302: raises $0.2 to $0.3
Hero: folds
Uncalled bet ($0.2) returned to 733de302
*** SHOWDOWN ***
733de302 collected $0.2 from pot
*** SUMMARY ***
Total pot $0.2 | Rake $0 | Jackpot $0 | Bingo $0 | Fortune $0
Seat 1: bc0c31ed (button) folded before Flop (didn't bet)
Seat 2: 733de302 (small blind) collected ($0.2)
Seat 3: Hero (big blind) folded before Flop
Seat 4: a0b0b7e6 folded before Flop (didn't bet)
Seat 5: 8c73f4d4 folded before Flop (didn't bet)
Seat 6: 4ceb413a folded before Flop (didn't bet)


Poker Hand #RC1452432992: Hold'em No Limit  ($0.05/$0.1) - 2023/04/05 13:16:18
Table 'RushAndCash2188252' 6-max Seat #1 is the button
Seat 1: bce49022 ($10.04 in chips)
Seat 2: 669b9c6d ($29.41 in chips)
Seat 3: 9ab0afee ($8.87 in chips)
Seat 4: c4d36b00 ($10.52 in chips)
Seat 5: Hero ($10.86 in chips)
Seat 6: 242fabaf ($8.79 in chips)
669b9c6d: posts small blind $0.05
9ab0afee: posts big blind $0.1
*** HOLE CARDS ***
Dealt to bce49022 
Dealt to 669b9c6d 
Dealt to 9ab0afee 
Dealt to c4d36b00 
Dealt to Hero [4s Td]
Dealt to 242fabaf 
c4d36b00: folds
Hero: folds
242fabaf: folds
bce49022: raises $0.11 to $0.21
669b9c6d: calls $0.16
9ab0afee: folds
*** FLOP *** [7d Jd As]
669b9c6d: checks
bce49022: bets $0.2
669b9c6d: folds
Uncalled bet ($0.2) returned to bce49022
*** SHOWDOWN ***
bce49022 collected $0.5 from pot
*** SUMMARY ***
Total pot $0.52 | Rake $0.02 | Jackpot $0 | Bingo $0 | Fortune $0
Board [7d Jd As]
Seat 1: bce49022 (button) won ($0.5)
Seat 2: 669b9c6d (small blind) folded on the Flop
Seat 3: 9ab0afee (big blind) folded before Flop
Seat 4: c4d36b00 folded before Flop (didn't bet)
Seat 5: Hero folded before Flop (didn't bet)
Seat 6: 242fabaf folded before Flop (didn't bet)


Poker Hand #RC1452432652: Hold'em No Limit  ($0.05/$0.1) - 2023/04/05 13:15:26
Table 'RushAndCash2187912' 6-max Seat #1 is the button
Seat 1: 1bca587b ($3.17 in chips)
Seat 2: fb1fb165 ($9.43 in chips)
Seat 3: 669b9c6d ($29.14 in chips)
Seat 4: 5ab7fea3 ($9.45 in chips)
Seat 5: 60343243 ($11.59 in chips)
Seat 6: Hero ($11.11 in chips)
fb1fb165: posts small blind $0.05
669b9c6d: posts big blind $0.1
*** HOLE CARDS ***
Dealt to 1bca587b 
Dealt to fb1fb165 
Dealt to 669b9c6d 
Dealt to 5ab7fea3 
Dealt to 60343243 
Dealt to Hero [4s 4d]
5ab7fea3: folds
60343243: folds
Hero: raises $0.15 to $0.25
1bca587b: folds
fb1fb165: folds
669b9c6d: calls $0.15
*** FLOP *** [5c Jd 3c]
669b9c6d: checks
Hero: checks
*** TURN *** [5c Jd 3c] [Kd]
669b9c6d: bets $0.42
Hero: folds
Uncalled bet ($0.42) returned to 669b9c6d
*** SHOWDOWN ***
669b9c6d collected $0.52 from pot
*** SUMMARY ***
Total pot $0.55 | Rake $0.03 | Jackpot $0 | Bingo $0 | Fortune $0
Board [5c Jd 3c Kd]
Seat 1: 1bca587b (button) folded before Flop (didn't bet)
Seat 2: fb1fb165 (small blind) folded before Flop
Seat 3: 669b9c6d (big blind) won ($0.52)
Seat 4: 5ab7fea3 folded before Flop (didn't bet)
Seat 5: 60343243 folded before Flop (didn't bet)
Seat 6: Hero folded on the Turn


Poker Hand #RC1452432537: Hold'em No Limit  ($0.05/$0.1) - 2023/04/05 13:15:07
Table 'RushAndCash2187797' 6-max Seat #1 is the button
Seat 1: 4d43a4d ($13.88 in chips)
Seat 2: 8b9de425 ($21.03 in chips)
Seat 3: 17dba31a ($10.1 in chips)
Seat 4: ee2f7b5d ($8.07 in chips)
Seat 5: Hero ($10.96 in chips)
Seat 6: 7f8fb4ce ($12.33 in chips)
8b9de425: posts small blind $0.05
17dba31a: posts big blind $0.1
*** HOLE CARDS ***
Dealt to 4d43a4d 
Dealt to 8b9de425 
Dealt to 17dba31a 
Dealt to ee2f7b5d 
Dealt to Hero [4h Ah]
Dealt to 7f8fb4ce 
ee2f7b5d: folds
Hero: raises $0.15 to $0.25
7f8fb4ce: folds
4d43a4d: folds
8b9de425: folds
17dba31a: folds
Uncalled bet ($0.15) returned to Hero
*** SHOWDOWN ***
Hero collected $0.25 from pot
*** SUMMARY ***
Total pot $0.25 | Rake $0 | Jackpot $0 | Bingo $0 | Fortune $0
Seat 1: 4d43a4d (button) folded before Flop (didn't bet)
Seat 2: 8b9de425 (small blind) folded before Flop
Seat 3: 17dba31a (big blind) folded before Flop
Seat 4: ee2f7b5d folded before Flop (didn't bet)
Seat 5: Hero collected ($0.25)
Seat 6: 7f8fb4ce folded before Flop (didn't bet)


Poker Hand #RC1452432451: Hold'em No Limit  ($0.05/$0.1) - 2023/04/05 13:14:52
Table 'RushAndCash2187711' 6-max Seat #1 is the button
Seat 1: Hero ($10.96 in chips)
Seat 2: dc89e49e ($11.6 in chips)
Seat 3: 93dab03 ($13.39 in chips)
Seat 4: 3b0d8197 ($18.17 in chips)
Seat 5: ca94da5 ($14.77 in chips)
Seat 6: dc6e5cb3 ($7.09 in chips)
dc89e49e: posts small blind $0.05
93dab03: posts big blind $0.1
*** HOLE CARDS ***
Dealt to Hero [Qd 9h]
Dealt to dc89e49e 
Dealt to 93dab03 
Dealt to 3b0d8197 
Dealt to ca94da5 
Dealt to dc6e5cb3 
3b0d8197: folds
ca94da5: folds
dc6e5cb3: raises $0.12 to $0.22
Hero: folds
dc89e49e: folds
93dab03: folds
Uncalled bet ($0.12) returned to dc6e5cb3
*** SHOWDOWN ***
dc6e5cb3 collected $0.25 from pot
*** SUMMARY ***
Total pot $0.25 | Rake $0 | Jackpot $0 | Bingo $0 | Fortune $0
Seat 1: Hero (button) folded before Flop (didn't bet)
Seat 2: dc89e49e (small blind) folded before Flop
Seat 3: 93dab03 (big blind) folded before Flop
Seat 4: 3b0d8197 folded before Flop (didn't bet)
Seat 5: ca94da5 folded before Flop (didn't bet)
Seat 6: dc6e5cb3 collected ($0.25)


Poker Hand #RC1452432340: Hold'em No Limit  ($0.05/$0.1) - 2023/04/05 13:14:34
Table 'RushAndCash2187600' 6-max Seat #1 is the button
Seat 1: 7f0c6026 ($20.44 in chips)
Seat 2: Hero ($11.01 in chips)
Seat 3: 9ddd6bf7 ($12.57 in chips)
Seat 4: d503e0bb ($28.84 in chips)
Seat 5: 7f680ce3 ($19.11 in chips)
Seat 6: 8f9a1d8b ($13.53 in chips)
Hero: posts small blind $0.05
9ddd6bf7: posts big blind $0.1
*** HOLE CARDS ***
Dealt to 7f0c6026 
Dealt to Hero [2h 9h]
Dealt to 9ddd6bf7 
Dealt to d503e0bb 
Dealt to 7f680ce3 
Dealt to 8f9a1d8b 
d503e0bb: folds
7f680ce3: folds
8f9a1d8b: folds
7f0c6026: raises $0.2 to $0.3
Hero: folds
9ddd6bf7: calls $0.2
*** FLOP *** [9s 7h 5s]
9ddd6bf7: checks
7f0c6026: bets $0.33
9ddd6bf7: calls $0.33
*** TURN *** [9s 7h 5s] [8s]
9ddd6bf7: checks
7f0c6026: checks
*** RIVER *** [9s 7h 5s 8s] [6s]
9ddd6bf7: bets $0.44
7f0c6026: folds
Uncalled bet ($0.44) returned to 9ddd6bf7
*** SHOWDOWN ***
9ddd6bf7 collected $1.25 from pot
*** SUMMARY ***
Total pot $1.31 | Rake $0.06 | Jackpot $0 | Bingo $0 | Fortune $0
Board [9s 7h 5s 8s 6s]
Seat 1: 7f0c6026 (button) folded on the River
Seat 2: Hero (small blind) folded before Flop
Seat 3: 9ddd6bf7 (big blind) won ($1.25)
Seat 4: d503e0bb folded before Flop (didn't bet)
Seat 5: 7f680ce3 folded before Flop (didn't bet)
Seat 6: 8f9a1d8b folded before Flop (didn't bet)


Poker Hand #RC1452432265: Hold'em No Limit  ($0.05/$0.1) - 2023/04/05 13:14:21
Table 'RushAndCash2187525' 6-max Seat #1 is the button
Seat 1: ae8aae04 ($34.01 in chips)
Seat 2: ada2aece ($10.45 in chips)
Seat 3: Hero ($10.96 in chips)
Seat 4: a204d02d ($16.52 in chips)
Seat 5: 28ecf119 ($25.21 in chips)
Seat 6: 4b7b4553 ($10 in chips)
ada2aece: posts small blind $0.05
Hero: posts big blind $0.1
*** HOLE CARDS ***
Dealt to ae8aae04 
Dealt to ada2aece 
Dealt to Hero [3d Jh]
Dealt to a204d02d 
Dealt to 28ecf119 
Dealt to 4b7b4553 
a204d02d: folds
28ecf119: folds
4b7b4553: folds
ae8aae04: folds
ada2aece: folds
Uncalled bet ($0.05) returned to Hero
*** SHOWDOWN ***
Hero collected $0.1 from pot
*** SUMMARY ***
Total pot $0.1 | Rake $0 | Jackpot $0 | Bingo $0 | Fortune $0
Seat 1: ae8aae04 (button) folded before Flop (didn't bet)
Seat 2: ada2aece (small blind) folded before Flop
Seat 3: Hero (big blind) collected ($0.1)
Seat 4: a204d02d folded before Flop (didn't bet)
Seat 5: 28ecf119 folded before Flop (didn't bet)
Seat 6: 4b7b4553 folded before Flop (didn't bet)


Poker Hand #RC1452432000: Hold'em No Limit  ($0.05/$0.1) - 2023/04/05 13:13:40
Table 'RushAndCash2187260' 6-max Seat #1 is the button
Seat 1: b9432768 ($9.87 in chips)
Seat 2: 7febd80b ($22.61 in chips)
Seat 3: ae8aae04 ($33.73 in chips)
Seat 4: 14abe6f0 ($13.75 in chips)
Seat 5: 8c7ced36 ($24.64 in chips)
Seat 6: Hero ($11.21 in chips)
7febd80b: posts small blind $0.05
ae8aae04: posts big blind $0.1
*** HOLE CARDS ***
Dealt to b9432768 
Dealt to 7febd80b 
Dealt to ae8aae04 
Dealt to 14abe6f0 
Dealt to 8c7ced36 
Dealt to Hero [Ad 5s]
14abe6f0: folds
8c7ced36: folds
Hero: raises $0.15 to $0.25
b9432768: folds
7febd80b: folds
ae8aae04: calls $0.15
*** FLOP *** [Ks Qd 6h]
ae8aae04: checks
Hero: checks
*** TURN *** [Ks Qd 6h] [9h]
ae8aae04: bets $0.56
Hero: folds
Uncalled bet ($0.56) returned to ae8aae04
*** SHOWDOWN ***
ae8aae04 collected $0.53 from pot
*** SUMMARY ***
Total pot $0.55 | Rake $0.02 | Jackpot $0 | Bingo $0 | Fortune $0
Board [Ks Qd 6h 9h]
Seat 1: b9432768 (button) folded before Flop (didn't bet)
Seat 2: 7febd80b (small blind) folded before Flop
Seat 3: ae8aae04 (big blind) won ($0.53)
Seat 4: 14abe6f0 folded before Flop (didn't bet)
Seat 5: 8c7ced36 folded before Flop (didn't bet)
Seat 6: Hero folded on the Turn


Poker Hand #RC1452431898: Hold'em No Limit  ($0.05/$0.1) - 2023/04/05 13:13:24
Table 'RushAndCash2187158' 6-max Seat #1 is the button
Seat 1: 4dc8db36 ($8.07 in chips)
Seat 2: 8ab8363f ($11.28 in chips)
Seat 3: 8895fd41 ($10 in chips)
Seat 4: e50d28f8 ($8.39 in chips)
Seat 5: 86684520 ($10.15 in chips)
Seat 6: Hero ($11.06 in chips)
8ab8363f: posts small blind $0.05
8895fd41: posts big blind $0.1
*** HOLE CARDS ***
Dealt to 4dc8db36 
Dealt to 8ab8363f 
Dealt to 8895fd41 
Dealt to e50d28f8 
Dealt to 86684520 
Dealt to Hero [8c Kc]
e50d28f8: folds
86684520: folds
Hero: raises $0.15 to $0.25
4dc8db36: folds
8ab8363f: folds
8895fd41: folds
Uncalled bet ($0.15) returned to Hero
*** SHOWDOWN ***
Hero collected $0.25 from pot
*** SUMMARY ***
Total pot $0.25 | Rake $0 | Jackpot $0 | Bingo $0 | Fortune $0
Seat 1: 4dc8db36 (button) folded before Flop (didn't bet)
Seat 2: 8ab8363f (small blind) folded before Flop
Seat 3: 8895fd41 (big blind) folded before Flop
Seat 4: e50d28f8 folded before Flop (didn't bet)
Seat 5: 86684520 folded before Flop (didn't bet)
Seat 6: Hero collected ($0.25)


Poker Hand #RC1452431862: Hold'em No Limit  ($0.05/$0.1) - 2023/04/05 13:13:19
Table 'RushAndCash2187122' 6-max Seat #1 is the button
Seat 1: e5e62705 ($11.15 in chips)
Seat 2: 7bae7d33 ($9.84 in chips)
Seat 3: 918ecc00 ($10.05 in chips)
Seat 4: Hero ($11.06 in chips)
Seat 5: 7f680ce3 ($19.62 in chips)
Seat 6: 9c1f01c0 ($29.91 in chips)
7bae7d33: posts small blind $0.05
918ecc00: posts big blind $0.1
*** HOLE CARDS ***
Dealt to e5e62705 
Dealt to 7bae7d33 
Dealt to 918ecc00 
Dealt to Hero [Ah 7d]
Dealt to 7f680ce3 
Dealt to 9c1f01c0 
Hero: folds
7f680ce3: folds
9c1f01c0: raises $0.2 to $0.3
e5e62705: folds
7bae7d33: folds
918ecc00: calls $0.2
*** FLOP *** [Qh Th 3h]
918ecc00: checks
9c1f01c0: checks
*** TURN *** [Qh Th 3h] [4d]
918ecc00: checks
9c1f01c0: checks
*** RIVER *** [Qh Th 3h 4d] [3s]
918ecc00: checks
9c1f01c0: checks
918ecc00: shows [8s 8d] (Pair of Eights and Pair of Treys)
9c1f01c0: shows [4s As] (Pair of Fours and Pair of Treys)
*** SHOWDOWN ***
918ecc00 collected $0.62 from pot
*** SUMMARY ***
Total pot $0.65 | Rake $0.03 | Jackpot $0 | Bingo $0 | Fortune $0
Board [Qh Th 3h 4d 3s]
Seat 1: e5e62705 (button) folded before Flop (didn't bet)
Seat 2: 7bae7d33 (small blind) folded before Flop
Seat 3: 918ecc00 (big blind) showed [8s 8d] and won ($0.62) with Pair of Eights and Pair of Treys
Seat 4: Hero folded before Flop (didn't bet)
Seat 5: 7f680ce3 folded before Flop (didn't bet)
Seat 6: 9c1f01c0 showed [4s As] and lost with Pair of Fours and Pair of Treys


Poker Hand #RC1452431818: Hold'em No Limit  ($0.05/$0.1) - 2023/04/05 13:13:11
Table 'RushAndCash2187078' 6-max Seat #1 is the button
Seat 1: 2818609d ($10.9 in chips)
Seat 2: 4426b3d6 ($7.55 in chips)
Seat 3: db0398aa ($9.16 in chips)
Seat 4: ce4417fe ($9.58 in chips)
Seat 5: 79201ae0 ($11.84 in chips)
Seat 6: Hero ($11.06 in chips)
4426b3d6: posts small blind $0.05
db0398aa: posts big blind $0.1
*** HOLE CARDS ***
Dealt to 2818609d 
Dealt to 4426b3d6 
Dealt to db0398aa 
Dealt to ce4417fe 
Dealt to 79201ae0 
Dealt to Hero [9h 6c]
ce4417fe: raises $0.1 to $0.2
79201ae0: folds
Hero: folds
2818609d: folds
4426b3d6: folds
db0398aa: folds
Uncalled bet ($0.1) returned to ce4417fe
*** SHOWDOWN ***
ce4417fe collected $0.25 from pot
*** SUMMARY ***
Total pot $0.25 | Rake $0 | Jackpot $0 | Bingo $0 | Fortune $0
Seat 1: 2818609d (button) folded before Flop (didn't bet)
Seat 2: 4426b3d6 (small blind) folded before Flop
Seat 3: db0398aa (big blind) folded before Flop
Seat 4: ce4417fe collected ($0.25)
Seat 5: 79201ae0 folded before Flop (didn't bet)
Seat 6: Hero folded before Flop (didn't bet)


Poker Hand #RC1452431429: Hold'em No Limit  ($0.05/$0.1) - 2023/04/05 13:12:07
Table 'RushAndCash2186689' 6-max Seat #1 is the button
Seat 1: Hero ($8.95 in chips)
Seat 2: f9abd6ae ($45.39 in chips)
Seat 3: 4426b3d6 ($10 in chips)
Seat 4: 6b0a51ad ($27.24 in chips)
Seat 5: 8b7545ea ($10.43 in chips)
Seat 6: fff0e904 ($10.63 in chips)
f9abd6ae: posts small blind $0.05
4426b3d6: posts big blind $0.1
*** HOLE CARDS ***
Dealt to Hero [7c Ac]
Dealt to f9abd6ae 
Dealt to 4426b3d6 
Dealt to 6b0a51ad 
Dealt to 8b7545ea 
Dealt to fff0e904 
6b0a51ad: folds
8b7545ea: folds
fff0e904: folds
Hero: raises $0.15 to $0.25
f9abd6ae: folds
4426b3d6: calls $0.15
*** FLOP *** [2d 7s Th]
4426b3d6: checks
Hero: checks
*** TURN *** [2d 7s Th] [6s]
4426b3d6: bets $0.28
Hero: calls $0.28
*** RIVER *** [2d 7s Th 6s] [7h]
4426b3d6: bets $0.84
Hero: raises $1.08 to $1.92
4426b3d6: calls $1.08
Hero: shows [7c Ac] (Three Sevens)
4426b3d6: shows [9c Tc] (Pair of Tens and Pair of Sevens)
*** SHOWDOWN ***
Hero collected $4.56 from pot
*** SUMMARY ***
Total pot $4.95 | Rake $0.24 | Jackpot $0.15 | Bingo $0 | Fortune $0
Board [2d 7s Th 6s 7h]
Seat 1: Hero (button) showed [7c Ac] and won ($4.56) with Three Sevens
Seat 2: f9abd6ae (small blind) folded before Flop
Seat 3: 4426b3d6 (big blind) showed [9c Tc] and lost with Pair of Tens and Pair of Sevens
Seat 4: 6b0a51ad folded before Flop (didn't bet)
Seat 5: 8b7545ea folded before Flop (didn't bet)
Seat 6: fff0e904 folded before Flop (didn't bet)


Poker Hand #RC1452431281: Hold'em No Limit  ($0.05/$0.1) - 2023/04/05 13:11:44
Table 'RushAndCash2186541' 6-max Seat #1 is the button
Seat 1: 91e5b927 ($11 in chips)
Seat 2: Hero ($9 in chips)
Seat 3: 6b0a51ad ($27.34 in chips)
Seat 4: 78ed6935 ($10 in chips)
Seat 5: 4692d41d ($24.63 in chips)
Seat 6: fa134ace ($29.19 in chips)
Hero: posts small blind $0.05
6b0a51ad: posts big blind $0.1
*** HOLE CARDS ***
Dealt to 91e5b927 
Dealt to Hero [5c Qs]
Dealt to 6b0a51ad 
Dealt to 78ed6935 
Dealt to 4692d41d 
Dealt to fa134ace 
78ed6935: raises $0.15 to $0.25
4692d41d: folds
fa134ace: folds
91e5b927: folds
Hero: folds
6b0a51ad: folds
Uncalled bet ($0.15) returned to 78ed6935
*** SHOWDOWN ***
78ed6935 collected $0.25 from pot
*** SUMMARY ***
Total pot $0.25 | Rake $0 | Jackpot $0 | Bingo $0 | Fortune $0
Seat 1: 91e5b927 (button) folded before Flop (didn't bet)
Seat 2: Hero (small blind) folded before Flop
Seat 3: 6b0a51ad (big blind) folded before Flop
Seat 4: 78ed6935 collected ($0.25)
Seat 5: 4692d41d folded before Flop (didn't bet)
Seat 6: fa134ace folded before Flop (didn't bet)


Poker Hand #RC1452430954: Hold'em No Limit  ($0.05/$0.1) - 2023/04/05 13:10:54
Table 'RushAndCash2186214' 6-max Seat #1 is the button
Seat 1: d29cfd30 ($16.21 in chips)
Seat 2: 91e5b927 ($10 in chips)
Seat 3: Hero ($10 in chips)
Seat 4: a1308147 ($10 in chips)
Seat 5: 88616cc5 ($11.14 in chips)
Seat 6: 43ad394 ($13.53 in chips)
91e5b927: posts small blind $0.05
Hero: posts big blind $0.1
*** HOLE CARDS ***
Dealt to d29cfd30 
Dealt to 91e5b927 
Dealt to Hero [Tc Kc]
Dealt to a1308147 
Dealt to 88616cc5 
Dealt to 43ad394 
a1308147: folds
88616cc5: calls $0.1
43ad394: folds
d29cfd30: folds
91e5b927: raises $0.25 to $0.35
Hero: raises $0.65 to $1
88616cc5: folds
91e5b927: raises $1.44 to $2.44
Hero: folds
Uncalled bet ($1.44) returned to 91e5b927
*** SHOWDOWN ***
91e5b927 collected $2 from pot
*** SUMMARY ***
Total pot $2.1 | Rake $0.1 | Jackpot $0 | Bingo $0 | Fortune $0
Seat 1: d29cfd30 (button) folded before Flop (didn't bet)
Seat 2: 91e5b927 (small blind) collected ($2)
Seat 3: Hero (big blind) folded before Flop
Seat 4: a1308147 folded before Flop (didn't bet)
Seat 5: 88616cc5 folded before Flop
Seat 6: 43ad394 folded before Flop (didn't bet)


