Poker Hand #RC1456710940: Hold'em No Limit  ($0.05/$0.1) - 2023/04/07 12:12:37
Table 'RushAndCash3096200' 6-max Seat #1 is the button
Seat 1: 8082a4b1 ($10 in chips)
Seat 2: e0a60d64 ($11.56 in chips)
Seat 3: 21cd535a ($11.41 in chips)
Seat 4: Hero ($9.72 in chips)
Seat 5: f91c4083 ($12 in chips)
Seat 6: 637bb493 ($11.81 in chips)
e0a60d64: posts small blind $0.05
21cd535a: posts big blind $0.1
*** HOLE CARDS ***
Dealt to 8082a4b1 
Dealt to e0a60d64 
Dealt to 21cd535a 
Dealt to Hero [Ad 2h]
Dealt to f91c4083 
Dealt to 637bb493 
Hero: folds
f91c4083: folds
637bb493: folds
8082a4b1: raises $0.15 to $0.25
e0a60d64: folds
21cd535a: calls $0.15
*** FLOP *** [4s 3h 6d]
21cd535a: checks
8082a4b1: checks
*** TURN *** [4s 3h 6d] [9h]
21cd535a: bets $0.28
8082a4b1: raises $0.56 to $0.84
21cd535a: folds
Uncalled bet ($0.56) returned to 8082a4b1
*** SHOWDOWN ***
8082a4b1 collected $1.05 from pot
*** SUMMARY ***
Total pot $1.11 | Rake $0.06 | Jackpot $0 | Bingo $0 | Fortune $0
Board [4s 3h 6d 9h]
Seat 1: 8082a4b1 (button) won ($1.05)
Seat 2: e0a60d64 (small blind) folded before Flop
Seat 3: 21cd535a (big blind) folded on the Turn
Seat 4: Hero folded before Flop (didn't bet)
Seat 5: f91c4083 folded before Flop (didn't bet)
Seat 6: 637bb493 folded before Flop (didn't bet)


Poker Hand #RC1456710915: Hold'em No Limit  ($0.05/$0.1) - 2023/04/07 12:12:33
Table 'RushAndCash3096175' 6-max Seat #1 is the button
Seat 1: 14926ddc ($10.81 in chips)
Seat 2: Hero ($9.77 in chips)
Seat 3: 270691b1 ($17.4 in chips)
Seat 4: 43b88ab ($11.26 in chips)
Seat 5: 22ae3f19 ($10.65 in chips)
Seat 6: f91c4083 ($12 in chips)
Hero: posts small blind $0.05
270691b1: posts big blind $0.1
*** HOLE CARDS ***
Dealt to 14926ddc 
Dealt to Hero [Tc 5s]
Dealt to 270691b1 
Dealt to 43b88ab 
Dealt to 22ae3f19 
Dealt to f91c4083 
43b88ab: calls $0.1
22ae3f19: raises $0.35 to $0.45
f91c4083: folds
14926ddc: folds
Hero: folds
270691b1: folds
43b88ab: calls $0.35
*** FLOP *** [Th 9s Jh]
43b88ab: checks
22ae3f19: bets $0.53
43b88ab: calls $0.53
*** TURN *** [Th 9s Jh] [4s]
43b88ab: checks
22ae3f19: bets $1.06
43b88ab: folds
Uncalled bet ($1.06) returned to 22ae3f19
*** SHOWDOWN ***
22ae3f19 collected $2.01 from pot
*** SUMMARY ***
Total pot $2.11 | Rake $0.1 | Jackpot $0 | Bingo $0 | Fortune $0
Board [Th 9s Jh 4s]
Seat 1: 14926ddc (button) folded before Flop (didn't bet)
Seat 2: Hero (small blind) folded before Flop
Seat 3: 270691b1 (big blind) folded before Flop
Seat 4: 43b88ab folded on the Turn
Seat 5: 22ae3f19 won ($2.01)
Seat 6: f91c4083 folded before Flop (didn't bet)


Poker Hand #RC1456710846: Hold'em No Limit  ($0.05/$0.1) - 2023/04/07 12:12:23
Table 'RushAndCash3096106' 6-max Seat #1 is the button
Seat 1: 6e8cc59d ($11.92 in chips)
Seat 2: 862d0a9f ($10 in chips)
Seat 3: Hero ($9.87 in chips)
Seat 4: e1c51bf5 ($8.25 in chips)
Seat 5: 5eda2915 ($11.81 in chips)
Seat 6: 33ead1fe ($28.82 in chips)
862d0a9f: posts small blind $0.05
Hero: posts big blind $0.1
*** HOLE CARDS ***
Dealt to 6e8cc59d 
Dealt to 862d0a9f 
Dealt to Hero [8d Jd]
Dealt to e1c51bf5 
Dealt to 5eda2915 
Dealt to 33ead1fe 
e1c51bf5: folds
5eda2915: folds
33ead1fe: folds
6e8cc59d: raises $0.2 to $0.3
862d0a9f: folds
Hero: folds
Uncalled bet ($0.2) returned to 6e8cc59d
*** SHOWDOWN ***
6e8cc59d collected $0.25 from pot
*** SUMMARY ***
Total pot $0.25 | Rake $0 | Jackpot $0 | Bingo $0 | Fortune $0
Seat 1: 6e8cc59d (button) collected ($0.25)
Seat 2: 862d0a9f (small blind) folded before Flop
Seat 3: Hero (big blind) folded before Flop
Seat 4: e1c51bf5 folded before Flop (didn't bet)
Seat 5: 5eda2915 folded before Flop (didn't bet)
Seat 6: 33ead1fe folded before Flop (didn't bet)


Poker Hand #RC1456710807: Hold'em No Limit  ($0.05/$0.1) - 2023/04/07 12:12:16
Table 'RushAndCash3096067' 6-max Seat #1 is the button
Seat 1: 5853b768 ($10 in chips)
Seat 2: 4fdad372 ($37 in chips)
Seat 3: 8af26062 ($10.17 in chips)
Seat 4: Hero ($9.87 in chips)
Seat 5: 506155ff ($30.92 in chips)
Seat 6: ec55179 ($10.55 in chips)
4fdad372: posts small blind $0.05
8af26062: posts big blind $0.1
*** HOLE CARDS ***
Dealt to 5853b768 
Dealt to 4fdad372 
Dealt to 8af26062 
Dealt to Hero [6d Ts]
Dealt to 506155ff 
Dealt to ec55179 
Hero: folds
506155ff: folds
ec55179: folds
5853b768: folds
4fdad372: folds
Uncalled bet ($0.05) returned to 8af26062
*** SHOWDOWN ***
8af26062 collected $0.1 from pot
*** SUMMARY ***
Total pot $0.1 | Rake $0 | Jackpot $0 | Bingo $0 | Fortune $0
Seat 1: 5853b768 (button) folded before Flop (didn't bet)
Seat 2: 4fdad372 (small blind) folded before Flop
Seat 3: 8af26062 (big blind) collected ($0.1)
Seat 4: Hero folded before Flop (didn't bet)
Seat 5: 506155ff folded before Flop (didn't bet)
Seat 6: ec55179 folded before Flop (didn't bet)


Poker Hand #RC1456710782: Hold'em No Limit  ($0.05/$0.1) - 2023/04/07 12:12:12
Table 'RushAndCash3096042' 6-max Seat #1 is the button
Seat 1: 1c6ccedc ($32.86 in chips)
Seat 2: 35c564e1 ($26.3 in chips)
Seat 3: fb335bf6 ($14.41 in chips)
Seat 4: Hero ($9.87 in chips)
Seat 5: fc5401c2 ($44.86 in chips)
Seat 6: 7ac8a880 ($11.62 in chips)
35c564e1: posts small blind $0.05
fb335bf6: posts big blind $0.1
*** HOLE CARDS ***
Dealt to 1c6ccedc 
Dealt to 35c564e1 
Dealt to fb335bf6 
Dealt to Hero [7s 5c]
Dealt to fc5401c2 
Dealt to 7ac8a880 
Hero: folds
fc5401c2: folds
7ac8a880: folds
1c6ccedc: raises $0.25 to $0.35
35c564e1: calls $0.3
fb335bf6: folds
*** FLOP *** [3c 2c 9s]
35c564e1: checks
1c6ccedc: bets $0.4
35c564e1: calls $0.4
*** TURN *** [3c 2c 9s] [4s]
35c564e1: checks
1c6ccedc: bets $0.53
35c564e1: folds
Uncalled bet ($0.53) returned to 1c6ccedc
*** SHOWDOWN ***
1c6ccedc collected $1.52 from pot
*** SUMMARY ***
Total pot $1.6 | Rake $0.08 | Jackpot $0 | Bingo $0 | Fortune $0
Board [3c 2c 9s 4s]
Seat 1: 1c6ccedc (button) won ($1.52)
Seat 2: 35c564e1 (small blind) folded on the Turn
Seat 3: fb335bf6 (big blind) folded before Flop
Seat 4: Hero folded before Flop (didn't bet)
Seat 5: fc5401c2 folded before Flop (didn't bet)
Seat 6: 7ac8a880 folded before Flop (didn't bet)


Poker Hand #RC1456710743: Hold'em No Limit  ($0.05/$0.1) - 2023/04/07 12:12:05
Table 'RushAndCash3096003' 6-max Seat #1 is the button
Seat 1: 436a54b5 ($17.49 in chips)
Seat 2: 9bdf2ba9 ($10.1 in chips)
Seat 3: Hero ($9.97 in chips)
Seat 4: 7b2cf2e4 ($26.12 in chips)
Seat 5: fb335bf6 ($14.41 in chips)
Seat 6: 80e9392 ($25.11 in chips)
9bdf2ba9: posts small blind $0.05
Hero: posts big blind $0.1
*** HOLE CARDS ***
Dealt to 436a54b5 
Dealt to 9bdf2ba9 
Dealt to Hero [Jd 6d]
Dealt to 7b2cf2e4 
Dealt to fb335bf6 
Dealt to 80e9392 
7b2cf2e4: raises $0.13 to $0.23
fb335bf6: folds
80e9392: folds
436a54b5: calls $0.23
9bdf2ba9: folds
Hero: folds
*** FLOP *** [Kh 4c 3c]
7b2cf2e4: bets $0.21
436a54b5: folds
Uncalled bet ($0.21) returned to 7b2cf2e4
*** SHOWDOWN ***
7b2cf2e4 collected $0.58 from pot
*** SUMMARY ***
Total pot $0.61 | Rake $0.03 | Jackpot $0 | Bingo $0 | Fortune $0
Board [Kh 4c 3c]
Seat 1: 436a54b5 (button) folded on the Flop
Seat 2: 9bdf2ba9 (small blind) folded before Flop
Seat 3: Hero (big blind) folded before Flop
Seat 4: 7b2cf2e4 won ($0.58)
Seat 5: fb335bf6 folded before Flop (didn't bet)
Seat 6: 80e9392 folded before Flop (didn't bet)


Poker Hand #RC1456710661: Hold'em No Limit  ($0.05/$0.1) - 2023/04/07 12:11:50
Table 'RushAndCash3095921' 6-max Seat #1 is the button
Seat 1: 9bdf2ba9 ($10.2 in chips)
Seat 2: 24a0ed91 ($9.39 in chips)
Seat 3: 18499f3c ($10 in chips)
Seat 4: 360dea29 ($9.7 in chips)
Seat 5: Hero ($9.97 in chips)
Seat 6: 472b6990 ($13.92 in chips)
24a0ed91: posts small blind $0.05
18499f3c: posts big blind $0.1
*** HOLE CARDS ***
Dealt to 9bdf2ba9 
Dealt to 24a0ed91 
Dealt to 18499f3c 
Dealt to 360dea29 
Dealt to Hero [As 2c]
Dealt to 472b6990 
360dea29: folds
Hero: folds
472b6990: folds
9bdf2ba9: folds
24a0ed91: raises $0.2 to $0.3
18499f3c: folds
Uncalled bet ($0.2) returned to 24a0ed91
*** SHOWDOWN ***
24a0ed91 collected $0.2 from pot
*** SUMMARY ***
Total pot $0.2 | Rake $0 | Jackpot $0 | Bingo $0 | Fortune $0
Seat 1: 9bdf2ba9 (button) folded before Flop (didn't bet)
Seat 2: 24a0ed91 (small blind) collected ($0.2)
Seat 3: 18499f3c (big blind) folded before Flop
Seat 4: 360dea29 folded before Flop (didn't bet)
Seat 5: Hero folded before Flop (didn't bet)
Seat 6: 472b6990 folded before Flop (didn't bet)


Poker Hand #RC1456710619: Hold'em No Limit  ($0.05/$0.1) - 2023/04/07 12:11:43
Table 'RushAndCash3095879' 6-max Seat #1 is the button
Seat 1: Hero ($9.97 in chips)
Seat 2: 45a1965e ($11.3 in chips)
Seat 3: b823bacd ($10 in chips)
Seat 4: 88f21ab0 ($3.29 in chips)
Seat 5: a0793553 ($20.67 in chips)
Seat 6: 4c5586e3 ($15.38 in chips)
45a1965e: posts small blind $0.05
b823bacd: posts big blind $0.1
*** HOLE CARDS ***
Dealt to Hero [6h Jc]
Dealt to 45a1965e 
Dealt to b823bacd 
Dealt to 88f21ab0 
Dealt to a0793553 
Dealt to 4c5586e3 
88f21ab0: folds
a0793553: folds
4c5586e3: folds
Hero: folds
45a1965e: raises $0.2 to $0.3
b823bacd: calls $0.2
*** FLOP *** [3s 8s 2s]
45a1965e: checks
b823bacd: checks
*** TURN *** [3s 8s 2s] [6d]
45a1965e: bets $0.4
b823bacd: folds
Uncalled bet ($0.4) returned to 45a1965e
*** SHOWDOWN ***
45a1965e collected $0.57 from pot
*** SUMMARY ***
Total pot $0.6 | Rake $0.03 | Jackpot $0 | Bingo $0 | Fortune $0
Board [3s 8s 2s 6d]
Seat 1: Hero (button) folded before Flop (didn't bet)
Seat 2: 45a1965e (small blind) won ($0.57)
Seat 3: b823bacd (big blind) folded on the Turn
Seat 4: 88f21ab0 folded before Flop (didn't bet)
Seat 5: a0793553 folded before Flop (didn't bet)
Seat 6: 4c5586e3 folded before Flop (didn't bet)


Poker Hand #RC1456710549: Hold'em No Limit  ($0.05/$0.1) - 2023/04/07 12:11:32
Table 'RushAndCash3095809' 6-max Seat #1 is the button
Seat 1: fa9894ed ($10 in chips)
Seat 2: Hero ($10.02 in chips)
Seat 3: 70d1c97f ($16.77 in chips)
Seat 4: d1527f03 ($9.85 in chips)
Seat 5: ebb5df26 ($9.78 in chips)
Seat 6: b69c5e3a ($18.84 in chips)
Hero: posts small blind $0.05
70d1c97f: posts big blind $0.1
*** HOLE CARDS ***
Dealt to fa9894ed 
Dealt to Hero [Qd 2s]
Dealt to 70d1c97f 
Dealt to d1527f03 
Dealt to ebb5df26 
Dealt to b69c5e3a 
d1527f03: folds
ebb5df26: folds
b69c5e3a: raises $0.15 to $0.25
fa9894ed: folds
Hero: folds
70d1c97f: folds
Uncalled bet ($0.15) returned to b69c5e3a
*** SHOWDOWN ***
b69c5e3a collected $0.25 from pot
*** SUMMARY ***
Total pot $0.25 | Rake $0 | Jackpot $0 | Bingo $0 | Fortune $0
Seat 1: fa9894ed (button) folded before Flop (didn't bet)
Seat 2: Hero (small blind) folded before Flop
Seat 3: 70d1c97f (big blind) folded before Flop
Seat 4: d1527f03 folded before Flop (didn't bet)
Seat 5: ebb5df26 folded before Flop (didn't bet)
Seat 6: b69c5e3a collected ($0.25)


Poker Hand #RC1456710523: Hold'em No Limit  ($0.05/$0.1) - 2023/04/07 12:11:27
Table 'RushAndCash3095783' 6-max Seat #1 is the button
Seat 1: 80e9392 ($25.16 in chips)
Seat 2: 33ead1fe ($29.17 in chips)
Seat 3: 91e92bf1 ($13.04 in chips)
Seat 4: 22090ba9 ($10.73 in chips)
Seat 5: Hero ($10.02 in chips)
Seat 6: 4cb23ece ($10.27 in chips)
33ead1fe: posts small blind $0.05
91e92bf1: posts big blind $0.1
*** HOLE CARDS ***
Dealt to 80e9392 
Dealt to 33ead1fe 
Dealt to 91e92bf1 
Dealt to 22090ba9 
Dealt to Hero [Th 7h]
Dealt to 4cb23ece 
22090ba9: folds
Hero: folds
4cb23ece: raises $0.1 to $0.2
80e9392: folds
33ead1fe: folds
91e92bf1: folds
Uncalled bet ($0.1) returned to 4cb23ece
*** SHOWDOWN ***
4cb23ece collected $0.25 from pot
*** SUMMARY ***
Total pot $0.25 | Rake $0 | Jackpot $0 | Bingo $0 | Fortune $0
Seat 1: 80e9392 (button) folded before Flop (didn't bet)
Seat 2: 33ead1fe (small blind) folded before Flop
Seat 3: 91e92bf1 (big blind) folded before Flop
Seat 4: 22090ba9 folded before Flop (didn't bet)
Seat 5: Hero folded before Flop (didn't bet)
Seat 6: 4cb23ece collected ($0.25)


Poker Hand #RC1456710082: Hold'em No Limit  ($0.05/$0.1) - 2023/04/07 12:10:10
Table 'RushAndCash3095342' 6-max Seat #1 is the button
Seat 1: Hero ($8.87 in chips)
Seat 2: 2ffcaaac ($11.15 in chips)
Seat 3: 33ead1fe ($30.39 in chips)
Seat 4: 89d40773 ($10 in chips)
Seat 5: e0a60d64 ($11.65 in chips)
Seat 6: 1905e80a ($17.64 in chips)
2ffcaaac: posts small blind $0.05
33ead1fe: posts big blind $0.1
*** HOLE CARDS ***
Dealt to Hero [As 2s]
Dealt to 2ffcaaac 
Dealt to 33ead1fe 
Dealt to 89d40773 
Dealt to e0a60d64 
Dealt to 1905e80a 
89d40773: folds
e0a60d64: folds
1905e80a: folds
Hero: raises $0.15 to $0.25
2ffcaaac: folds
33ead1fe: calls $0.15
*** FLOP *** [Qs 5h 4s]
33ead1fe: checks
Hero: bets $0.42
33ead1fe: calls $0.42
*** TURN *** [Qs 5h 4s] [9s]
33ead1fe: checks
Hero: bets $0.55
33ead1fe: calls $0.55
*** RIVER *** [Qs 5h 4s 9s] [3s]
33ead1fe: checks
Hero: bets $1.25
33ead1fe: folds
Uncalled bet ($1.25) returned to Hero
*** SHOWDOWN ***
Hero collected $2.37 from pot
*** SUMMARY ***
Total pot $2.49 | Rake $0.12 | Jackpot $0 | Bingo $0 | Fortune $0
Board [Qs 5h 4s 9s 3s]
Seat 1: Hero (button) won ($2.37)
Seat 2: 2ffcaaac (small blind) folded before Flop
Seat 3: 33ead1fe (big blind) folded on the River
Seat 4: 89d40773 folded before Flop (didn't bet)
Seat 5: e0a60d64 folded before Flop (didn't bet)
Seat 6: 1905e80a folded before Flop (didn't bet)


Poker Hand #RC1456710037: Hold'em No Limit  ($0.05/$0.1) - 2023/04/07 12:10:03
Table 'RushAndCash3095297' 6-max Seat #1 is the button
Seat 1: be697cc5 ($23.92 in chips)
Seat 2: Hero ($8.92 in chips)
Seat 3: bb24ba4b ($13.69 in chips)
Seat 4: 4587a60d ($15.1 in chips)
Seat 5: 33ead1fe ($30.39 in chips)
Seat 6: 141276ed ($15.37 in chips)
Hero: posts small blind $0.05
bb24ba4b: posts big blind $0.1
*** HOLE CARDS ***
Dealt to be697cc5 
Dealt to Hero [Qd 5h]
Dealt to bb24ba4b 
Dealt to 4587a60d 
Dealt to 33ead1fe 
Dealt to 141276ed 
4587a60d: folds
33ead1fe: folds
141276ed: raises $0.15 to $0.25
be697cc5: folds
Hero: folds
bb24ba4b: folds
Uncalled bet ($0.15) returned to 141276ed
*** SHOWDOWN ***
141276ed collected $0.25 from pot
*** SUMMARY ***
Total pot $0.25 | Rake $0 | Jackpot $0 | Bingo $0 | Fortune $0
Seat 1: be697cc5 (button) folded before Flop (didn't bet)
Seat 2: Hero (small blind) folded before Flop
Seat 3: bb24ba4b (big blind) folded before Flop
Seat 4: 4587a60d folded before Flop (didn't bet)
Seat 5: 33ead1fe folded before Flop (didn't bet)
Seat 6: 141276ed collected ($0.25)


Poker Hand #RC1456709933: Hold'em No Limit  ($0.05/$0.1) - 2023/04/07 12:09:45
Table 'RushAndCash3095193' 6-max Seat #1 is the button
Seat 1: bf6f1943 ($10 in chips)
Seat 2: ee3612a ($10.92 in chips)
Seat 3: 8d9fa47b ($10 in chips)
Seat 4: 1ce003d6 ($35.92 in chips)
Seat 5: Hero ($8.92 in chips)
Seat 6: a59e0e84 ($6.46 in chips)
ee3612a: posts small blind $0.05
8d9fa47b: posts big blind $0.1
*** HOLE CARDS ***
Dealt to bf6f1943 
Dealt to ee3612a 
Dealt to 8d9fa47b 
Dealt to 1ce003d6 
Dealt to Hero [8h 4s]
Dealt to a59e0e84 
1ce003d6: folds
Hero: folds
a59e0e84: folds
bf6f1943: folds
ee3612a: folds
Uncalled bet ($0.05) returned to 8d9fa47b
*** SHOWDOWN ***
8d9fa47b collected $0.1 from pot
*** SUMMARY ***
Total pot $0.1 | Rake $0 | Jackpot $0 | Bingo $0 | Fortune $0
Seat 1: bf6f1943 (button) folded before Flop (didn't bet)
Seat 2: ee3612a (small blind) folded before Flop
Seat 3: 8d9fa47b (big blind) collected ($0.1)
Seat 4: 1ce003d6 folded before Flop (didn't bet)
Seat 5: Hero folded before Flop (didn't bet)
Seat 6: a59e0e84 folded before Flop (didn't bet)


Poker Hand #RC1456709868: Hold'em No Limit  ($0.05/$0.1) - 2023/04/07 12:09:33
Table 'RushAndCash3095128' 6-max Seat #1 is the button
Seat 1: Hero ($8.92 in chips)
Seat 2: 67d9a986 ($10 in chips)
Seat 3: 23cb619e ($23.27 in chips)
Seat 4: db6d2eaf ($14.73 in chips)
Seat 5: 143ed893 ($10.32 in chips)
Seat 6: c1f2cb80 ($11.08 in chips)
67d9a986: posts small blind $0.05
23cb619e: posts big blind $0.1
*** HOLE CARDS ***
Dealt to Hero [8c 5s]
Dealt to 67d9a986 
Dealt to 23cb619e 
Dealt to db6d2eaf 
Dealt to 143ed893 
Dealt to c1f2cb80 
db6d2eaf: folds
143ed893: folds
c1f2cb80: raises $0.1 to $0.2
Hero: folds
67d9a986: folds
23cb619e: raises $0.8 to $1
c1f2cb80: raises $1.4 to $2.4
23cb619e: calls $1.4
*** FLOP *** [Jd 2h Ts]
23cb619e: checks
c1f2cb80: checks
*** TURN *** [Jd 2h Ts] [2c]
23cb619e: bets $2.43
c1f2cb80: folds
Uncalled bet ($2.43) returned to 23cb619e
*** SHOWDOWN ***
23cb619e collected $4.47 from pot
*** SUMMARY ***
Total pot $4.85 | Rake $0.23 | Jackpot $0.15 | Bingo $0 | Fortune $0
Board [Jd 2h Ts 2c]
Seat 1: Hero (button) folded before Flop (didn't bet)
Seat 2: 67d9a986 (small blind) folded before Flop
Seat 3: 23cb619e (big blind) won ($4.47)
Seat 4: db6d2eaf folded before Flop (didn't bet)
Seat 5: 143ed893 folded before Flop (didn't bet)
Seat 6: c1f2cb80 folded on the Turn


Poker Hand #RC1456709789: Hold'em No Limit  ($0.05/$0.1) - 2023/04/07 12:09:18
Table 'RushAndCash3095049' 6-max Seat #1 is the button
Seat 1: 56ae0f09 ($4.68 in chips)
Seat 2: 2f5487fe ($16.68 in chips)
Seat 3: 2ffcaaac ($11.25 in chips)
Seat 4: bccaaaba ($6.1 in chips)
Seat 5: cca05e35 ($10.15 in chips)
Seat 6: Hero ($8.92 in chips)
2f5487fe: posts small blind $0.05
2ffcaaac: posts big blind $0.1
*** HOLE CARDS ***
Dealt to 56ae0f09 
Dealt to 2f5487fe 
Dealt to 2ffcaaac 
Dealt to bccaaaba 
Dealt to cca05e35 
Dealt to Hero [5c 2h]
bccaaaba: raises $0.2 to $0.3
cca05e35: raises $0.5 to $0.8
Hero: folds
56ae0f09: folds
2f5487fe: folds
2ffcaaac: folds
bccaaaba: calls $0.5
*** FLOP *** [Qh 9s Tc]
bccaaaba: checks
cca05e35: bets $0.4
bccaaaba: calls $0.4
*** TURN *** [Qh 9s Tc] [6c]
bccaaaba: checks
cca05e35: bets $1.5
bccaaaba: raises $3.4 to $4.9 and is all-in
cca05e35: calls $3.4
bccaaaba: shows [Js Kh] (Kings-High Straight)
cca05e35: shows [Qs Ah] (Pair of Queens)
*** RIVER *** [Qh 9s Tc 6c] [2s]
*** SHOWDOWN ***
bccaaaba collected $11.9 from pot
*** SUMMARY ***
Total pot $12.35 | Rake $0.3 | Jackpot $0.15 | Bingo $0 | Fortune $0
Board [Qh 9s Tc 6c 2s]
Seat 1: 56ae0f09 (button) folded before Flop (didn't bet)
Seat 2: 2f5487fe (small blind) folded before Flop
Seat 3: 2ffcaaac (big blind) folded before Flop
Seat 4: bccaaaba showed [Js Kh] and won ($11.9) with Kings-High Straight
Seat 5: cca05e35 showed [Qs Ah] and lost with Pair of Queens
Seat 6: Hero folded before Flop (didn't bet)


Poker Hand #RC1456709413: Hold'em No Limit  ($0.05/$0.1) - 2023/04/07 12:08:14
Table 'RushAndCash3094673' 6-max Seat #1 is the button
Seat 1: cc47e618 ($10.63 in chips)
Seat 2: 69e10184 ($10.2 in chips)
Seat 3: Hero ($7.17 in chips)
Seat 4: 56ae0f09 ($6.72 in chips)
Seat 5: 256287a6 ($12.37 in chips)
Seat 6: c699478f ($14.64 in chips)
69e10184: posts small blind $0.05
Hero: posts big blind $0.1
*** HOLE CARDS ***
Dealt to cc47e618 
Dealt to 69e10184 
Dealt to Hero [Jd Jc]
Dealt to 56ae0f09 
Dealt to 256287a6 
Dealt to c699478f 
56ae0f09: raises $0.1 to $0.2
256287a6: folds
c699478f: folds
cc47e618: folds
69e10184: folds
Hero: raises $0.6 to $0.8
56ae0f09: calls $0.6
*** FLOP *** [Ac 4s 4h]
Hero: checks
56ae0f09: checks
*** TURN *** [Ac 4s 4h] [As]
Hero: checks
56ae0f09: bets $1.24
Hero: calls $1.24
*** RIVER *** [Ac 4s 4h As] [3s]
Hero: checks
56ae0f09: checks
Hero: shows [Jd Jc] (Pair of Aces and Pair of Jacks)
56ae0f09: shows [Ks Th] (Pair of Aces and Pair of Fours)
*** SHOWDOWN ***
Hero collected $3.79 from pot
*** SUMMARY ***
Total pot $4.13 | Rake $0.19 | Jackpot $0.15 | Bingo $0 | Fortune $0
Board [Ac 4s 4h As 3s]
Seat 1: cc47e618 (button) folded before Flop (didn't bet)
Seat 2: 69e10184 (small blind) folded before Flop
Seat 3: Hero (big blind) showed [Jd Jc] and won ($3.79) with Pair of Aces and Pair of Jacks
Seat 4: 56ae0f09 showed [Ks Th] and lost with Pair of Aces and Pair of Fours
Seat 5: 256287a6 folded before Flop (didn't bet)
Seat 6: c699478f folded before Flop (didn't bet)


Poker Hand #RC1456709340: Hold'em No Limit  ($0.05/$0.1) - 2023/04/07 12:08:03
Table 'RushAndCash3094600' 6-max Seat #1 is the button
Seat 1: a25be7cf ($12.29 in chips)
Seat 2: 94e0f9ff ($14.62 in chips)
Seat 3: 85659f66 ($11.33 in chips)
Seat 4: 6fe682f8 ($12.44 in chips)
Seat 5: 1ee63112 ($10 in chips)
Seat 6: Hero ($7.17 in chips)
94e0f9ff: posts small blind $0.05
85659f66: posts big blind $0.1
*** HOLE CARDS ***
Dealt to a25be7cf 
Dealt to 94e0f9ff 
Dealt to 85659f66 
Dealt to 6fe682f8 
Dealt to 1ee63112 
Dealt to Hero [Jc Td]
6fe682f8: raises $0.1 to $0.2
1ee63112: folds
Hero: folds
a25be7cf: folds
94e0f9ff: folds
85659f66: calls $0.1
*** FLOP *** [8h 2d 5d]
85659f66: checks
6fe682f8: bets $0.15
85659f66: folds
Uncalled bet ($0.15) returned to 6fe682f8
*** SHOWDOWN ***
6fe682f8 collected $0.43 from pot
*** SUMMARY ***
Total pot $0.45 | Rake $0.02 | Jackpot $0 | Bingo $0 | Fortune $0
Board [8h 2d 5d]
Seat 1: a25be7cf (button) folded before Flop (didn't bet)
Seat 2: 94e0f9ff (small blind) folded before Flop
Seat 3: 85659f66 (big blind) folded on the Flop
Seat 4: 6fe682f8 won ($0.43)
Seat 5: 1ee63112 folded before Flop (didn't bet)
Seat 6: Hero folded before Flop (didn't bet)


Poker Hand #RC1456709318: Hold'em No Limit  ($0.05/$0.1) - 2023/04/07 12:07:59
Table 'RushAndCash3094578' 6-max Seat #1 is the button
Seat 1: af876f7b ($10.49 in chips)
Seat 2: 222debf1 ($5.57 in chips)
Seat 3: 63bf279 ($9.51 in chips)
Seat 4: 238bed03 ($10 in chips)
Seat 5: c2ba5e79 ($12.47 in chips)
Seat 6: Hero ($7.17 in chips)
222debf1: posts small blind $0.05
63bf279: posts big blind $0.1
*** HOLE CARDS ***
Dealt to af876f7b 
Dealt to 222debf1 
Dealt to 63bf279 
Dealt to 238bed03 
Dealt to c2ba5e79 
Dealt to Hero [3c 6c]
238bed03: folds
c2ba5e79: raises $0.15 to $0.25
Hero: folds
af876f7b: folds
222debf1: calls $0.2
63bf279: folds
*** FLOP *** [7d Tc 4h]
222debf1: checks
c2ba5e79: bets $0.3
222debf1: calls $0.3
*** TURN *** [7d Tc 4h] [3h]
222debf1: checks
c2ba5e79: bets $0.9
222debf1: calls $0.9
*** RIVER *** [7d Tc 4h 3h] [8s]
222debf1: checks
c2ba5e79: bets $11.02 and is all-in
222debf1: calls $4.12 and is all-in
Uncalled bet ($6.9) returned to c2ba5e79
c2ba5e79: shows [Qc Qh] (Pair of Queens)
222debf1: shows [6s 8h] (Pair of Eights)
*** SHOWDOWN ***
c2ba5e79 collected $10.79 from pot
*** SUMMARY ***
Total pot $11.24 | Rake $0.3 | Jackpot $0.15 | Bingo $0 | Fortune $0
Board [7d Tc 4h 3h 8s]
Seat 1: af876f7b (button) folded before Flop (didn't bet)
Seat 2: 222debf1 (small blind) showed [6s 8h] and lost with Pair of Eights
Seat 3: 63bf279 (big blind) folded before Flop
Seat 4: 238bed03 folded before Flop (didn't bet)
Seat 5: c2ba5e79 showed [Qc Qh] and won ($10.79) with Pair of Queens
Seat 6: Hero folded before Flop (didn't bet)


Poker Hand #RC1456709187: Hold'em No Limit  ($0.05/$0.1) - 2023/04/07 12:07:38
Table 'RushAndCash3094447' 6-max Seat #1 is the button
Seat 1: 270691b1 ($15.95 in chips)
Seat 2: 1ee63112 ($10 in chips)
Seat 3: 3b52b675 ($13.17 in chips)
Seat 4: 7ac8a880 ($10.64 in chips)
Seat 5: 59f5b19a ($10.29 in chips)
Seat 6: Hero ($7.02 in chips)
1ee63112: posts small blind $0.05
3b52b675: posts big blind $0.1
*** HOLE CARDS ***
Dealt to 270691b1 
Dealt to 1ee63112 
Dealt to 3b52b675 
Dealt to 7ac8a880 
Dealt to 59f5b19a 
Dealt to Hero [2h 2c]
7ac8a880: folds
59f5b19a: folds
Hero: raises $0.1 to $0.2
270691b1: folds
1ee63112: folds
3b52b675: folds
Uncalled bet ($0.1) returned to Hero
*** SHOWDOWN ***
Hero collected $0.25 from pot
*** SUMMARY ***
Total pot $0.25 | Rake $0 | Jackpot $0 | Bingo $0 | Fortune $0
Seat 1: 270691b1 (button) folded before Flop (didn't bet)
Seat 2: 1ee63112 (small blind) folded before Flop
Seat 3: 3b52b675 (big blind) folded before Flop
Seat 4: 7ac8a880 folded before Flop (didn't bet)
Seat 5: 59f5b19a folded before Flop (didn't bet)
Seat 6: Hero collected ($0.25)


Poker Hand #RC1456709124: Hold'em No Limit  ($0.05/$0.1) - 2023/04/07 12:07:26
Table 'RushAndCash3094384' 6-max Seat #1 is the button
Seat 1: 1905e80a ($17.5 in chips)
Seat 2: 576c653e ($9.97 in chips)
Seat 3: Hero ($6.97 in chips)
Seat 4: c1f2cb80 ($11.08 in chips)
Seat 5: 6c85eebb ($10 in chips)
Seat 6: c7f548fc ($10 in chips)
576c653e: posts small blind $0.05
Hero: posts big blind $0.1
*** HOLE CARDS ***
Dealt to 1905e80a 
Dealt to 576c653e 
Dealt to Hero [6s Td]
Dealt to c1f2cb80 
Dealt to 6c85eebb 
Dealt to c7f548fc 
c1f2cb80: folds
6c85eebb: folds
c7f548fc: folds
1905e80a: folds
576c653e: folds
Uncalled bet ($0.05) returned to Hero
*** SHOWDOWN ***
Hero collected $0.1 from pot
*** SUMMARY ***
Total pot $0.1 | Rake $0 | Jackpot $0 | Bingo $0 | Fortune $0
Seat 1: 1905e80a (button) folded before Flop (didn't bet)
Seat 2: 576c653e (small blind) folded before Flop
Seat 3: Hero (big blind) collected ($0.1)
Seat 4: c1f2cb80 folded before Flop (didn't bet)
Seat 5: 6c85eebb folded before Flop (didn't bet)
Seat 6: c7f548fc folded before Flop (didn't bet)


Poker Hand #RC1456708999: Hold'em No Limit  ($0.05/$0.1) - 2023/04/07 12:07:04
Table 'RushAndCash3094259' 6-max Seat #1 is the button
Seat 1: 352d4af ($16.1 in chips)
Seat 2: bf6f1943 ($8.41 in chips)
Seat 3: 1516c360 ($12.32 in chips)
Seat 4: 3af4b087 ($22.84 in chips)
Seat 5: 397064e9 ($13.11 in chips)
Seat 6: Hero ($6.82 in chips)
bf6f1943: posts small blind $0.05
1516c360: posts big blind $0.1
*** HOLE CARDS ***
Dealt to 352d4af 
Dealt to bf6f1943 
Dealt to 1516c360 
Dealt to 3af4b087 
Dealt to 397064e9 
Dealt to Hero [7d Ad]
3af4b087: folds
397064e9: folds
Hero: raises $0.15 to $0.25
352d4af: folds
bf6f1943: folds
1516c360: folds
Uncalled bet ($0.15) returned to Hero
*** SHOWDOWN ***
Hero collected $0.25 from pot
*** SUMMARY ***
Total pot $0.25 | Rake $0 | Jackpot $0 | Bingo $0 | Fortune $0
Seat 1: 352d4af (button) folded before Flop (didn't bet)
Seat 2: bf6f1943 (small blind) folded before Flop
Seat 3: 1516c360 (big blind) folded before Flop
Seat 4: 3af4b087 folded before Flop (didn't bet)
Seat 5: 397064e9 folded before Flop (didn't bet)
Seat 6: Hero collected ($0.25)


Poker Hand #RC1456708691: Hold'em No Limit  ($0.05/$0.1) - 2023/04/07 12:06:13
Table 'RushAndCash3093951' 6-max Seat #1 is the button
Seat 1: Hero ($7.07 in chips)
Seat 2: 2f04a40 ($12.07 in chips)
Seat 3: 3af4b087 ($22.56 in chips)
Seat 4: 35c564e1 ($28.02 in chips)
Seat 5: 4d7054f9 ($10.15 in chips)
Seat 6: 4445cc3a ($8.71 in chips)
2f04a40: posts small blind $0.05
3af4b087: posts big blind $0.1
*** HOLE CARDS ***
Dealt to Hero [Kc Th]
Dealt to 2f04a40 
Dealt to 3af4b087 
Dealt to 35c564e1 
Dealt to 4d7054f9 
Dealt to 4445cc3a 
35c564e1: folds
4d7054f9: folds
4445cc3a: folds
Hero: raises $0.15 to $0.25
2f04a40: folds
3af4b087: raises $0.55 to $0.8
Hero: folds
Uncalled bet ($0.55) returned to 3af4b087
*** SHOWDOWN ***
3af4b087 collected $0.53 from pot
*** SUMMARY ***
Total pot $0.55 | Rake $0.02 | Jackpot $0 | Bingo $0 | Fortune $0
Seat 1: Hero (button) folded before Flop
Seat 2: 2f04a40 (small blind) folded before Flop
Seat 3: 3af4b087 (big blind) collected ($0.53)
Seat 4: 35c564e1 folded before Flop (didn't bet)
Seat 5: 4d7054f9 folded before Flop (didn't bet)
Seat 6: 4445cc3a folded before Flop (didn't bet)


Poker Hand #RC1456708591: Hold'em No Limit  ($0.05/$0.1) - 2023/04/07 12:05:57
Table 'RushAndCash3093851' 6-max Seat #1 is the button
Seat 1: 2f140b63 ($21.1 in chips)
Seat 2: Hero ($7.12 in chips)
Seat 3: 5d5efd7b ($19.59 in chips)
Seat 4: a37e35d5 ($10 in chips)
Seat 5: 7cab4739 ($15.98 in chips)
Seat 6: 65f22aee ($21.41 in chips)
Hero: posts small blind $0.05
5d5efd7b: posts big blind $0.1
*** HOLE CARDS ***
Dealt to 2f140b63 
Dealt to Hero [8s 5d]
Dealt to 5d5efd7b 
Dealt to a37e35d5 
Dealt to 7cab4739 
Dealt to 65f22aee 
a37e35d5: folds
7cab4739: folds
65f22aee: folds
2f140b63: raises $0.15 to $0.25
Hero: folds
5d5efd7b: raises $0.55 to $0.8
2f140b63: calls $0.55
*** FLOP *** [8h Qc Ah]
5d5efd7b: bets $0.55
2f140b63: raises $1.38 to $1.93
5d5efd7b: folds
Uncalled bet ($1.38) returned to 2f140b63
*** SHOWDOWN ***
2f140b63 collected $2.62 from pot
*** SUMMARY ***
Total pot $2.75 | Rake $0.13 | Jackpot $0 | Bingo $0 | Fortune $0
Board [8h Qc Ah]
Seat 1: 2f140b63 (button) won ($2.62)
Seat 2: Hero (small blind) folded before Flop
Seat 3: 5d5efd7b (big blind) folded on the Flop
Seat 4: a37e35d5 folded before Flop (didn't bet)
Seat 5: 7cab4739 folded before Flop (didn't bet)
Seat 6: 65f22aee folded before Flop (didn't bet)


Poker Hand #RC1456708556: Hold'em No Limit  ($0.05/$0.1) - 2023/04/07 12:05:52
Table 'RushAndCash3093816' 6-max Seat #1 is the button
Seat 1: 4dd76049 ($40.92 in chips)
Seat 2: 4db1dc87 ($24.63 in chips)
Seat 3: 79e451bc ($21.58 in chips)
Seat 4: 8a6bec0 ($10 in chips)
Seat 5: Hero ($7.12 in chips)
Seat 6: 87c49912 ($39.23 in chips)
4db1dc87: posts small blind $0.05
79e451bc: posts big blind $0.1
*** HOLE CARDS ***
Dealt to 4dd76049 
Dealt to 4db1dc87 
Dealt to 79e451bc 
Dealt to 8a6bec0 
Dealt to Hero [Jh 3c]
Dealt to 87c49912 
8a6bec0: folds
Hero: folds
87c49912: folds
4dd76049: raises $0.15 to $0.25
4db1dc87: raises $0.75 to $1
79e451bc: folds
4dd76049: calls $0.75
*** FLOP *** [2s 7h Kd]
4db1dc87: bets $0.7
4dd76049: folds
Uncalled bet ($0.7) returned to 4db1dc87
*** SHOWDOWN ***
4db1dc87 collected $2 from pot
*** SUMMARY ***
Total pot $2.1 | Rake $0.1 | Jackpot $0 | Bingo $0 | Fortune $0
Board [2s 7h Kd]
Seat 1: 4dd76049 (button) folded on the Flop
Seat 2: 4db1dc87 (small blind) won ($2)
Seat 3: 79e451bc (big blind) folded before Flop
Seat 4: 8a6bec0 folded before Flop (didn't bet)
Seat 5: Hero folded before Flop (didn't bet)
Seat 6: 87c49912 folded before Flop (didn't bet)


Poker Hand #RC1456708209: Hold'em No Limit  ($0.05/$0.1) - 2023/04/07 12:04:55
Table 'RushAndCash3093469' 6-max Seat #1 is the button
Seat 1: Hero ($6.11 in chips)
Seat 2: b5353bf8 ($32.4 in chips)
Seat 3: 346d6423 ($9.6 in chips)
Seat 4: b69c5e3a ($10.86 in chips)
Seat 5: 617f565c ($10.1 in chips)
Seat 6: d8e9fac1 ($18.42 in chips)
b5353bf8: posts small blind $0.05
346d6423: posts big blind $0.1
*** HOLE CARDS ***
Dealt to Hero [Ah 8d]
Dealt to b5353bf8 
Dealt to 346d6423 
Dealt to b69c5e3a 
Dealt to 617f565c 
Dealt to d8e9fac1 
b69c5e3a: folds
617f565c: folds
d8e9fac1: folds
Hero: raises $0.15 to $0.25
b5353bf8: calls $0.2
346d6423: calls $0.15
*** FLOP *** [Ad Kc 9d]
b5353bf8: checks
346d6423: checks
Hero: checks
*** TURN *** [Ad Kc 9d] [5c]
b5353bf8: bets $0.1
346d6423: folds
Hero: raises $0.4 to $0.5
b5353bf8: calls $0.4
*** RIVER *** [Ad Kc 9d 5c] [Jc]
b5353bf8: bets $0.1
Hero: calls $0.1
b5353bf8: shows [6d 6s] (Pair of Sixes)
Hero: shows [Ah 8d] (Pair of Aces)
*** SHOWDOWN ***
Hero collected $1.86 from pot
*** SUMMARY ***
Total pot $1.95 | Rake $0.09 | Jackpot $0 | Bingo $0 | Fortune $0
Board [Ad Kc 9d 5c Jc]
Seat 1: Hero (button) showed [Ah 8d] and won ($1.86) with Pair of Aces
Seat 2: b5353bf8 (small blind) showed [6d 6s] and lost with Pair of Sixes
Seat 3: 346d6423 (big blind) folded on the Turn
Seat 4: b69c5e3a folded before Flop (didn't bet)
Seat 5: 617f565c folded before Flop (didn't bet)
Seat 6: d8e9fac1 folded before Flop (didn't bet)


Poker Hand #RC1456708166: Hold'em No Limit  ($0.05/$0.1) - 2023/04/07 12:04:48
Table 'RushAndCash3093426' 6-max Seat #1 is the button
Seat 1: ca6b9cde ($14.18 in chips)
Seat 2: d0f479f1 ($6.6 in chips)
Seat 3: 256287a6 ($19.54 in chips)
Seat 4: f0c3a984 ($13.27 in chips)
Seat 5: Hero ($6.11 in chips)
Seat 6: ed7ccdc6 ($11.86 in chips)
d0f479f1: posts small blind $0.05
256287a6: posts big blind $0.1
*** HOLE CARDS ***
Dealt to ca6b9cde 
Dealt to d0f479f1 
Dealt to 256287a6 
Dealt to f0c3a984 
Dealt to Hero [6s 7c]
Dealt to ed7ccdc6 
f0c3a984: folds
Hero: folds
ed7ccdc6: raises $0.2 to $0.3
ca6b9cde: folds
d0f479f1: folds
256287a6: calls $0.2
*** FLOP *** [3d 4s 7s]
256287a6: checks
ed7ccdc6: bets $0.39
256287a6: calls $0.39
*** TURN *** [3d 4s 7s] [5h]
256287a6: checks
ed7ccdc6: bets $0.86
256287a6: raises $1.14 to $2
ed7ccdc6: calls $1.14
*** RIVER *** [3d 4s 7s 5h] [Tc]
256287a6: bets $4.5
ed7ccdc6: calls $4.5
256287a6: shows [9h 9d] (Pair of Nines)
ed7ccdc6: shows [4d 6d] (Sevens-High Straight)
*** SHOWDOWN ***
ed7ccdc6 collected $13.98 from pot
*** SUMMARY ***
Total pot $14.43 | Rake $0.3 | Jackpot $0.15 | Bingo $0 | Fortune $0
Board [3d 4s 7s 5h Tc]
Seat 1: ca6b9cde (button) folded before Flop (didn't bet)
Seat 2: d0f479f1 (small blind) folded before Flop
Seat 3: 256287a6 (big blind) showed [9h 9d] and lost with Pair of Nines
Seat 4: f0c3a984 folded before Flop (didn't bet)
Seat 5: Hero folded before Flop (didn't bet)
Seat 6: ed7ccdc6 showed [4d 6d] and won ($13.98) with Sevens-High Straight


Poker Hand #RC1456708036: Hold'em No Limit  ($0.05/$0.1) - 2023/04/07 12:04:26
Table 'RushAndCash3093296' 6-max Seat #1 is the button
Seat 1: 7e63e461 ($11.24 in chips)
Seat 2: 4c5586e3 ($10.1 in chips)
Seat 3: Hero ($6.21 in chips)
Seat 4: f4a96d1b ($16.03 in chips)
Seat 5: 89307087 ($13.2 in chips)
Seat 6: 2f5487fe ($13.06 in chips)
4c5586e3: posts small blind $0.05
Hero: posts big blind $0.1
*** HOLE CARDS ***
Dealt to 7e63e461 
Dealt to 4c5586e3 
Dealt to Hero [Jd 4d]
Dealt to f4a96d1b 
Dealt to 89307087 
Dealt to 2f5487fe 
f4a96d1b: folds
89307087: raises $0.12 to $0.22
2f5487fe: folds
7e63e461: folds
4c5586e3: folds
Hero: folds
Uncalled bet ($0.12) returned to 89307087
*** SHOWDOWN ***
89307087 collected $0.25 from pot
*** SUMMARY ***
Total pot $0.25 | Rake $0 | Jackpot $0 | Bingo $0 | Fortune $0
Seat 1: 7e63e461 (button) folded before Flop (didn't bet)
Seat 2: 4c5586e3 (small blind) folded before Flop
Seat 3: Hero (big blind) folded before Flop
Seat 4: f4a96d1b folded before Flop (didn't bet)
Seat 5: 89307087 collected ($0.25)
Seat 6: 2f5487fe folded before Flop (didn't bet)


Poker Hand #RC1456707790: Hold'em No Limit  ($0.05/$0.1) - 2023/04/07 12:03:46
Table 'RushAndCash3093050' 6-max Seat #1 is the button
Seat 1: c0df221 ($9.57 in chips)
Seat 2: 2f5487fe ($12.23 in chips)
Seat 3: 1516c360 ($11.84 in chips)
Seat 4: bb005a13 ($14.04 in chips)
Seat 5: 4c5586e3 ($10.3 in chips)
Seat 6: Hero ($6.81 in chips)
2f5487fe: posts small blind $0.05
1516c360: posts big blind $0.1
*** HOLE CARDS ***
Dealt to c0df221 
Dealt to 2f5487fe 
Dealt to 1516c360 
Dealt to bb005a13 
Dealt to 4c5586e3 
Dealt to Hero [8c Ac]
bb005a13: folds
4c5586e3: raises $0.1 to $0.2
Hero: raises $0.4 to $0.6
c0df221: folds
2f5487fe: raises $1.2 to $1.8
1516c360: folds
4c5586e3: folds
Hero: folds
Uncalled bet ($1.2) returned to 2f5487fe
*** SHOWDOWN ***
2f5487fe collected $1.43 from pot
*** SUMMARY ***
Total pot $1.5 | Rake $0.07 | Jackpot $0 | Bingo $0 | Fortune $0
Seat 1: c0df221 (button) folded before Flop (didn't bet)
Seat 2: 2f5487fe (small blind) collected ($1.43)
Seat 3: 1516c360 (big blind) folded before Flop
Seat 4: bb005a13 folded before Flop (didn't bet)
Seat 5: 4c5586e3 folded before Flop
Seat 6: Hero folded before Flop


Poker Hand #RC1456707729: Hold'em No Limit  ($0.05/$0.1) - 2023/04/07 12:03:37
Table 'RushAndCash3092989' 6-max Seat #1 is the button
Seat 1: eabbf486 ($12.85 in chips)
Seat 2: Hero ($6.86 in chips)
Seat 3: 87c49912 ($38.25 in chips)
Seat 4: 8808e93 ($10.89 in chips)
Seat 5: 479d43d ($8.91 in chips)
Seat 6: d94235da ($10.35 in chips)
Hero: posts small blind $0.05
87c49912: posts big blind $0.1
*** HOLE CARDS ***
Dealt to eabbf486 
Dealt to Hero [8h 5h]
Dealt to 87c49912 
Dealt to 8808e93 
Dealt to 479d43d 
Dealt to d94235da 
8808e93: folds
479d43d: raises $0.15 to $0.25
d94235da: raises $0.49 to $0.74
eabbf486: folds
Hero: folds
87c49912: folds
479d43d: calls $0.49
*** FLOP *** [4s 9h Jh]
479d43d: bets $0.54
d94235da: folds
Uncalled bet ($0.54) returned to 479d43d
*** SHOWDOWN ***
479d43d collected $1.55 from pot
*** SUMMARY ***
Total pot $1.63 | Rake $0.08 | Jackpot $0 | Bingo $0 | Fortune $0
Board [4s 9h Jh]
Seat 1: eabbf486 (button) folded before Flop (didn't bet)
Seat 2: Hero (small blind) folded before Flop
Seat 3: 87c49912 (big blind) folded before Flop
Seat 4: 8808e93 folded before Flop (didn't bet)
Seat 5: 479d43d won ($1.55)
Seat 6: d94235da folded on the Flop


Poker Hand #RC1456707689: Hold'em No Limit  ($0.05/$0.1) - 2023/04/07 12:03:30
Table 'RushAndCash3092949' 6-max Seat #1 is the button
Seat 1: aa2d11d8 ($15.44 in chips)
Seat 2: e3c32931 ($23.99 in chips)
Seat 3: a15ce749 ($18.42 in chips)
Seat 4: b2112288 ($10 in chips)
Seat 5: 82849675 ($10.2 in chips)
Seat 6: Hero ($6.86 in chips)
e3c32931: posts small blind $0.05
a15ce749: posts big blind $0.1
*** HOLE CARDS ***
Dealt to aa2d11d8 
Dealt to e3c32931 
Dealt to a15ce749 
Dealt to b2112288 
Dealt to 82849675 
Dealt to Hero [4d Ks]
b2112288: folds
82849675: folds
Hero: folds
aa2d11d8: folds
e3c32931: folds
Uncalled bet ($0.05) returned to a15ce749
*** SHOWDOWN ***
a15ce749 collected $0.1 from pot
*** SUMMARY ***
Total pot $0.1 | Rake $0 | Jackpot $0 | Bingo $0 | Fortune $0
Seat 1: aa2d11d8 (button) folded before Flop (didn't bet)
Seat 2: e3c32931 (small blind) folded before Flop
Seat 3: a15ce749 (big blind) collected ($0.1)
Seat 4: b2112288 folded before Flop (didn't bet)
Seat 5: 82849675 folded before Flop (didn't bet)
Seat 6: Hero folded before Flop (didn't bet)


Poker Hand #RC1456707647: Hold'em No Limit  ($0.05/$0.1) - 2023/04/07 12:03:24
Table 'RushAndCash3092907' 6-max Seat #1 is the button
Seat 1: 74df6125 ($15.53 in chips)
Seat 2: c63722cb ($13.05 in chips)
Seat 3: 7fa18e56 ($10 in chips)
Seat 4: Hero ($6.86 in chips)
Seat 5: 204fb5f0 ($18.88 in chips)
Seat 6: 1a6b4da0 ($9.1 in chips)
c63722cb: posts small blind $0.05
7fa18e56: posts big blind $0.1
*** HOLE CARDS ***
Dealt to 74df6125 
Dealt to c63722cb 
Dealt to 7fa18e56 
Dealt to Hero [Kd 9s]
Dealt to 204fb5f0 
Dealt to 1a6b4da0 
Hero: folds
204fb5f0: raises $0.13 to $0.23
1a6b4da0: raises $0.31 to $0.54
74df6125: folds
c63722cb: folds
7fa18e56: folds
204fb5f0: calls $0.31
*** FLOP *** [Qh 5h 7c]
204fb5f0: checks
1a6b4da0: checks
*** TURN *** [Qh 5h 7c] [Ts]
204fb5f0: bets $0.93
1a6b4da0: calls $0.93
*** RIVER *** [Qh 5h 7c Ts] [As]
204fb5f0: bets $2.32
1a6b4da0: calls $2.32
204fb5f0: shows [Jh Kh] (Aces-High Straight)
1a6b4da0: shows [Qc 8c] (Pair of Queens)
*** SHOWDOWN ***
204fb5f0 collected $7.28 from pot
*** SUMMARY ***
Total pot $7.73 | Rake $0.3 | Jackpot $0.15 | Bingo $0 | Fortune $0
Board [Qh 5h 7c Ts As]
Seat 1: 74df6125 (button) folded before Flop (didn't bet)
Seat 2: c63722cb (small blind) folded before Flop
Seat 3: 7fa18e56 (big blind) folded before Flop
Seat 4: Hero folded before Flop (didn't bet)
Seat 5: 204fb5f0 showed [Jh Kh] and won ($7.28) with Aces-High Straight
Seat 6: 1a6b4da0 showed [Qc 8c] and lost with Pair of Queens


Poker Hand #RC1456707615: Hold'em No Limit  ($0.05/$0.1) - 2023/04/07 12:03:19
Table 'RushAndCash3092875' 6-max Seat #1 is the button
Seat 1: 33ead1fe ($30.04 in chips)
Seat 2: Hero ($6.91 in chips)
Seat 3: c31e8880 ($13.6 in chips)
Seat 4: 5d5efd7b ($20.24 in chips)
Seat 5: 5e3058d1 ($10 in chips)
Seat 6: 26c4fb86 ($10.16 in chips)
Hero: posts small blind $0.05
c31e8880: posts big blind $0.1
*** HOLE CARDS ***
Dealt to 33ead1fe 
Dealt to Hero [Kc 5h]
Dealt to c31e8880 
Dealt to 5d5efd7b 
Dealt to 5e3058d1 
Dealt to 26c4fb86 
5d5efd7b: folds
5e3058d1: raises $0.12 to $0.22
26c4fb86: calls $0.22
33ead1fe: folds
Hero: folds
c31e8880: folds
*** FLOP *** [Jd 9s 8h]
5e3058d1: bets $0.2
26c4fb86: calls $0.2
*** TURN *** [Jd 9s 8h] [Ah]
5e3058d1: checks
26c4fb86: bets $0.75
5e3058d1: calls $0.75
*** RIVER *** [Jd 9s 8h Ah] [Ks]
5e3058d1: checks
26c4fb86: checks
5e3058d1: shows [8c 8d] (Three Eights)
26c4fb86: shows [Ad Jh] (Pair of Aces and Pair of Jacks)
*** SHOWDOWN ***
5e3058d1 collected $2.37 from pot
*** SUMMARY ***
Total pot $2.49 | Rake $0.12 | Jackpot $0 | Bingo $0 | Fortune $0
Board [Jd 9s 8h Ah Ks]
Seat 1: 33ead1fe (button) folded before Flop (didn't bet)
Seat 2: Hero (small blind) folded before Flop
Seat 3: c31e8880 (big blind) folded before Flop
Seat 4: 5d5efd7b folded before Flop (didn't bet)
Seat 5: 5e3058d1 showed [8c 8d] and won ($2.37) with Three Eights
Seat 6: 26c4fb86 showed [Ad Jh] and lost with Pair of Aces and Pair of Jacks


Poker Hand #RC1456707576: Hold'em No Limit  ($0.05/$0.1) - 2023/04/07 12:03:14
Table 'RushAndCash3092836' 6-max Seat #1 is the button
Seat 1: ebb5df26 ($9.85 in chips)
Seat 2: 56ae0f09 ($8.04 in chips)
Seat 3: Hero ($7.01 in chips)
Seat 4: 74774c77 ($10 in chips)
Seat 5: 25c3fb00 ($9.45 in chips)
Seat 6: a2bc5fe2 ($10 in chips)
56ae0f09: posts small blind $0.05
Hero: posts big blind $0.1
*** HOLE CARDS ***
Dealt to ebb5df26 
Dealt to 56ae0f09 
Dealt to Hero [Qh 4d]
Dealt to 74774c77 
Dealt to 25c3fb00 
Dealt to a2bc5fe2 
74774c77: folds
25c3fb00: raises $0.1 to $0.2
a2bc5fe2: folds
ebb5df26: folds
56ae0f09: folds
Hero: folds
Uncalled bet ($0.1) returned to 25c3fb00
*** SHOWDOWN ***
25c3fb00 collected $0.25 from pot
*** SUMMARY ***
Total pot $0.25 | Rake $0 | Jackpot $0 | Bingo $0 | Fortune $0
Seat 1: ebb5df26 (button) folded before Flop (didn't bet)
Seat 2: 56ae0f09 (small blind) folded before Flop
Seat 3: Hero (big blind) folded before Flop
Seat 4: 74774c77 folded before Flop (didn't bet)
Seat 5: 25c3fb00 collected ($0.25)
Seat 6: a2bc5fe2 folded before Flop (didn't bet)


Poker Hand #RC1456707468: Hold'em No Limit  ($0.05/$0.1) - 2023/04/07 12:02:57
Table 'RushAndCash3092728' 6-max Seat #1 is the button
Seat 1: 35211315 ($10 in chips)
Seat 2: 63d399c1 ($11.42 in chips)
Seat 3: Hero ($7.11 in chips)
Seat 4: cb2a2201 ($10.42 in chips)
Seat 5: ec9edfb4 ($12.92 in chips)
Seat 6: 5f5a1fb4 ($11.9 in chips)
63d399c1: posts small blind $0.05
Hero: posts big blind $0.1
*** HOLE CARDS ***
Dealt to 35211315 
Dealt to 63d399c1 
Dealt to Hero [9s Kh]
Dealt to cb2a2201 
Dealt to ec9edfb4 
Dealt to 5f5a1fb4 
cb2a2201: folds
ec9edfb4: folds
5f5a1fb4: raises $0.15 to $0.25
35211315: raises $0.5 to $0.75
63d399c1: folds
Hero: folds
5f5a1fb4: calls $0.5
*** FLOP *** [Ad Kd 8d]
5f5a1fb4: checks
35211315: bets $0.45
5f5a1fb4: folds
Uncalled bet ($0.45) returned to 35211315
*** SHOWDOWN ***
35211315 collected $1.57 from pot
*** SUMMARY ***
Total pot $1.65 | Rake $0.08 | Jackpot $0 | Bingo $0 | Fortune $0
Board [Ad Kd 8d]
Seat 1: 35211315 (button) won ($1.57)
Seat 2: 63d399c1 (small blind) folded before Flop
Seat 3: Hero (big blind) folded before Flop
Seat 4: cb2a2201 folded before Flop (didn't bet)
Seat 5: ec9edfb4 folded before Flop (didn't bet)
Seat 6: 5f5a1fb4 folded on the Flop


Poker Hand #RC1456707438: Hold'em No Limit  ($0.05/$0.1) - 2023/04/07 12:02:53
Table 'RushAndCash3092698' 6-max Seat #1 is the button
Seat 1: Hero ($7.11 in chips)
Seat 2: 4a79fc25 ($13.46 in chips)
Seat 3: 830670df ($10.78 in chips)
Seat 4: ac4e0c1 ($11.02 in chips)
Seat 5: dcf9816 ($10.97 in chips)
Seat 6: 80e9392 ($26.02 in chips)
4a79fc25: posts small blind $0.05
830670df: posts big blind $0.1
*** HOLE CARDS ***
Dealt to Hero [8c 5h]
Dealt to 4a79fc25 
Dealt to 830670df 
Dealt to ac4e0c1 
Dealt to dcf9816 
Dealt to 80e9392 
ac4e0c1: folds
dcf9816: raises $0.15 to $0.25
80e9392: folds
Hero: folds
4a79fc25: folds
830670df: folds
Uncalled bet ($0.15) returned to dcf9816
*** SHOWDOWN ***
dcf9816 collected $0.25 from pot
*** SUMMARY ***
Total pot $0.25 | Rake $0 | Jackpot $0 | Bingo $0 | Fortune $0
Seat 1: Hero (button) folded before Flop (didn't bet)
Seat 2: 4a79fc25 (small blind) folded before Flop
Seat 3: 830670df (big blind) folded before Flop
Seat 4: ac4e0c1 folded before Flop (didn't bet)
Seat 5: dcf9816 collected ($0.25)
Seat 6: 80e9392 folded before Flop (didn't bet)


Poker Hand #RC1456707411: Hold'em No Limit  ($0.05/$0.1) - 2023/04/07 12:02:48
Table 'RushAndCash3092671' 6-max Seat #1 is the button
Seat 1: 840fd803 ($11.35 in chips)
Seat 2: 65f22aee ($21.86 in chips)
Seat 3: 2e96edc9 ($10 in chips)
Seat 4: Hero ($7.11 in chips)
Seat 5: 3d3159cc ($10.85 in chips)
Seat 6: fa30b9bf ($23.62 in chips)
65f22aee: posts small blind $0.05
2e96edc9: posts big blind $0.1
*** HOLE CARDS ***
Dealt to 840fd803 
Dealt to 65f22aee 
Dealt to 2e96edc9 
Dealt to Hero [3s 6d]
Dealt to 3d3159cc 
Dealt to fa30b9bf 
Hero: folds
3d3159cc: folds
fa30b9bf: folds
840fd803: folds
65f22aee: raises $0.2 to $0.3
2e96edc9: folds
Uncalled bet ($0.2) returned to 65f22aee
*** SHOWDOWN ***
65f22aee collected $0.2 from pot
*** SUMMARY ***
Total pot $0.2 | Rake $0 | Jackpot $0 | Bingo $0 | Fortune $0
Seat 1: 840fd803 (button) folded before Flop (didn't bet)
Seat 2: 65f22aee (small blind) collected ($0.2)
Seat 3: 2e96edc9 (big blind) folded before Flop
Seat 4: Hero folded before Flop (didn't bet)
Seat 5: 3d3159cc folded before Flop (didn't bet)
Seat 6: fa30b9bf folded before Flop (didn't bet)


Poker Hand #RC1456707364: Hold'em No Limit  ($0.05/$0.1) - 2023/04/07 12:02:40
Table 'RushAndCash3092624' 6-max Seat #1 is the button
Seat 1: db6d2eaf ($11.15 in chips)
Seat 2: 1fce2ae1 ($10.54 in chips)
Seat 3: 1ba92797 ($10 in chips)
Seat 4: Hero ($7.11 in chips)
Seat 5: cca05e35 ($10.1 in chips)
Seat 6: 78a8268a ($11.95 in chips)
1fce2ae1: posts small blind $0.05
1ba92797: posts big blind $0.1
*** HOLE CARDS ***
Dealt to db6d2eaf 
Dealt to 1fce2ae1 
Dealt to 1ba92797 
Dealt to Hero [6s Ts]
Dealt to cca05e35 
Dealt to 78a8268a 
Hero: folds
cca05e35: folds
78a8268a: folds
db6d2eaf: folds
1fce2ae1: folds
Uncalled bet ($0.05) returned to 1ba92797
*** SHOWDOWN ***
1ba92797 collected $0.1 from pot
*** SUMMARY ***
Total pot $0.1 | Rake $0 | Jackpot $0 | Bingo $0 | Fortune $0
Seat 1: db6d2eaf (button) folded before Flop (didn't bet)
Seat 2: 1fce2ae1 (small blind) folded before Flop
Seat 3: 1ba92797 (big blind) collected ($0.1)
Seat 4: Hero folded before Flop (didn't bet)
Seat 5: cca05e35 folded before Flop (didn't bet)
Seat 6: 78a8268a folded before Flop (didn't bet)


Poker Hand #RC1456707301: Hold'em No Limit  ($0.05/$0.1) - 2023/04/07 12:02:30
Table 'RushAndCash3092561' 6-max Seat #1 is the button
Seat 1: 74774c77 ($10 in chips)
Seat 2: Hero ($7.16 in chips)
Seat 3: 572e39a8 ($6.77 in chips)
Seat 4: 45c5fa9b ($13.17 in chips)
Seat 5: 79af5cde ($7.97 in chips)
Seat 6: d2d6ab6d ($10.42 in chips)
Hero: posts small blind $0.05
572e39a8: posts big blind $0.1
*** HOLE CARDS ***
Dealt to 74774c77 
Dealt to Hero [Ks 5c]
Dealt to 572e39a8 
Dealt to 45c5fa9b 
Dealt to 79af5cde 
Dealt to d2d6ab6d 
45c5fa9b: raises $0.1 to $0.2
79af5cde: folds
d2d6ab6d: folds
74774c77: folds
Hero: folds
572e39a8: folds
Uncalled bet ($0.1) returned to 45c5fa9b
*** SHOWDOWN ***
45c5fa9b collected $0.25 from pot
*** SUMMARY ***
Total pot $0.25 | Rake $0 | Jackpot $0 | Bingo $0 | Fortune $0
Seat 1: 74774c77 (button) folded before Flop (didn't bet)
Seat 2: Hero (small blind) folded before Flop
Seat 3: 572e39a8 (big blind) folded before Flop
Seat 4: 45c5fa9b collected ($0.25)
Seat 5: 79af5cde folded before Flop (didn't bet)
Seat 6: d2d6ab6d folded before Flop (didn't bet)


Poker Hand #RC1456707262: Hold'em No Limit  ($0.05/$0.1) - 2023/04/07 12:02:24
Table 'RushAndCash3092522' 6-max Seat #1 is the button
Seat 1: 248245df ($10 in chips)
Seat 2: 810f5bf9 ($13.76 in chips)
Seat 3: 3c3f726c ($10 in chips)
Seat 4: 53857549 ($6.58 in chips)
Seat 5: Hero ($7.16 in chips)
Seat 6: 40ee80db ($10.03 in chips)
810f5bf9: posts small blind $0.05
3c3f726c: posts big blind $0.1
*** HOLE CARDS ***
Dealt to 248245df 
Dealt to 810f5bf9 
Dealt to 3c3f726c 
Dealt to 53857549 
Dealt to Hero [8s 9d]
Dealt to 40ee80db 
53857549: folds
Hero: folds
40ee80db: raises $0.15 to $0.25
248245df: folds
810f5bf9: folds
3c3f726c: raises $0.65 to $0.9
40ee80db: calls $0.65
*** FLOP *** [5d 9s Kd]
3c3f726c: bets $0.7
40ee80db: calls $0.7
*** TURN *** [5d 9s Kd] [8h]
3c3f726c: bets $1.47
40ee80db: calls $1.47
*** RIVER *** [5d 9s Kd 8h] [Ah]
3c3f726c: checks
40ee80db: checks
3c3f726c: shows [Td Th] (Pair of Tens)
40ee80db: shows [Jd Jh] (Pair of Jacks)
*** SHOWDOWN ***
40ee80db collected $5.74 from pot
*** SUMMARY ***
Total pot $6.19 | Rake $0.3 | Jackpot $0.15 | Bingo $0 | Fortune $0
Board [5d 9s Kd 8h Ah]
Seat 1: 248245df (button) folded before Flop (didn't bet)
Seat 2: 810f5bf9 (small blind) folded before Flop
Seat 3: 3c3f726c (big blind) showed [Td Th] and lost with Pair of Tens
Seat 4: 53857549 folded before Flop (didn't bet)
Seat 5: Hero folded before Flop (didn't bet)
Seat 6: 40ee80db showed [Jd Jh] and won ($5.74) with Pair of Jacks


Poker Hand #RC1456707216: Hold'em No Limit  ($0.05/$0.1) - 2023/04/07 12:02:17
Table 'RushAndCash3092476' 6-max Seat #1 is the button
Seat 1: 4c134268 ($4.42 in chips)
Seat 2: 964d4f7 ($10 in chips)
Seat 3: cc012293 ($13.5 in chips)
Seat 4: 5dd0e07a ($10 in chips)
Seat 5: Hero ($7.16 in chips)
Seat 6: 7631f22e ($10.45 in chips)
964d4f7: posts small blind $0.05
cc012293: posts big blind $0.1
*** HOLE CARDS ***
Dealt to 4c134268 
Dealt to 964d4f7 
Dealt to cc012293 
Dealt to 5dd0e07a 
Dealt to Hero [8h 4d]
Dealt to 7631f22e 
5dd0e07a: folds
Hero: folds
7631f22e: folds
4c134268: raises $0.15 to $0.25
964d4f7: folds
cc012293: folds
Uncalled bet ($0.15) returned to 4c134268
*** SHOWDOWN ***
4c134268 collected $0.25 from pot
*** SUMMARY ***
Total pot $0.25 | Rake $0 | Jackpot $0 | Bingo $0 | Fortune $0
Seat 1: 4c134268 (button) collected ($0.25)
Seat 2: 964d4f7 (small blind) folded before Flop
Seat 3: cc012293 (big blind) folded before Flop
Seat 4: 5dd0e07a folded before Flop (didn't bet)
Seat 5: Hero folded before Flop (didn't bet)
Seat 6: 7631f22e folded before Flop (didn't bet)


Poker Hand #RC1456707177: Hold'em No Limit  ($0.05/$0.1) - 2023/04/07 12:02:11
Table 'RushAndCash3092437' 6-max Seat #1 is the button
Seat 1: 89baf59b ($24.37 in chips)
Seat 2: b130125d ($12.05 in chips)
Seat 3: 82c41ae8 ($10 in chips)
Seat 4: Hero ($7.16 in chips)
Seat 5: b9620412 ($9.78 in chips)
Seat 6: 7b2cf2e4 ($10.83 in chips)
b130125d: posts small blind $0.05
82c41ae8: posts big blind $0.1
*** HOLE CARDS ***
Dealt to 89baf59b 
Dealt to b130125d 
Dealt to 82c41ae8 
Dealt to Hero [6d Qc]
Dealt to b9620412 
Dealt to 7b2cf2e4 
Hero: folds
b9620412: folds
7b2cf2e4: folds
89baf59b: folds
b130125d: raises $0.2 to $0.3
82c41ae8: folds
Uncalled bet ($0.2) returned to b130125d
*** SHOWDOWN ***
b130125d collected $0.2 from pot
*** SUMMARY ***
Total pot $0.2 | Rake $0 | Jackpot $0 | Bingo $0 | Fortune $0
Seat 1: 89baf59b (button) folded before Flop (didn't bet)
Seat 2: b130125d (small blind) collected ($0.2)
Seat 3: 82c41ae8 (big blind) folded before Flop
Seat 4: Hero folded before Flop (didn't bet)
Seat 5: b9620412 folded before Flop (didn't bet)
Seat 6: 7b2cf2e4 folded before Flop (didn't bet)


Poker Hand #RC1456707150: Hold'em No Limit  ($0.05/$0.1) - 2023/04/07 12:02:07
Table 'RushAndCash3092410' 6-max Seat #1 is the button
Seat 1: ac0e72fc ($15.68 in chips)
Seat 2: 506155ff ($22.49 in chips)
Seat 3: d2993e12 ($13.5 in chips)
Seat 4: Hero ($7.16 in chips)
Seat 5: 40ee80db ($10.18 in chips)
Seat 6: 7214a3ce ($25.13 in chips)
506155ff: posts small blind $0.05
d2993e12: posts big blind $0.1
*** HOLE CARDS ***
Dealt to ac0e72fc 
Dealt to 506155ff 
Dealt to d2993e12 
Dealt to Hero [5c 3h]
Dealt to 40ee80db 
Dealt to 7214a3ce 
Hero: folds
40ee80db: folds
7214a3ce: folds
ac0e72fc: folds
506155ff: folds
Uncalled bet ($0.05) returned to d2993e12
*** SHOWDOWN ***
d2993e12 collected $0.1 from pot
*** SUMMARY ***
Total pot $0.1 | Rake $0 | Jackpot $0 | Bingo $0 | Fortune $0
Seat 1: ac0e72fc (button) folded before Flop (didn't bet)
Seat 2: 506155ff (small blind) folded before Flop
Seat 3: d2993e12 (big blind) collected ($0.1)
Seat 4: Hero folded before Flop (didn't bet)
Seat 5: 40ee80db folded before Flop (didn't bet)
Seat 6: 7214a3ce folded before Flop (didn't bet)


Poker Hand #RC1456707082: Hold'em No Limit  ($0.05/$0.1) - 2023/04/07 12:01:55
Table 'RushAndCash3092342' 6-max Seat #1 is the button
Seat 1: Hero ($7.16 in chips)
Seat 2: 1ba92797 ($10 in chips)
Seat 3: 9b99ef22 ($27.97 in chips)
Seat 4: 440790ac ($10.79 in chips)
Seat 5: a1b98f6f ($22.37 in chips)
Seat 6: 80618481 ($15.26 in chips)
1ba92797: posts small blind $0.05
9b99ef22: posts big blind $0.1
*** HOLE CARDS ***
Dealt to Hero [Jd Kh]
Dealt to 1ba92797 
Dealt to 9b99ef22 
Dealt to 440790ac 
Dealt to a1b98f6f 
Dealt to 80618481 
440790ac: raises $0.13 to $0.23
a1b98f6f: calls $0.23
80618481: folds
Hero: folds
1ba92797: folds
9b99ef22: folds
*** FLOP *** [Kc 3s Td]
440790ac: bets $10.56 and is all-in
a1b98f6f: folds
Uncalled bet ($10.56) returned to 440790ac
*** SHOWDOWN ***
440790ac collected $0.58 from pot
*** SUMMARY ***
Total pot $0.61 | Rake $0.03 | Jackpot $0 | Bingo $0 | Fortune $0
Board [Kc 3s Td]
Seat 1: Hero (button) folded before Flop (didn't bet)
Seat 2: 1ba92797 (small blind) folded before Flop
Seat 3: 9b99ef22 (big blind) folded before Flop
Seat 4: 440790ac won ($0.58)
Seat 5: a1b98f6f folded on the Flop
Seat 6: 80618481 folded before Flop (didn't bet)


Poker Hand #RC1456707049: Hold'em No Limit  ($0.05/$0.1) - 2023/04/07 12:01:49
Table 'RushAndCash3092309' 6-max Seat #1 is the button
Seat 1: Hero ($7.16 in chips)
Seat 2: f210b1d ($18.88 in chips)
Seat 3: 4601a268 ($34.02 in chips)
Seat 4: a570e75d ($23.93 in chips)
Seat 5: 60151139 ($11.61 in chips)
Seat 6: e0a60d64 ($10.69 in chips)
f210b1d: posts small blind $0.05
4601a268: posts big blind $0.1
*** HOLE CARDS ***
Dealt to Hero [2d Kh]
Dealt to f210b1d 
Dealt to 4601a268 
Dealt to a570e75d 
Dealt to 60151139 
Dealt to e0a60d64 
a570e75d: raises $0.12 to $0.22
60151139: folds
e0a60d64: folds
Hero: folds
f210b1d: calls $0.17
4601a268: folds
*** FLOP *** [6c 8s Js]
f210b1d: checks
a570e75d: checks
*** TURN *** [6c 8s Js] [Ac]
f210b1d: checks
a570e75d: bets $0.18
f210b1d: folds
Uncalled bet ($0.18) returned to a570e75d
*** SHOWDOWN ***
a570e75d collected $0.52 from pot
*** SUMMARY ***
Total pot $0.54 | Rake $0.02 | Jackpot $0 | Bingo $0 | Fortune $0
Board [6c 8s Js Ac]
Seat 1: Hero (button) folded before Flop (didn't bet)
Seat 2: f210b1d (small blind) folded on the Turn
Seat 3: 4601a268 (big blind) folded before Flop
Seat 4: a570e75d won ($0.52)
Seat 5: 60151139 folded before Flop (didn't bet)
Seat 6: e0a60d64 folded before Flop (didn't bet)


Poker Hand #RC1456706584: Hold'em No Limit  ($0.05/$0.1) - 2023/04/07 12:00:33
Table 'RushAndCash3091844' 6-max Seat #1 is the button
Seat 1: 37cd5015 ($13.61 in chips)
Seat 2: Hero ($7.66 in chips)
Seat 3: 22498734 ($10 in chips)
Seat 4: 147c8405 ($15.9 in chips)
Seat 5: cc076a85 ($24.5 in chips)
Seat 6: 81e8e3d4 ($10 in chips)
Hero: posts small blind $0.05
22498734: posts big blind $0.1
*** HOLE CARDS ***
Dealt to 37cd5015 
Dealt to Hero [9c Ac]
Dealt to 22498734 
Dealt to 147c8405 
Dealt to cc076a85 
Dealt to 81e8e3d4 
147c8405: folds
cc076a85: folds
81e8e3d4: folds
37cd5015: folds
Hero: raises $0.2 to $0.3
22498734: calls $0.2
*** FLOP *** [6h 5s 6d]
Hero: checks
22498734: checks
*** TURN *** [6h 5s 6d] [Ts]
Hero: checks
22498734: bets $0.2
Hero: calls $0.2
*** RIVER *** [6h 5s 6d Ts] [2c]
Hero: checks
22498734: bets $0.33
Hero: folds
Uncalled bet ($0.33) returned to 22498734
*** SHOWDOWN ***
22498734 collected $0.95 from pot
*** SUMMARY ***
Total pot $1 | Rake $0.05 | Jackpot $0 | Bingo $0 | Fortune $0
Board [6h 5s 6d Ts 2c]
Seat 1: 37cd5015 (button) folded before Flop (didn't bet)
Seat 2: Hero (small blind) folded on the River
Seat 3: 22498734 (big blind) won ($0.95)
Seat 4: 147c8405 folded before Flop (didn't bet)
Seat 5: cc076a85 folded before Flop (didn't bet)
Seat 6: 81e8e3d4 folded before Flop (didn't bet)


Poker Hand #RC1456706555: Hold'em No Limit  ($0.05/$0.1) - 2023/04/07 12:00:27
Table 'RushAndCash3091815' 6-max Seat #1 is the button
Seat 1: 208ced85 ($12.06 in chips)
Seat 2: 37e9b04d ($13.08 in chips)
Seat 3: Hero ($7.76 in chips)
Seat 4: 97004154 ($10.55 in chips)
Seat 5: e5e04a15 ($12.97 in chips)
Seat 6: dea7a4d4 ($17.83 in chips)
37e9b04d: posts small blind $0.05
Hero: posts big blind $0.1
*** HOLE CARDS ***
Dealt to 208ced85 
Dealt to 37e9b04d 
Dealt to Hero [Qh Ts]
Dealt to 97004154 
Dealt to e5e04a15 
Dealt to dea7a4d4 
97004154: folds
e5e04a15: raises $0.15 to $0.25
dea7a4d4: folds
208ced85: folds
37e9b04d: folds
Hero: folds
Uncalled bet ($0.15) returned to e5e04a15
*** SHOWDOWN ***
e5e04a15 collected $0.25 from pot
*** SUMMARY ***
Total pot $0.25 | Rake $0 | Jackpot $0 | Bingo $0 | Fortune $0
Seat 1: 208ced85 (button) folded before Flop (didn't bet)
Seat 2: 37e9b04d (small blind) folded before Flop
Seat 3: Hero (big blind) folded before Flop
Seat 4: 97004154 folded before Flop (didn't bet)
Seat 5: e5e04a15 collected ($0.25)
Seat 6: dea7a4d4 folded before Flop (didn't bet)


Poker Hand #RC1456706519: Hold'em No Limit  ($0.05/$0.1) - 2023/04/07 12:00:22
Table 'RushAndCash3091779' 6-max Seat #1 is the button
Seat 1: c908f09d ($11.4 in chips)
Seat 2: ad643599 ($11.27 in chips)
Seat 3: 506155ff ($22.84 in chips)
Seat 4: 65f22aee ($22.36 in chips)
Seat 5: a59e0e84 ($11.76 in chips)
Seat 6: Hero ($7.76 in chips)
ad643599: posts small blind $0.05
506155ff: posts big blind $0.1
*** HOLE CARDS ***
Dealt to c908f09d 
Dealt to ad643599 
Dealt to 506155ff 
Dealt to 65f22aee 
Dealt to a59e0e84 
Dealt to Hero [Ah 6s]
65f22aee: folds
a59e0e84: folds
Hero: folds
c908f09d: folds
ad643599: folds
Uncalled bet ($0.05) returned to 506155ff
*** SHOWDOWN ***
506155ff collected $0.1 from pot
*** SUMMARY ***
Total pot $0.1 | Rake $0 | Jackpot $0 | Bingo $0 | Fortune $0
Seat 1: c908f09d (button) folded before Flop (didn't bet)
Seat 2: ad643599 (small blind) folded before Flop
Seat 3: 506155ff (big blind) collected ($0.1)
Seat 4: 65f22aee folded before Flop (didn't bet)
Seat 5: a59e0e84 folded before Flop (didn't bet)
Seat 6: Hero folded before Flop (didn't bet)


Poker Hand #RC1456706476: Hold'em No Limit  ($0.05/$0.1) - 2023/04/07 12:00:14
Table 'RushAndCash3091736' 6-max Seat #1 is the button
Seat 1: 81e8e3d4 ($10.15 in chips)
Seat 2: a86de797 ($2.77 in chips)
Seat 3: a0135fa6 ($7.68 in chips)
Seat 4: bc8a2627 ($15.45 in chips)
Seat 5: Hero ($7.76 in chips)
Seat 6: 7719e9dd ($25.98 in chips)
a86de797: posts small blind $0.05
a0135fa6: posts big blind $0.1
*** HOLE CARDS ***
Dealt to 81e8e3d4 
Dealt to a86de797 
Dealt to a0135fa6 
Dealt to bc8a2627 
Dealt to Hero [5c 4d]
Dealt to 7719e9dd 
bc8a2627: folds
Hero: folds
7719e9dd: folds
81e8e3d4: folds
a86de797: folds
Uncalled bet ($0.05) returned to a0135fa6
*** SHOWDOWN ***
a0135fa6 collected $0.1 from pot
*** SUMMARY ***
Total pot $0.1 | Rake $0 | Jackpot $0 | Bingo $0 | Fortune $0
Seat 1: 81e8e3d4 (button) folded before Flop (didn't bet)
Seat 2: a86de797 (small blind) folded before Flop
Seat 3: a0135fa6 (big blind) collected ($0.1)
Seat 4: bc8a2627 folded before Flop (didn't bet)
Seat 5: Hero folded before Flop (didn't bet)
Seat 6: 7719e9dd folded before Flop (didn't bet)


Poker Hand #RC1456706434: Hold'em No Limit  ($0.05/$0.1) - 2023/04/07 12:00:07
Table 'RushAndCash3091694' 6-max Seat #1 is the button
Seat 1: 8649665a ($10.52 in chips)
Seat 2: 456dd7c9 ($14.67 in chips)
Seat 3: 2586712 ($19.03 in chips)
Seat 4: b130125d ($11.57 in chips)
Seat 5: Hero ($7.76 in chips)
Seat 6: b75e340d ($10.83 in chips)
456dd7c9: posts small blind $0.05
2586712: posts big blind $0.1
*** HOLE CARDS ***
Dealt to 8649665a 
Dealt to 456dd7c9 
Dealt to 2586712 
Dealt to b130125d 
Dealt to Hero [Jc 8s]
Dealt to b75e340d 
b130125d: folds
Hero: folds
b75e340d: raises $0.12 to $0.22
8649665a: raises $0.45 to $0.67
456dd7c9: folds
2586712: folds
b75e340d: folds
Uncalled bet ($0.45) returned to 8649665a
*** SHOWDOWN ***
8649665a collected $0.56 from pot
*** SUMMARY ***
Total pot $0.59 | Rake $0.03 | Jackpot $0 | Bingo $0 | Fortune $0
Seat 1: 8649665a (button) collected ($0.56)
Seat 2: 456dd7c9 (small blind) folded before Flop
Seat 3: 2586712 (big blind) folded before Flop
Seat 4: b130125d folded before Flop (didn't bet)
Seat 5: Hero folded before Flop (didn't bet)
Seat 6: b75e340d folded before Flop


Poker Hand #RC1456705959: Hold'em No Limit  ($0.05/$0.1) - 2023/04/07 11:58:53
Table 'RushAndCash3091219' 6-max Seat #1 is the button
Seat 1: b130125d ($10 in chips)
Seat 2: c415f057 ($10.02 in chips)
Seat 3: 167e2edc ($32.2 in chips)
Seat 4: 66ded3d2 ($10.7 in chips)
Seat 5: 550e3b3f ($11.18 in chips)
Seat 6: Hero ($9.5 in chips)
c415f057: posts small blind $0.05
167e2edc: posts big blind $0.1
*** HOLE CARDS ***
Dealt to b130125d 
Dealt to c415f057 
Dealt to 167e2edc 
Dealt to 66ded3d2 
Dealt to 550e3b3f 
Dealt to Hero [Tc Th]
66ded3d2: folds
550e3b3f: folds
Hero: raises $0.15 to $0.25
b130125d: raises $0.49 to $0.74
c415f057: folds
167e2edc: folds
Hero: calls $0.49
*** FLOP *** [3s 9d 4d]
Hero: checks
b130125d: bets $1
Hero: calls $1
*** TURN *** [3s 9d 4d] [4c]
Hero: checks
b130125d: bets $2.73
Hero: folds
Uncalled bet ($2.73) returned to b130125d
Hero: shows [Tc Th] (Pair of Tens and Pair of Fours)
*** SHOWDOWN ***
b130125d collected $3.31 from pot
*** SUMMARY ***
Total pot $3.63 | Rake $0.17 | Jackpot $0.15 | Bingo $0 | Fortune $0
Board [3s 9d 4d 4c]
Seat 1: b130125d (button) won ($3.31)
Seat 2: c415f057 (small blind) folded before Flop
Seat 3: 167e2edc (big blind) folded before Flop
Seat 4: 66ded3d2 folded before Flop (didn't bet)
Seat 5: 550e3b3f folded before Flop (didn't bet)
Seat 6: Hero folded on the Turn


Poker Hand #RC1456705787: Hold'em No Limit  ($0.05/$0.1) - 2023/04/07 11:58:27
Table 'RushAndCash3091047' 6-max Seat #1 is the button
Seat 1: b5998eb7 ($11.23 in chips)
Seat 2: Hero ($9.75 in chips)
Seat 3: 550e3b3f ($10.95 in chips)
Seat 4: 206b55a8 ($10.18 in chips)
Seat 5: 881cf369 ($10.57 in chips)
Seat 6: 6f689ff9 ($8.84 in chips)
Hero: posts small blind $0.05
550e3b3f: posts big blind $0.1
*** HOLE CARDS ***
Dealt to b5998eb7 
Dealt to Hero [Ac 6c]
Dealt to 550e3b3f 
Dealt to 206b55a8 
Dealt to 881cf369 
Dealt to 6f689ff9 
206b55a8: folds
881cf369: folds
6f689ff9: folds
b5998eb7: folds
Hero: raises $0.15 to $0.25
550e3b3f: raises $0.65 to $0.9
Hero: folds
Uncalled bet ($0.65) returned to 550e3b3f
*** SHOWDOWN ***
550e3b3f collected $0.48 from pot
*** SUMMARY ***
Total pot $0.5 | Rake $0.02 | Jackpot $0 | Bingo $0 | Fortune $0
Seat 1: b5998eb7 (button) folded before Flop (didn't bet)
Seat 2: Hero (small blind) folded before Flop
Seat 3: 550e3b3f (big blind) collected ($0.48)
Seat 4: 206b55a8 folded before Flop (didn't bet)
Seat 5: 881cf369 folded before Flop (didn't bet)
Seat 6: 6f689ff9 folded before Flop (didn't bet)


Poker Hand #RC1456670705: Hold'em No Limit  ($0.05/$0.1) - 2023/04/07 11:45:01
Table 'RushAndCash3085965' 6-max Seat #1 is the button
Seat 1: 5f5a1fb4 ($10.06 in chips)
Seat 2: 1f0fa29f ($29.19 in chips)
Seat 3: Hero ($9.85 in chips)
Seat 4: fe374011 ($10 in chips)
Seat 5: e6d7c2b ($10.03 in chips)
Seat 6: 70104101 ($12.7 in chips)
1f0fa29f: posts small blind $0.05
Hero: posts big blind $0.1
*** HOLE CARDS ***
Dealt to 5f5a1fb4 
Dealt to 1f0fa29f 
Dealt to Hero [2h Jh]
Dealt to fe374011 
Dealt to e6d7c2b 
Dealt to 70104101 
fe374011: raises $0.15 to $0.25
e6d7c2b: raises $0.49 to $0.74
70104101: folds
5f5a1fb4: folds
1f0fa29f: folds
Hero: folds
fe374011: calls $0.49
*** FLOP *** [5s Kh 4d]
fe374011: checks
e6d7c2b: bets $0.58
fe374011: calls $0.58
*** TURN *** [5s Kh 4d] [3d]
fe374011: checks
e6d7c2b: bets $2.1
fe374011: folds
Uncalled bet ($2.1) returned to e6d7c2b
*** SHOWDOWN ***
e6d7c2b collected $2.65 from pot
*** SUMMARY ***
Total pot $2.79 | Rake $0.14 | Jackpot $0 | Bingo $0 | Fortune $0
Board [5s Kh 4d 3d]
Seat 1: 5f5a1fb4 (button) folded before Flop (didn't bet)
Seat 2: 1f0fa29f (small blind) folded before Flop
Seat 3: Hero (big blind) folded before Flop
Seat 4: fe374011 folded on the Turn
Seat 5: e6d7c2b won ($2.65)
Seat 6: 70104101 folded before Flop (didn't bet)


Poker Hand #RC1456670667: Hold'em No Limit  ($0.05/$0.1) - 2023/04/07 11:44:54
Table 'RushAndCash3085927' 6-max Seat #1 is the button
Seat 1: b176d6d6 ($11.02 in chips)
Seat 2: 412ceaec ($10.1 in chips)
Seat 3: 3707ce1 ($7.91 in chips)
Seat 4: 6a2a4095 ($12.46 in chips)
Seat 5: Hero ($9.85 in chips)
Seat 6: 29970b33 ($9.19 in chips)
412ceaec: posts small blind $0.05
3707ce1: posts big blind $0.1
*** HOLE CARDS ***
Dealt to b176d6d6 
Dealt to 412ceaec 
Dealt to 3707ce1 
Dealt to 6a2a4095 
Dealt to Hero [4d 4h]
Dealt to 29970b33 
6a2a4095: raises $0.14 to $0.24
Hero: folds
29970b33: folds
b176d6d6: folds
412ceaec: folds
3707ce1: calls $0.14
*** FLOP *** [4s 8s 3h]
3707ce1: checks
6a2a4095: checks
*** TURN *** [4s 8s 3h] [Kc]
3707ce1: checks
6a2a4095: checks
*** RIVER *** [4s 8s 3h Kc] [6c]
3707ce1: checks
6a2a4095: checks
3707ce1: shows [8c Qc] (Pair of Eights)
6a2a4095: shows [9c 9h] (Pair of Nines)
*** SHOWDOWN ***
6a2a4095 collected $0.51 from pot
*** SUMMARY ***
Total pot $0.53 | Rake $0.02 | Jackpot $0 | Bingo $0 | Fortune $0
Board [4s 8s 3h Kc 6c]
Seat 1: b176d6d6 (button) folded before Flop (didn't bet)
Seat 2: 412ceaec (small blind) folded before Flop
Seat 3: 3707ce1 (big blind) showed [8c Qc] and lost with Pair of Eights
Seat 4: 6a2a4095 showed [9c 9h] and won ($0.51) with Pair of Nines
Seat 5: Hero folded before Flop (didn't bet)
Seat 6: 29970b33 folded before Flop (didn't bet)


Poker Hand #RC1456670630: Hold'em No Limit  ($0.05/$0.1) - 2023/04/07 11:44:48
Table 'RushAndCash3085890' 6-max Seat #1 is the button
Seat 1: Hero ($9.85 in chips)
Seat 2: c31e8880 ($17.57 in chips)
Seat 3: 35cffacc ($10.02 in chips)
Seat 4: 26a40f5e ($10.57 in chips)
Seat 5: 8df60157 ($11.73 in chips)
Seat 6: 5b97ef9b ($15.59 in chips)
c31e8880: posts small blind $0.05
35cffacc: posts big blind $0.1
*** HOLE CARDS ***
Dealt to Hero [2s 5d]
Dealt to c31e8880 
Dealt to 35cffacc 
Dealt to 26a40f5e 
Dealt to 8df60157 
Dealt to 5b97ef9b 
26a40f5e: folds
8df60157: raises $0.15 to $0.25
5b97ef9b: folds
Hero: folds
c31e8880: folds
35cffacc: folds
Uncalled bet ($0.15) returned to 8df60157
*** SHOWDOWN ***
8df60157 collected $0.25 from pot
*** SUMMARY ***
Total pot $0.25 | Rake $0 | Jackpot $0 | Bingo $0 | Fortune $0
Seat 1: Hero (button) folded before Flop (didn't bet)
Seat 2: c31e8880 (small blind) folded before Flop
Seat 3: 35cffacc (big blind) folded before Flop
Seat 4: 26a40f5e folded before Flop (didn't bet)
Seat 5: 8df60157 collected ($0.25)
Seat 6: 5b97ef9b folded before Flop (didn't bet)


Poker Hand #RC1456670607: Hold'em No Limit  ($0.05/$0.1) - 2023/04/07 11:44:43
Table 'RushAndCash3085867' 6-max Seat #1 is the button
Seat 1: 8df60157 ($11.73 in chips)
Seat 2: Hero ($9.9 in chips)
Seat 3: 74df6125 ($23.91 in chips)
Seat 4: 4a52059f ($20.83 in chips)
Seat 5: 98f3d295 ($17.53 in chips)
Seat 6: 79a60d2a ($10 in chips)
Hero: posts small blind $0.05
74df6125: posts big blind $0.1
*** HOLE CARDS ***
Dealt to 8df60157 
Dealt to Hero [4d 9s]
Dealt to 74df6125 
Dealt to 4a52059f 
Dealt to 98f3d295 
Dealt to 79a60d2a 
4a52059f: folds
98f3d295: folds
79a60d2a: folds
8df60157: folds
Hero: folds
Uncalled bet ($0.05) returned to 74df6125
*** SHOWDOWN ***
74df6125 collected $0.1 from pot
*** SUMMARY ***
Total pot $0.1 | Rake $0 | Jackpot $0 | Bingo $0 | Fortune $0
Seat 1: 8df60157 (button) folded before Flop (didn't bet)
Seat 2: Hero (small blind) folded before Flop
Seat 3: 74df6125 (big blind) collected ($0.1)
Seat 4: 4a52059f folded before Flop (didn't bet)
Seat 5: 98f3d295 folded before Flop (didn't bet)
Seat 6: 79a60d2a folded before Flop (didn't bet)


Poker Hand #RC1456670546: Hold'em No Limit  ($0.05/$0.1) - 2023/04/07 11:44:34
Table 'RushAndCash3085806' 6-max Seat #1 is the button
Seat 1: 70d1c97f ($17.41 in chips)
Seat 2: aec249b9 ($11.16 in chips)
Seat 3: 9ad10009 ($14.83 in chips)
Seat 4: bdaff43d ($10 in chips)
Seat 5: Hero ($9.9 in chips)
Seat 6: 35cffacc ($10.02 in chips)
aec249b9: posts small blind $0.05
9ad10009: posts big blind $0.1
*** HOLE CARDS ***
Dealt to 70d1c97f 
Dealt to aec249b9 
Dealt to 9ad10009 
Dealt to bdaff43d 
Dealt to Hero [6d 5h]
Dealt to 35cffacc 
bdaff43d: folds
Hero: folds
35cffacc: folds
70d1c97f: raises $0.1 to $0.2
aec249b9: folds
9ad10009: folds
Uncalled bet ($0.1) returned to 70d1c97f
*** SHOWDOWN ***
70d1c97f collected $0.25 from pot
*** SUMMARY ***
Total pot $0.25 | Rake $0 | Jackpot $0 | Bingo $0 | Fortune $0
Seat 1: 70d1c97f (button) collected ($0.25)
Seat 2: aec249b9 (small blind) folded before Flop
Seat 3: 9ad10009 (big blind) folded before Flop
Seat 4: bdaff43d folded before Flop (didn't bet)
Seat 5: Hero folded before Flop (didn't bet)
Seat 6: 35cffacc folded before Flop (didn't bet)


Poker Hand #RC1456670480: Hold'em No Limit  ($0.05/$0.1) - 2023/04/07 11:44:25
Table 'RushAndCash3085740' 6-max Seat #1 is the button
Seat 1: 1fce2ae1 ($10.2 in chips)
Seat 2: 9a5b8515 ($16.75 in chips)
Seat 3: Hero ($10 in chips)
Seat 4: f9b46dd1 ($10 in chips)
Seat 5: 731a886e ($10.06 in chips)
Seat 6: 42c8ca5a ($10.86 in chips)
9a5b8515: posts small blind $0.05
Hero: posts big blind $0.1
*** HOLE CARDS ***
Dealt to 1fce2ae1 
Dealt to 9a5b8515 
Dealt to Hero [2h Kh]
Dealt to f9b46dd1 
Dealt to 731a886e 
Dealt to 42c8ca5a 
f9b46dd1: folds
731a886e: folds
42c8ca5a: raises $0.13 to $0.23
1fce2ae1: folds
9a5b8515: folds
Hero: folds
Uncalled bet ($0.13) returned to 42c8ca5a
*** SHOWDOWN ***
42c8ca5a collected $0.25 from pot
*** SUMMARY ***
Total pot $0.25 | Rake $0 | Jackpot $0 | Bingo $0 | Fortune $0
Seat 1: 1fce2ae1 (button) folded before Flop (didn't bet)
Seat 2: 9a5b8515 (small blind) folded before Flop
Seat 3: Hero (big blind) folded before Flop
Seat 4: f9b46dd1 folded before Flop (didn't bet)
Seat 5: 731a886e folded before Flop (didn't bet)
Seat 6: 42c8ca5a collected ($0.25)


Poker Hand #RC1456669854: Hold'em No Limit  ($0.05/$0.1) - 2023/04/07 11:42:52
Table 'RushAndCash3085114' 6-max Seat #1 is the button
Seat 1: 3bfa9b27 ($16.32 in chips)
Seat 2: 2ad7d0ec ($10 in chips)
Seat 3: 147c8405 ($10.12 in chips)
Seat 4: Hero ($5.74 in chips)
Seat 5: 9a36b824 ($10.81 in chips)
Seat 6: c1b510d9 ($74.67 in chips)
2ad7d0ec: posts small blind $0.05
147c8405: posts big blind $0.1
*** HOLE CARDS ***
Dealt to 3bfa9b27 
Dealt to 2ad7d0ec 
Dealt to 147c8405 
Dealt to Hero [Qh As]
Dealt to 9a36b824 
Dealt to c1b510d9 
Hero: raises $0.15 to $0.25
9a36b824: folds
c1b510d9: raises $0.65 to $0.9
3bfa9b27: folds
2ad7d0ec: folds
147c8405: folds
Hero: calls $0.65
*** FLOP *** [Qc 4h 4s]
Hero: checks
c1b510d9: bets $0.49
Hero: calls $0.49
*** TURN *** [Qc 4h 4s] [5s]
Hero: checks
c1b510d9: bets $1.3
Hero: calls $1.3
*** RIVER *** [Qc 4h 4s 5s] [5h]
Hero: checks
c1b510d9: bets $71.98 and is all-in
Hero: calls $3.05 and is all-in
Uncalled bet ($68.93) returned to c1b510d9
c1b510d9: shows [Ks Kc] (Pair of Kings and Pair of Fives)
Hero: shows [Qh As] (Pair of Queens and Pair of Fives)
*** SHOWDOWN ***
c1b510d9 collected $11.18 from pot
*** SUMMARY ***
Total pot $11.63 | Rake $0.3 | Jackpot $0.15 | Bingo $0 | Fortune $0
Board [Qc 4h 4s 5s 5h]
Seat 1: 3bfa9b27 (button) folded before Flop (didn't bet)
Seat 2: 2ad7d0ec (small blind) folded before Flop
Seat 3: 147c8405 (big blind) folded before Flop
Seat 4: Hero showed [Qh As] and lost with Pair of Queens and Pair of Fives
Seat 5: 9a36b824 folded before Flop (didn't bet)
Seat 6: c1b510d9 showed [Ks Kc] and won ($11.18) with Pair of Kings and Pair of Fives


Poker Hand #RC1456669820: Hold'em No Limit  ($0.05/$0.1) - 2023/04/07 11:42:45
Table 'RushAndCash3085080' 6-max Seat #1 is the button
Seat 1: Hero ($5.74 in chips)
Seat 2: bac23024 ($18.97 in chips)
Seat 3: 4856e750 ($10.25 in chips)
Seat 4: 31461e63 ($9.14 in chips)
Seat 5: 4a36695a ($12.85 in chips)
Seat 6: 528d16ff ($8.23 in chips)
bac23024: posts small blind $0.05
4856e750: posts big blind $0.1
*** HOLE CARDS ***
Dealt to Hero [7c 9h]
Dealt to bac23024 
Dealt to 4856e750 
Dealt to 31461e63 
Dealt to 4a36695a 
Dealt to 528d16ff 
31461e63: folds
4a36695a: folds
528d16ff: folds
Hero: folds
bac23024: folds
Uncalled bet ($0.05) returned to 4856e750
*** SHOWDOWN ***
4856e750 collected $0.1 from pot
*** SUMMARY ***
Total pot $0.1 | Rake $0 | Jackpot $0 | Bingo $0 | Fortune $0
Seat 1: Hero (button) folded before Flop (didn't bet)
Seat 2: bac23024 (small blind) folded before Flop
Seat 3: 4856e750 (big blind) collected ($0.1)
Seat 4: 31461e63 folded before Flop (didn't bet)
Seat 5: 4a36695a folded before Flop (didn't bet)
Seat 6: 528d16ff folded before Flop (didn't bet)


Poker Hand #RC1456669746: Hold'em No Limit  ($0.05/$0.1) - 2023/04/07 11:42:31
Table 'RushAndCash3085006' 6-max Seat #1 is the button
Seat 1: bd484c10 ($15.84 in chips)
Seat 2: e1c7cbfe ($12.66 in chips)
Seat 3: 5424f0c7 ($14.32 in chips)
Seat 4: Hero ($5.99 in chips)
Seat 5: 4ff762de ($10.15 in chips)
Seat 6: fb335bf6 ($10.05 in chips)
e1c7cbfe: posts small blind $0.05
5424f0c7: posts big blind $0.1
*** HOLE CARDS ***
Dealt to bd484c10 
Dealt to e1c7cbfe 
Dealt to 5424f0c7 
Dealt to Hero [Kh Jd]
Dealt to 4ff762de 
Dealt to fb335bf6 
Hero: raises $0.15 to $0.25
4ff762de: raises $0.55 to $0.8
fb335bf6: raises $1.32 to $2.12
bd484c10: folds
e1c7cbfe: folds
5424f0c7: folds
Hero: folds
4ff762de: folds
Uncalled bet ($1.32) returned to fb335bf6
*** SHOWDOWN ***
fb335bf6 collected $1.9 from pot
*** SUMMARY ***
Total pot $2 | Rake $0.1 | Jackpot $0 | Bingo $0 | Fortune $0
Seat 1: bd484c10 (button) folded before Flop (didn't bet)
Seat 2: e1c7cbfe (small blind) folded before Flop
Seat 3: 5424f0c7 (big blind) folded before Flop
Seat 4: Hero folded before Flop
Seat 5: 4ff762de folded before Flop
Seat 6: fb335bf6 collected ($1.9)


Poker Hand #RC1456669709: Hold'em No Limit  ($0.05/$0.1) - 2023/04/07 11:42:27
Table 'RushAndCash3084969' 6-max Seat #1 is the button
Seat 1: f44784c2 ($11.88 in chips)
Seat 2: 29bded5b ($11.05 in chips)
Seat 3: 3e7d5428 ($10.65 in chips)
Seat 4: Hero ($5.99 in chips)
Seat 5: f210b1d ($17.43 in chips)
Seat 6: cdc348a4 ($10.27 in chips)
29bded5b: posts small blind $0.05
3e7d5428: posts big blind $0.1
*** HOLE CARDS ***
Dealt to f44784c2 
Dealt to 29bded5b 
Dealt to 3e7d5428 
Dealt to Hero [Js 6s]
Dealt to f210b1d 
Dealt to cdc348a4 
Hero: folds
f210b1d: raises $0.1 to $0.2
cdc348a4: folds
f44784c2: folds
29bded5b: folds
3e7d5428: folds
Uncalled bet ($0.1) returned to f210b1d
*** SHOWDOWN ***
f210b1d collected $0.25 from pot
*** SUMMARY ***
Total pot $0.25 | Rake $0 | Jackpot $0 | Bingo $0 | Fortune $0
Seat 1: f44784c2 (button) folded before Flop (didn't bet)
Seat 2: 29bded5b (small blind) folded before Flop
Seat 3: 3e7d5428 (big blind) folded before Flop
Seat 4: Hero folded before Flop (didn't bet)
Seat 5: f210b1d collected ($0.25)
Seat 6: cdc348a4 folded before Flop (didn't bet)


Poker Hand #RC1456669473: Hold'em No Limit  ($0.05/$0.1) - 2023/04/07 11:41:49
Table 'RushAndCash3084733' 6-max Seat #1 is the button
Seat 1: 41db8f8 ($11.08 in chips)
Seat 2: f44784c2 ($11.38 in chips)
Seat 3: Hero ($6.54 in chips)
Seat 4: 44afbdfe ($8.74 in chips)
Seat 5: 79af5cde ($10.44 in chips)
Seat 6: bac23024 ($19.37 in chips)
f44784c2: posts small blind $0.05
Hero: posts big blind $0.1
*** HOLE CARDS ***
Dealt to 41db8f8 
Dealt to f44784c2 
Dealt to Hero [Ts Jc]
Dealt to 44afbdfe 
Dealt to 79af5cde 
Dealt to bac23024 
44afbdfe: folds
79af5cde: folds
bac23024: folds
41db8f8: folds
f44784c2: raises $0.1 to $0.2
Hero: raises $0.35 to $0.55
f44784c2: calls $0.35
*** FLOP *** [5h Qs Qd]
f44784c2: checks
Hero: checks
*** TURN *** [5h Qs Qd] [5d]
f44784c2: bets $0.37
Hero: folds
Uncalled bet ($0.37) returned to f44784c2
*** SHOWDOWN ***
f44784c2 collected $1.05 from pot
*** SUMMARY ***
Total pot $1.1 | Rake $0.05 | Jackpot $0 | Bingo $0 | Fortune $0
Board [5h Qs Qd 5d]
Seat 1: 41db8f8 (button) folded before Flop (didn't bet)
Seat 2: f44784c2 (small blind) won ($1.05)
Seat 3: Hero (big blind) folded on the Turn
Seat 4: 44afbdfe folded before Flop (didn't bet)
Seat 5: 79af5cde folded before Flop (didn't bet)
Seat 6: bac23024 folded before Flop (didn't bet)


Poker Hand #RC1456669222: Hold'em No Limit  ($0.05/$0.1) - 2023/04/07 11:41:09
Table 'RushAndCash3084482' 6-max Seat #1 is the button
Seat 1: Hero ($6.26 in chips)
Seat 2: 7b2952c ($18.95 in chips)
Seat 3: f44784c2 ($11.63 in chips)
Seat 4: 7438d908 ($14.3 in chips)
Seat 5: 6d6c7d36 ($9.85 in chips)
Seat 6: 1f20c338 ($5.06 in chips)
7b2952c: posts small blind $0.05
f44784c2: posts big blind $0.1
*** HOLE CARDS ***
Dealt to Hero [As Kc]
Dealt to 7b2952c 
Dealt to f44784c2 
Dealt to 7438d908 
Dealt to 6d6c7d36 
Dealt to 1f20c338 
7438d908: folds
6d6c7d36: folds
1f20c338: folds
Hero: raises $0.15 to $0.25
7b2952c: folds
f44784c2: calls $0.15
*** FLOP *** [7d Kd Ks]
f44784c2: checks
Hero: checks
*** TURN *** [7d Kd Ks] [Js]
f44784c2: checks
Hero: bets $0.37
f44784c2: folds
Uncalled bet ($0.37) returned to Hero
*** SHOWDOWN ***
Hero collected $0.53 from pot
*** SUMMARY ***
Total pot $0.55 | Rake $0.02 | Jackpot $0 | Bingo $0 | Fortune $0
Board [7d Kd Ks Js]
Seat 1: Hero (button) won ($0.53)
Seat 2: 7b2952c (small blind) folded before Flop
Seat 3: f44784c2 (big blind) folded on the Turn
Seat 4: 7438d908 folded before Flop (didn't bet)
Seat 5: 6d6c7d36 folded before Flop (didn't bet)
Seat 6: 1f20c338 folded before Flop (didn't bet)


Poker Hand #RC1456669174: Hold'em No Limit  ($0.05/$0.1) - 2023/04/07 11:41:01
Table 'RushAndCash3084434' 6-max Seat #1 is the button
Seat 1: 79a60d2a ($10 in chips)
Seat 2: 9f9e168c ($12.32 in chips)
Seat 3: 1a24d8df ($8.61 in chips)
Seat 4: Hero ($6.26 in chips)
Seat 5: f210b1d ($17.93 in chips)
Seat 6: e7c4d09f ($11.2 in chips)
9f9e168c: posts small blind $0.05
1a24d8df: posts big blind $0.1
*** HOLE CARDS ***
Dealt to 79a60d2a 
Dealt to 9f9e168c 
Dealt to 1a24d8df 
Dealt to Hero [9d Js]
Dealt to f210b1d 
Dealt to e7c4d09f 
Hero: folds
f210b1d: raises $0.1 to $0.2
e7c4d09f: folds
79a60d2a: folds
9f9e168c: folds
1a24d8df: raises $0.1 to $0.3
f210b1d: calls $0.1
*** FLOP *** [6d Kc 8s]
1a24d8df: bets $0.65
f210b1d: folds
Uncalled bet ($0.65) returned to 1a24d8df
*** SHOWDOWN ***
1a24d8df collected $0.62 from pot
*** SUMMARY ***
Total pot $0.65 | Rake $0.03 | Jackpot $0 | Bingo $0 | Fortune $0
Board [6d Kc 8s]
Seat 1: 79a60d2a (button) folded before Flop (didn't bet)
Seat 2: 9f9e168c (small blind) folded before Flop
Seat 3: 1a24d8df (big blind) won ($0.62)
Seat 4: Hero folded before Flop (didn't bet)
Seat 5: f210b1d folded on the Flop
Seat 6: e7c4d09f folded before Flop (didn't bet)


Poker Hand #RC1456669070: Hold'em No Limit  ($0.05/$0.1) - 2023/04/07 11:40:45
Table 'RushAndCash3084330' 6-max Seat #1 is the button
Seat 1: f32a40db ($12.41 in chips)
Seat 2: Hero ($6.31 in chips)
Seat 3: d92b90f6 ($11.72 in chips)
Seat 4: 581573e3 ($10.54 in chips)
Seat 5: 58fb9a3a ($12.28 in chips)
Seat 6: 67d0f872 ($10.23 in chips)
Hero: posts small blind $0.05
d92b90f6: posts big blind $0.1
*** HOLE CARDS ***
Dealt to f32a40db 
Dealt to Hero [5h Jh]
Dealt to d92b90f6 
Dealt to 581573e3 
Dealt to 58fb9a3a 
Dealt to 67d0f872 
581573e3: folds
58fb9a3a: folds
67d0f872: folds
f32a40db: folds
Hero: folds
Uncalled bet ($0.05) returned to d92b90f6
*** SHOWDOWN ***
d92b90f6 collected $0.1 from pot
*** SUMMARY ***
Total pot $0.1 | Rake $0 | Jackpot $0 | Bingo $0 | Fortune $0
Seat 1: f32a40db (button) folded before Flop (didn't bet)
Seat 2: Hero (small blind) folded before Flop
Seat 3: d92b90f6 (big blind) collected ($0.1)
Seat 4: 581573e3 folded before Flop (didn't bet)
Seat 5: 58fb9a3a folded before Flop (didn't bet)
Seat 6: 67d0f872 folded before Flop (didn't bet)


Poker Hand #RC1456668995: Hold'em No Limit  ($0.05/$0.1) - 2023/04/07 11:40:32
Table 'RushAndCash3084255' 6-max Seat #1 is the button
Seat 1: d2993e12 ($10.27 in chips)
Seat 2: 72fa4a17 ($9.55 in chips)
Seat 3: Hero ($6.41 in chips)
Seat 4: 8ab2ecff ($10 in chips)
Seat 5: c7b38c77 ($16.55 in chips)
Seat 6: d277d7cb ($18.1 in chips)
72fa4a17: posts small blind $0.05
Hero: posts big blind $0.1
*** HOLE CARDS ***
Dealt to d2993e12 
Dealt to 72fa4a17 
Dealt to Hero [Qs 3c]
Dealt to 8ab2ecff 
Dealt to c7b38c77 
Dealt to d277d7cb 
8ab2ecff: folds
c7b38c77: folds
d277d7cb: raises $0.12 to $0.22
d2993e12: folds
72fa4a17: folds
Hero: folds
Uncalled bet ($0.12) returned to d277d7cb
*** SHOWDOWN ***
d277d7cb collected $0.25 from pot
*** SUMMARY ***
Total pot $0.25 | Rake $0 | Jackpot $0 | Bingo $0 | Fortune $0
Seat 1: d2993e12 (button) folded before Flop (didn't bet)
Seat 2: 72fa4a17 (small blind) folded before Flop
Seat 3: Hero (big blind) folded before Flop
Seat 4: 8ab2ecff folded before Flop (didn't bet)
Seat 5: c7b38c77 folded before Flop (didn't bet)
Seat 6: d277d7cb collected ($0.25)


Poker Hand #RC1456668961: Hold'em No Limit  ($0.05/$0.1) - 2023/04/07 11:40:27
Table 'RushAndCash3084221' 6-max Seat #1 is the button
Seat 1: bc6bd61c ($10 in chips)
Seat 2: 97a13df2 ($9.7 in chips)
Seat 3: 256287a6 ($8.49 in chips)
Seat 4: Hero ($6.41 in chips)
Seat 5: 7d6f9e9 ($10.49 in chips)
Seat 6: 73382020 ($7.72 in chips)
97a13df2: posts small blind $0.05
256287a6: posts big blind $0.1
*** HOLE CARDS ***
Dealt to bc6bd61c 
Dealt to 97a13df2 
Dealt to 256287a6 
Dealt to Hero [6d 3h]
Dealt to 7d6f9e9 
Dealt to 73382020 
Hero: folds
7d6f9e9: folds
73382020: folds
bc6bd61c: raises $0.12 to $0.22
97a13df2: folds
256287a6: folds
Uncalled bet ($0.12) returned to bc6bd61c
*** SHOWDOWN ***
bc6bd61c collected $0.25 from pot
*** SUMMARY ***
Total pot $0.25 | Rake $0 | Jackpot $0 | Bingo $0 | Fortune $0
Seat 1: bc6bd61c (button) collected ($0.25)
Seat 2: 97a13df2 (small blind) folded before Flop
Seat 3: 256287a6 (big blind) folded before Flop
Seat 4: Hero folded before Flop (didn't bet)
Seat 5: 7d6f9e9 folded before Flop (didn't bet)
Seat 6: 73382020 folded before Flop (didn't bet)


Poker Hand #RC1456668874: Hold'em No Limit  ($0.05/$0.1) - 2023/04/07 11:40:12
Table 'RushAndCash3084134' 6-max Seat #1 is the button
Seat 1: 530b6848 ($10.86 in chips)
Seat 2: Hero ($6.46 in chips)
Seat 3: e6649e7b ($19.78 in chips)
Seat 4: 204fb5f0 ($29.73 in chips)
Seat 5: 98f3d295 ($15.79 in chips)
Seat 6: bac23024 ($19.47 in chips)
Hero: posts small blind $0.05
e6649e7b: posts big blind $0.1
*** HOLE CARDS ***
Dealt to 530b6848 
Dealt to Hero [Ac 7d]
Dealt to e6649e7b 
Dealt to 204fb5f0 
Dealt to 98f3d295 
Dealt to bac23024 
204fb5f0: folds
98f3d295: folds
bac23024: raises $0.15 to $0.25
530b6848: folds
Hero: folds
e6649e7b: calls $0.15
*** FLOP *** [Ts Kh 5h]
e6649e7b: checks
bac23024: checks
*** TURN *** [Ts Kh 5h] [3c]
e6649e7b: bets $0.74
bac23024: folds
Uncalled bet ($0.74) returned to e6649e7b
*** SHOWDOWN ***
e6649e7b collected $0.53 from pot
*** SUMMARY ***
Total pot $0.55 | Rake $0.02 | Jackpot $0 | Bingo $0 | Fortune $0
Board [Ts Kh 5h 3c]
Seat 1: 530b6848 (button) folded before Flop (didn't bet)
Seat 2: Hero (small blind) folded before Flop
Seat 3: e6649e7b (big blind) won ($0.53)
Seat 4: 204fb5f0 folded before Flop (didn't bet)
Seat 5: 98f3d295 folded before Flop (didn't bet)
Seat 6: bac23024 folded on the Turn


Poker Hand #RC1456668827: Hold'em No Limit  ($0.05/$0.1) - 2023/04/07 11:40:05
Table 'RushAndCash3084087' 6-max Seat #1 is the button
Seat 1: e7cbc97d ($10 in chips)
Seat 2: f206c335 ($9.39 in chips)
Seat 3: 9c5a851 ($10 in chips)
Seat 4: 810f5bf9 ($22.98 in chips)
Seat 5: 1daea4eb ($18.02 in chips)
Seat 6: Hero ($6.46 in chips)
f206c335: posts small blind $0.05
9c5a851: posts big blind $0.1
*** HOLE CARDS ***
Dealt to e7cbc97d 
Dealt to f206c335 
Dealt to 9c5a851 
Dealt to 810f5bf9 
Dealt to 1daea4eb 
Dealt to Hero [Js 5h]
810f5bf9: folds
1daea4eb: folds
Hero: folds
e7cbc97d: raises $0.2 to $0.3
f206c335: folds
9c5a851: folds
Uncalled bet ($0.2) returned to e7cbc97d
*** SHOWDOWN ***
e7cbc97d collected $0.25 from pot
*** SUMMARY ***
Total pot $0.25 | Rake $0 | Jackpot $0 | Bingo $0 | Fortune $0
Seat 1: e7cbc97d (button) collected ($0.25)
Seat 2: f206c335 (small blind) folded before Flop
Seat 3: 9c5a851 (big blind) folded before Flop
Seat 4: 810f5bf9 folded before Flop (didn't bet)
Seat 5: 1daea4eb folded before Flop (didn't bet)
Seat 6: Hero folded before Flop (didn't bet)


Poker Hand #RC1456668788: Hold'em No Limit  ($0.05/$0.1) - 2023/04/07 11:39:58
Table 'RushAndCash3084048' 6-max Seat #1 is the button
Seat 1: 5ebaddcd ($10 in chips)
Seat 2: 93e498ca ($9.52 in chips)
Seat 3: 1039213d ($10.3 in chips)
Seat 4: ebf31bad ($10 in chips)
Seat 5: Hero ($6.46 in chips)
Seat 6: ee3612a ($13.79 in chips)
93e498ca: posts small blind $0.05
1039213d: posts big blind $0.1
*** HOLE CARDS ***
Dealt to 5ebaddcd 
Dealt to 93e498ca 
Dealt to 1039213d 
Dealt to ebf31bad 
Dealt to Hero [9d Jh]
Dealt to ee3612a 
ebf31bad: folds
Hero: folds
ee3612a: raises $0.2 to $0.3
5ebaddcd: folds
93e498ca: folds
1039213d: folds
Uncalled bet ($0.2) returned to ee3612a
*** SHOWDOWN ***
ee3612a collected $0.25 from pot
*** SUMMARY ***
Total pot $0.25 | Rake $0 | Jackpot $0 | Bingo $0 | Fortune $0
Seat 1: 5ebaddcd (button) folded before Flop (didn't bet)
Seat 2: 93e498ca (small blind) folded before Flop
Seat 3: 1039213d (big blind) folded before Flop
Seat 4: ebf31bad folded before Flop (didn't bet)
Seat 5: Hero folded before Flop (didn't bet)
Seat 6: ee3612a collected ($0.25)


Poker Hand #RC1456668669: Hold'em No Limit  ($0.05/$0.1) - 2023/04/07 11:39:39
Table 'RushAndCash3083929' 6-max Seat #1 is the button
Seat 1: Hero ($6.46 in chips)
Seat 2: f6a067f ($10.89 in chips)
Seat 3: 53a19511 ($74.23 in chips)
Seat 4: 1754e524 ($10 in chips)
Seat 5: b6b2204f ($30.35 in chips)
Seat 6: 6be17b56 ($10.24 in chips)
f6a067f: posts small blind $0.05
53a19511: posts big blind $0.1
*** HOLE CARDS ***
Dealt to Hero [2h 4s]
Dealt to f6a067f 
Dealt to 53a19511 
Dealt to 1754e524 
Dealt to b6b2204f 
Dealt to 6be17b56 
1754e524: folds
b6b2204f: raises $0.15 to $0.25
6be17b56: folds
Hero: folds
f6a067f: raises $0.15 to $0.4
53a19511: folds
b6b2204f: calls $0.15
*** FLOP *** [9d Jh 9h]
f6a067f: checks
b6b2204f: bets $0.3
f6a067f: calls $0.3
*** TURN *** [9d Jh 9h] [6d]
f6a067f: checks
b6b2204f: checks
*** RIVER *** [9d Jh 9h 6d] [Jc]
f6a067f: checks
b6b2204f: bets $0.75
f6a067f: folds
Uncalled bet ($0.75) returned to b6b2204f
*** SHOWDOWN ***
b6b2204f collected $1.43 from pot
*** SUMMARY ***
Total pot $1.5 | Rake $0.07 | Jackpot $0 | Bingo $0 | Fortune $0
Board [9d Jh 9h 6d Jc]
Seat 1: Hero (button) folded before Flop (didn't bet)
Seat 2: f6a067f (small blind) folded on the River
Seat 3: 53a19511 (big blind) folded before Flop
Seat 4: 1754e524 folded before Flop (didn't bet)
Seat 5: b6b2204f won ($1.43)
Seat 6: 6be17b56 folded before Flop (didn't bet)


Poker Hand #RC1456668617: Hold'em No Limit  ($0.05/$0.1) - 2023/04/07 11:39:31
Table 'RushAndCash3083877' 6-max Seat #1 is the button
Seat 1: b6b2204f ($30.35 in chips)
Seat 2: 5a5585ac ($25.61 in chips)
Seat 3: ac0e72fc ($15.69 in chips)
Seat 4: f585eef5 ($2.11 in chips)
Seat 5: Hero ($6.46 in chips)
Seat 6: 910e93dc ($10 in chips)
5a5585ac: posts small blind $0.05
ac0e72fc: posts big blind $0.1
*** HOLE CARDS ***
Dealt to b6b2204f 
Dealt to 5a5585ac 
Dealt to ac0e72fc 
Dealt to f585eef5 
Dealt to Hero [7d 5s]
Dealt to 910e93dc 
f585eef5: folds
Hero: folds
910e93dc: folds
b6b2204f: folds
5a5585ac: folds
Uncalled bet ($0.05) returned to ac0e72fc
*** SHOWDOWN ***
ac0e72fc collected $0.1 from pot
*** SUMMARY ***
Total pot $0.1 | Rake $0 | Jackpot $0 | Bingo $0 | Fortune $0
Seat 1: b6b2204f (button) folded before Flop (didn't bet)
Seat 2: 5a5585ac (small blind) folded before Flop
Seat 3: ac0e72fc (big blind) collected ($0.1)
Seat 4: f585eef5 folded before Flop (didn't bet)
Seat 5: Hero folded before Flop (didn't bet)
Seat 6: 910e93dc folded before Flop (didn't bet)


Poker Hand #RC1456668571: Hold'em No Limit  ($0.05/$0.1) - 2023/04/07 11:39:24
Table 'RushAndCash3083831' 6-max Seat #1 is the button
Seat 1: a4380876 ($11.14 in chips)
Seat 2: 4522d87 ($10 in chips)
Seat 3: ee7d8556 ($10 in chips)
Seat 4: Hero ($6.46 in chips)
Seat 5: 6be73340 ($13.39 in chips)
Seat 6: 530b6848 ($11.11 in chips)
4522d87: posts small blind $0.05
ee7d8556: posts big blind $0.1
*** HOLE CARDS ***
Dealt to a4380876 
Dealt to 4522d87 
Dealt to ee7d8556 
Dealt to Hero [9d 8d]
Dealt to 6be73340 
Dealt to 530b6848 
Hero: folds
6be73340: folds
530b6848: folds
a4380876: folds
4522d87: raises $0.2 to $0.3
ee7d8556: folds
Uncalled bet ($0.2) returned to 4522d87
*** SHOWDOWN ***
4522d87 collected $0.2 from pot
*** SUMMARY ***
Total pot $0.2 | Rake $0 | Jackpot $0 | Bingo $0 | Fortune $0
Seat 1: a4380876 (button) folded before Flop (didn't bet)
Seat 2: 4522d87 (small blind) collected ($0.2)
Seat 3: ee7d8556 (big blind) folded before Flop
Seat 4: Hero folded before Flop (didn't bet)
Seat 5: 6be73340 folded before Flop (didn't bet)
Seat 6: 530b6848 folded before Flop (didn't bet)


Poker Hand #RC1456668537: Hold'em No Limit  ($0.05/$0.1) - 2023/04/07 11:39:19
Table 'RushAndCash3083797' 6-max Seat #1 is the button
Seat 1: Hero ($6.46 in chips)
Seat 2: 617f565c ($10 in chips)
Seat 3: b86c2fb2 ($11.91 in chips)
Seat 4: 2bfd1b14 ($15.32 in chips)
Seat 5: ed7ccdc6 ($18.71 in chips)
Seat 6: 5a5585ac ($25.31 in chips)
617f565c: posts small blind $0.05
b86c2fb2: posts big blind $0.1
*** HOLE CARDS ***
Dealt to Hero [6s Jh]
Dealt to 617f565c 
Dealt to b86c2fb2 
Dealt to 2bfd1b14 
Dealt to ed7ccdc6 
Dealt to 5a5585ac 
2bfd1b14: folds
ed7ccdc6: folds
5a5585ac: raises $0.13 to $0.23
Hero: folds
617f565c: folds
b86c2fb2: folds
Uncalled bet ($0.13) returned to 5a5585ac
*** SHOWDOWN ***
5a5585ac collected $0.25 from pot
*** SUMMARY ***
Total pot $0.25 | Rake $0 | Jackpot $0 | Bingo $0 | Fortune $0
Seat 1: Hero (button) folded before Flop (didn't bet)
Seat 2: 617f565c (small blind) folded before Flop
Seat 3: b86c2fb2 (big blind) folded before Flop
Seat 4: 2bfd1b14 folded before Flop (didn't bet)
Seat 5: ed7ccdc6 folded before Flop (didn't bet)
Seat 6: 5a5585ac collected ($0.25)


Poker Hand #RC1456668465: Hold'em No Limit  ($0.05/$0.1) - 2023/04/07 11:39:07
Table 'RushAndCash3083725' 6-max Seat #1 is the button
Seat 1: 63bf279 ($10.99 in chips)
Seat 2: Hero ($6.36 in chips)
Seat 3: c4d9b1c0 ($9.21 in chips)
Seat 4: 6c625696 ($9 in chips)
Seat 5: ea5c4cab ($10.15 in chips)
Seat 6: 617f565c ($10 in chips)
Hero: posts small blind $0.05
c4d9b1c0: posts big blind $0.1
*** HOLE CARDS ***
Dealt to 63bf279 
Dealt to Hero [8s Qh]
Dealt to c4d9b1c0 
Dealt to 6c625696 
Dealt to ea5c4cab 
Dealt to 617f565c 
6c625696: folds
ea5c4cab: folds
617f565c: folds
63bf279: folds
Hero: raises $0.2 to $0.3
c4d9b1c0: folds
Uncalled bet ($0.2) returned to Hero
*** SHOWDOWN ***
Hero collected $0.2 from pot
*** SUMMARY ***
Total pot $0.2 | Rake $0 | Jackpot $0 | Bingo $0 | Fortune $0
Seat 1: 63bf279 (button) folded before Flop (didn't bet)
Seat 2: Hero (small blind) collected ($0.2)
Seat 3: c4d9b1c0 (big blind) folded before Flop
Seat 4: 6c625696 folded before Flop (didn't bet)
Seat 5: ea5c4cab folded before Flop (didn't bet)
Seat 6: 617f565c folded before Flop (didn't bet)


Poker Hand #RC1456668435: Hold'em No Limit  ($0.05/$0.1) - 2023/04/07 11:39:01
Table 'RushAndCash3083695' 6-max Seat #1 is the button
Seat 1: f56d4f3a ($3.73 in chips)
Seat 2: 78263b8b ($21.69 in chips)
Seat 3: 49d6d1f1 ($10.29 in chips)
Seat 4: cc012293 ($10.5 in chips)
Seat 5: 28d6b5ec ($20.94 in chips)
Seat 6: Hero ($6.36 in chips)
78263b8b: posts small blind $0.05
49d6d1f1: posts big blind $0.1
*** HOLE CARDS ***
Dealt to f56d4f3a 
Dealt to 78263b8b 
Dealt to 49d6d1f1 
Dealt to cc012293 
Dealt to 28d6b5ec 
Dealt to Hero [6c 9c]
cc012293: folds
28d6b5ec: folds
Hero: folds
f56d4f3a: folds
78263b8b: calls $0.05
49d6d1f1: checks
*** FLOP *** [Tc Kc Kd]
78263b8b: checks
49d6d1f1: checks
*** TURN *** [Tc Kc Kd] [Jh]
78263b8b: bets $0.1
49d6d1f1: folds
Uncalled bet ($0.1) returned to 78263b8b
*** SHOWDOWN ***
78263b8b collected $0.19 from pot
*** SUMMARY ***
Total pot $0.2 | Rake $0.01 | Jackpot $0 | Bingo $0 | Fortune $0
Board [Tc Kc Kd Jh]
Seat 1: f56d4f3a (button) folded before Flop (didn't bet)
Seat 2: 78263b8b (small blind) won ($0.19)
Seat 3: 49d6d1f1 (big blind) folded on the Turn
Seat 4: cc012293 folded before Flop (didn't bet)
Seat 5: 28d6b5ec folded before Flop (didn't bet)
Seat 6: Hero folded before Flop (didn't bet)


Poker Hand #RC1456668238: Hold'em No Limit  ($0.05/$0.1) - 2023/04/07 11:38:27
Table 'RushAndCash3083498' 6-max Seat #1 is the button
Seat 1: 78263b8b ($21.41 in chips)
Seat 2: bc6bd61c ($10 in chips)
Seat 3: Hero ($6.61 in chips)
Seat 4: d2993e12 ($10.57 in chips)
Seat 5: 391f89d3 ($13.1 in chips)
Seat 6: d7bd5db0 ($20.1 in chips)
bc6bd61c: posts small blind $0.05
Hero: posts big blind $0.1
*** HOLE CARDS ***
Dealt to 78263b8b 
Dealt to bc6bd61c 
Dealt to Hero [6c 5c]
Dealt to d2993e12 
Dealt to 391f89d3 
Dealt to d7bd5db0 
d2993e12: folds
391f89d3: folds
d7bd5db0: folds
78263b8b: raises $0.15 to $0.25
bc6bd61c: folds
Hero: calls $0.15
*** FLOP *** [7s 8d 6d]
Hero: checks
78263b8b: bets $0.42
Hero: folds
Uncalled bet ($0.42) returned to 78263b8b
*** SHOWDOWN ***
78263b8b collected $0.53 from pot
*** SUMMARY ***
Total pot $0.55 | Rake $0.02 | Jackpot $0 | Bingo $0 | Fortune $0
Board [7s 8d 6d]
Seat 1: 78263b8b (button) won ($0.53)
Seat 2: bc6bd61c (small blind) folded before Flop
Seat 3: Hero (big blind) folded on the Flop
Seat 4: d2993e12 folded before Flop (didn't bet)
Seat 5: 391f89d3 folded before Flop (didn't bet)
Seat 6: d7bd5db0 folded before Flop (didn't bet)


Poker Hand #RC1456668196: Hold'em No Limit  ($0.05/$0.1) - 2023/04/07 11:38:21
Table 'RushAndCash3083456' 6-max Seat #1 is the button
Seat 1: 4a105909 ($14.35 in chips)
Seat 2: 8df60157 ($12.5 in chips)
Seat 3: 67d0f872 ($10.38 in chips)
Seat 4: Hero ($6.61 in chips)
Seat 5: bd484c10 ($15.25 in chips)
Seat 6: fa1c17c1 ($16.06 in chips)
8df60157: posts small blind $0.05
67d0f872: posts big blind $0.1
*** HOLE CARDS ***
Dealt to 4a105909 
Dealt to 8df60157 
Dealt to 67d0f872 
Dealt to Hero [6h Qc]
Dealt to bd484c10 
Dealt to fa1c17c1 
Hero: folds
bd484c10: folds
fa1c17c1: folds
4a105909: folds
8df60157: folds
Uncalled bet ($0.05) returned to 67d0f872
*** SHOWDOWN ***
67d0f872 collected $0.1 from pot
*** SUMMARY ***
Total pot $0.1 | Rake $0 | Jackpot $0 | Bingo $0 | Fortune $0
Seat 1: 4a105909 (button) folded before Flop (didn't bet)
Seat 2: 8df60157 (small blind) folded before Flop
Seat 3: 67d0f872 (big blind) collected ($0.1)
Seat 4: Hero folded before Flop (didn't bet)
Seat 5: bd484c10 folded before Flop (didn't bet)
Seat 6: fa1c17c1 folded before Flop (didn't bet)


Poker Hand #RC1456668157: Hold'em No Limit  ($0.05/$0.1) - 2023/04/07 11:38:15
Table 'RushAndCash3083417' 6-max Seat #1 is the button
Seat 1: 8cf5e31e ($10.15 in chips)
Seat 2: 1d2d7003 ($12.27 in chips)
Seat 3: 16968f13 ($10 in chips)
Seat 4: f1e67b9e ($16.43 in chips)
Seat 5: 6b0f928f ($11.07 in chips)
Seat 6: Hero ($6.61 in chips)
1d2d7003: posts small blind $0.05
16968f13: posts big blind $0.1
*** HOLE CARDS ***
Dealt to 8cf5e31e 
Dealt to 1d2d7003 
Dealt to 16968f13 
Dealt to f1e67b9e 
Dealt to 6b0f928f 
Dealt to Hero [9d 4s]
f1e67b9e: folds
6b0f928f: folds
Hero: folds
8cf5e31e: folds
1d2d7003: folds
Uncalled bet ($0.05) returned to 16968f13
*** SHOWDOWN ***
16968f13 collected $0.1 from pot
*** SUMMARY ***
Total pot $0.1 | Rake $0 | Jackpot $0 | Bingo $0 | Fortune $0
Seat 1: 8cf5e31e (button) folded before Flop (didn't bet)
Seat 2: 1d2d7003 (small blind) folded before Flop
Seat 3: 16968f13 (big blind) collected ($0.1)
Seat 4: f1e67b9e folded before Flop (didn't bet)
Seat 5: 6b0f928f folded before Flop (didn't bet)
Seat 6: Hero folded before Flop (didn't bet)


Poker Hand #RC1456668094: Hold'em No Limit  ($0.05/$0.1) - 2023/04/07 11:38:05
Table 'RushAndCash3083354' 6-max Seat #1 is the button
Seat 1: 4a52059f ($10 in chips)
Seat 2: Hero ($6.66 in chips)
Seat 3: 299ef6c ($12.55 in chips)
Seat 4: c699478f ($10.2 in chips)
Seat 5: 93cdb17b ($26.22 in chips)
Seat 6: 244e0448 ($11.13 in chips)
Hero: posts small blind $0.05
299ef6c: posts big blind $0.1
*** HOLE CARDS ***
Dealt to 4a52059f 
Dealt to Hero [5h 7d]
Dealt to 299ef6c 
Dealt to c699478f 
Dealt to 93cdb17b 
Dealt to 244e0448 
c699478f: folds
93cdb17b: folds
244e0448: raises $0.15 to $0.25
4a52059f: folds
Hero: folds
299ef6c: folds
Uncalled bet ($0.15) returned to 244e0448
*** SHOWDOWN ***
244e0448 collected $0.25 from pot
*** SUMMARY ***
Total pot $0.25 | Rake $0 | Jackpot $0 | Bingo $0 | Fortune $0
Seat 1: 4a52059f (button) folded before Flop (didn't bet)
Seat 2: Hero (small blind) folded before Flop
Seat 3: 299ef6c (big blind) folded before Flop
Seat 4: c699478f folded before Flop (didn't bet)
Seat 5: 93cdb17b folded before Flop (didn't bet)
Seat 6: 244e0448 collected ($0.25)


Poker Hand #RC1456668064: Hold'em No Limit  ($0.05/$0.1) - 2023/04/07 11:38:01
Table 'RushAndCash3083324' 6-max Seat #1 is the button
Seat 1: eabbf486 ($14.49 in chips)
Seat 2: 17ba0cfd ($10 in chips)
Seat 3: 79e451bc ($11.28 in chips)
Seat 4: 24a0ed91 ($9.9 in chips)
Seat 5: 8e5bfc88 ($9.05 in chips)
Seat 6: Hero ($6.66 in chips)
17ba0cfd: posts small blind $0.05
79e451bc: posts big blind $0.1
*** HOLE CARDS ***
Dealt to eabbf486 
Dealt to 17ba0cfd 
Dealt to 79e451bc 
Dealt to 24a0ed91 
Dealt to 8e5bfc88 
Dealt to Hero [6s 4c]
24a0ed91: folds
8e5bfc88: folds
Hero: folds
eabbf486: raises $0.15 to $0.25
17ba0cfd: calls $0.2
79e451bc: folds
*** FLOP *** [8s 2h 4h]
17ba0cfd: checks
eabbf486: bets $0.2
17ba0cfd: raises $0.72 to $0.92
eabbf486: folds
Uncalled bet ($0.72) returned to 17ba0cfd
*** SHOWDOWN ***
17ba0cfd collected $0.95 from pot
*** SUMMARY ***
Total pot $1 | Rake $0.05 | Jackpot $0 | Bingo $0 | Fortune $0
Board [8s 2h 4h]
Seat 1: eabbf486 (button) folded on the Flop
Seat 2: 17ba0cfd (small blind) won ($0.95)
Seat 3: 79e451bc (big blind) folded before Flop
Seat 4: 24a0ed91 folded before Flop (didn't bet)
Seat 5: 8e5bfc88 folded before Flop (didn't bet)
Seat 6: Hero folded before Flop (didn't bet)


Poker Hand #RC1456667976: Hold'em No Limit  ($0.05/$0.1) - 2023/04/07 11:37:48
Table 'RushAndCash3083236' 6-max Seat #1 is the button
Seat 1: 9d3f10f8 ($15.85 in chips)
Seat 2: 2d16a1ba ($10.71 in chips)
Seat 3: Hero ($6.76 in chips)
Seat 4: 617f565c ($10 in chips)
Seat 5: 391f89d3 ($13.25 in chips)
Seat 6: 7cab4739 ($19.76 in chips)
2d16a1ba: posts small blind $0.05
Hero: posts big blind $0.1
*** HOLE CARDS ***
Dealt to 9d3f10f8 
Dealt to 2d16a1ba 
Dealt to Hero [8d 5h]
Dealt to 617f565c 
Dealt to 391f89d3 
Dealt to 7cab4739 
617f565c: folds
391f89d3: folds
7cab4739: folds
9d3f10f8: raises $0.2 to $0.3
2d16a1ba: folds
Hero: folds
Uncalled bet ($0.2) returned to 9d3f10f8
*** SHOWDOWN ***
9d3f10f8 collected $0.25 from pot
*** SUMMARY ***
Total pot $0.25 | Rake $0 | Jackpot $0 | Bingo $0 | Fortune $0
Seat 1: 9d3f10f8 (button) collected ($0.25)
Seat 2: 2d16a1ba (small blind) folded before Flop
Seat 3: Hero (big blind) folded before Flop
Seat 4: 617f565c folded before Flop (didn't bet)
Seat 5: 391f89d3 folded before Flop (didn't bet)
Seat 6: 7cab4739 folded before Flop (didn't bet)


Poker Hand #RC1456667919: Hold'em No Limit  ($0.05/$0.1) - 2023/04/07 11:37:38
Table 'RushAndCash3083179' 6-max Seat #1 is the button
Seat 1: Hero ($6.76 in chips)
Seat 2: 8d1b2757 ($14.28 in chips)
Seat 3: c4d9b1c0 ($11.76 in chips)
Seat 4: 6c625696 ($8.53 in chips)
Seat 5: febdc50d ($10.11 in chips)
Seat 6: 5e720447 ($25.67 in chips)
8d1b2757: posts small blind $0.05
c4d9b1c0: posts big blind $0.1
*** HOLE CARDS ***
Dealt to Hero [4h 5h]
Dealt to 8d1b2757 
Dealt to c4d9b1c0 
Dealt to 6c625696 
Dealt to febdc50d 
Dealt to 5e720447 
6c625696: raises $0.15 to $0.25
febdc50d: folds
5e720447: folds
Hero: folds
8d1b2757: folds
c4d9b1c0: folds
Uncalled bet ($0.15) returned to 6c625696
*** SHOWDOWN ***
6c625696 collected $0.25 from pot
*** SUMMARY ***
Total pot $0.25 | Rake $0 | Jackpot $0 | Bingo $0 | Fortune $0
Seat 1: Hero (button) folded before Flop (didn't bet)
Seat 2: 8d1b2757 (small blind) folded before Flop
Seat 3: c4d9b1c0 (big blind) folded before Flop
Seat 4: 6c625696 collected ($0.25)
Seat 5: febdc50d folded before Flop (didn't bet)
Seat 6: 5e720447 folded before Flop (didn't bet)


Poker Hand #RC1456667877: Hold'em No Limit  ($0.05/$0.1) - 2023/04/07 11:37:30
Table 'RushAndCash3083137' 6-max Seat #1 is the button
Seat 1: b6bd39ad ($16.38 in chips)
Seat 2: fa30b9bf ($22.24 in chips)
Seat 3: febdc50d ($10.21 in chips)
Seat 4: 5a11912c ($10.33 in chips)
Seat 5: f6a4de20 ($10 in chips)
Seat 6: Hero ($6.76 in chips)
fa30b9bf: posts small blind $0.05
febdc50d: posts big blind $0.1
*** HOLE CARDS ***
Dealt to b6bd39ad 
Dealt to fa30b9bf 
Dealt to febdc50d 
Dealt to 5a11912c 
Dealt to f6a4de20 
Dealt to Hero [7d 3d]
5a11912c: folds
f6a4de20: raises $0.15 to $0.25
Hero: folds
b6bd39ad: folds
fa30b9bf: folds
febdc50d: folds
Uncalled bet ($0.15) returned to f6a4de20
*** SHOWDOWN ***
f6a4de20 collected $0.25 from pot
*** SUMMARY ***
Total pot $0.25 | Rake $0 | Jackpot $0 | Bingo $0 | Fortune $0
Seat 1: b6bd39ad (button) folded before Flop (didn't bet)
Seat 2: fa30b9bf (small blind) folded before Flop
Seat 3: febdc50d (big blind) folded before Flop
Seat 4: 5a11912c folded before Flop (didn't bet)
Seat 5: f6a4de20 collected ($0.25)
Seat 6: Hero folded before Flop (didn't bet)


Poker Hand #RC1456667824: Hold'em No Limit  ($0.05/$0.1) - 2023/04/07 11:37:22
Table 'RushAndCash3083084' 6-max Seat #1 is the button
Seat 1: 7cab4739 ($20.11 in chips)
Seat 2: 9d3f10f8 ($15.44 in chips)
Seat 3: 617f565c ($10 in chips)
Seat 4: Hero ($6.76 in chips)
Seat 5: 399a152d ($17.95 in chips)
Seat 6: 960e6af4 ($11.38 in chips)
9d3f10f8: posts small blind $0.05
617f565c: posts big blind $0.1
*** HOLE CARDS ***
Dealt to 7cab4739 
Dealt to 9d3f10f8 
Dealt to 617f565c 
Dealt to Hero [9s Ah]
Dealt to 399a152d 
Dealt to 960e6af4 
Hero: folds
399a152d: folds
960e6af4: folds
7cab4739: raises $0.25 to $0.35
9d3f10f8: raises $0.6 to $0.95
617f565c: folds
7cab4739: folds
Uncalled bet ($0.6) returned to 9d3f10f8
*** SHOWDOWN ***
9d3f10f8 collected $0.76 from pot
*** SUMMARY ***
Total pot $0.8 | Rake $0.04 | Jackpot $0 | Bingo $0 | Fortune $0
Seat 1: 7cab4739 (button) folded before Flop
Seat 2: 9d3f10f8 (small blind) collected ($0.76)
Seat 3: 617f565c (big blind) folded before Flop
Seat 4: Hero folded before Flop (didn't bet)
Seat 5: 399a152d folded before Flop (didn't bet)
Seat 6: 960e6af4 folded before Flop (didn't bet)


Poker Hand #RC1456667748: Hold'em No Limit  ($0.05/$0.1) - 2023/04/07 11:37:09
Table 'RushAndCash3083008' 6-max Seat #1 is the button
Seat 1: 6827f3ae ($9.18 in chips)
Seat 2: ebb70f2d ($10.46 in chips)
Seat 3: e6ee1b67 ($11.69 in chips)
Seat 4: 9d5b7c3d ($12.77 in chips)
Seat 5: 36097234 ($10.64 in chips)
Seat 6: Hero ($6.76 in chips)
ebb70f2d: posts small blind $0.05
e6ee1b67: posts big blind $0.1
*** HOLE CARDS ***
Dealt to 6827f3ae 
Dealt to ebb70f2d 
Dealt to e6ee1b67 
Dealt to 9d5b7c3d 
Dealt to 36097234 
Dealt to Hero [3d 8h]
9d5b7c3d: folds
36097234: folds
Hero: folds
6827f3ae: folds
ebb70f2d: folds
Uncalled bet ($0.05) returned to e6ee1b67
*** SHOWDOWN ***
e6ee1b67 collected $0.1 from pot
*** SUMMARY ***
Total pot $0.1 | Rake $0 | Jackpot $0 | Bingo $0 | Fortune $0
Seat 1: 6827f3ae (button) folded before Flop (didn't bet)
Seat 2: ebb70f2d (small blind) folded before Flop
Seat 3: e6ee1b67 (big blind) collected ($0.1)
Seat 4: 9d5b7c3d folded before Flop (didn't bet)
Seat 5: 36097234 folded before Flop (didn't bet)
Seat 6: Hero folded before Flop (didn't bet)


Poker Hand #RC1456667687: Hold'em No Limit  ($0.05/$0.1) - 2023/04/07 11:36:59
Table 'RushAndCash3082947' 6-max Seat #1 is the button
Seat 1: Hero ($6.76 in chips)
Seat 2: 7f2f9357 ($15.9 in chips)
Seat 3: f128ea02 ($15.99 in chips)
Seat 4: 55e69af0 ($11.65 in chips)
Seat 5: e1e1fbad ($11.79 in chips)
Seat 6: 5ad948a6 ($9.1 in chips)
7f2f9357: posts small blind $0.05
f128ea02: posts big blind $0.1
*** HOLE CARDS ***
Dealt to Hero [4c 3c]
Dealt to 7f2f9357 
Dealt to f128ea02 
Dealt to 55e69af0 
Dealt to e1e1fbad 
Dealt to 5ad948a6 
55e69af0: folds
e1e1fbad: folds
5ad948a6: raises $0.15 to $0.25
Hero: folds
7f2f9357: folds
f128ea02: folds
Uncalled bet ($0.15) returned to 5ad948a6
*** SHOWDOWN ***
5ad948a6 collected $0.25 from pot
*** SUMMARY ***
Total pot $0.25 | Rake $0 | Jackpot $0 | Bingo $0 | Fortune $0
Seat 1: Hero (button) folded before Flop (didn't bet)
Seat 2: 7f2f9357 (small blind) folded before Flop
Seat 3: f128ea02 (big blind) folded before Flop
Seat 4: 55e69af0 folded before Flop (didn't bet)
Seat 5: e1e1fbad folded before Flop (didn't bet)
Seat 6: 5ad948a6 collected ($0.25)


Poker Hand #RC1456667662: Hold'em No Limit  ($0.05/$0.1) - 2023/04/07 11:36:55
Table 'RushAndCash3082922' 6-max Seat #1 is the button
Seat 1: 65f22aee ($25.88 in chips)
Seat 2: 18e1b26e ($10.84 in chips)
Seat 3: Hero ($6.86 in chips)
Seat 4: 4c134268 ($4.85 in chips)
Seat 5: b6b2204f ($29.17 in chips)
Seat 6: 1ce64bc0 ($8.3 in chips)
18e1b26e: posts small blind $0.05
Hero: posts big blind $0.1
*** HOLE CARDS ***
Dealt to 65f22aee 
Dealt to 18e1b26e 
Dealt to Hero [3c 7d]
Dealt to 4c134268 
Dealt to b6b2204f 
Dealt to 1ce64bc0 
4c134268: folds
b6b2204f: folds
1ce64bc0: folds
65f22aee: folds
18e1b26e: calls $0.05
Hero: checks
*** FLOP *** [Tc 9c Jh]
18e1b26e: checks
Hero: checks
*** TURN *** [Tc 9c Jh] [3s]
18e1b26e: checks
Hero: checks
*** RIVER *** [Tc 9c Jh 3s] [Qh]
18e1b26e: bets $0.1
Hero: folds
Uncalled bet ($0.1) returned to 18e1b26e
*** SHOWDOWN ***
18e1b26e collected $0.19 from pot
*** SUMMARY ***
Total pot $0.2 | Rake $0.01 | Jackpot $0 | Bingo $0 | Fortune $0
Board [Tc 9c Jh 3s Qh]
Seat 1: 65f22aee (button) folded before Flop (didn't bet)
Seat 2: 18e1b26e (small blind) won ($0.19)
Seat 3: Hero (big blind) folded on the River
Seat 4: 4c134268 folded before Flop (didn't bet)
Seat 5: b6b2204f folded before Flop (didn't bet)
Seat 6: 1ce64bc0 folded before Flop (didn't bet)


Poker Hand #RC1456667570: Hold'em No Limit  ($0.05/$0.1) - 2023/04/07 11:36:41
Table 'RushAndCash3082830' 6-max Seat #1 is the button
Seat 1: e3a745f4 ($10.62 in chips)
Seat 2: Hero ($6.91 in chips)
Seat 3: 5ad948a6 ($9.2 in chips)
Seat 4: b5353bf8 ($28.22 in chips)
Seat 5: 7b4c063c ($18.72 in chips)
Seat 6: cd2da17d ($21.75 in chips)
Hero: posts small blind $0.05
5ad948a6: posts big blind $0.1
*** HOLE CARDS ***
Dealt to e3a745f4 
Dealt to Hero [Ad 7d]
Dealt to 5ad948a6 
Dealt to b5353bf8 
Dealt to 7b4c063c 
Dealt to cd2da17d 
b5353bf8: folds
7b4c063c: raises $0.15 to $0.25
cd2da17d: folds
e3a745f4: folds
Hero: folds
5ad948a6: folds
Uncalled bet ($0.15) returned to 7b4c063c
*** SHOWDOWN ***
7b4c063c collected $0.25 from pot
*** SUMMARY ***
Total pot $0.25 | Rake $0 | Jackpot $0 | Bingo $0 | Fortune $0
Seat 1: e3a745f4 (button) folded before Flop (didn't bet)
Seat 2: Hero (small blind) folded before Flop
Seat 3: 5ad948a6 (big blind) folded before Flop
Seat 4: b5353bf8 folded before Flop (didn't bet)
Seat 5: 7b4c063c collected ($0.25)
Seat 6: cd2da17d folded before Flop (didn't bet)


Poker Hand #RC1456667536: Hold'em No Limit  ($0.05/$0.1) - 2023/04/07 11:36:35
Table 'RushAndCash3082796' 6-max Seat #1 is the button
Seat 1: ac0e72fc ($16.07 in chips)
Seat 2: b6bd39ad ($16.43 in chips)
Seat 3: 2305f002 ($16.75 in chips)
Seat 4: 2323c051 ($10 in chips)
Seat 5: 6d51ba0 ($7.3 in chips)
Seat 6: Hero ($6.91 in chips)
b6bd39ad: posts small blind $0.05
2305f002: posts big blind $0.1
*** HOLE CARDS ***
Dealt to ac0e72fc 
Dealt to b6bd39ad 
Dealt to 2305f002 
Dealt to 2323c051 
Dealt to 6d51ba0 
Dealt to Hero [Qh 9d]
2323c051: folds
6d51ba0: folds
Hero: folds
ac0e72fc: folds
b6bd39ad: folds
Uncalled bet ($0.05) returned to 2305f002
*** SHOWDOWN ***
2305f002 collected $0.1 from pot
*** SUMMARY ***
Total pot $0.1 | Rake $0 | Jackpot $0 | Bingo $0 | Fortune $0
Seat 1: ac0e72fc (button) folded before Flop (didn't bet)
Seat 2: b6bd39ad (small blind) folded before Flop
Seat 3: 2305f002 (big blind) collected ($0.1)
Seat 4: 2323c051 folded before Flop (didn't bet)
Seat 5: 6d51ba0 folded before Flop (didn't bet)
Seat 6: Hero folded before Flop (didn't bet)


Poker Hand #RC1456667508: Hold'em No Limit  ($0.05/$0.1) - 2023/04/07 11:36:31
Table 'RushAndCash3082768' 6-max Seat #1 is the button
Seat 1: b19e7719 ($14.1 in chips)
Seat 2: 2fd004d2 ($27.3 in chips)
Seat 3: db09426a ($17.4 in chips)
Seat 4: 92e77a83 ($10.34 in chips)
Seat 5: Hero ($6.91 in chips)
Seat 6: 17ba0cfd ($10.48 in chips)
2fd004d2: posts small blind $0.05
db09426a: posts big blind $0.1
*** HOLE CARDS ***
Dealt to b19e7719 
Dealt to 2fd004d2 
Dealt to db09426a 
Dealt to 92e77a83 
Dealt to Hero [6d 3d]
Dealt to 17ba0cfd 
92e77a83: folds
Hero: folds
17ba0cfd: folds
b19e7719: folds
2fd004d2: folds
Uncalled bet ($0.05) returned to db09426a
*** SHOWDOWN ***
db09426a collected $0.1 from pot
*** SUMMARY ***
Total pot $0.1 | Rake $0 | Jackpot $0 | Bingo $0 | Fortune $0
Seat 1: b19e7719 (button) folded before Flop (didn't bet)
Seat 2: 2fd004d2 (small blind) folded before Flop
Seat 3: db09426a (big blind) collected ($0.1)
Seat 4: 92e77a83 folded before Flop (didn't bet)
Seat 5: Hero folded before Flop (didn't bet)
Seat 6: 17ba0cfd folded before Flop (didn't bet)


Poker Hand #RC1456667477: Hold'em No Limit  ($0.05/$0.1) - 2023/04/07 11:36:27
Table 'RushAndCash3082737' 6-max Seat #1 is the button
Seat 1: 7ecbc933 ($11.13 in chips)
Seat 2: 966357c5 ($9.88 in chips)
Seat 3: 27888cb0 ($10.02 in chips)
Seat 4: f56d4f3a ($3.88 in chips)
Seat 5: 6b0f928f ($12.37 in chips)
Seat 6: Hero ($6.91 in chips)
966357c5: posts small blind $0.05
27888cb0: posts big blind $0.1
*** HOLE CARDS ***
Dealt to 7ecbc933 
Dealt to 966357c5 
Dealt to 27888cb0 
Dealt to f56d4f3a 
Dealt to 6b0f928f 
Dealt to Hero [6c 4c]
f56d4f3a: folds
6b0f928f: folds
Hero: folds
7ecbc933: folds
966357c5: folds
Uncalled bet ($0.05) returned to 27888cb0
*** SHOWDOWN ***
27888cb0 collected $0.1 from pot
*** SUMMARY ***
Total pot $0.1 | Rake $0 | Jackpot $0 | Bingo $0 | Fortune $0
Seat 1: 7ecbc933 (button) folded before Flop (didn't bet)
Seat 2: 966357c5 (small blind) folded before Flop
Seat 3: 27888cb0 (big blind) collected ($0.1)
Seat 4: f56d4f3a folded before Flop (didn't bet)
Seat 5: 6b0f928f folded before Flop (didn't bet)
Seat 6: Hero folded before Flop (didn't bet)


Poker Hand #RC1456667139: Hold'em No Limit  ($0.05/$0.1) - 2023/04/07 11:35:35
Table 'RushAndCash3082399' 6-max Seat #1 is the button
Seat 1: Hero ($7.16 in chips)
Seat 2: 5ad948a6 ($9.4 in chips)
Seat 3: 966357c5 ($9.6 in chips)
Seat 4: 89de995e ($10.15 in chips)
Seat 5: 23cd2988 ($9.88 in chips)
Seat 6: 2bfd1b14 ($15.42 in chips)
5ad948a6: posts small blind $0.05
966357c5: posts big blind $0.1
*** HOLE CARDS ***
Dealt to Hero [Qs As]
Dealt to 5ad948a6 
Dealt to 966357c5 
Dealt to 89de995e 
Dealt to 23cd2988 
Dealt to 2bfd1b14 
89de995e: folds
23cd2988: folds
2bfd1b14: folds
Hero: raises $0.15 to $0.25
5ad948a6: folds
966357c5: calls $0.15
*** FLOP *** [4d 5d 8d]
966357c5: checks
Hero: checks
*** TURN *** [4d 5d 8d] [Ks]
966357c5: checks
Hero: checks
*** RIVER *** [4d 5d 8d Ks] [Kc]
966357c5: checks
Hero: checks
966357c5: shows [Qc Kh] (Three Kings)
Hero: shows [Qs As] (Pair of Kings)
*** SHOWDOWN ***
966357c5 collected $0.53 from pot
*** SUMMARY ***
Total pot $0.55 | Rake $0.02 | Jackpot $0 | Bingo $0 | Fortune $0
Board [4d 5d 8d Ks Kc]
Seat 1: Hero (button) showed [Qs As] and lost with Pair of Kings
Seat 2: 5ad948a6 (small blind) folded before Flop
Seat 3: 966357c5 (big blind) showed [Qc Kh] and won ($0.53) with Three Kings
Seat 4: 89de995e folded before Flop (didn't bet)
Seat 5: 23cd2988 folded before Flop (didn't bet)
Seat 6: 2bfd1b14 folded before Flop (didn't bet)


Poker Hand #RC1456667040: Hold'em No Limit  ($0.05/$0.1) - 2023/04/07 11:35:18
Table 'RushAndCash3082300' 6-max Seat #1 is the button
Seat 1: e5e04a15 ($11.28 in chips)
Seat 2: 67fe6f9 ($29.94 in chips)
Seat 3: Hero ($7.26 in chips)
Seat 4: 8ab2ecff ($10 in chips)
Seat 5: 180913a1 ($11.29 in chips)
Seat 6: b3de8156 ($6.8 in chips)
67fe6f9: posts small blind $0.05
Hero: posts big blind $0.1
*** HOLE CARDS ***
Dealt to e5e04a15 
Dealt to 67fe6f9 
Dealt to Hero [4d 8c]
Dealt to 8ab2ecff 
Dealt to 180913a1 
Dealt to b3de8156 
8ab2ecff: raises $0.13 to $0.23
180913a1: folds
b3de8156: folds
e5e04a15: folds
67fe6f9: folds
Hero: folds
Uncalled bet ($0.13) returned to 8ab2ecff
*** SHOWDOWN ***
8ab2ecff collected $0.25 from pot
*** SUMMARY ***
Total pot $0.25 | Rake $0 | Jackpot $0 | Bingo $0 | Fortune $0
Seat 1: e5e04a15 (button) folded before Flop (didn't bet)
Seat 2: 67fe6f9 (small blind) folded before Flop
Seat 3: Hero (big blind) folded before Flop
Seat 4: 8ab2ecff collected ($0.25)
Seat 5: 180913a1 folded before Flop (didn't bet)
Seat 6: b3de8156 folded before Flop (didn't bet)


Poker Hand #RC1456666929: Hold'em No Limit  ($0.05/$0.1) - 2023/04/07 11:35:01
Table 'RushAndCash3082189' 6-max Seat #1 is the button
Seat 1: 3d553509 ($10.74 in chips)
Seat 2: Hero ($7.31 in chips)
Seat 3: e183df7e ($10.15 in chips)
Seat 4: 508fbc26 ($12.62 in chips)
Seat 5: 75978e0e ($10.98 in chips)
Seat 6: 6863e72e ($10.56 in chips)
Hero: posts small blind $0.05
e183df7e: posts big blind $0.1
*** HOLE CARDS ***
Dealt to 3d553509 
Dealt to Hero [Kh 9h]
Dealt to e183df7e 
Dealt to 508fbc26 
Dealt to 75978e0e 
Dealt to 6863e72e 
508fbc26: raises $0.2 to $0.3
75978e0e: raises $0.6 to $0.9
6863e72e: folds
3d553509: folds
Hero: folds
e183df7e: folds
508fbc26: calls $0.6
*** FLOP *** [Td 5c 8s]
508fbc26: checks
75978e0e: checks
*** TURN *** [Td 5c 8s] [5s]
508fbc26: bets $0.98
75978e0e: folds
Uncalled bet ($0.98) returned to 508fbc26
*** SHOWDOWN ***
508fbc26 collected $1.86 from pot
*** SUMMARY ***
Total pot $1.95 | Rake $0.09 | Jackpot $0 | Bingo $0 | Fortune $0
Board [Td 5c 8s 5s]
Seat 1: 3d553509 (button) folded before Flop (didn't bet)
Seat 2: Hero (small blind) folded before Flop
Seat 3: e183df7e (big blind) folded before Flop
Seat 4: 508fbc26 won ($1.86)
Seat 5: 75978e0e folded on the Turn
Seat 6: 6863e72e folded before Flop (didn't bet)


Poker Hand #RC1456666871: Hold'em No Limit  ($0.05/$0.1) - 2023/04/07 11:34:51
Table 'RushAndCash3082131' 6-max Seat #1 is the button
Seat 1: 749d3db3 ($21.07 in chips)
Seat 2: e1e1fbad ($12.09 in chips)
Seat 3: d7d93175 ($38.26 in chips)
Seat 4: 24a0ed91 ($9.92 in chips)
Seat 5: Hero ($7.31 in chips)
Seat 6: f4cd01de ($10 in chips)
e1e1fbad: posts small blind $0.05
d7d93175: posts big blind $0.1
*** HOLE CARDS ***
Dealt to 749d3db3 
Dealt to e1e1fbad 
Dealt to d7d93175 
Dealt to 24a0ed91 
Dealt to Hero [Ks Th]
Dealt to f4cd01de 
24a0ed91: raises $0.15 to $0.25
Hero: folds
f4cd01de: folds
749d3db3: folds
e1e1fbad: folds
d7d93175: folds
Uncalled bet ($0.15) returned to 24a0ed91
*** SHOWDOWN ***
24a0ed91 collected $0.25 from pot
*** SUMMARY ***
Total pot $0.25 | Rake $0 | Jackpot $0 | Bingo $0 | Fortune $0
Seat 1: 749d3db3 (button) folded before Flop (didn't bet)
Seat 2: e1e1fbad (small blind) folded before Flop
Seat 3: d7d93175 (big blind) folded before Flop
Seat 4: 24a0ed91 collected ($0.25)
Seat 5: Hero folded before Flop (didn't bet)
Seat 6: f4cd01de folded before Flop (didn't bet)


Poker Hand #RC1456666710: Hold'em No Limit  ($0.05/$0.1) - 2023/04/07 11:34:25
Table 'RushAndCash3081970' 6-max Seat #1 is the button
Seat 1: 1a24d8df ($9.1 in chips)
Seat 2: 89baf59b ($20.06 in chips)
Seat 3: f165af76 ($11.59 in chips)
Seat 4: 7da7bc92 ($10.23 in chips)
Seat 5: ebb70f2d ($12.28 in chips)
Seat 6: Hero ($7.31 in chips)
89baf59b: posts small blind $0.05
f165af76: posts big blind $0.1
*** HOLE CARDS ***
Dealt to 1a24d8df 
Dealt to 89baf59b 
Dealt to f165af76 
Dealt to 7da7bc92 
Dealt to ebb70f2d 
Dealt to Hero [4s Ad]
7da7bc92: folds
ebb70f2d: folds
Hero: folds
1a24d8df: folds
89baf59b: folds
Uncalled bet ($0.05) returned to f165af76
*** SHOWDOWN ***
f165af76 collected $0.1 from pot
*** SUMMARY ***
Total pot $0.1 | Rake $0 | Jackpot $0 | Bingo $0 | Fortune $0
Seat 1: 1a24d8df (button) folded before Flop (didn't bet)
Seat 2: 89baf59b (small blind) folded before Flop
Seat 3: f165af76 (big blind) collected ($0.1)
Seat 4: 7da7bc92 folded before Flop (didn't bet)
Seat 5: ebb70f2d folded before Flop (didn't bet)
Seat 6: Hero folded before Flop (didn't bet)


Poker Hand #RC1456666622: Hold'em No Limit  ($0.05/$0.1) - 2023/04/07 11:34:11
Table 'RushAndCash3081882' 6-max Seat #1 is the button
Seat 1: d2993e12 ($10.78 in chips)
Seat 2: 7fe74add ($10.44 in chips)
Seat 3: 530b6848 ($11.59 in chips)
Seat 4: 6c625696 ($4.62 in chips)
Seat 5: a4380876 ($13.11 in chips)
Seat 6: Hero ($7.16 in chips)
7fe74add: posts small blind $0.05
530b6848: posts big blind $0.1
*** HOLE CARDS ***
Dealt to d2993e12 
Dealt to 7fe74add 
Dealt to 530b6848 
Dealt to 6c625696 
Dealt to a4380876 
Dealt to Hero [8d 8h]
6c625696: folds
a4380876: folds
Hero: raises $0.15 to $0.25
d2993e12: folds
7fe74add: folds
530b6848: folds
Uncalled bet ($0.15) returned to Hero
*** SHOWDOWN ***
Hero collected $0.25 from pot
*** SUMMARY ***
Total pot $0.25 | Rake $0 | Jackpot $0 | Bingo $0 | Fortune $0
Seat 1: d2993e12 (button) folded before Flop (didn't bet)
Seat 2: 7fe74add (small blind) folded before Flop
Seat 3: 530b6848 (big blind) folded before Flop
Seat 4: 6c625696 folded before Flop (didn't bet)
Seat 5: a4380876 folded before Flop (didn't bet)
Seat 6: Hero collected ($0.25)


Poker Hand #RC1456666509: Hold'em No Limit  ($0.05/$0.1) - 2023/04/07 11:33:51
Table 'RushAndCash3081769' 6-max Seat #1 is the button
Seat 1: 86aff57 ($9.8 in chips)
Seat 2: Hero ($7.21 in chips)
Seat 3: a7724d84 ($13.5 in chips)
Seat 4: ad028957 ($13.51 in chips)
Seat 5: 2fd004d2 ($26.8 in chips)
Seat 6: 7fe74add ($10.44 in chips)
Hero: posts small blind $0.05
a7724d84: posts big blind $0.1
*** HOLE CARDS ***
Dealt to 86aff57 
Dealt to Hero [3s 3h]
Dealt to a7724d84 
Dealt to ad028957 
Dealt to 2fd004d2 
Dealt to 7fe74add 
ad028957: folds
2fd004d2: raises $0.15 to $0.25
7fe74add: folds
86aff57: folds
Hero: folds
a7724d84: folds
Uncalled bet ($0.15) returned to 2fd004d2
*** SHOWDOWN ***
2fd004d2 collected $0.25 from pot
*** SUMMARY ***
Total pot $0.25 | Rake $0 | Jackpot $0 | Bingo $0 | Fortune $0
Seat 1: 86aff57 (button) folded before Flop (didn't bet)
Seat 2: Hero (small blind) folded before Flop
Seat 3: a7724d84 (big blind) folded before Flop
Seat 4: ad028957 folded before Flop (didn't bet)
Seat 5: 2fd004d2 collected ($0.25)
Seat 6: 7fe74add folded before Flop (didn't bet)


Poker Hand #RC1456666444: Hold'em No Limit  ($0.05/$0.1) - 2023/04/07 11:33:41
Table 'RushAndCash3081704' 6-max Seat #1 is the button
Seat 1: 58d73444 ($36.15 in chips)
Seat 2: be697cc5 ($12.68 in chips)
Seat 3: Hero ($7.16 in chips)
Seat 4: e5e04a15 ($10.65 in chips)
Seat 5: fed9a9c8 ($10.13 in chips)
Seat 6: 7214a3ce ($9.78 in chips)
be697cc5: posts small blind $0.05
Hero: posts big blind $0.1
*** HOLE CARDS ***
Dealt to 58d73444 
Dealt to be697cc5 
Dealt to Hero [Jh Jd]
Dealt to e5e04a15 
Dealt to fed9a9c8 
Dealt to 7214a3ce 
e5e04a15: folds
fed9a9c8: folds
7214a3ce: folds
58d73444: folds
be697cc5: folds
Uncalled bet ($0.05) returned to Hero
*** SHOWDOWN ***
Hero collected $0.1 from pot
*** SUMMARY ***
Total pot $0.1 | Rake $0 | Jackpot $0 | Bingo $0 | Fortune $0
Seat 1: 58d73444 (button) folded before Flop (didn't bet)
Seat 2: be697cc5 (small blind) folded before Flop
Seat 3: Hero (big blind) collected ($0.1)
Seat 4: e5e04a15 folded before Flop (didn't bet)
Seat 5: fed9a9c8 folded before Flop (didn't bet)
Seat 6: 7214a3ce folded before Flop (didn't bet)


Poker Hand #RC1456666253: Hold'em No Limit  ($0.05/$0.1) - 2023/04/07 11:33:09
Table 'RushAndCash3081513' 6-max Seat #1 is the button
Seat 1: Hero ($7.41 in chips)
Seat 2: 5fde9c98 ($12.98 in chips)
Seat 3: 58d73444 ($35.87 in chips)
Seat 4: 19c46074 ($10.55 in chips)
Seat 5: 788a8ec4 ($10 in chips)
Seat 6: 1aa70c37 ($11.11 in chips)
5fde9c98: posts small blind $0.05
58d73444: posts big blind $0.1
*** HOLE CARDS ***
Dealt to Hero [Jd Qs]
Dealt to 5fde9c98 
Dealt to 58d73444 
Dealt to 19c46074 
Dealt to 788a8ec4 
Dealt to 1aa70c37 
19c46074: folds
788a8ec4: folds
1aa70c37: folds
Hero: raises $0.15 to $0.25
5fde9c98: folds
58d73444: calls $0.15
*** FLOP *** [2s 3h Ah]
58d73444: bets $0.43
Hero: folds
Uncalled bet ($0.43) returned to 58d73444
*** SHOWDOWN ***
58d73444 collected $0.53 from pot
*** SUMMARY ***
Total pot $0.55 | Rake $0.02 | Jackpot $0 | Bingo $0 | Fortune $0
Board [2s 3h Ah]
Seat 1: Hero (button) folded on the Flop
Seat 2: 5fde9c98 (small blind) folded before Flop
Seat 3: 58d73444 (big blind) won ($0.53)
Seat 4: 19c46074 folded before Flop (didn't bet)
Seat 5: 788a8ec4 folded before Flop (didn't bet)
Seat 6: 1aa70c37 folded before Flop (didn't bet)


Poker Hand #RC1456666224: Hold'em No Limit  ($0.05/$0.1) - 2023/04/07 11:33:04
Table 'RushAndCash3081484' 6-max Seat #1 is the button
Seat 1: 93cdb17b ($26.08 in chips)
Seat 2: 391f89d3 ($15.31 in chips)
Seat 3: 9ab324da ($19.73 in chips)
Seat 4: 2bfd1b14 ($16.17 in chips)
Seat 5: 92e77a83 ($10 in chips)
Seat 6: Hero ($7.41 in chips)
391f89d3: posts small blind $0.05
9ab324da: posts big blind $0.1
*** HOLE CARDS ***
Dealt to 93cdb17b 
Dealt to 391f89d3 
Dealt to 9ab324da 
Dealt to 2bfd1b14 
Dealt to 92e77a83 
Dealt to Hero [5h 8h]
2bfd1b14: folds
92e77a83: folds
Hero: folds
93cdb17b: raises $0.1 to $0.2
391f89d3: folds
9ab324da: folds
Uncalled bet ($0.1) returned to 93cdb17b
*** SHOWDOWN ***
93cdb17b collected $0.25 from pot
*** SUMMARY ***
Total pot $0.25 | Rake $0 | Jackpot $0 | Bingo $0 | Fortune $0
Seat 1: 93cdb17b (button) collected ($0.25)
Seat 2: 391f89d3 (small blind) folded before Flop
Seat 3: 9ab324da (big blind) folded before Flop
Seat 4: 2bfd1b14 folded before Flop (didn't bet)
Seat 5: 92e77a83 folded before Flop (didn't bet)
Seat 6: Hero folded before Flop (didn't bet)


Poker Hand #RC1456666196: Hold'em No Limit  ($0.05/$0.1) - 2023/04/07 11:32:59
Table 'RushAndCash3081456' 6-max Seat #1 is the button
Seat 1: a7724d84 ($13.45 in chips)
Seat 2: 65b07678 ($8.69 in chips)
Seat 3: 8affa98b ($10 in chips)
Seat 4: Hero ($7.41 in chips)
Seat 5: 958abe9a ($10 in chips)
Seat 6: ea5c4cab ($11.31 in chips)
65b07678: posts small blind $0.05
8affa98b: posts big blind $0.1
*** HOLE CARDS ***
Dealt to a7724d84 
Dealt to 65b07678 
Dealt to 8affa98b 
Dealt to Hero [7h 6h]
Dealt to 958abe9a 
Dealt to ea5c4cab 
Hero: folds
958abe9a: folds
ea5c4cab: folds
a7724d84: raises $0.15 to $0.25
65b07678: folds
8affa98b: folds
Uncalled bet ($0.15) returned to a7724d84
*** SHOWDOWN ***
a7724d84 collected $0.25 from pot
*** SUMMARY ***
Total pot $0.25 | Rake $0 | Jackpot $0 | Bingo $0 | Fortune $0
Seat 1: a7724d84 (button) collected ($0.25)
Seat 2: 65b07678 (small blind) folded before Flop
Seat 3: 8affa98b (big blind) folded before Flop
Seat 4: Hero folded before Flop (didn't bet)
Seat 5: 958abe9a folded before Flop (didn't bet)
Seat 6: ea5c4cab folded before Flop (didn't bet)


Poker Hand #RC1456666164: Hold'em No Limit  ($0.05/$0.1) - 2023/04/07 11:32:55
Table 'RushAndCash3081424' 6-max Seat #1 is the button
Seat 1: 7256ff58 ($24.14 in chips)
Seat 2: db6d2eaf ($10.66 in chips)
Seat 3: 532d581b ($10.36 in chips)
Seat 4: 9ad10009 ($16.21 in chips)
Seat 5: Hero ($7.41 in chips)
Seat 6: e6e85371 ($16.87 in chips)
db6d2eaf: posts small blind $0.05
532d581b: posts big blind $0.1
*** HOLE CARDS ***
Dealt to 7256ff58 
Dealt to db6d2eaf 
Dealt to 532d581b 
Dealt to 9ad10009 
Dealt to Hero [4d Jh]
Dealt to e6e85371 
9ad10009: folds
Hero: folds
e6e85371: folds
7256ff58: raises $0.15 to $0.25
db6d2eaf: folds
532d581b: raises $0.8 to $1.05
7256ff58: folds
Uncalled bet ($0.8) returned to 532d581b
*** SHOWDOWN ***
532d581b collected $0.53 from pot
*** SUMMARY ***
Total pot $0.55 | Rake $0.02 | Jackpot $0 | Bingo $0 | Fortune $0
Seat 1: 7256ff58 (button) folded before Flop
Seat 2: db6d2eaf (small blind) folded before Flop
Seat 3: 532d581b (big blind) collected ($0.53)
Seat 4: 9ad10009 folded before Flop (didn't bet)
Seat 5: Hero folded before Flop (didn't bet)
Seat 6: e6e85371 folded before Flop (didn't bet)


Poker Hand #RC1456666131: Hold'em No Limit  ($0.05/$0.1) - 2023/04/07 11:32:48
Table 'RushAndCash3081391' 6-max Seat #1 is the button
Seat 1: Hero ($7.41 in chips)
Seat 2: 530b6848 ($11.89 in chips)
Seat 3: 68c91a77 ($10.97 in chips)
Seat 4: c1f2cb80 ($10 in chips)
Seat 5: b6bd39ad ($16.17 in chips)
Seat 6: 5a11912c ($9.9 in chips)
530b6848: posts small blind $0.05
68c91a77: posts big blind $0.1
*** HOLE CARDS ***
Dealt to Hero [3c 9d]
Dealt to 530b6848 
Dealt to 68c91a77 
Dealt to c1f2cb80 
Dealt to b6bd39ad 
Dealt to 5a11912c 
c1f2cb80: folds
b6bd39ad: folds
5a11912c: folds
Hero: folds
530b6848: raises $0.1 to $0.2
68c91a77: folds
Uncalled bet ($0.1) returned to 530b6848
*** SHOWDOWN ***
530b6848 collected $0.2 from pot
*** SUMMARY ***
Total pot $0.2 | Rake $0 | Jackpot $0 | Bingo $0 | Fortune $0
Seat 1: Hero (button) folded before Flop (didn't bet)
Seat 2: 530b6848 (small blind) collected ($0.2)
Seat 3: 68c91a77 (big blind) folded before Flop
Seat 4: c1f2cb80 folded before Flop (didn't bet)
Seat 5: b6bd39ad folded before Flop (didn't bet)
Seat 6: 5a11912c folded before Flop (didn't bet)


Poker Hand #RC1456666053: Hold'em No Limit  ($0.05/$0.1) - 2023/04/07 11:32:34
Table 'RushAndCash3081313' 6-max Seat #1 is the button
Seat 1: c35cd416 ($37.19 in chips)
Seat 2: Hero ($7.31 in chips)
Seat 3: 788a8ec4 ($10 in chips)
Seat 4: 958abe9a ($10.09 in chips)
Seat 5: 18e1b26e ($10.17 in chips)
Seat 6: 5b97ef9b ($19.6 in chips)
Hero: posts small blind $0.05
788a8ec4: posts big blind $0.1
*** HOLE CARDS ***
Dealt to c35cd416 
Dealt to Hero [8s Qc]
Dealt to 788a8ec4 
Dealt to 958abe9a 
Dealt to 18e1b26e 
Dealt to 5b97ef9b 
958abe9a: folds
18e1b26e: folds
5b97ef9b: folds
c35cd416: folds
Hero: raises $0.2 to $0.3
788a8ec4: folds
Uncalled bet ($0.2) returned to Hero
*** SHOWDOWN ***
Hero collected $0.2 from pot
*** SUMMARY ***
Total pot $0.2 | Rake $0 | Jackpot $0 | Bingo $0 | Fortune $0
Seat 1: c35cd416 (button) folded before Flop (didn't bet)
Seat 2: Hero (small blind) collected ($0.2)
Seat 3: 788a8ec4 (big blind) folded before Flop
Seat 4: 958abe9a folded before Flop (didn't bet)
Seat 5: 18e1b26e folded before Flop (didn't bet)
Seat 6: 5b97ef9b folded before Flop (didn't bet)


Poker Hand #RC1456665734: Hold'em No Limit  ($0.05/$0.1) - 2023/04/07 11:31:44
Table 'RushAndCash3080994' 6-max Seat #1 is the button
Seat 1: 2fd004d2 ($26.83 in chips)
Seat 2: 9955d467 ($5.84 in chips)
Seat 3: Hero ($7.72 in chips)
Seat 4: d159fefc ($7.54 in chips)
Seat 5: 5fd7a81 ($10 in chips)
Seat 6: bc853fc5 ($10 in chips)
9955d467: posts small blind $0.05
Hero: posts big blind $0.1
*** HOLE CARDS ***
Dealt to 2fd004d2 
Dealt to 9955d467 
Dealt to Hero [Qc Kd]
Dealt to d159fefc 
Dealt to 5fd7a81 
Dealt to bc853fc5 
d159fefc: raises $0.12 to $0.22
5fd7a81: folds
bc853fc5: folds
2fd004d2: folds
9955d467: folds
Hero: calls $0.12
*** FLOP *** [Tc 7d 4c]
Hero: checks
d159fefc: bets $0.19
Hero: calls $0.19
*** TURN *** [Tc 7d 4c] [Jh]
Hero: checks
d159fefc: bets $0.59
Hero: folds
Uncalled bet ($0.59) returned to d159fefc
*** SHOWDOWN ***
d159fefc collected $0.83 from pot
*** SUMMARY ***
Total pot $0.87 | Rake $0.04 | Jackpot $0 | Bingo $0 | Fortune $0
Board [Tc 7d 4c Jh]
Seat 1: 2fd004d2 (button) folded before Flop (didn't bet)
Seat 2: 9955d467 (small blind) folded before Flop
Seat 3: Hero (big blind) folded on the Turn
Seat 4: d159fefc won ($0.83)
Seat 5: 5fd7a81 folded before Flop (didn't bet)
Seat 6: bc853fc5 folded before Flop (didn't bet)


Poker Hand #RC1456665705: Hold'em No Limit  ($0.05/$0.1) - 2023/04/07 11:31:38
Table 'RushAndCash3080965' 6-max Seat #1 is the button
Seat 1: ebf31bad ($10 in chips)
Seat 2: 6c85eebb ($10 in chips)
Seat 3: 27888cb0 ($8.79 in chips)
Seat 4: 72fa4a17 ($10 in chips)
Seat 5: 33ead1fe ($32.74 in chips)
Seat 6: Hero ($7.72 in chips)
6c85eebb: posts small blind $0.05
27888cb0: posts big blind $0.1
*** HOLE CARDS ***
Dealt to ebf31bad 
Dealt to 6c85eebb 
Dealt to 27888cb0 
Dealt to 72fa4a17 
Dealt to 33ead1fe 
Dealt to Hero [2s Tc]
72fa4a17: folds
33ead1fe: folds
Hero: folds
ebf31bad: folds
6c85eebb: folds
Uncalled bet ($0.05) returned to 27888cb0
*** SHOWDOWN ***
27888cb0 collected $0.1 from pot
*** SUMMARY ***
Total pot $0.1 | Rake $0 | Jackpot $0 | Bingo $0 | Fortune $0
Seat 1: ebf31bad (button) folded before Flop (didn't bet)
Seat 2: 6c85eebb (small blind) folded before Flop
Seat 3: 27888cb0 (big blind) collected ($0.1)
Seat 4: 72fa4a17 folded before Flop (didn't bet)
Seat 5: 33ead1fe folded before Flop (didn't bet)
Seat 6: Hero folded before Flop (didn't bet)


Poker Hand #RC1456665679: Hold'em No Limit  ($0.05/$0.1) - 2023/04/07 11:31:33
Table 'RushAndCash3080939' 6-max Seat #1 is the button
Seat 1: 33ead1fe ($32.74 in chips)
Seat 2: Hero ($7.77 in chips)
Seat 3: 29bded5b ($10.6 in chips)
Seat 4: 244e0448 ($10.73 in chips)
Seat 5: ea5c4cab ($11.46 in chips)
Seat 6: 6be17b56 ($10.22 in chips)
Hero: posts small blind $0.05
29bded5b: posts big blind $0.1
*** HOLE CARDS ***
Dealt to 33ead1fe 
Dealt to Hero [4s 8h]
Dealt to 29bded5b 
Dealt to 244e0448 
Dealt to ea5c4cab 
Dealt to 6be17b56 
244e0448: raises $0.15 to $0.25
ea5c4cab: folds
6be17b56: folds
33ead1fe: folds
Hero: folds
29bded5b: calls $0.15
*** FLOP *** [7d Kh 6c]
29bded5b: checks
244e0448: checks
*** TURN *** [7d Kh 6c] [7c]
29bded5b: checks
244e0448: bets $0.42
29bded5b: calls $0.42
*** RIVER *** [7d Kh 6c 7c] [Qd]
29bded5b: checks
244e0448: bets $1.05
29bded5b: calls $1.05
244e0448: shows [2c Ac] (Pair of Sevens)
29bded5b: shows [Tc Qc] (Pair of Queens and Pair of Sevens)
*** SHOWDOWN ***
29bded5b collected $3.18 from pot
*** SUMMARY ***
Total pot $3.49 | Rake $0.16 | Jackpot $0.15 | Bingo $0 | Fortune $0
Board [7d Kh 6c 7c Qd]
Seat 1: 33ead1fe (button) folded before Flop (didn't bet)
Seat 2: Hero (small blind) folded before Flop
Seat 3: 29bded5b (big blind) showed [Tc Qc] and won ($3.18) with Pair of Queens and Pair of Sevens
Seat 4: 244e0448 showed [2c Ac] and lost with Pair of Sevens
Seat 5: ea5c4cab folded before Flop (didn't bet)
Seat 6: 6be17b56 folded before Flop (didn't bet)


Poker Hand #RC1456665612: Hold'em No Limit  ($0.05/$0.1) - 2023/04/07 11:31:22
Table 'RushAndCash3080872' 6-max Seat #1 is the button
Seat 1: 10d7c8e4 ($11.02 in chips)
Seat 2: 6a2a4095 ($10.18 in chips)
Seat 3: Hero ($7.87 in chips)
Seat 4: e6649e7b ($14.84 in chips)
Seat 5: 89baf59b ($18.61 in chips)
Seat 6: 3f77e795 ($10.1 in chips)
6a2a4095: posts small blind $0.05
Hero: posts big blind $0.1
*** HOLE CARDS ***
Dealt to 10d7c8e4 
Dealt to 6a2a4095 
Dealt to Hero [Ks 5h]
Dealt to e6649e7b 
Dealt to 89baf59b 
Dealt to 3f77e795 
e6649e7b: folds
89baf59b: raises $0.13 to $0.23
3f77e795: folds
10d7c8e4: folds
6a2a4095: raises $0.56 to $0.79
Hero: folds
89baf59b: calls $0.56
*** FLOP *** [4h Kh 6h]
6a2a4095: checks
89baf59b: checks
*** TURN *** [4h Kh 6h] [Tc]
6a2a4095: bets $1.01
89baf59b: calls $1.01
*** RIVER *** [4h Kh 6h Tc] [Qd]
6a2a4095: checks
89baf59b: checks
6a2a4095: shows [8s 8c] (Pair of Eights)
89baf59b: shows [9s 9h] (Pair of Nines)
*** SHOWDOWN ***
89baf59b collected $3.38 from pot
*** SUMMARY ***
Total pot $3.7 | Rake $0.17 | Jackpot $0.15 | Bingo $0 | Fortune $0
Board [4h Kh 6h Tc Qd]
Seat 1: 10d7c8e4 (button) folded before Flop (didn't bet)
Seat 2: 6a2a4095 (small blind) showed [8s 8c] and lost with Pair of Eights
Seat 3: Hero (big blind) folded before Flop
Seat 4: e6649e7b folded before Flop (didn't bet)
Seat 5: 89baf59b showed [9s 9h] and won ($3.38) with Pair of Nines
Seat 6: 3f77e795 folded before Flop (didn't bet)


Poker Hand #RC1456665453: Hold'em No Limit  ($0.05/$0.1) - 2023/04/07 11:30:52
Table 'RushAndCash3080713' 6-max Seat #1 is the button
Seat 1: Hero ($8.09 in chips)
Seat 2: 6c85eebb ($10.05 in chips)
Seat 3: 6a2a4095 ($9.72 in chips)
Seat 4: f585eef5 ($6.85 in chips)
Seat 5: e6649e7b ($15.06 in chips)
Seat 6: eff4e203 ($14.93 in chips)
6c85eebb: posts small blind $0.05
6a2a4095: posts big blind $0.1
*** HOLE CARDS ***
Dealt to Hero [5h 6h]
Dealt to 6c85eebb 
Dealt to 6a2a4095 
Dealt to f585eef5 
Dealt to e6649e7b 
Dealt to eff4e203 
f585eef5: folds
e6649e7b: raises $0.12 to $0.22
eff4e203: folds
Hero: calls $0.22
6c85eebb: folds
6a2a4095: raises $0.71 to $0.93
e6649e7b: folds
Hero: folds
Uncalled bet ($0.71) returned to 6a2a4095
*** SHOWDOWN ***
6a2a4095 collected $0.68 from pot
*** SUMMARY ***
Total pot $0.71 | Rake $0.03 | Jackpot $0 | Bingo $0 | Fortune $0
Seat 1: Hero (button) folded before Flop
Seat 2: 6c85eebb (small blind) folded before Flop
Seat 3: 6a2a4095 (big blind) collected ($0.68)
Seat 4: f585eef5 folded before Flop (didn't bet)
Seat 5: e6649e7b folded before Flop
Seat 6: eff4e203 folded before Flop (didn't bet)


Poker Hand #RC1456665394: Hold'em No Limit  ($0.05/$0.1) - 2023/04/07 11:30:41
Table 'RushAndCash3080654' 6-max Seat #1 is the button
Seat 1: dcd481d ($12.72 in chips)
Seat 2: 550e3b3f ($15.64 in chips)
Seat 3: 8582274b ($12.32 in chips)
Seat 4: f8dcfabf ($13.59 in chips)
Seat 5: 2bfd1b14 ($17.07 in chips)
Seat 6: Hero ($7.94 in chips)
550e3b3f: posts small blind $0.05
8582274b: posts big blind $0.1
*** HOLE CARDS ***
Dealt to dcd481d 
Dealt to 550e3b3f 
Dealt to 8582274b 
Dealt to f8dcfabf 
Dealt to 2bfd1b14 
Dealt to Hero [As 2s]
f8dcfabf: folds
2bfd1b14: folds
Hero: raises $0.15 to $0.25
dcd481d: folds
550e3b3f: folds
8582274b: folds
Uncalled bet ($0.15) returned to Hero
*** SHOWDOWN ***
Hero collected $0.25 from pot
*** SUMMARY ***
Total pot $0.25 | Rake $0 | Jackpot $0 | Bingo $0 | Fortune $0
Seat 1: dcd481d (button) folded before Flop (didn't bet)
Seat 2: 550e3b3f (small blind) folded before Flop
Seat 3: 8582274b (big blind) folded before Flop
Seat 4: f8dcfabf folded before Flop (didn't bet)
Seat 5: 2bfd1b14 folded before Flop (didn't bet)
Seat 6: Hero collected ($0.25)


Poker Hand #RC1456664989: Hold'em No Limit  ($0.05/$0.1) - 2023/04/07 11:29:34
Table 'RushAndCash3080249' 6-max Seat #1 is the button
Seat 1: d7bd5db0 ($10.16 in chips)
Seat 2: f8dcfabf ($13.27 in chips)
Seat 3: 18c7823d ($10.65 in chips)
Seat 4: c69f0f99 ($4.8 in chips)
Seat 5: Hero ($8.19 in chips)
Seat 6: d7d93175 ($37.45 in chips)
f8dcfabf: posts small blind $0.05
18c7823d: posts big blind $0.1
*** HOLE CARDS ***
Dealt to d7bd5db0 
Dealt to f8dcfabf 
Dealt to 18c7823d 
Dealt to c69f0f99 
Dealt to Hero [Js Kh]
Dealt to d7d93175 
c69f0f99: folds
Hero: raises $0.15 to $0.25
d7d93175: folds
d7bd5db0: folds
f8dcfabf: calls $0.2
18c7823d: folds
*** FLOP *** [5h 3s Qd]
f8dcfabf: checks
Hero: checks
*** TURN *** [5h 3s Qd] [Qs]
f8dcfabf: checks
Hero: checks
*** RIVER *** [5h 3s Qd Qs] [6c]
f8dcfabf: checks
Hero: checks
f8dcfabf: shows [7s 6s] (Pair of Queens and Pair of Sixes)
Hero: shows [Js Kh] (Pair of Queens)
*** SHOWDOWN ***
f8dcfabf collected $0.57 from pot
*** SUMMARY ***
Total pot $0.6 | Rake $0.03 | Jackpot $0 | Bingo $0 | Fortune $0
Board [5h 3s Qd Qs 6c]
Seat 1: d7bd5db0 (button) folded before Flop (didn't bet)
Seat 2: f8dcfabf (small blind) showed [7s 6s] and won ($0.57) with Pair of Queens and Pair of Sixes
Seat 3: 18c7823d (big blind) folded before Flop
Seat 4: c69f0f99 folded before Flop (didn't bet)
Seat 5: Hero showed [Js Kh] and lost with Pair of Queens
Seat 6: d7d93175 folded before Flop (didn't bet)


Poker Hand #RC1456664962: Hold'em No Limit  ($0.05/$0.1) - 2023/04/07 11:29:29
Table 'RushAndCash3080222' 6-max Seat #1 is the button
Seat 1: 65f22aee ($25.1 in chips)
Seat 2: 78263b8b ($10 in chips)
Seat 3: 143ed893 ($10.15 in chips)
Seat 4: ebf553bb ($11.43 in chips)
Seat 5: 7719e9dd ($21.88 in chips)
Seat 6: Hero ($8.19 in chips)
78263b8b: posts small blind $0.05
143ed893: posts big blind $0.1
*** HOLE CARDS ***
Dealt to 65f22aee 
Dealt to 78263b8b 
Dealt to 143ed893 
Dealt to ebf553bb 
Dealt to 7719e9dd 
Dealt to Hero [3c Jh]
ebf553bb: folds
7719e9dd: raises $0.14 to $0.24
Hero: folds
65f22aee: folds
78263b8b: raises $0.8 to $1.04
143ed893: folds
7719e9dd: folds
Uncalled bet ($0.8) returned to 78263b8b
*** SHOWDOWN ***
78263b8b collected $0.56 from pot
*** SUMMARY ***
Total pot $0.58 | Rake $0.02 | Jackpot $0 | Bingo $0 | Fortune $0
Seat 1: 65f22aee (button) folded before Flop (didn't bet)
Seat 2: 78263b8b (small blind) collected ($0.56)
Seat 3: 143ed893 (big blind) folded before Flop
Seat 4: ebf553bb folded before Flop (didn't bet)
Seat 5: 7719e9dd folded before Flop
Seat 6: Hero folded before Flop (didn't bet)


Poker Hand #RC1456664938: Hold'em No Limit  ($0.05/$0.1) - 2023/04/07 11:29:24
Table 'RushAndCash3080198' 6-max Seat #1 is the button
Seat 1: cd2da17d ($24.19 in chips)
Seat 2: b19e7719 ($12.98 in chips)
Seat 3: 7b2952c ($10.1 in chips)
Seat 4: 3f77e795 ($10 in chips)
Seat 5: Hero ($8.19 in chips)
Seat 6: eb1df274 ($3.52 in chips)
b19e7719: posts small blind $0.05
7b2952c: posts big blind $0.1
*** HOLE CARDS ***
Dealt to cd2da17d 
Dealt to b19e7719 
Dealt to 7b2952c 
Dealt to 3f77e795 
Dealt to Hero [6c 3d]
Dealt to eb1df274 
3f77e795: folds
Hero: folds
eb1df274: raises $0.1 to $0.2
cd2da17d: calls $0.2
b19e7719: folds
7b2952c: calls $0.1
*** FLOP *** [Kd Jc 8d]
7b2952c: checks
eb1df274: checks
cd2da17d: checks
*** TURN *** [Kd Jc 8d] [5h]
7b2952c: checks
eb1df274: checks
cd2da17d: bets $0.49
7b2952c: folds
eb1df274: folds
Uncalled bet ($0.49) returned to cd2da17d
7b2952c: shows [Ah] (Ace-High)
*** SHOWDOWN ***
cd2da17d collected $0.62 from pot
*** SUMMARY ***
Total pot $0.65 | Rake $0.03 | Jackpot $0 | Bingo $0 | Fortune $0
Board [Kd Jc 8d 5h]
Seat 1: cd2da17d (button) won ($0.62)
Seat 2: b19e7719 (small blind) folded before Flop
Seat 3: 7b2952c (big blind) folded on the Turn
Seat 4: 3f77e795 folded before Flop (didn't bet)
Seat 5: Hero folded before Flop (didn't bet)
Seat 6: eb1df274 folded on the Turn


Poker Hand #RC1456664883: Hold'em No Limit  ($0.05/$0.1) - 2023/04/07 11:29:15
Table 'RushAndCash3080143' 6-max Seat #1 is the button
Seat 1: Hero ($8.19 in chips)
Seat 2: eb1df274 ($3.57 in chips)
Seat 3: b21ceb61 ($21.43 in chips)
Seat 4: f3c4a902 ($10 in chips)
Seat 5: c842cfbd ($12.16 in chips)
Seat 6: 10d7c8e4 ($11.27 in chips)
eb1df274: posts small blind $0.05
b21ceb61: posts big blind $0.1
*** HOLE CARDS ***
Dealt to Hero [Qc 9h]
Dealt to eb1df274 
Dealt to b21ceb61 
Dealt to f3c4a902 
Dealt to c842cfbd 
Dealt to 10d7c8e4 
f3c4a902: folds
c842cfbd: folds
10d7c8e4: raises $0.15 to $0.25
Hero: folds
eb1df274: folds
b21ceb61: folds
Uncalled bet ($0.15) returned to 10d7c8e4
*** SHOWDOWN ***
10d7c8e4 collected $0.25 from pot
*** SUMMARY ***
Total pot $0.25 | Rake $0 | Jackpot $0 | Bingo $0 | Fortune $0
Seat 1: Hero (button) folded before Flop (didn't bet)
Seat 2: eb1df274 (small blind) folded before Flop
Seat 3: b21ceb61 (big blind) folded before Flop
Seat 4: f3c4a902 folded before Flop (didn't bet)
Seat 5: c842cfbd folded before Flop (didn't bet)
Seat 6: 10d7c8e4 collected ($0.25)


Poker Hand #RC1456664854: Hold'em No Limit  ($0.05/$0.1) - 2023/04/07 11:29:10
Table 'RushAndCash3080114' 6-max Seat #1 is the button
Seat 1: f63578b ($9.34 in chips)
Seat 2: Hero ($8.24 in chips)
Seat 3: 35b855b ($10 in chips)
Seat 4: 9d5b7c3d ($10 in chips)
Seat 5: b6bd39ad ($15.25 in chips)
Seat 6: 20a7143f ($11.09 in chips)
Hero: posts small blind $0.05
35b855b: posts big blind $0.1
*** HOLE CARDS ***
Dealt to f63578b 
Dealt to Hero [2s Td]
Dealt to 35b855b 
Dealt to 9d5b7c3d 
Dealt to b6bd39ad 
Dealt to 20a7143f 
9d5b7c3d: folds
b6bd39ad: raises $0.15 to $0.25
20a7143f: raises $0.49 to $0.74
f63578b: folds
Hero: folds
35b855b: calls $0.64
b6bd39ad: raises $14.51 to $15.25 and is all-in
20a7143f: folds
35b855b: folds
Uncalled bet ($14.51) returned to b6bd39ad
*** SHOWDOWN ***
b6bd39ad collected $2.16 from pot
*** SUMMARY ***
Total pot $2.27 | Rake $0.11 | Jackpot $0 | Bingo $0 | Fortune $0
Seat 1: f63578b (button) folded before Flop (didn't bet)
Seat 2: Hero (small blind) folded before Flop
Seat 3: 35b855b (big blind) folded before Flop
Seat 4: 9d5b7c3d folded before Flop (didn't bet)
Seat 5: b6bd39ad collected ($2.16)
Seat 6: 20a7143f folded before Flop


Poker Hand #RC1456664822: Hold'em No Limit  ($0.05/$0.1) - 2023/04/07 11:29:05
Table 'RushAndCash3080082' 6-max Seat #1 is the button
Seat 1: 637bb493 ($10.1 in chips)
Seat 2: 180913a1 ($9.75 in chips)
Seat 3: Hero ($8.34 in chips)
Seat 4: bbe7e23e ($10 in chips)
Seat 5: 70521d97 ($16.54 in chips)
Seat 6: f938a0db ($12.29 in chips)
180913a1: posts small blind $0.05
Hero: posts big blind $0.1
*** HOLE CARDS ***
Dealt to 637bb493 
Dealt to 180913a1 
Dealt to Hero [4h 9h]
Dealt to bbe7e23e 
Dealt to 70521d97 
Dealt to f938a0db 
bbe7e23e: folds
70521d97: folds
f938a0db: folds
637bb493: raises $0.15 to $0.25
180913a1: folds
Hero: folds
Uncalled bet ($0.15) returned to 637bb493
*** SHOWDOWN ***
637bb493 collected $0.25 from pot
*** SUMMARY ***
Total pot $0.25 | Rake $0 | Jackpot $0 | Bingo $0 | Fortune $0
Seat 1: 637bb493 (button) collected ($0.25)
Seat 2: 180913a1 (small blind) folded before Flop
Seat 3: Hero (big blind) folded before Flop
Seat 4: bbe7e23e folded before Flop (didn't bet)
Seat 5: 70521d97 folded before Flop (didn't bet)
Seat 6: f938a0db folded before Flop (didn't bet)


Poker Hand #RC1456664781: Hold'em No Limit  ($0.05/$0.1) - 2023/04/07 11:28:58
Table 'RushAndCash3080041' 6-max Seat #1 is the button
Seat 1: ac4e0c1 ($10.43 in chips)
Seat 2: bd484c10 ($12.02 in chips)
Seat 3: e1e1fbad ($12.6 in chips)
Seat 4: 7f6dcfc1 ($12.61 in chips)
Seat 5: 4486944f ($14.45 in chips)
Seat 6: Hero ($8.34 in chips)
bd484c10: posts small blind $0.05
e1e1fbad: posts big blind $0.1
*** HOLE CARDS ***
Dealt to ac4e0c1 
Dealt to bd484c10 
Dealt to e1e1fbad 
Dealt to 7f6dcfc1 
Dealt to 4486944f 
Dealt to Hero [8c 2s]
7f6dcfc1: folds
4486944f: folds
Hero: folds
ac4e0c1: folds
bd484c10: raises $0.2 to $0.3
e1e1fbad: folds
Uncalled bet ($0.2) returned to bd484c10
*** SHOWDOWN ***
bd484c10 collected $0.2 from pot
*** SUMMARY ***
Total pot $0.2 | Rake $0 | Jackpot $0 | Bingo $0 | Fortune $0
Seat 1: ac4e0c1 (button) folded before Flop (didn't bet)
Seat 2: bd484c10 (small blind) collected ($0.2)
Seat 3: e1e1fbad (big blind) folded before Flop
Seat 4: 7f6dcfc1 folded before Flop (didn't bet)
Seat 5: 4486944f folded before Flop (didn't bet)
Seat 6: Hero folded before Flop (didn't bet)


Poker Hand #RC1456664757: Hold'em No Limit  ($0.05/$0.1) - 2023/04/07 11:28:54
Table 'RushAndCash3080017' 6-max Seat #1 is the button
Seat 1: ba4efd2e ($10.25 in chips)
Seat 2: bf6f1943 ($8.67 in chips)
Seat 3: 88f452a6 ($26.43 in chips)
Seat 4: f073b4e ($16.51 in chips)
Seat 5: Hero ($8.34 in chips)
Seat 6: 58fb9a3a ($10 in chips)
bf6f1943: posts small blind $0.05
88f452a6: posts big blind $0.1
*** HOLE CARDS ***
Dealt to ba4efd2e 
Dealt to bf6f1943 
Dealt to 88f452a6 
Dealt to f073b4e 
Dealt to Hero [2d Th]
Dealt to 58fb9a3a 
f073b4e: folds
Hero: folds
58fb9a3a: folds
ba4efd2e: folds
bf6f1943: folds
Uncalled bet ($0.05) returned to 88f452a6
*** SHOWDOWN ***
88f452a6 collected $0.1 from pot
*** SUMMARY ***
Total pot $0.1 | Rake $0 | Jackpot $0 | Bingo $0 | Fortune $0
Seat 1: ba4efd2e (button) folded before Flop (didn't bet)
Seat 2: bf6f1943 (small blind) folded before Flop
Seat 3: 88f452a6 (big blind) collected ($0.1)
Seat 4: f073b4e folded before Flop (didn't bet)
Seat 5: Hero folded before Flop (didn't bet)
Seat 6: 58fb9a3a folded before Flop (didn't bet)


Poker Hand #RC1456624735: Hold'em No Limit  ($0.05/$0.1) - 2023/04/07 11:28:50
Table 'RushAndCash3079995' 6-max Seat #1 is the button
Seat 1: 391f89d3 ($16.97 in chips)
Seat 2: 7f09a304 ($11.89 in chips)
Seat 3: 9ad10009 ($13.5 in chips)
Seat 4: Hero ($8.34 in chips)
Seat 5: fed9a9c8 ($10.76 in chips)
Seat 6: bf6f1943 ($8.67 in chips)
7f09a304: posts small blind $0.05
9ad10009: posts big blind $0.1
*** HOLE CARDS ***
Dealt to 391f89d3 
Dealt to 7f09a304 
Dealt to 9ad10009 
Dealt to Hero [2c 7c]
Dealt to fed9a9c8 
Dealt to bf6f1943 
Hero: folds
fed9a9c8: folds
bf6f1943: folds
391f89d3: raises $0.1 to $0.2
7f09a304: calls $0.15
9ad10009: calls $0.1
*** FLOP *** [Ac Jc 2s]
7f09a304: checks
9ad10009: checks
391f89d3: bets $0.2
7f09a304: folds
9ad10009: folds
Uncalled bet ($0.2) returned to 391f89d3
*** SHOWDOWN ***
391f89d3 collected $0.57 from pot
*** SUMMARY ***
Total pot $0.6 | Rake $0.03 | Jackpot $0 | Bingo $0 | Fortune $0
Board [Ac Jc 2s]
Seat 1: 391f89d3 (button) won ($0.57)
Seat 2: 7f09a304 (small blind) folded on the Flop
Seat 3: 9ad10009 (big blind) folded on the Flop
Seat 4: Hero folded before Flop (didn't bet)
Seat 5: fed9a9c8 folded before Flop (didn't bet)
Seat 6: bf6f1943 folded before Flop (didn't bet)


Poker Hand #RC1456624706: Hold'em No Limit  ($0.05/$0.1) - 2023/04/07 11:28:44
Table 'RushAndCash3079966' 6-max Seat #1 is the button
Seat 1: 1ce003d6 ($10.15 in chips)
Seat 2: 4cdb9be2 ($11.27 in chips)
Seat 3: 18c7823d ($11 in chips)
Seat 4: dea7a4d4 ($14.65 in chips)
Seat 5: ed7ccdc6 ($19.75 in chips)
Seat 6: Hero ($8.34 in chips)
4cdb9be2: posts small blind $0.05
18c7823d: posts big blind $0.1
*** HOLE CARDS ***
Dealt to 1ce003d6 
Dealt to 4cdb9be2 
Dealt to 18c7823d 
Dealt to dea7a4d4 
Dealt to ed7ccdc6 
Dealt to Hero [Jc Th]
dea7a4d4: folds
ed7ccdc6: raises $0.2 to $0.3
Hero: folds
1ce003d6: calls $0.3
4cdb9be2: folds
18c7823d: folds
*** FLOP *** [9h 3d Qc]
ed7ccdc6: bets $0.45
1ce003d6: calls $0.45
*** TURN *** [9h 3d Qc] [4c]
ed7ccdc6: bets $0.99
1ce003d6: raises $1.82 to $2.81
ed7ccdc6: calls $1.82
*** RIVER *** [9h 3d Qc 4c] [Ts]
ed7ccdc6: checks
1ce003d6: bets $6.59 and is all-in
ed7ccdc6: folds
Uncalled bet ($6.59) returned to 1ce003d6
*** SHOWDOWN ***
1ce003d6 collected $6.82 from pot
*** SUMMARY ***
Total pot $7.27 | Rake $0.3 | Jackpot $0.15 | Bingo $0 | Fortune $0
Board [9h 3d Qc 4c Ts]
Seat 1: 1ce003d6 (button) won ($6.82)
Seat 2: 4cdb9be2 (small blind) folded before Flop
Seat 3: 18c7823d (big blind) folded before Flop
Seat 4: dea7a4d4 folded before Flop (didn't bet)
Seat 5: ed7ccdc6 folded on the River
Seat 6: Hero folded before Flop (didn't bet)


Poker Hand #RC1456624676: Hold'em No Limit  ($0.05/$0.1) - 2023/04/07 11:28:39
Table 'RushAndCash3079936' 6-max Seat #1 is the button
Seat 1: ce41d4dc ($13.43 in chips)
Seat 2: Hero ($8.39 in chips)
Seat 3: 7d6f9e9 ($10.86 in chips)
Seat 4: bb005a13 ($19.53 in chips)
Seat 5: 54cc5108 ($10.64 in chips)
Seat 6: c1f48396 ($21.73 in chips)
Hero: posts small blind $0.05
7d6f9e9: posts big blind $0.1
*** HOLE CARDS ***
Dealt to ce41d4dc 
Dealt to Hero [7c Td]
Dealt to 7d6f9e9 
Dealt to bb005a13 
Dealt to 54cc5108 
Dealt to c1f48396 
bb005a13: folds
54cc5108: folds
c1f48396: folds
ce41d4dc: raises $0.13 to $0.23
Hero: folds
7d6f9e9: raises $0.87 to $1.1
ce41d4dc: folds
Uncalled bet ($0.87) returned to 7d6f9e9
*** SHOWDOWN ***
7d6f9e9 collected $0.49 from pot
*** SUMMARY ***
Total pot $0.51 | Rake $0.02 | Jackpot $0 | Bingo $0 | Fortune $0
Seat 1: ce41d4dc (button) folded before Flop
Seat 2: Hero (small blind) folded before Flop
Seat 3: 7d6f9e9 (big blind) collected ($0.49)
Seat 4: bb005a13 folded before Flop (didn't bet)
Seat 5: 54cc5108 folded before Flop (didn't bet)
Seat 6: c1f48396 folded before Flop (didn't bet)


Poker Hand #RC1456624438: Hold'em No Limit  ($0.05/$0.1) - 2023/04/07 11:27:57
Table 'RushAndCash3079698' 6-max Seat #1 is the button
Seat 1: 9cf2632d ($14.71 in chips)
Seat 2: c1f48396 ($21.28 in chips)
Seat 3: Hero ($8.89 in chips)
Seat 4: ab07da20 ($10.82 in chips)
Seat 5: b5998eb7 ($14.28 in chips)
Seat 6: c69f0f99 ($5.15 in chips)
c1f48396: posts small blind $0.05
Hero: posts big blind $0.1
*** HOLE CARDS ***
Dealt to 9cf2632d 
Dealt to c1f48396 
Dealt to Hero [4h 4c]
Dealt to ab07da20 
Dealt to b5998eb7 
Dealt to c69f0f99 
ab07da20: folds
b5998eb7: folds
c69f0f99: folds
9cf2632d: folds
c1f48396: raises $0.2 to $0.3
Hero: calls $0.2
*** FLOP *** [Th 8h Ah]
c1f48396: bets $0.2
Hero: calls $0.2
*** TURN *** [Th 8h Ah] [7d]
c1f48396: bets $0.65
Hero: folds
Uncalled bet ($0.65) returned to c1f48396
*** SHOWDOWN ***
c1f48396 collected $0.95 from pot
*** SUMMARY ***
Total pot $1 | Rake $0.05 | Jackpot $0 | Bingo $0 | Fortune $0
Board [Th 8h Ah 7d]
Seat 1: 9cf2632d (button) folded before Flop (didn't bet)
Seat 2: c1f48396 (small blind) won ($0.95)
Seat 3: Hero (big blind) folded on the Turn
Seat 4: ab07da20 folded before Flop (didn't bet)
Seat 5: b5998eb7 folded before Flop (didn't bet)
Seat 6: c69f0f99 folded before Flop (didn't bet)


Poker Hand #RC1456624383: Hold'em No Limit  ($0.05/$0.1) - 2023/04/07 11:27:48
Table 'RushAndCash3079643' 6-max Seat #1 is the button
Seat 1: Hero ($8.89 in chips)
Seat 2: 6ecc4900 ($15 in chips)
Seat 3: ab07da20 ($10.97 in chips)
Seat 4: 11d3b02 ($12.21 in chips)
Seat 5: 3f51d7c6 ($10 in chips)
Seat 6: 5db48cbf ($20.31 in chips)
6ecc4900: posts small blind $0.05
ab07da20: posts big blind $0.1
*** HOLE CARDS ***
Dealt to Hero [2h 5h]
Dealt to 6ecc4900 
Dealt to ab07da20 
Dealt to 11d3b02 
Dealt to 3f51d7c6 
Dealt to 5db48cbf 
11d3b02: folds
3f51d7c6: folds
5db48cbf: raises $0.2 to $0.3
Hero: folds
6ecc4900: folds
ab07da20: folds
Uncalled bet ($0.2) returned to 5db48cbf
*** SHOWDOWN ***
5db48cbf collected $0.25 from pot
*** SUMMARY ***
Total pot $0.25 | Rake $0 | Jackpot $0 | Bingo $0 | Fortune $0
Seat 1: Hero (button) folded before Flop (didn't bet)
Seat 2: 6ecc4900 (small blind) folded before Flop
Seat 3: ab07da20 (big blind) folded before Flop
Seat 4: 11d3b02 folded before Flop (didn't bet)
Seat 5: 3f51d7c6 folded before Flop (didn't bet)
Seat 6: 5db48cbf collected ($0.25)


Poker Hand #RC1456624351: Hold'em No Limit  ($0.05/$0.1) - 2023/04/07 11:27:43
Table 'RushAndCash3079611' 6-max Seat #1 is the button
Seat 1: 5aff78f5 ($7.58 in chips)
Seat 2: fc5401c2 ($41.55 in chips)
Seat 3: ce41d4dc ($13.69 in chips)
Seat 4: 9f9e168c ($10.37 in chips)
Seat 5: Hero ($8.89 in chips)
Seat 6: fc3af32a ($10.97 in chips)
fc5401c2: posts small blind $0.05
ce41d4dc: posts big blind $0.1
*** HOLE CARDS ***
Dealt to 5aff78f5 
Dealt to fc5401c2 
Dealt to ce41d4dc 
Dealt to 9f9e168c 
Dealt to Hero [9h 2d]
Dealt to fc3af32a 
9f9e168c: folds
Hero: folds
fc3af32a: folds
5aff78f5: folds
fc5401c2: raises $0.16 to $0.26
ce41d4dc: calls $0.16
*** FLOP *** [Qd Js 8d]
fc5401c2: checks
ce41d4dc: checks
*** TURN *** [Qd Js 8d] [Qc]
fc5401c2: checks
ce41d4dc: checks
*** RIVER *** [Qd Js 8d Qc] [9c]
fc5401c2: bets $0.1
ce41d4dc: folds
Uncalled bet ($0.1) returned to fc5401c2
*** SHOWDOWN ***
fc5401c2 collected $0.5 from pot
*** SUMMARY ***
Total pot $0.52 | Rake $0.02 | Jackpot $0 | Bingo $0 | Fortune $0
Board [Qd Js 8d Qc 9c]
Seat 1: 5aff78f5 (button) folded before Flop (didn't bet)
Seat 2: fc5401c2 (small blind) won ($0.5)
Seat 3: ce41d4dc (big blind) folded on the River
Seat 4: 9f9e168c folded before Flop (didn't bet)
Seat 5: Hero folded before Flop (didn't bet)
Seat 6: fc3af32a folded before Flop (didn't bet)


Poker Hand #RC1456624250: Hold'em No Limit  ($0.05/$0.1) - 2023/04/07 11:27:27
Table 'RushAndCash3079510' 6-max Seat #1 is the button
Seat 1: 5db48cbf ($20.46 in chips)
Seat 2: 85ab0efa ($10 in chips)
Seat 3: aec401af ($24.93 in chips)
Seat 4: 9f76b743 ($11 in chips)
Seat 5: Hero ($8.89 in chips)
Seat 6: 1c8b76f1 ($13.94 in chips)
85ab0efa: posts small blind $0.05
aec401af: posts big blind $0.1
*** HOLE CARDS ***
Dealt to 5db48cbf 
Dealt to 85ab0efa 
Dealt to aec401af 
Dealt to 9f76b743 
Dealt to Hero [8c Ts]
Dealt to 1c8b76f1 
9f76b743: folds
Hero: folds
1c8b76f1: folds
5db48cbf: folds
85ab0efa: folds
Uncalled bet ($0.05) returned to aec401af
*** SHOWDOWN ***
aec401af collected $0.1 from pot
*** SUMMARY ***
Total pot $0.1 | Rake $0 | Jackpot $0 | Bingo $0 | Fortune $0
Seat 1: 5db48cbf (button) folded before Flop (didn't bet)
Seat 2: 85ab0efa (small blind) folded before Flop
Seat 3: aec401af (big blind) collected ($0.1)
Seat 4: 9f76b743 folded before Flop (didn't bet)
Seat 5: Hero folded before Flop (didn't bet)
Seat 6: 1c8b76f1 folded before Flop (didn't bet)


Poker Hand #RC1456623996: Hold'em No Limit  ($0.05/$0.1) - 2023/04/07 11:26:47
Table 'RushAndCash3079256' 6-max Seat #1 is the button
Seat 1: Hero ($9.42 in chips)
Seat 2: 391f89d3 ($16.8 in chips)
Seat 3: 9f76b743 ($10.47 in chips)
Seat 4: be697cc5 ($14.15 in chips)
Seat 5: d5f4fa0b ($7.9 in chips)
Seat 6: 6ecc4900 ($14.95 in chips)
391f89d3: posts small blind $0.05
9f76b743: posts big blind $0.1
*** HOLE CARDS ***
Dealt to Hero [Qc Jc]
Dealt to 391f89d3 
Dealt to 9f76b743 
Dealt to be697cc5 
Dealt to d5f4fa0b 
Dealt to 6ecc4900 
be697cc5: folds
d5f4fa0b: folds
6ecc4900: folds
Hero: raises $0.15 to $0.25
391f89d3: folds
9f76b743: calls $0.15
*** FLOP *** [3s 4s Tc]
9f76b743: checks
Hero: bets $0.28
9f76b743: calls $0.28
*** TURN *** [3s 4s Tc] [7s]
9f76b743: checks
Hero: checks
*** RIVER *** [3s 4s Tc 7s] [8h]
9f76b743: bets $0.75
Hero: folds
Uncalled bet ($0.75) returned to 9f76b743
*** SHOWDOWN ***
9f76b743 collected $1.06 from pot
*** SUMMARY ***
Total pot $1.11 | Rake $0.05 | Jackpot $0 | Bingo $0 | Fortune $0
Board [3s 4s Tc 7s 8h]
Seat 1: Hero (button) folded on the River
Seat 2: 391f89d3 (small blind) folded before Flop
Seat 3: 9f76b743 (big blind) won ($1.06)
Seat 4: be697cc5 folded before Flop (didn't bet)
Seat 5: d5f4fa0b folded before Flop (didn't bet)
Seat 6: 6ecc4900 folded before Flop (didn't bet)


Poker Hand #RC1456623972: Hold'em No Limit  ($0.05/$0.1) - 2023/04/07 11:26:42
Table 'RushAndCash3079232' 6-max Seat #1 is the button
Seat 1: fe7c4d73 ($9.78 in chips)
Seat 2: c11a6a4f ($14.78 in chips)
Seat 3: Hero ($9.37 in chips)
Seat 4: 7f6dcfc1 ($11.58 in chips)
Seat 5: f1e67b9e ($17.92 in chips)
Seat 6: cb820f53 ($10.97 in chips)
c11a6a4f: posts small blind $0.05
Hero: posts big blind $0.1
*** HOLE CARDS ***
Dealt to fe7c4d73 
Dealt to c11a6a4f 
Dealt to Hero [5h 9h]
Dealt to 7f6dcfc1 
Dealt to f1e67b9e 
Dealt to cb820f53 
7f6dcfc1: folds
f1e67b9e: folds
cb820f53: folds
fe7c4d73: folds
c11a6a4f: folds
Uncalled bet ($0.05) returned to Hero
*** SHOWDOWN ***
Hero collected $0.1 from pot
*** SUMMARY ***
Total pot $0.1 | Rake $0 | Jackpot $0 | Bingo $0 | Fortune $0
Seat 1: fe7c4d73 (button) folded before Flop (didn't bet)
Seat 2: c11a6a4f (small blind) folded before Flop
Seat 3: Hero (big blind) collected ($0.1)
Seat 4: 7f6dcfc1 folded before Flop (didn't bet)
Seat 5: f1e67b9e folded before Flop (didn't bet)
Seat 6: cb820f53 folded before Flop (didn't bet)


Poker Hand #RC1456623944: Hold'em No Limit  ($0.05/$0.1) - 2023/04/07 11:26:37
Table 'RushAndCash3079204' 6-max Seat #1 is the button
Seat 1: 64721c4f ($14.29 in chips)
Seat 2: Hero ($9.42 in chips)
Seat 3: f2ac3e6c ($11.15 in chips)
Seat 4: 33fe99e ($12.28 in chips)
Seat 5: 7cab4739 ($16.99 in chips)
Seat 6: 17f8506b ($10.19 in chips)
Hero: posts small blind $0.05
f2ac3e6c: posts big blind $0.1
*** HOLE CARDS ***
Dealt to 64721c4f 
Dealt to Hero [2h 5d]
Dealt to f2ac3e6c 
Dealt to 33fe99e 
Dealt to 7cab4739 
Dealt to 17f8506b 
33fe99e: folds
7cab4739: folds
17f8506b: folds
64721c4f: raises $0.14 to $0.24
Hero: folds
f2ac3e6c: folds
Uncalled bet ($0.14) returned to 64721c4f
*** SHOWDOWN ***
64721c4f collected $0.25 from pot
*** SUMMARY ***
Total pot $0.25 | Rake $0 | Jackpot $0 | Bingo $0 | Fortune $0
Seat 1: 64721c4f (button) collected ($0.25)
Seat 2: Hero (small blind) folded before Flop
Seat 3: f2ac3e6c (big blind) folded before Flop
Seat 4: 33fe99e folded before Flop (didn't bet)
Seat 5: 7cab4739 folded before Flop (didn't bet)
Seat 6: 17f8506b folded before Flop (didn't bet)


Poker Hand #RC1456623907: Hold'em No Limit  ($0.05/$0.1) - 2023/04/07 11:26:32
Table 'RushAndCash3079167' 6-max Seat #1 is the button
Seat 1: fd391163 ($11.44 in chips)
Seat 2: c31e8880 ($23.22 in chips)
Seat 3: eabbf486 ($14.72 in chips)
Seat 4: f8126b23 ($14.45 in chips)
Seat 5: Hero ($9.42 in chips)
Seat 6: cd46d45a ($36.32 in chips)
c31e8880: posts small blind $0.05
eabbf486: posts big blind $0.1
*** HOLE CARDS ***
Dealt to fd391163 
Dealt to c31e8880 
Dealt to eabbf486 
Dealt to f8126b23 
Dealt to Hero [4h Ac]
Dealt to cd46d45a 
f8126b23: folds
Hero: folds
cd46d45a: raises $0.1 to $0.2
fd391163: folds
c31e8880: folds
eabbf486: folds
Uncalled bet ($0.1) returned to cd46d45a
*** SHOWDOWN ***
cd46d45a collected $0.25 from pot
*** SUMMARY ***
Total pot $0.25 | Rake $0 | Jackpot $0 | Bingo $0 | Fortune $0
Seat 1: fd391163 (button) folded before Flop (didn't bet)
Seat 2: c31e8880 (small blind) folded before Flop
Seat 3: eabbf486 (big blind) folded before Flop
Seat 4: f8126b23 folded before Flop (didn't bet)
Seat 5: Hero folded before Flop (didn't bet)
Seat 6: cd46d45a collected ($0.25)


Poker Hand #RC1456623858: Hold'em No Limit  ($0.05/$0.1) - 2023/04/07 11:26:24
Table 'RushAndCash3079118' 6-max Seat #1 is the button
Seat 1: 9cb03fbb ($11.4 in chips)
Seat 2: 810f5bf9 ($14.62 in chips)
Seat 3: d159fefc ($11.36 in chips)
Seat 4: b3de8156 ($11.04 in chips)
Seat 5: Hero ($9.42 in chips)
Seat 6: 1f6bce5a ($11.27 in chips)
810f5bf9: posts small blind $0.05
d159fefc: posts big blind $0.1
*** HOLE CARDS ***
Dealt to 9cb03fbb 
Dealt to 810f5bf9 
Dealt to d159fefc 
Dealt to b3de8156 
Dealt to Hero [4c Qd]
Dealt to 1f6bce5a 
b3de8156: folds
Hero: folds
1f6bce5a: folds
9cb03fbb: folds
810f5bf9: folds
Uncalled bet ($0.05) returned to d159fefc
*** SHOWDOWN ***
d159fefc collected $0.1 from pot
*** SUMMARY ***
Total pot $0.1 | Rake $0 | Jackpot $0 | Bingo $0 | Fortune $0
Seat 1: 9cb03fbb (button) folded before Flop (didn't bet)
Seat 2: 810f5bf9 (small blind) folded before Flop
Seat 3: d159fefc (big blind) collected ($0.1)
Seat 4: b3de8156 folded before Flop (didn't bet)
Seat 5: Hero folded before Flop (didn't bet)
Seat 6: 1f6bce5a folded before Flop (didn't bet)


Poker Hand #RC1456623831: Hold'em No Limit  ($0.05/$0.1) - 2023/04/07 11:26:18
Table 'RushAndCash3079091' 6-max Seat #1 is the button
Seat 1: Hero ($9.42 in chips)
Seat 2: 74df6125 ($20.42 in chips)
Seat 3: 9ad10009 ($13.82 in chips)
Seat 4: 18c7823d ($11.21 in chips)
Seat 5: 20a7143f ($10.33 in chips)
Seat 6: db6d2eaf ($13.03 in chips)
74df6125: posts small blind $0.05
9ad10009: posts big blind $0.1
*** HOLE CARDS ***
Dealt to Hero [4c 8d]
Dealt to 74df6125 
Dealt to 9ad10009 
Dealt to 18c7823d 
Dealt to 20a7143f 
Dealt to db6d2eaf 
18c7823d: folds
20a7143f: raises $0.12 to $0.22
db6d2eaf: folds
Hero: folds
74df6125: folds
9ad10009: folds
Uncalled bet ($0.12) returned to 20a7143f
*** SHOWDOWN ***
20a7143f collected $0.25 from pot
*** SUMMARY ***
Total pot $0.25 | Rake $0 | Jackpot $0 | Bingo $0 | Fortune $0
Seat 1: Hero (button) folded before Flop (didn't bet)
Seat 2: 74df6125 (small blind) folded before Flop
Seat 3: 9ad10009 (big blind) folded before Flop
Seat 4: 18c7823d folded before Flop (didn't bet)
Seat 5: 20a7143f collected ($0.25)
Seat 6: db6d2eaf folded before Flop (didn't bet)


Poker Hand #RC1456623805: Hold'em No Limit  ($0.05/$0.1) - 2023/04/07 11:26:14
Table 'RushAndCash3079065' 6-max Seat #1 is the button
Seat 1: 1ed94b ($10 in chips)
Seat 2: ea775aa ($14.33 in chips)
Seat 3: 204fb5f0 ($26.31 in chips)
Seat 4: Hero ($9.42 in chips)
Seat 5: 32e62a55 ($9.94 in chips)
Seat 6: ca462d72 ($17.17 in chips)
ea775aa: posts small blind $0.05
204fb5f0: posts big blind $0.1
*** HOLE CARDS ***
Dealt to 1ed94b 
Dealt to ea775aa 
Dealt to 204fb5f0 
Dealt to Hero [4s Js]
Dealt to 32e62a55 
Dealt to ca462d72 
Hero: folds
32e62a55: folds
ca462d72: folds
1ed94b: folds
ea775aa: raises $0.15 to $0.25
204fb5f0: calls $0.15
*** FLOP *** [6s 8d 7h]
ea775aa: checks
204fb5f0: checks
*** TURN *** [6s 8d 7h] [3s]
ea775aa: checks
204fb5f0: checks
*** RIVER *** [6s 8d 7h 3s] [Kd]
ea775aa: checks
204fb5f0: checks
ea775aa: shows [Th Qd] (King-High)
204fb5f0: shows [Ts Ah] (Ace-High)
*** SHOWDOWN ***
204fb5f0 collected $0.48 from pot
*** SUMMARY ***
Total pot $0.5 | Rake $0.02 | Jackpot $0 | Bingo $0 | Fortune $0
Board [6s 8d 7h 3s Kd]
Seat 1: 1ed94b (button) folded before Flop (didn't bet)
Seat 2: ea775aa (small blind) showed [Th Qd] and lost with King-High
Seat 3: 204fb5f0 (big blind) showed [Ts Ah] and won ($0.48) with Ace-High
Seat 4: Hero folded before Flop (didn't bet)
Seat 5: 32e62a55 folded before Flop (didn't bet)
Seat 6: ca462d72 folded before Flop (didn't bet)


Poker Hand #RC1456623678: Hold'em No Limit  ($0.05/$0.1) - 2023/04/07 11:25:52
Table 'RushAndCash3078938' 6-max Seat #1 is the button
Seat 1: 9226f2fd ($10.1 in chips)
Seat 2: e7c4d09f ($12.03 in chips)
Seat 3: c51bdbf7 ($11.51 in chips)
Seat 4: c036e9a1 ($15.75 in chips)
Seat 5: Hero ($9.67 in chips)
Seat 6: 2fd004d2 ($22.51 in chips)
e7c4d09f: posts small blind $0.05
c51bdbf7: posts big blind $0.1
*** HOLE CARDS ***
Dealt to 9226f2fd 
Dealt to e7c4d09f 
Dealt to c51bdbf7 
Dealt to c036e9a1 
Dealt to Hero [5d 5s]
Dealt to 2fd004d2 
c036e9a1: folds
Hero: raises $0.15 to $0.25
2fd004d2: folds
9226f2fd: raises $0.6 to $0.85
e7c4d09f: folds
c51bdbf7: folds
Hero: folds
Uncalled bet ($0.6) returned to 9226f2fd
*** SHOWDOWN ***
9226f2fd collected $0.62 from pot
*** SUMMARY ***
Total pot $0.65 | Rake $0.03 | Jackpot $0 | Bingo $0 | Fortune $0
Seat 1: 9226f2fd (button) collected ($0.62)
Seat 2: e7c4d09f (small blind) folded before Flop
Seat 3: c51bdbf7 (big blind) folded before Flop
Seat 4: c036e9a1 folded before Flop (didn't bet)
Seat 5: Hero folded before Flop
Seat 6: 2fd004d2 folded before Flop (didn't bet)


Poker Hand #RC1456623624: Hold'em No Limit  ($0.05/$0.1) - 2023/04/07 11:25:43
Table 'RushAndCash3078884' 6-max Seat #1 is the button
Seat 1: 87c49912 ($13.38 in chips)
Seat 2: 5db48cbf ($22.96 in chips)
Seat 3: Hero ($9.62 in chips)
Seat 4: ae2ca060 ($18.6 in chips)
Seat 5: ac6a1e39 ($22.66 in chips)
Seat 6: ae7575d ($9.26 in chips)
5db48cbf: posts small blind $0.05
Hero: posts big blind $0.1
*** HOLE CARDS ***
Dealt to 87c49912 
Dealt to 5db48cbf 
Dealt to Hero [Jd 6s]
Dealt to ae2ca060 
Dealt to ac6a1e39 
Dealt to ae7575d 
ae2ca060: folds
ac6a1e39: folds
ae7575d: folds
87c49912: folds
5db48cbf: folds
Uncalled bet ($0.05) returned to Hero
*** SHOWDOWN ***
Hero collected $0.1 from pot
*** SUMMARY ***
Total pot $0.1 | Rake $0 | Jackpot $0 | Bingo $0 | Fortune $0
Seat 1: 87c49912 (button) folded before Flop (didn't bet)
Seat 2: 5db48cbf (small blind) folded before Flop
Seat 3: Hero (big blind) collected ($0.1)
Seat 4: ae2ca060 folded before Flop (didn't bet)
Seat 5: ac6a1e39 folded before Flop (didn't bet)
Seat 6: ae7575d folded before Flop (didn't bet)


Poker Hand #RC1456623553: Hold'em No Limit  ($0.05/$0.1) - 2023/04/07 11:25:32
Table 'RushAndCash3078813' 6-max Seat #1 is the button
Seat 1: bf45ff2b ($12.48 in chips)
Seat 2: Hero ($9.67 in chips)
Seat 3: 4184c7be ($10.31 in chips)
Seat 4: 35c564e1 ($20.1 in chips)
Seat 5: bd484c10 ($12.6 in chips)
Seat 6: ff1bc3ff ($14.05 in chips)
Hero: posts small blind $0.05
4184c7be: posts big blind $0.1
*** HOLE CARDS ***
Dealt to bf45ff2b 
Dealt to Hero [6s Kh]
Dealt to 4184c7be 
Dealt to 35c564e1 
Dealt to bd484c10 
Dealt to ff1bc3ff 
35c564e1: folds
bd484c10: folds
ff1bc3ff: raises $0.12 to $0.22
bf45ff2b: folds
Hero: folds
4184c7be: calls $0.12
*** FLOP *** [Qd 9c Ah]
4184c7be: checks
ff1bc3ff: bets $0.17
4184c7be: calls $0.17
*** TURN *** [Qd 9c Ah] [8d]
4184c7be: checks
ff1bc3ff: bets $0.63
4184c7be: calls $0.63
*** RIVER *** [Qd 9c Ah 8d] [6h]
4184c7be: checks
ff1bc3ff: bets $2
4184c7be: folds
Uncalled bet ($2) returned to ff1bc3ff
*** SHOWDOWN ***
ff1bc3ff collected $1.99 from pot
*** SUMMARY ***
Total pot $2.09 | Rake $0.1 | Jackpot $0 | Bingo $0 | Fortune $0
Board [Qd 9c Ah 8d 6h]
Seat 1: bf45ff2b (button) folded before Flop (didn't bet)
Seat 2: Hero (small blind) folded before Flop
Seat 3: 4184c7be (big blind) folded on the River
Seat 4: 35c564e1 folded before Flop (didn't bet)
Seat 5: bd484c10 folded before Flop (didn't bet)
Seat 6: ff1bc3ff won ($1.99)


Poker Hand #RC1456623512: Hold'em No Limit  ($0.05/$0.1) - 2023/04/07 11:25:26
Table 'RushAndCash3078772' 6-max Seat #1 is the button
Seat 1: bc8a2627 ($21.61 in chips)
Seat 2: c75d65ae ($3.27 in chips)
Seat 3: 1b656600 ($11.06 in chips)
Seat 4: de401cf9 ($17.88 in chips)
Seat 5: Hero ($9.67 in chips)
Seat 6: 6c625696 ($4.57 in chips)
c75d65ae: posts small blind $0.05
1b656600: posts big blind $0.1
*** HOLE CARDS ***
Dealt to bc8a2627 
Dealt to c75d65ae 
Dealt to 1b656600 
Dealt to de401cf9 
Dealt to Hero [7d 5h]
Dealt to 6c625696 
de401cf9: folds
Hero: folds
6c625696: folds
bc8a2627: folds
c75d65ae: raises $0.2 to $0.3
1b656600: folds
Uncalled bet ($0.2) returned to c75d65ae
*** SHOWDOWN ***
c75d65ae collected $0.2 from pot
*** SUMMARY ***
Total pot $0.2 | Rake $0 | Jackpot $0 | Bingo $0 | Fortune $0
Seat 1: bc8a2627 (button) folded before Flop (didn't bet)
Seat 2: c75d65ae (small blind) collected ($0.2)
Seat 3: 1b656600 (big blind) folded before Flop
Seat 4: de401cf9 folded before Flop (didn't bet)
Seat 5: Hero folded before Flop (didn't bet)
Seat 6: 6c625696 folded before Flop (didn't bet)


Poker Hand #RC1456623484: Hold'em No Limit  ($0.05/$0.1) - 2023/04/07 11:25:20
Table 'RushAndCash3078744' 6-max Seat #1 is the button
Seat 1: 58bc4163 ($29.5 in chips)
Seat 2: 550e3b3f ($18.58 in chips)
Seat 3: 6e24e8cf ($10 in chips)
Seat 4: Hero ($9.67 in chips)
Seat 5: 167866ca ($10 in chips)
Seat 6: 761a0b94 ($10 in chips)
550e3b3f: posts small blind $0.05
6e24e8cf: posts big blind $0.1
*** HOLE CARDS ***
Dealt to 58bc4163 
Dealt to 550e3b3f 
Dealt to 6e24e8cf 
Dealt to Hero [2d Ts]
Dealt to 167866ca 
Dealt to 761a0b94 
Hero: folds
167866ca: folds
761a0b94: folds
58bc4163: raises $0.15 to $0.25
550e3b3f: raises $0.85 to $1.1
6e24e8cf: folds
58bc4163: raises $1.2 to $2.3
550e3b3f: calls $1.2
*** FLOP *** [Ah Ks Td]
550e3b3f: checks
58bc4163: checks
*** TURN *** [Ah Ks Td] [7s]
550e3b3f: checks
58bc4163: bets $2.35
550e3b3f: folds
Uncalled bet ($2.35) returned to 58bc4163
*** SHOWDOWN ***
58bc4163 collected $4.33 from pot
*** SUMMARY ***
Total pot $4.7 | Rake $0.22 | Jackpot $0.15 | Bingo $0 | Fortune $0
Board [Ah Ks Td 7s]
Seat 1: 58bc4163 (button) won ($4.33)
Seat 2: 550e3b3f (small blind) folded on the Turn
Seat 3: 6e24e8cf (big blind) folded before Flop
Seat 4: Hero folded before Flop (didn't bet)
Seat 5: 167866ca folded before Flop (didn't bet)
Seat 6: 761a0b94 folded before Flop (didn't bet)


Poker Hand #RC1456623337: Hold'em No Limit  ($0.05/$0.1) - 2023/04/07 11:24:54
Table 'RushAndCash3078597' 6-max Seat #1 is the button
Seat 1: Hero ($8.62 in chips)
Seat 2: ead9d055 ($19.79 in chips)
Seat 3: dcd481d ($11.28 in chips)
Seat 4: d159fefc ($10.89 in chips)
Seat 5: 550e3b3f ($18.83 in chips)
Seat 6: d0bbec8e ($10 in chips)
ead9d055: posts small blind $0.05
dcd481d: posts big blind $0.1
*** HOLE CARDS ***
Dealt to Hero [Qh Qs]
Dealt to ead9d055 
Dealt to dcd481d 
Dealt to d159fefc 
Dealt to 550e3b3f 
Dealt to d0bbec8e 
d159fefc: folds
550e3b3f: raises $0.15 to $0.25
d0bbec8e: raises $0.49 to $0.74
Hero: raises $1.04 to $1.78
ead9d055: folds
dcd481d: folds
550e3b3f: folds
d0bbec8e: folds
Uncalled bet ($1.04) returned to Hero
*** SHOWDOWN ***
Hero collected $1.79 from pot
*** SUMMARY ***
Total pot $1.88 | Rake $0.09 | Jackpot $0 | Bingo $0 | Fortune $0
Seat 1: Hero (button) collected ($1.79)
Seat 2: ead9d055 (small blind) folded before Flop
Seat 3: dcd481d (big blind) folded before Flop
Seat 4: d159fefc folded before Flop (didn't bet)
Seat 5: 550e3b3f folded before Flop
Seat 6: d0bbec8e folded before Flop


Poker Hand #RC1456623214: Hold'em No Limit  ($0.05/$0.1) - 2023/04/07 11:24:35
Table 'RushAndCash3078474' 6-max Seat #1 is the button
Seat 1: 4870d703 ($11.83 in chips)
Seat 2: Hero ($8.67 in chips)
Seat 3: 391f89d3 ($16.9 in chips)
Seat 4: cea97513 ($10 in chips)
Seat 5: 508fbc26 ($10.46 in chips)
Seat 6: 9e18683b ($9.99 in chips)
Hero: posts small blind $0.05
391f89d3: posts big blind $0.1
*** HOLE CARDS ***
Dealt to 4870d703 
Dealt to Hero [5d 2s]
Dealt to 391f89d3 
Dealt to cea97513 
Dealt to 508fbc26 
Dealt to 9e18683b 
cea97513: folds
508fbc26: raises $0.2 to $0.3
9e18683b: folds
4870d703: folds
Hero: folds
391f89d3: folds
Uncalled bet ($0.2) returned to 508fbc26
*** SHOWDOWN ***
508fbc26 collected $0.25 from pot
*** SUMMARY ***
Total pot $0.25 | Rake $0 | Jackpot $0 | Bingo $0 | Fortune $0
Seat 1: 4870d703 (button) folded before Flop (didn't bet)
Seat 2: Hero (small blind) folded before Flop
Seat 3: 391f89d3 (big blind) folded before Flop
Seat 4: cea97513 folded before Flop (didn't bet)
Seat 5: 508fbc26 collected ($0.25)
Seat 6: 9e18683b folded before Flop (didn't bet)


Poker Hand #RC1456623158: Hold'em No Limit  ($0.05/$0.1) - 2023/04/07 11:24:26
Table 'RushAndCash3078418' 6-max Seat #1 is the button
Seat 1: a6483b5 ($11.6 in chips)
Seat 2: b7379121 ($10.51 in chips)
Seat 3: Hero ($8.62 in chips)
Seat 4: c75d65ae ($3.62 in chips)
Seat 5: 826c37ba ($10.23 in chips)
Seat 6: 1f6bce5a ($11.14 in chips)
b7379121: posts small blind $0.05
Hero: posts big blind $0.1
*** HOLE CARDS ***
Dealt to a6483b5 
Dealt to b7379121 
Dealt to Hero [Kc Js]
Dealt to c75d65ae 
Dealt to 826c37ba 
Dealt to 1f6bce5a 
c75d65ae: folds
826c37ba: folds
1f6bce5a: folds
a6483b5: folds
b7379121: folds
Uncalled bet ($0.05) returned to Hero
*** SHOWDOWN ***
Hero collected $0.1 from pot
*** SUMMARY ***
Total pot $0.1 | Rake $0 | Jackpot $0 | Bingo $0 | Fortune $0
Seat 1: a6483b5 (button) folded before Flop (didn't bet)
Seat 2: b7379121 (small blind) folded before Flop
Seat 3: Hero (big blind) collected ($0.1)
Seat 4: c75d65ae folded before Flop (didn't bet)
Seat 5: 826c37ba folded before Flop (didn't bet)
Seat 6: 1f6bce5a folded before Flop (didn't bet)


Poker Hand #RC1456623129: Hold'em No Limit  ($0.05/$0.1) - 2023/04/07 11:24:22
Table 'RushAndCash3078389' 6-max Seat #1 is the button
Seat 1: 87c49912 ($13.38 in chips)
Seat 2: b6bd39ad ($17.87 in chips)
Seat 3: a4380876 ($11.52 in chips)
Seat 4: 13531c8a ($14.99 in chips)
Seat 5: 89d40773 ($15.94 in chips)
Seat 6: Hero ($8.62 in chips)
b6bd39ad: posts small blind $0.05
a4380876: posts big blind $0.1
*** HOLE CARDS ***
Dealt to 87c49912 
Dealt to b6bd39ad 
Dealt to a4380876 
Dealt to 13531c8a 
Dealt to 89d40773 
Dealt to Hero [Tc 3d]
13531c8a: folds
89d40773: raises $0.15 to $0.25
Hero: folds
87c49912: folds
b6bd39ad: folds
a4380876: folds
Uncalled bet ($0.15) returned to 89d40773
*** SHOWDOWN ***
89d40773 collected $0.25 from pot
*** SUMMARY ***
Total pot $0.25 | Rake $0 | Jackpot $0 | Bingo $0 | Fortune $0
Seat 1: 87c49912 (button) folded before Flop (didn't bet)
Seat 2: b6bd39ad (small blind) folded before Flop
Seat 3: a4380876 (big blind) folded before Flop
Seat 4: 13531c8a folded before Flop (didn't bet)
Seat 5: 89d40773 collected ($0.25)
Seat 6: Hero folded before Flop (didn't bet)


Poker Hand #RC1456623098: Hold'em No Limit  ($0.05/$0.1) - 2023/04/07 11:24:17
Table 'RushAndCash3078358' 6-max Seat #1 is the button
Seat 1: 761a0b94 ($10 in chips)
Seat 2: 6c85eebb ($10 in chips)
Seat 3: 8e5bfc88 ($10.01 in chips)
Seat 4: Hero ($8.62 in chips)
Seat 5: c4d9b1c0 ($11.99 in chips)
Seat 6: be87951c ($12.37 in chips)
6c85eebb: posts small blind $0.05
8e5bfc88: posts big blind $0.1
*** HOLE CARDS ***
Dealt to 761a0b94 
Dealt to 6c85eebb 
Dealt to 8e5bfc88 
Dealt to Hero [8d 2c]
Dealt to c4d9b1c0 
Dealt to be87951c 
Hero: folds
c4d9b1c0: folds
be87951c: folds
761a0b94: folds
6c85eebb: folds
Uncalled bet ($0.05) returned to 8e5bfc88
*** SHOWDOWN ***
8e5bfc88 collected $0.1 from pot
*** SUMMARY ***
Total pot $0.1 | Rake $0 | Jackpot $0 | Bingo $0 | Fortune $0
Seat 1: 761a0b94 (button) folded before Flop (didn't bet)
Seat 2: 6c85eebb (small blind) folded before Flop
Seat 3: 8e5bfc88 (big blind) collected ($0.1)
Seat 4: Hero folded before Flop (didn't bet)
Seat 5: c4d9b1c0 folded before Flop (didn't bet)
Seat 6: be87951c folded before Flop (didn't bet)


Poker Hand #RC1456623055: Hold'em No Limit  ($0.05/$0.1) - 2023/04/07 11:24:11
Table 'RushAndCash3078315' 6-max Seat #1 is the button
Seat 1: 82849675 ($10 in chips)
Seat 2: 2dde7830 ($11.93 in chips)
Seat 3: f2008b23 ($19.75 in chips)
Seat 4: 472b6990 ($11.07 in chips)
Seat 5: 532d581b ($10 in chips)
Seat 6: Hero ($8.62 in chips)
2dde7830: posts small blind $0.05
f2008b23: posts big blind $0.1
*** HOLE CARDS ***
Dealt to 82849675 
Dealt to 2dde7830 
Dealt to f2008b23 
Dealt to 472b6990 
Dealt to 532d581b 
Dealt to Hero [7c 6d]
472b6990: folds
532d581b: raises $0.1 to $0.2
Hero: folds
82849675: folds
2dde7830: raises $0.6 to $0.8
f2008b23: folds
532d581b: calls $0.6
*** FLOP *** [6c Qs 4s]
2dde7830: bets $1.13
532d581b: calls $1.13
*** TURN *** [6c Qs 4s] [4c]
2dde7830: bets $2.62
532d581b: raises $5.45 to $8.07 and is all-in
2dde7830: calls $5.45
532d581b: shows [Ah Qh] (Pair of Queens and Pair of Fours)
2dde7830: shows [Ad As] (Pair of Aces and Pair of Fours)
2dde7830: Chooses to EV Cashout 
*** RIVER *** [6c Qs 4s 4c] [Td]
2dde7830: Pays Cashout Risk ($0.63)
*** SHOWDOWN ***
2dde7830 collected $19.65 from pot
*** SUMMARY ***
Total pot $20.1 | Rake $0.3 | Jackpot $0.15 | Bingo $0 | Fortune $0
Board [6c Qs 4s 4c Td]
Seat 1: 82849675 (button) folded before Flop (didn't bet)
Seat 2: 2dde7830 (small blind) showed [Ad As] and won ($19.65) with Pair of Aces and Pair of Fours, Cashout Risk ($0.63)
Seat 3: f2008b23 (big blind) folded before Flop
Seat 4: 472b6990 folded before Flop (didn't bet)
Seat 5: 532d581b showed [Ah Qh] and lost with Pair of Queens and Pair of Fours
Seat 6: Hero folded before Flop (didn't bet)


Poker Hand #RC1456623016: Hold'em No Limit  ($0.05/$0.1) - 2023/04/07 11:24:04
Table 'RushAndCash3078276' 6-max Seat #1 is the button
Seat 1: 2dde7830 ($11.93 in chips)
Seat 2: 29530482 ($4.98 in chips)
Seat 3: cea97513 ($10 in chips)
Seat 4: 91a22693 ($14.57 in chips)
Seat 5: Hero ($8.62 in chips)
Seat 6: 64721c4f ($12.86 in chips)
29530482: posts small blind $0.05
cea97513: posts big blind $0.1
*** HOLE CARDS ***
Dealt to 2dde7830 
Dealt to 29530482 
Dealt to cea97513 
Dealt to 91a22693 
Dealt to Hero [Th 2d]
Dealt to 64721c4f 
91a22693: folds
Hero: folds
64721c4f: folds
2dde7830: folds
29530482: raises $0.2 to $0.3
cea97513: folds
Uncalled bet ($0.2) returned to 29530482
*** SHOWDOWN ***
29530482 collected $0.2 from pot
*** SUMMARY ***
Total pot $0.2 | Rake $0 | Jackpot $0 | Bingo $0 | Fortune $0
Seat 1: 2dde7830 (button) folded before Flop (didn't bet)
Seat 2: 29530482 (small blind) collected ($0.2)
Seat 3: cea97513 (big blind) folded before Flop
Seat 4: 91a22693 folded before Flop (didn't bet)
Seat 5: Hero folded before Flop (didn't bet)
Seat 6: 64721c4f folded before Flop (didn't bet)


Poker Hand #RC1456622985: Hold'em No Limit  ($0.05/$0.1) - 2023/04/07 11:23:59
Table 'RushAndCash3078245' 6-max Seat #1 is the button
Seat 1: 2e3ec09b ($10.88 in chips)
Seat 2: Hero ($8.67 in chips)
Seat 3: 7cab4739 ($19.49 in chips)
Seat 4: 88f452a6 ($24.58 in chips)
Seat 5: 27aebce3 ($5.18 in chips)
Seat 6: 7212ebd8 ($11.46 in chips)
Hero: posts small blind $0.05
7cab4739: posts big blind $0.1
*** HOLE CARDS ***
Dealt to 2e3ec09b 
Dealt to Hero [Qh 2c]
Dealt to 7cab4739 
Dealt to 88f452a6 
Dealt to 27aebce3 
Dealt to 7212ebd8 
88f452a6: calls $0.1
27aebce3: raises $0.35 to $0.45
7212ebd8: folds
2e3ec09b: raises $0.85 to $1.3
Hero: folds
7cab4739: folds
88f452a6: folds
27aebce3: calls $0.85
*** FLOP *** [3d 3s 8d]
27aebce3: checks
2e3ec09b: checks
*** TURN *** [3d 3s 8d] [2s]
27aebce3: checks
2e3ec09b: checks
*** RIVER *** [3d 3s 8d 2s] [As]
27aebce3: checks
2e3ec09b: bets $1.43
27aebce3: calls $1.43
2e3ec09b: shows [Kh Ac] (Pair of Aces and Pair of Treys)
27aebce3: shows [Jc Ah] (Pair of Aces and Pair of Treys)
*** SHOWDOWN ***
2e3ec09b collected $5.29 from pot
*** SUMMARY ***
Total pot $5.71 | Rake $0.27 | Jackpot $0.15 | Bingo $0 | Fortune $0
Board [3d 3s 8d 2s As]
Seat 1: 2e3ec09b (button) showed [Kh Ac] and won ($5.29) with Pair of Aces and Pair of Treys
Seat 2: Hero (small blind) folded before Flop
Seat 3: 7cab4739 (big blind) folded before Flop
Seat 4: 88f452a6 folded before Flop
Seat 5: 27aebce3 showed [Jc Ah] and lost with Pair of Aces and Pair of Treys
Seat 6: 7212ebd8 folded before Flop (didn't bet)


Poker Hand #RC1456622774: Hold'em No Limit  ($0.05/$0.1) - 2023/04/07 11:23:23
Table 'RushAndCash3078034' 6-max Seat #1 is the button
Seat 1: 9d5b7c3d ($12.38 in chips)
Seat 2: 7212ebd8 ($11.68 in chips)
Seat 3: Hero ($8.26 in chips)
Seat 4: f073b4e ($11.32 in chips)
Seat 5: 34070ed6 ($10 in chips)
Seat 6: 7aae144e ($10 in chips)
7212ebd8: posts small blind $0.05
Hero: posts big blind $0.1
*** HOLE CARDS ***
Dealt to 9d5b7c3d 
Dealt to 7212ebd8 
Dealt to Hero [Kd Ad]
Dealt to f073b4e 
Dealt to 34070ed6 
Dealt to 7aae144e 
f073b4e: folds
34070ed6: raises $0.12 to $0.22
7aae144e: folds
9d5b7c3d: folds
7212ebd8: calls $0.17
Hero: raises $0.89 to $1.11
34070ed6: folds
7212ebd8: folds
Uncalled bet ($0.89) returned to Hero
*** SHOWDOWN ***
Hero collected $0.63 from pot
*** SUMMARY ***
Total pot $0.66 | Rake $0.03 | Jackpot $0 | Bingo $0 | Fortune $0
Seat 1: 9d5b7c3d (button) folded before Flop (didn't bet)
Seat 2: 7212ebd8 (small blind) folded before Flop
Seat 3: Hero (big blind) collected ($0.63)
Seat 4: f073b4e folded before Flop (didn't bet)
Seat 5: 34070ed6 folded before Flop
Seat 6: 7aae144e folded before Flop (didn't bet)


Poker Hand #RC1456622747: Hold'em No Limit  ($0.05/$0.1) - 2023/04/07 11:23:19
Table 'RushAndCash3078007' 6-max Seat #1 is the button
Seat 1: Hero ($8.26 in chips)
Seat 2: 72fc0201 ($6.82 in chips)
Seat 3: c4d9b1c0 ($14.25 in chips)
Seat 4: ef135a2e ($10.1 in chips)
Seat 5: 6315467b ($25.56 in chips)
Seat 6: 6b09da99 ($15.35 in chips)
72fc0201: posts small blind $0.05
c4d9b1c0: posts big blind $0.1
*** HOLE CARDS ***
Dealt to Hero [Ts 5s]
Dealt to 72fc0201 
Dealt to c4d9b1c0 
Dealt to ef135a2e 
Dealt to 6315467b 
Dealt to 6b09da99 
ef135a2e: folds
6315467b: folds
6b09da99: raises $0.16 to $0.26
Hero: folds
72fc0201: folds
c4d9b1c0: raises $0.57 to $0.83
6b09da99: calls $0.57
*** FLOP *** [4s 4c 3s]
c4d9b1c0: bets $0.57
6b09da99: raises $0.86 to $1.43
c4d9b1c0: calls $0.86
*** TURN *** [4s 4c 3s] [5c]
c4d9b1c0: checks
6b09da99: bets $2.06
c4d9b1c0: folds
Uncalled bet ($2.06) returned to 6b09da99
*** SHOWDOWN ***
6b09da99 collected $4.2 from pot
*** SUMMARY ***
Total pot $4.57 | Rake $0.22 | Jackpot $0.15 | Bingo $0 | Fortune $0
Board [4s 4c 3s 5c]
Seat 1: Hero (button) folded before Flop (didn't bet)
Seat 2: 72fc0201 (small blind) folded before Flop
Seat 3: c4d9b1c0 (big blind) folded on the Turn
Seat 4: ef135a2e folded before Flop (didn't bet)
Seat 5: 6315467b folded before Flop (didn't bet)
Seat 6: 6b09da99 won ($4.2)


Poker Hand #RC1456622721: Hold'em No Limit  ($0.05/$0.1) - 2023/04/07 11:23:14
Table 'RushAndCash3077981' 6-max Seat #1 is the button
Seat 1: febdc50d ($10.28 in chips)
Seat 2: 2ffae2ba ($20.27 in chips)
Seat 3: 767e6751 ($13.5 in chips)
Seat 4: Hero ($8.26 in chips)
Seat 5: be697cc5 ($13.12 in chips)
Seat 6: 9d5b7c3d ($12.38 in chips)
2ffae2ba: posts small blind $0.05
767e6751: posts big blind $0.1
*** HOLE CARDS ***
Dealt to febdc50d 
Dealt to 2ffae2ba 
Dealt to 767e6751 
Dealt to Hero [Js 5h]
Dealt to be697cc5 
Dealt to 9d5b7c3d 
Hero: folds
be697cc5: raises $0.15 to $0.25
9d5b7c3d: folds
febdc50d: folds
2ffae2ba: folds
767e6751: calls $0.15
*** FLOP *** [Ac 7h 2h]
767e6751: checks
be697cc5: checks
*** TURN *** [Ac 7h 2h] [3s]
767e6751: checks
be697cc5: checks
*** RIVER *** [Ac 7h 2h 3s] [8d]
767e6751: checks
be697cc5: bets $0.28
767e6751: folds
Uncalled bet ($0.28) returned to be697cc5
*** SHOWDOWN ***
be697cc5 collected $0.53 from pot
*** SUMMARY ***
Total pot $0.55 | Rake $0.02 | Jackpot $0 | Bingo $0 | Fortune $0
Board [Ac 7h 2h 3s 8d]
Seat 1: febdc50d (button) folded before Flop (didn't bet)
Seat 2: 2ffae2ba (small blind) folded before Flop
Seat 3: 767e6751 (big blind) folded on the River
Seat 4: Hero folded before Flop (didn't bet)
Seat 5: be697cc5 won ($0.53)
Seat 6: 9d5b7c3d folded before Flop (didn't bet)


Poker Hand #RC1456622691: Hold'em No Limit  ($0.05/$0.1) - 2023/04/07 11:23:09
Table 'RushAndCash3077951' 6-max Seat #1 is the button
Seat 1: c8ee7af2 ($27.43 in chips)
Seat 2: 6e24e8cf ($10 in chips)
Seat 3: 761a0b94 ($10 in chips)
Seat 4: Hero ($8.26 in chips)
Seat 5: 93cdb17b ($23.27 in chips)
Seat 6: 3e93bdf1 ($10.15 in chips)
6e24e8cf: posts small blind $0.05
761a0b94: posts big blind $0.1
*** HOLE CARDS ***
Dealt to c8ee7af2 
Dealt to 6e24e8cf 
Dealt to 761a0b94 
Dealt to Hero [6h Kh]
Dealt to 93cdb17b 
Dealt to 3e93bdf1 
Hero: folds
93cdb17b: folds
3e93bdf1: raises $0.12 to $0.22
c8ee7af2: folds
6e24e8cf: folds
761a0b94: folds
Uncalled bet ($0.12) returned to 3e93bdf1
*** SHOWDOWN ***
3e93bdf1 collected $0.25 from pot
*** SUMMARY ***
Total pot $0.25 | Rake $0 | Jackpot $0 | Bingo $0 | Fortune $0
Seat 1: c8ee7af2 (button) folded before Flop (didn't bet)
Seat 2: 6e24e8cf (small blind) folded before Flop
Seat 3: 761a0b94 (big blind) folded before Flop
Seat 4: Hero folded before Flop (didn't bet)
Seat 5: 93cdb17b folded before Flop (didn't bet)
Seat 6: 3e93bdf1 collected ($0.25)


Poker Hand #RC1456622656: Hold'em No Limit  ($0.05/$0.1) - 2023/04/07 11:23:04
Table 'RushAndCash3077916' 6-max Seat #1 is the button
Seat 1: Hero ($8.26 in chips)
Seat 2: 802a89e3 ($23.96 in chips)
Seat 3: 28b75ee6 ($17.65 in chips)
Seat 4: 7256ff58 ($18.07 in chips)
Seat 5: 74df6125 ($20.43 in chips)
Seat 6: e95b4c2d ($11.97 in chips)
802a89e3: posts small blind $0.05
28b75ee6: posts big blind $0.1
*** HOLE CARDS ***
Dealt to Hero [6h Js]
Dealt to 802a89e3 
Dealt to 28b75ee6 
Dealt to 7256ff58 
Dealt to 74df6125 
Dealt to e95b4c2d 
7256ff58: raises $0.15 to $0.25
74df6125: folds
e95b4c2d: folds
Hero: folds
802a89e3: folds
28b75ee6: folds
Uncalled bet ($0.15) returned to 7256ff58
*** SHOWDOWN ***
7256ff58 collected $0.25 from pot
*** SUMMARY ***
Total pot $0.25 | Rake $0 | Jackpot $0 | Bingo $0 | Fortune $0
Seat 1: Hero (button) folded before Flop (didn't bet)
Seat 2: 802a89e3 (small blind) folded before Flop
Seat 3: 28b75ee6 (big blind) folded before Flop
Seat 4: 7256ff58 collected ($0.25)
Seat 5: 74df6125 folded before Flop (didn't bet)
Seat 6: e95b4c2d folded before Flop (didn't bet)


Poker Hand #RC1456622603: Hold'em No Limit  ($0.05/$0.1) - 2023/04/07 11:22:55
Table 'RushAndCash3077863' 6-max Seat #1 is the button
Seat 1: 6c625696 ($4.7 in chips)
Seat 2: 98f3d295 ($14.71 in chips)
Seat 3: e95b4c2d ($12.07 in chips)
Seat 4: dda6ec44 ($10.72 in chips)
Seat 5: 7f6dcfc1 ($10.25 in chips)
Seat 6: Hero ($8.26 in chips)
98f3d295: posts small blind $0.05
e95b4c2d: posts big blind $0.1
*** HOLE CARDS ***
Dealt to 6c625696 
Dealt to 98f3d295 
Dealt to e95b4c2d 
Dealt to dda6ec44 
Dealt to 7f6dcfc1 
Dealt to Hero [Kd 9h]
dda6ec44: raises $0.2 to $0.3
7f6dcfc1: folds
Hero: folds
6c625696: raises $0.5 to $0.8
98f3d295: folds
e95b4c2d: folds
dda6ec44: calls $0.5
*** FLOP *** [Ks Ad 5d]
dda6ec44: checks
6c625696: bets $0.6
dda6ec44: calls $0.6
*** TURN *** [Ks Ad 5d] [Tc]
dda6ec44: checks
6c625696: bets $1
dda6ec44: calls $1
*** RIVER *** [Ks Ad 5d Tc] [Qs]
dda6ec44: checks
6c625696: bets $1.5
dda6ec44: raises $2.63 to $4.13
6c625696: calls $0.8 and is all-in
Uncalled bet ($1.83) returned to dda6ec44
dda6ec44: shows [Ac Jh] (Aces-High Straight)
6c625696: shows [Js Jd] (Aces-High Straight)
*** SHOWDOWN ***
dda6ec44 collected $4.55 from pot
6c625696 collected $4.55 from pot
*** SUMMARY ***
Total pot $9.55 | Rake $0.3 | Jackpot $0.15 | Bingo $0 | Fortune $0
Board [Ks Ad 5d Tc Qs]
Seat 1: 6c625696 (button) showed [Js Jd] and won ($4.55) with Aces-High Straight
Seat 2: 98f3d295 (small blind) folded before Flop
Seat 3: e95b4c2d (big blind) folded before Flop
Seat 4: dda6ec44 showed [Ac Jh] and won ($4.55) with Aces-High Straight
Seat 5: 7f6dcfc1 folded before Flop (didn't bet)
Seat 6: Hero folded before Flop (didn't bet)


Poker Hand #RC1456622277: Hold'em No Limit  ($0.05/$0.1) - 2023/04/07 11:22:00
Table 'RushAndCash3077537' 6-max Seat #1 is the button
Seat 1: d8efb2d7 ($14.38 in chips)
Seat 2: 8582274b ($11.88 in chips)
Seat 3: Hero ($9.6 in chips)
Seat 4: e81af2f2 ($11.79 in chips)
Seat 5: dda6ec44 ($9.46 in chips)
Seat 6: 89d40773 ($16.88 in chips)
8582274b: posts small blind $0.05
Hero: posts big blind $0.1
*** HOLE CARDS ***
Dealt to d8efb2d7 
Dealt to 8582274b 
Dealt to Hero [Ks 9s]
Dealt to e81af2f2 
Dealt to dda6ec44 
Dealt to 89d40773 
e81af2f2: folds
dda6ec44: raises $0.2 to $0.3
89d40773: folds
d8efb2d7: folds
8582274b: folds
Hero: calls $0.2
*** FLOP *** [8c 2d 8h]
Hero: checks
dda6ec44: checks
*** TURN *** [8c 2d 8h] [6h]
Hero: bets $0.33
dda6ec44: calls $0.33
*** RIVER *** [8c 2d 8h 6h] [7s]
Hero: bets $0.71
dda6ec44: calls $0.71
Hero: shows [Ks 9s] (Pair of Eights)
dda6ec44: shows [As Kd] (Pair of Eights)
*** SHOWDOWN ***
dda6ec44 collected $2.6 from pot
*** SUMMARY ***
Total pot $2.73 | Rake $0.13 | Jackpot $0 | Bingo $0 | Fortune $0
Board [8c 2d 8h 6h 7s]
Seat 1: d8efb2d7 (button) folded before Flop (didn't bet)
Seat 2: 8582274b (small blind) folded before Flop
Seat 3: Hero (big blind) showed [Ks 9s] and lost with Pair of Eights
Seat 4: e81af2f2 folded before Flop (didn't bet)
Seat 5: dda6ec44 showed [As Kd] and won ($2.6) with Pair of Eights
Seat 6: 89d40773 folded before Flop (didn't bet)


Poker Hand #RC1456621741: Hold'em No Limit  ($0.05/$0.1) - 2023/04/07 11:20:26
Table 'RushAndCash3077001' 6-max Seat #1 is the button
Seat 1: e0a91486 ($8.61 in chips)
Seat 2: Hero ($11.1 in chips)
Seat 3: c29ebe21 ($13.31 in chips)
Seat 4: 3a38f110 ($11.95 in chips)
Seat 5: f72db975 ($10.1 in chips)
Seat 6: ce41d4dc ($11.94 in chips)
Hero: posts small blind $0.05
c29ebe21: posts big blind $0.1
*** HOLE CARDS ***
Dealt to e0a91486 
Dealt to Hero [As 8s]
Dealt to c29ebe21 
Dealt to 3a38f110 
Dealt to f72db975 
Dealt to ce41d4dc 
3a38f110: folds
f72db975: folds
ce41d4dc: folds
e0a91486: raises $0.14 to $0.24
Hero: raises $0.76 to $1
c29ebe21: folds
e0a91486: calls $0.76
*** FLOP *** [Jc Ks 8h]
Hero: checks
e0a91486: checks
*** TURN *** [Jc Ks 8h] [Kh]
Hero: checks
e0a91486: checks
*** RIVER *** [Jc Ks 8h Kh] [Ad]
Hero: bets $0.5
e0a91486: raises $3.1 to $3.6
Hero: folds
Uncalled bet ($3.1) returned to e0a91486
*** SHOWDOWN ***
e0a91486 collected $2.81 from pot
*** SUMMARY ***
Total pot $3.1 | Rake $0.14 | Jackpot $0.15 | Bingo $0 | Fortune $0
Board [Jc Ks 8h Kh Ad]
Seat 1: e0a91486 (button) won ($2.81)
Seat 2: Hero (small blind) folded on the River
Seat 3: c29ebe21 (big blind) folded before Flop
Seat 4: 3a38f110 folded before Flop (didn't bet)
Seat 5: f72db975 folded before Flop (didn't bet)
Seat 6: ce41d4dc folded before Flop (didn't bet)


Poker Hand #RC1456621709: Hold'em No Limit  ($0.05/$0.1) - 2023/04/07 11:20:21
Table 'RushAndCash3076969' 6-max Seat #1 is the button
Seat 1: 9bf4d213 ($6.84 in chips)
Seat 2: db293a2f ($12.65 in chips)
Seat 3: 79a0453c ($5.05 in chips)
Seat 4: Hero ($11.1 in chips)
Seat 5: b21ceb61 ($10.88 in chips)
Seat 6: 98146ab8 ($13.03 in chips)
db293a2f: posts small blind $0.05
79a0453c: posts big blind $0.1
*** HOLE CARDS ***
Dealt to 9bf4d213 
Dealt to db293a2f 
Dealt to 79a0453c 
Dealt to Hero [Tc 5h]
Dealt to b21ceb61 
Dealt to 98146ab8 
Hero: folds
b21ceb61: folds
98146ab8: folds
9bf4d213: folds
db293a2f: raises $0.2 to $0.3
79a0453c: calls $0.2
*** FLOP *** [3h 7s 7d]
db293a2f: checks
79a0453c: checks
*** TURN *** [3h 7s 7d] [5d]
db293a2f: bets $0.2
79a0453c: folds
Uncalled bet ($0.2) returned to db293a2f
*** SHOWDOWN ***
db293a2f collected $0.57 from pot
*** SUMMARY ***
Total pot $0.6 | Rake $0.03 | Jackpot $0 | Bingo $0 | Fortune $0
Board [3h 7s 7d 5d]
Seat 1: 9bf4d213 (button) folded before Flop (didn't bet)
Seat 2: db293a2f (small blind) won ($0.57)
Seat 3: 79a0453c (big blind) folded on the Turn
Seat 4: Hero folded before Flop (didn't bet)
Seat 5: b21ceb61 folded before Flop (didn't bet)
Seat 6: 98146ab8 folded before Flop (didn't bet)


Poker Hand #RC1456621669: Hold'em No Limit  ($0.05/$0.1) - 2023/04/07 11:20:13
Table 'RushAndCash3076929' 6-max Seat #1 is the button
Seat 1: 29376847 ($11.48 in chips)
Seat 2: 99d6008f ($10 in chips)
Seat 3: fd391163 ($10 in chips)
Seat 4: 4bd2333e ($5.7 in chips)
Seat 5: Hero ($11.1 in chips)
Seat 6: 1f6bce5a ($11.46 in chips)
99d6008f: posts small blind $0.05
fd391163: posts big blind $0.1
*** HOLE CARDS ***
Dealt to 29376847 
Dealt to 99d6008f 
Dealt to fd391163 
Dealt to 4bd2333e 
Dealt to Hero [Qh 2h]
Dealt to 1f6bce5a 
4bd2333e: folds
Hero: folds
1f6bce5a: folds
29376847: folds
99d6008f: folds
Uncalled bet ($0.05) returned to fd391163
*** SHOWDOWN ***
fd391163 collected $0.1 from pot
*** SUMMARY ***
Total pot $0.1 | Rake $0 | Jackpot $0 | Bingo $0 | Fortune $0
Seat 1: 29376847 (button) folded before Flop (didn't bet)
Seat 2: 99d6008f (small blind) folded before Flop
Seat 3: fd391163 (big blind) collected ($0.1)
Seat 4: 4bd2333e folded before Flop (didn't bet)
Seat 5: Hero folded before Flop (didn't bet)
Seat 6: 1f6bce5a folded before Flop (didn't bet)


Poker Hand #RC1456621639: Hold'em No Limit  ($0.05/$0.1) - 2023/04/07 11:20:09
Table 'RushAndCash3076899' 6-max Seat #1 is the button
Seat 1: 692d4013 ($20.43 in chips)
Seat 2: ac0e72fc ($12.3 in chips)
Seat 3: d159fefc ($10 in chips)
Seat 4: Hero ($11.1 in chips)
Seat 5: 7552d01 ($10.17 in chips)
Seat 6: 70d1c97f ($10.24 in chips)
ac0e72fc: posts small blind $0.05
d159fefc: posts big blind $0.1
*** HOLE CARDS ***
Dealt to 692d4013 
Dealt to ac0e72fc 
Dealt to d159fefc 
Dealt to Hero [7d Jc]
Dealt to 7552d01 
Dealt to 70d1c97f 
Hero: folds
7552d01: raises $0.15 to $0.25
70d1c97f: folds
692d4013: folds
ac0e72fc: folds
d159fefc: folds
Uncalled bet ($0.15) returned to 7552d01
*** SHOWDOWN ***
7552d01 collected $0.25 from pot
*** SUMMARY ***
Total pot $0.25 | Rake $0 | Jackpot $0 | Bingo $0 | Fortune $0
Seat 1: 692d4013 (button) folded before Flop (didn't bet)
Seat 2: ac0e72fc (small blind) folded before Flop
Seat 3: d159fefc (big blind) folded before Flop
Seat 4: Hero folded before Flop (didn't bet)
Seat 5: 7552d01 collected ($0.25)
Seat 6: 70d1c97f folded before Flop (didn't bet)


Poker Hand #RC1456621609: Hold'em No Limit  ($0.05/$0.1) - 2023/04/07 11:20:02
Table 'RushAndCash3076869' 6-max Seat #1 is the button
Seat 1: 9d5b7c3d ($13.48 in chips)
Seat 2: 9870067d ($22.66 in chips)
Seat 3: b6bd39ad ($10.6 in chips)
Seat 4: Hero ($11.1 in chips)
Seat 5: 167866ca ($10.1 in chips)
Seat 6: 28d6b5ec ($10.79 in chips)
9870067d: posts small blind $0.05
b6bd39ad: posts big blind $0.1
*** HOLE CARDS ***
Dealt to 9d5b7c3d 
Dealt to 9870067d 
Dealt to b6bd39ad 
Dealt to Hero [Kd 7h]
Dealt to 167866ca 
Dealt to 28d6b5ec 
Hero: folds
167866ca: folds
28d6b5ec: folds
9d5b7c3d: folds
9870067d: folds
Uncalled bet ($0.05) returned to b6bd39ad
*** SHOWDOWN ***
b6bd39ad collected $0.1 from pot
*** SUMMARY ***
Total pot $0.1 | Rake $0 | Jackpot $0 | Bingo $0 | Fortune $0
Seat 1: 9d5b7c3d (button) folded before Flop (didn't bet)
Seat 2: 9870067d (small blind) folded before Flop
Seat 3: b6bd39ad (big blind) collected ($0.1)
Seat 4: Hero folded before Flop (didn't bet)
Seat 5: 167866ca folded before Flop (didn't bet)
Seat 6: 28d6b5ec folded before Flop (didn't bet)


Poker Hand #RC1456621541: Hold'em No Limit  ($0.05/$0.1) - 2023/04/07 11:19:49
Table 'RushAndCash3076801' 6-max Seat #1 is the button
Seat 1: 4fdad372 ($38.38 in chips)
Seat 2: cd46d45a ($37.12 in chips)
Seat 3: Hero ($11.2 in chips)
Seat 4: a331a0aa ($10 in chips)
Seat 5: 29376847 ($11.63 in chips)
Seat 6: 7b2952c ($10 in chips)
cd46d45a: posts small blind $0.05
Hero: posts big blind $0.1
*** HOLE CARDS ***
Dealt to 4fdad372 
Dealt to cd46d45a 
Dealt to Hero [6s 9s]
Dealt to a331a0aa 
Dealt to 29376847 
Dealt to 7b2952c 
a331a0aa: raises $0.15 to $0.25
29376847: folds
7b2952c: folds
4fdad372: folds
cd46d45a: folds
Hero: folds
Uncalled bet ($0.15) returned to a331a0aa
*** SHOWDOWN ***
a331a0aa collected $0.25 from pot
*** SUMMARY ***
Total pot $0.25 | Rake $0 | Jackpot $0 | Bingo $0 | Fortune $0
Seat 1: 4fdad372 (button) folded before Flop (didn't bet)
Seat 2: cd46d45a (small blind) folded before Flop
Seat 3: Hero (big blind) folded before Flop
Seat 4: a331a0aa collected ($0.25)
Seat 5: 29376847 folded before Flop (didn't bet)
Seat 6: 7b2952c folded before Flop (didn't bet)


Poker Hand #RC1456621506: Hold'em No Limit  ($0.05/$0.1) - 2023/04/07 11:19:43
Table 'RushAndCash3076766' 6-max Seat #1 is the button
Seat 1: e6e85371 ($14.1 in chips)
Seat 2: 44afbdfe ($9.81 in chips)
Seat 3: 472b6990 ($11.98 in chips)
Seat 4: faf131c1 ($10 in chips)
Seat 5: a1fbd3f9 ($14.47 in chips)
Seat 6: Hero ($11.2 in chips)
44afbdfe: posts small blind $0.05
472b6990: posts big blind $0.1
*** HOLE CARDS ***
Dealt to e6e85371 
Dealt to 44afbdfe 
Dealt to 472b6990 
Dealt to faf131c1 
Dealt to a1fbd3f9 
Dealt to Hero [3d Qh]
faf131c1: folds
a1fbd3f9: raises $0.15 to $0.25
Hero: folds
e6e85371: folds
44afbdfe: folds
472b6990: folds
Uncalled bet ($0.15) returned to a1fbd3f9
*** SHOWDOWN ***
a1fbd3f9 collected $0.25 from pot
*** SUMMARY ***
Total pot $0.25 | Rake $0 | Jackpot $0 | Bingo $0 | Fortune $0
Seat 1: e6e85371 (button) folded before Flop (didn't bet)
Seat 2: 44afbdfe (small blind) folded before Flop
Seat 3: 472b6990 (big blind) folded before Flop
Seat 4: faf131c1 folded before Flop (didn't bet)
Seat 5: a1fbd3f9 collected ($0.25)
Seat 6: Hero folded before Flop (didn't bet)


Poker Hand #RC1456621479: Hold'em No Limit  ($0.05/$0.1) - 2023/04/07 11:19:39
Table 'RushAndCash3076739' 6-max Seat #1 is the button
Seat 1: 20a7143f ($10 in chips)
Seat 2: Hero ($11.25 in chips)
Seat 3: 86aff57 ($19.07 in chips)
Seat 4: cd2da17d ($10.55 in chips)
Seat 5: 21657e08 ($10 in chips)
Seat 6: ec55179 ($10 in chips)
Hero: posts small blind $0.05
86aff57: posts big blind $0.1
*** HOLE CARDS ***
Dealt to 20a7143f 
Dealt to Hero [2d Js]
Dealt to 86aff57 
Dealt to cd2da17d 
Dealt to 21657e08 
Dealt to ec55179 
cd2da17d: folds
21657e08: raises $0.15 to $0.25
ec55179: folds
20a7143f: folds
Hero: folds
86aff57: folds
Uncalled bet ($0.15) returned to 21657e08
*** SHOWDOWN ***
21657e08 collected $0.25 from pot
*** SUMMARY ***
Total pot $0.25 | Rake $0 | Jackpot $0 | Bingo $0 | Fortune $0
Seat 1: 20a7143f (button) folded before Flop (didn't bet)
Seat 2: Hero (small blind) folded before Flop
Seat 3: 86aff57 (big blind) folded before Flop
Seat 4: cd2da17d folded before Flop (didn't bet)
Seat 5: 21657e08 collected ($0.25)
Seat 6: ec55179 folded before Flop (didn't bet)


Poker Hand #RC1456621423: Hold'em No Limit  ($0.05/$0.1) - 2023/04/07 11:19:29
Table 'RushAndCash3076683' 6-max Seat #1 is the button
Seat 1: Hero ($11.25 in chips)
Seat 2: e600f2be ($9.9 in chips)
Seat 3: fd391163 ($10.15 in chips)
Seat 4: f1e67b9e ($21.66 in chips)
Seat 5: 4fdad372 ($38.43 in chips)
Seat 6: 534934de ($10 in chips)
e600f2be: posts small blind $0.05
fd391163: posts big blind $0.1
*** HOLE CARDS ***
Dealt to Hero [6h 3h]
Dealt to e600f2be 
Dealt to fd391163 
Dealt to f1e67b9e 
Dealt to 4fdad372 
Dealt to 534934de 
f1e67b9e: raises $0.14 to $0.24
4fdad372: folds
534934de: folds
Hero: folds
e600f2be: folds
fd391163: folds
Uncalled bet ($0.14) returned to f1e67b9e
*** SHOWDOWN ***
f1e67b9e collected $0.25 from pot
*** SUMMARY ***
Total pot $0.25 | Rake $0 | Jackpot $0 | Bingo $0 | Fortune $0
Seat 1: Hero (button) folded before Flop (didn't bet)
Seat 2: e600f2be (small blind) folded before Flop
Seat 3: fd391163 (big blind) folded before Flop
Seat 4: f1e67b9e collected ($0.25)
Seat 5: 4fdad372 folded before Flop (didn't bet)
Seat 6: 534934de folded before Flop (didn't bet)


Poker Hand #RC1456621392: Hold'em No Limit  ($0.05/$0.1) - 2023/04/07 11:19:23
Table 'RushAndCash3076652' 6-max Seat #1 is the button
Seat 1: f87607e6 ($10 in chips)
Seat 2: d6fce36f ($16.96 in chips)
Seat 3: 44afbdfe ($9.91 in chips)
Seat 4: 1905e80a ($14.74 in chips)
Seat 5: cea97513 ($10.3 in chips)
Seat 6: Hero ($11.25 in chips)
d6fce36f: posts small blind $0.05
44afbdfe: posts big blind $0.1
*** HOLE CARDS ***
Dealt to f87607e6 
Dealt to d6fce36f 
Dealt to 44afbdfe 
Dealt to 1905e80a 
Dealt to cea97513 
Dealt to Hero [3c 9h]
1905e80a: folds
cea97513: folds
Hero: folds
f87607e6: raises $0.15 to $0.25
d6fce36f: raises $0.54 to $0.79
44afbdfe: folds
f87607e6: folds
Uncalled bet ($0.54) returned to d6fce36f
*** SHOWDOWN ***
d6fce36f collected $0.57 from pot
*** SUMMARY ***
Total pot $0.6 | Rake $0.03 | Jackpot $0 | Bingo $0 | Fortune $0
Seat 1: f87607e6 (button) folded before Flop
Seat 2: d6fce36f (small blind) collected ($0.57)
Seat 3: 44afbdfe (big blind) folded before Flop
Seat 4: 1905e80a folded before Flop (didn't bet)
Seat 5: cea97513 folded before Flop (didn't bet)
Seat 6: Hero folded before Flop (didn't bet)


Poker Hand #RC1456621135: Hold'em No Limit  ($0.05/$0.1) - 2023/04/07 11:18:42
Table 'RushAndCash3076395' 6-max Seat #1 is the button
Seat 1: 33cce1ad ($17.47 in chips)
Seat 2: 204fb5f0 ($19.13 in chips)
Seat 3: Hero ($11.07 in chips)
Seat 4: 4a105909 ($11.44 in chips)
Seat 5: 98146ab8 ($13.33 in chips)
Seat 6: e1acbed9 ($10.32 in chips)
204fb5f0: posts small blind $0.05
Hero: posts big blind $0.1
*** HOLE CARDS ***
Dealt to 33cce1ad 
Dealt to 204fb5f0 
Dealt to Hero [7s 9d]
Dealt to 4a105909 
Dealt to 98146ab8 
Dealt to e1acbed9 
4a105909: folds
98146ab8: folds
e1acbed9: folds
33cce1ad: folds
204fb5f0: calls $0.05
Hero: checks
*** FLOP *** [7c Jc 3s]
204fb5f0: bets $0.1
Hero: calls $0.1
*** TURN *** [7c Jc 3s] [Ks]
204fb5f0: checks
Hero: bets $0.14
204fb5f0: folds
Uncalled bet ($0.14) returned to Hero
*** SHOWDOWN ***
Hero collected $0.38 from pot
*** SUMMARY ***
Total pot $0.4 | Rake $0.02 | Jackpot $0 | Bingo $0 | Fortune $0
Board [7c Jc 3s Ks]
Seat 1: 33cce1ad (button) folded before Flop (didn't bet)
Seat 2: 204fb5f0 (small blind) folded on the Turn
Seat 3: Hero (big blind) won ($0.38)
Seat 4: 4a105909 folded before Flop (didn't bet)
Seat 5: 98146ab8 folded before Flop (didn't bet)
Seat 6: e1acbed9 folded before Flop (didn't bet)


Poker Hand #RC1456620920: Hold'em No Limit  ($0.05/$0.1) - 2023/04/07 11:18:07
Table 'RushAndCash3076180' 6-max Seat #1 is the button
Seat 1: Hero ($11.32 in chips)
Seat 2: 33cce1ad ($17.15 in chips)
Seat 3: 802a89e3 ($10.46 in chips)
Seat 4: 2ffae2ba ($20.27 in chips)
Seat 5: 9870067d ($12.63 in chips)
Seat 6: 9955d467 ($4.4 in chips)
33cce1ad: posts small blind $0.05
802a89e3: posts big blind $0.1
*** HOLE CARDS ***
Dealt to Hero [9c Kh]
Dealt to 33cce1ad 
Dealt to 802a89e3 
Dealt to 2ffae2ba 
Dealt to 9870067d 
Dealt to 9955d467 
2ffae2ba: folds
9870067d: folds
9955d467: folds
Hero: raises $0.15 to $0.25
33cce1ad: raises $0.75 to $1
802a89e3: folds
Hero: folds
Uncalled bet ($0.75) returned to 33cce1ad
*** SHOWDOWN ***
33cce1ad collected $0.57 from pot
*** SUMMARY ***
Total pot $0.6 | Rake $0.03 | Jackpot $0 | Bingo $0 | Fortune $0
Seat 1: Hero (button) folded before Flop
Seat 2: 33cce1ad (small blind) collected ($0.57)
Seat 3: 802a89e3 (big blind) folded before Flop
Seat 4: 2ffae2ba folded before Flop (didn't bet)
Seat 5: 9870067d folded before Flop (didn't bet)
Seat 6: 9955d467 folded before Flop (didn't bet)


Poker Hand #RC1456620559: Hold'em No Limit  ($0.05/$0.1) - 2023/04/07 11:17:06
Table 'RushAndCash3075819' 6-max Seat #1 is the button
Seat 1: b8848e7d ($12.28 in chips)
Seat 2: Hero ($11.54 in chips)
Seat 3: 9955d467 ($4.63 in chips)
Seat 4: 5fb06e70 ($10.52 in chips)
Seat 5: fe310807 ($9.39 in chips)
Seat 6: 714be4e ($11.86 in chips)
Hero: posts small blind $0.05
9955d467: posts big blind $0.1
*** HOLE CARDS ***
Dealt to b8848e7d 
Dealt to Hero [Td 9c]
Dealt to 9955d467 
Dealt to 5fb06e70 
Dealt to fe310807 
Dealt to 714be4e 
5fb06e70: folds
fe310807: folds
714be4e: folds
b8848e7d: folds
Hero: raises $0.2 to $0.3
9955d467: calls $0.2
*** FLOP *** [Ah Ts 9h]
Hero: bets $0.45
9955d467: raises $0.85 to $1.3
Hero: raises $4.8 to $6.1
9955d467: calls $3.03 and is all-in
Uncalled bet ($1.77) returned to Hero
Hero: shows [Td 9c] (Pair of Tens and Pair of Nines)
9955d467: shows [9d Th] (Pair of Tens and Pair of Nines)
*** TURN *** [Ah Ts 9h] [3s]
*** RIVER *** [Ah Ts 9h 3s] [2c]
*** SHOWDOWN ***
Hero collected $4.41 from pot
9955d467 collected $4.4 from pot
*** SUMMARY ***
Total pot $9.26 | Rake $0.3 | Jackpot $0.15 | Bingo $0 | Fortune $0
Board [Ah Ts 9h 3s 2c]
Seat 1: b8848e7d (button) folded before Flop (didn't bet)
Seat 2: Hero (small blind) showed [Td 9c] and won ($4.41) with Pair of Tens and Pair of Nines
Seat 3: 9955d467 (big blind) showed [9d Th] and won ($4.4) with Pair of Tens and Pair of Nines
Seat 4: 5fb06e70 folded before Flop (didn't bet)
Seat 5: fe310807 folded before Flop (didn't bet)
Seat 6: 714be4e folded before Flop (didn't bet)


Poker Hand #RC1456620294: Hold'em No Limit  ($0.05/$0.1) - 2023/04/07 11:16:23
Table 'RushAndCash3075554' 6-max Seat #1 is the button
Seat 1: 9955d467 ($4.26 in chips)
Seat 2: f8126b23 ($13.21 in chips)
Seat 3: 2c787ec2 ($10.64 in chips)
Seat 4: b6b2204f ($27.06 in chips)
Seat 5: 9cb03fbb ($10.51 in chips)
Seat 6: Hero ($11.79 in chips)
f8126b23: posts small blind $0.05
2c787ec2: posts big blind $0.1
*** HOLE CARDS ***
Dealt to 9955d467 
Dealt to f8126b23 
Dealt to 2c787ec2 
Dealt to b6b2204f 
Dealt to 9cb03fbb 
Dealt to Hero [Kh Qd]
b6b2204f: folds
9cb03fbb: folds
Hero: raises $0.15 to $0.25
9955d467: calls $0.25
f8126b23: folds
2c787ec2: folds
*** FLOP *** [7c 7s 9c]
Hero: checks
9955d467: bets $0.33
Hero: folds
Uncalled bet ($0.33) returned to 9955d467
*** SHOWDOWN ***
9955d467 collected $0.62 from pot
*** SUMMARY ***
Total pot $0.65 | Rake $0.03 | Jackpot $0 | Bingo $0 | Fortune $0
Board [7c 7s 9c]
Seat 1: 9955d467 (button) won ($0.62)
Seat 2: f8126b23 (small blind) folded before Flop
Seat 3: 2c787ec2 (big blind) folded before Flop
Seat 4: b6b2204f folded before Flop (didn't bet)
Seat 5: 9cb03fbb folded before Flop (didn't bet)
Seat 6: Hero folded on the Flop


Poker Hand #RC1456620261: Hold'em No Limit  ($0.05/$0.1) - 2023/04/07 11:16:18
Table 'RushAndCash3075521' 6-max Seat #1 is the button
Seat 1: 3cd503a8 ($2.04 in chips)
Seat 2: ac4e0c1 ($10.1 in chips)
Seat 3: f0407d6c ($10 in chips)
Seat 4: Hero ($11.79 in chips)
Seat 5: bf6f1943 ($9.75 in chips)
Seat 6: a355cc6f ($6.69 in chips)
ac4e0c1: posts small blind $0.05
f0407d6c: posts big blind $0.1
*** HOLE CARDS ***
Dealt to 3cd503a8 
Dealt to ac4e0c1 
Dealt to f0407d6c 
Dealt to Hero [3h Jh]
Dealt to bf6f1943 
Dealt to a355cc6f 
Hero: folds
bf6f1943: folds
a355cc6f: folds
3cd503a8: folds
ac4e0c1: folds
Uncalled bet ($0.05) returned to f0407d6c
*** SHOWDOWN ***
f0407d6c collected $0.1 from pot
*** SUMMARY ***
Total pot $0.1 | Rake $0 | Jackpot $0 | Bingo $0 | Fortune $0
Seat 1: 3cd503a8 (button) folded before Flop (didn't bet)
Seat 2: ac4e0c1 (small blind) folded before Flop
Seat 3: f0407d6c (big blind) collected ($0.1)
Seat 4: Hero folded before Flop (didn't bet)
Seat 5: bf6f1943 folded before Flop (didn't bet)
Seat 6: a355cc6f folded before Flop (didn't bet)


Poker Hand #RC1456620236: Hold'em No Limit  ($0.05/$0.1) - 2023/04/07 11:16:14
Table 'RushAndCash3075496' 6-max Seat #1 is the button
Seat 1: 8ed73182 ($16.48 in chips)
Seat 2: c862b7f8 ($21.26 in chips)
Seat 3: 960e6af4 ($9.5 in chips)
Seat 4: 4522d87 ($10.15 in chips)
Seat 5: c739096b ($8.76 in chips)
Seat 6: Hero ($11.79 in chips)
c862b7f8: posts small blind $0.05
960e6af4: posts big blind $0.1
*** HOLE CARDS ***
Dealt to 8ed73182 
Dealt to c862b7f8 
Dealt to 960e6af4 
Dealt to 4522d87 
Dealt to c739096b 
Dealt to Hero [4h Qs]
4522d87: folds
c739096b: folds
Hero: folds
8ed73182: folds
c862b7f8: folds
Uncalled bet ($0.05) returned to 960e6af4
*** SHOWDOWN ***
960e6af4 collected $0.1 from pot
*** SUMMARY ***
Total pot $0.1 | Rake $0 | Jackpot $0 | Bingo $0 | Fortune $0
Seat 1: 8ed73182 (button) folded before Flop (didn't bet)
Seat 2: c862b7f8 (small blind) folded before Flop
Seat 3: 960e6af4 (big blind) collected ($0.1)
Seat 4: 4522d87 folded before Flop (didn't bet)
Seat 5: c739096b folded before Flop (didn't bet)
Seat 6: Hero folded before Flop (didn't bet)


Poker Hand #RC1456620160: Hold'em No Limit  ($0.05/$0.1) - 2023/04/07 11:16:02
Table 'RushAndCash3075420' 6-max Seat #1 is the button
Seat 1: Hero ($11.64 in chips)
Seat 2: e6a51605 ($10.2 in chips)
Seat 3: 35634f83 ($10.33 in chips)
Seat 4: ec55179 ($10.94 in chips)
Seat 5: e1e1fbad ($10 in chips)
Seat 6: 9a36b824 ($10 in chips)
e6a51605: posts small blind $0.05
35634f83: posts big blind $0.1
*** HOLE CARDS ***
Dealt to Hero [As 8c]
Dealt to e6a51605 
Dealt to 35634f83 
Dealt to ec55179 
Dealt to e1e1fbad 
Dealt to 9a36b824 
ec55179: folds
e1e1fbad: folds
9a36b824: folds
Hero: raises $0.15 to $0.25
e6a51605: folds
35634f83: folds
Uncalled bet ($0.15) returned to Hero
*** SHOWDOWN ***
Hero collected $0.25 from pot
*** SUMMARY ***
Total pot $0.25 | Rake $0 | Jackpot $0 | Bingo $0 | Fortune $0
Seat 1: Hero (button) collected ($0.25)
Seat 2: e6a51605 (small blind) folded before Flop
Seat 3: 35634f83 (big blind) folded before Flop
Seat 4: ec55179 folded before Flop (didn't bet)
Seat 5: e1e1fbad folded before Flop (didn't bet)
Seat 6: 9a36b824 folded before Flop (didn't bet)


Poker Hand #RC1456620079: Hold'em No Limit  ($0.05/$0.1) - 2023/04/07 11:15:48
Table 'RushAndCash3075339' 6-max Seat #1 is the button
Seat 1: d7bd5db0 ($22.04 in chips)
Seat 2: Hero ($11.69 in chips)
Seat 3: f56d4f3a ($7.26 in chips)
Seat 4: 266cd6d4 ($10.13 in chips)
Seat 5: bf6f1943 ($9.85 in chips)
Seat 6: 29376847 ($11.87 in chips)
Hero: posts small blind $0.05
f56d4f3a: posts big blind $0.1
*** HOLE CARDS ***
Dealt to d7bd5db0 
Dealt to Hero [4d Ad]
Dealt to f56d4f3a 
Dealt to 266cd6d4 
Dealt to bf6f1943 
Dealt to 29376847 
266cd6d4: raises $0.15 to $0.25
bf6f1943: folds
29376847: folds
d7bd5db0: folds
Hero: folds
f56d4f3a: folds
Uncalled bet ($0.15) returned to 266cd6d4
*** SHOWDOWN ***
266cd6d4 collected $0.25 from pot
*** SUMMARY ***
Total pot $0.25 | Rake $0 | Jackpot $0 | Bingo $0 | Fortune $0
Seat 1: d7bd5db0 (button) folded before Flop (didn't bet)
Seat 2: Hero (small blind) folded before Flop
Seat 3: f56d4f3a (big blind) folded before Flop
Seat 4: 266cd6d4 collected ($0.25)
Seat 5: bf6f1943 folded before Flop (didn't bet)
Seat 6: 29376847 folded before Flop (didn't bet)


Poker Hand #RC1456620054: Hold'em No Limit  ($0.05/$0.1) - 2023/04/07 11:15:44
Table 'RushAndCash3075314' 6-max Seat #1 is the button
Seat 1: 8e72d539 ($10.66 in chips)
Seat 2: 1f6bce5a ($11.16 in chips)
Seat 3: Hero ($11.79 in chips)
Seat 4: f165af76 ($9.25 in chips)
Seat 5: 5db48cbf ($10.71 in chips)
Seat 6: f2ac3e6c ($11.12 in chips)
1f6bce5a: posts small blind $0.05
Hero: posts big blind $0.1
*** HOLE CARDS ***
Dealt to 8e72d539 
Dealt to 1f6bce5a 
Dealt to Hero [2s 5h]
Dealt to f165af76 
Dealt to 5db48cbf 
Dealt to f2ac3e6c 
f165af76: raises $0.12 to $0.22
5db48cbf: folds
f2ac3e6c: folds
8e72d539: calls $0.22
1f6bce5a: folds
Hero: folds
*** FLOP *** [8s 4s 6d]
f165af76: checks
8e72d539: bets $0.3
f165af76: folds
Uncalled bet ($0.3) returned to 8e72d539
*** SHOWDOWN ***
8e72d539 collected $0.56 from pot
*** SUMMARY ***
Total pot $0.59 | Rake $0.03 | Jackpot $0 | Bingo $0 | Fortune $0
Board [8s 4s 6d]
Seat 1: 8e72d539 (button) won ($0.56)
Seat 2: 1f6bce5a (small blind) folded before Flop
Seat 3: Hero (big blind) folded before Flop
Seat 4: f165af76 folded on the Flop
Seat 5: 5db48cbf folded before Flop (didn't bet)
Seat 6: f2ac3e6c folded before Flop (didn't bet)


Poker Hand #RC1456620019: Hold'em No Limit  ($0.05/$0.1) - 2023/04/07 11:15:38
Table 'RushAndCash3075279' 6-max Seat #1 is the button
Seat 1: b5998eb7 ($14.73 in chips)
Seat 2: 98f3d295 ($10.58 in chips)
Seat 3: b8e0e2b8 ($18.1 in chips)
Seat 4: 5ebc95db ($21.56 in chips)
Seat 5: ad028957 ($14.63 in chips)
Seat 6: Hero ($11.79 in chips)
98f3d295: posts small blind $0.05
b8e0e2b8: posts big blind $0.1
*** HOLE CARDS ***
Dealt to b5998eb7 
Dealt to 98f3d295 
Dealt to b8e0e2b8 
Dealt to 5ebc95db 
Dealt to ad028957 
Dealt to Hero [2d 7s]
5ebc95db: folds
ad028957: folds
Hero: folds
b5998eb7: folds
98f3d295: calls $0.05
b8e0e2b8: checks
*** FLOP *** [Td Tc Qs]
98f3d295: bets $0.1
b8e0e2b8: folds
Uncalled bet ($0.1) returned to 98f3d295
*** SHOWDOWN ***
98f3d295 collected $0.19 from pot
*** SUMMARY ***
Total pot $0.2 | Rake $0.01 | Jackpot $0 | Bingo $0 | Fortune $0
Board [Td Tc Qs]
Seat 1: b5998eb7 (button) folded before Flop (didn't bet)
Seat 2: 98f3d295 (small blind) won ($0.19)
Seat 3: b8e0e2b8 (big blind) folded on the Flop
Seat 4: 5ebc95db folded before Flop (didn't bet)
Seat 5: ad028957 folded before Flop (didn't bet)
Seat 6: Hero folded before Flop (didn't bet)


Poker Hand #RC1456619682: Hold'em No Limit  ($0.05/$0.1) - 2023/04/07 11:14:44
Table 'RushAndCash3074942' 6-max Seat #1 is the button
Seat 1: 5ebc95db ($21.19 in chips)
Seat 2: c11a6a4f ($14.21 in chips)
Seat 3: 81e8e3d4 ($12.17 in chips)
Seat 4: e1c7cbfe ($10.15 in chips)
Seat 5: Hero ($12.04 in chips)
Seat 6: 719077a0 ($12.45 in chips)
c11a6a4f: posts small blind $0.05
81e8e3d4: posts big blind $0.1
*** HOLE CARDS ***
Dealt to 5ebc95db 
Dealt to c11a6a4f 
Dealt to 81e8e3d4 
Dealt to e1c7cbfe 
Dealt to Hero [Kc Qh]
Dealt to 719077a0 
e1c7cbfe: folds
Hero: raises $0.15 to $0.25
719077a0: folds
5ebc95db: calls $0.25
c11a6a4f: folds
81e8e3d4: folds
*** FLOP *** [4s Jh 8c]
Hero: checks
5ebc95db: bets $0.49
Hero: folds
Uncalled bet ($0.49) returned to 5ebc95db
*** SHOWDOWN ***
5ebc95db collected $0.62 from pot
*** SUMMARY ***
Total pot $0.65 | Rake $0.03 | Jackpot $0 | Bingo $0 | Fortune $0
Board [4s Jh 8c]
Seat 1: 5ebc95db (button) won ($0.62)
Seat 2: c11a6a4f (small blind) folded before Flop
Seat 3: 81e8e3d4 (big blind) folded before Flop
Seat 4: e1c7cbfe folded before Flop (didn't bet)
Seat 5: Hero folded on the Flop
Seat 6: 719077a0 folded before Flop (didn't bet)


Poker Hand #RC1456619610: Hold'em No Limit  ($0.05/$0.1) - 2023/04/07 11:14:32
Table 'RushAndCash3074870' 6-max Seat #1 is the button
Seat 1: Hero ($12.04 in chips)
Seat 2: 14d6795c ($27.02 in chips)
Seat 3: dea7a4d4 ($17.97 in chips)
Seat 4: 2ad7d0ec ($10.58 in chips)
Seat 5: 1ed94b ($11.64 in chips)
Seat 6: d7bd5db0 ($21.84 in chips)
14d6795c: posts small blind $0.05
dea7a4d4: posts big blind $0.1
*** HOLE CARDS ***
Dealt to Hero [7c 9c]
Dealt to 14d6795c 
Dealt to dea7a4d4 
Dealt to 2ad7d0ec 
Dealt to 1ed94b 
Dealt to d7bd5db0 
2ad7d0ec: folds
1ed94b: folds
d7bd5db0: folds
Hero: folds
14d6795c: raises $0.2 to $0.3
dea7a4d4: folds
Uncalled bet ($0.2) returned to 14d6795c
*** SHOWDOWN ***
14d6795c collected $0.2 from pot
*** SUMMARY ***
Total pot $0.2 | Rake $0 | Jackpot $0 | Bingo $0 | Fortune $0
Seat 1: Hero (button) folded before Flop (didn't bet)
Seat 2: 14d6795c (small blind) collected ($0.2)
Seat 3: dea7a4d4 (big blind) folded before Flop
Seat 4: 2ad7d0ec folded before Flop (didn't bet)
Seat 5: 1ed94b folded before Flop (didn't bet)
Seat 6: d7bd5db0 folded before Flop (didn't bet)


Poker Hand #RC1456619516: Hold'em No Limit  ($0.05/$0.1) - 2023/04/07 11:14:17
Table 'RushAndCash3074776' 6-max Seat #1 is the button
Seat 1: b86c2fb2 ($10 in chips)
Seat 2: 4870d703 ($12.3 in chips)
Seat 3: 22090ba9 ($10 in chips)
Seat 4: b6b2204f ($26.01 in chips)
Seat 5: 70ded09d ($9.22 in chips)
Seat 6: Hero ($11.89 in chips)
4870d703: posts small blind $0.05
22090ba9: posts big blind $0.1
*** HOLE CARDS ***
Dealt to b86c2fb2 
Dealt to 4870d703 
Dealt to 22090ba9 
Dealt to b6b2204f 
Dealt to 70ded09d 
Dealt to Hero [Ac Kd]
b6b2204f: folds
70ded09d: folds
Hero: raises $0.15 to $0.25
b86c2fb2: folds
4870d703: folds
22090ba9: folds
Uncalled bet ($0.15) returned to Hero
*** SHOWDOWN ***
Hero collected $0.25 from pot
*** SUMMARY ***
Total pot $0.25 | Rake $0 | Jackpot $0 | Bingo $0 | Fortune $0
Seat 1: b86c2fb2 (button) folded before Flop (didn't bet)
Seat 2: 4870d703 (small blind) folded before Flop
Seat 3: 22090ba9 (big blind) folded before Flop
Seat 4: b6b2204f folded before Flop (didn't bet)
Seat 5: 70ded09d folded before Flop (didn't bet)
Seat 6: Hero collected ($0.25)


Poker Hand #RC1456619468: Hold'em No Limit  ($0.05/$0.1) - 2023/04/07 11:14:09
Table 'RushAndCash3074728' 6-max Seat #1 is the button
Seat 1: 2dde7830 ($10 in chips)
Seat 2: Hero ($11.94 in chips)
Seat 3: f1e67b9e ($13.76 in chips)
Seat 4: f7a1747f ($13.03 in chips)
Seat 5: 2347ac94 ($12.69 in chips)
Seat 6: bac77af ($10.75 in chips)
Hero: posts small blind $0.05
f1e67b9e: posts big blind $0.1
*** HOLE CARDS ***
Dealt to 2dde7830 
Dealt to Hero [9s 6d]
Dealt to f1e67b9e 
Dealt to f7a1747f 
Dealt to 2347ac94 
Dealt to bac77af 
f7a1747f: folds
2347ac94: raises $0.14 to $0.24
bac77af: folds
2dde7830: folds
Hero: folds
f1e67b9e: calls $0.14
*** FLOP *** [3c 8s 7s]
f1e67b9e: checks
2347ac94: bets $0.35
f1e67b9e: folds
Uncalled bet ($0.35) returned to 2347ac94
*** SHOWDOWN ***
2347ac94 collected $0.51 from pot
*** SUMMARY ***
Total pot $0.53 | Rake $0.02 | Jackpot $0 | Bingo $0 | Fortune $0
Board [3c 8s 7s]
Seat 1: 2dde7830 (button) folded before Flop (didn't bet)
Seat 2: Hero (small blind) folded before Flop
Seat 3: f1e67b9e (big blind) folded on the Flop
Seat 4: f7a1747f folded before Flop (didn't bet)
Seat 5: 2347ac94 won ($0.51)
Seat 6: bac77af folded before Flop (didn't bet)


Poker Hand #RC1456619399: Hold'em No Limit  ($0.05/$0.1) - 2023/04/07 11:14:00
Table 'RushAndCash3074659' 6-max Seat #1 is the button
Seat 1: fd5d7da6 ($10 in chips)
Seat 2: 8d378929 ($10.05 in chips)
Seat 3: Hero ($11.89 in chips)
Seat 4: b0bba503 ($2.88 in chips)
Seat 5: 6dc45064 ($10.07 in chips)
Seat 6: 21c6d2a5 ($8.87 in chips)
8d378929: posts small blind $0.05
Hero: posts big blind $0.1
*** HOLE CARDS ***
Dealt to fd5d7da6 
Dealt to 8d378929 
Dealt to Hero [Ah Jh]
Dealt to b0bba503 
Dealt to 6dc45064 
Dealt to 21c6d2a5 
b0bba503: folds
6dc45064: folds
21c6d2a5: folds
fd5d7da6: folds
8d378929: folds
Uncalled bet ($0.05) returned to Hero
*** SHOWDOWN ***
Hero collected $0.1 from pot
*** SUMMARY ***
Total pot $0.1 | Rake $0 | Jackpot $0 | Bingo $0 | Fortune $0
Seat 1: fd5d7da6 (button) folded before Flop (didn't bet)
Seat 2: 8d378929 (small blind) folded before Flop
Seat 3: Hero (big blind) collected ($0.1)
Seat 4: b0bba503 folded before Flop (didn't bet)
Seat 5: 6dc45064 folded before Flop (didn't bet)
Seat 6: 21c6d2a5 folded before Flop (didn't bet)


Poker Hand #RC1456619178: Hold'em No Limit  ($0.05/$0.1) - 2023/04/07 11:13:23
Table 'RushAndCash3074438' 6-max Seat #1 is the button
Seat 1: 44cbd13b ($8.66 in chips)
Seat 2: 1de66650 ($17.18 in chips)
Seat 3: 8e72d539 ($10.33 in chips)
Seat 4: b0bba503 ($3.75 in chips)
Seat 5: e2bb582f ($33.6 in chips)
Seat 6: Hero ($10.96 in chips)
1de66650: posts small blind $0.05
8e72d539: posts big blind $0.1
*** HOLE CARDS ***
Dealt to 44cbd13b 
Dealt to 1de66650 
Dealt to 8e72d539 
Dealt to b0bba503 
Dealt to e2bb582f 
Dealt to Hero [Ks Kh]
b0bba503: raises $0.2 to $0.3
e2bb582f: folds
Hero: raises $0.57 to $0.87
44cbd13b: folds
1de66650: folds
8e72d539: folds
b0bba503: calls $0.57
*** FLOP *** [Jh 7s 4d]
b0bba503: checks
Hero: bets $0.95
b0bba503: folds
Uncalled bet ($0.95) returned to Hero
*** SHOWDOWN ***
Hero collected $1.8 from pot
*** SUMMARY ***
Total pot $1.89 | Rake $0.09 | Jackpot $0 | Bingo $0 | Fortune $0
Board [Jh 7s 4d]
Seat 1: 44cbd13b (button) folded before Flop (didn't bet)
Seat 2: 1de66650 (small blind) folded before Flop
Seat 3: 8e72d539 (big blind) folded before Flop
Seat 4: b0bba503 folded on the Flop
Seat 5: e2bb582f folded before Flop (didn't bet)
Seat 6: Hero won ($1.8)


Poker Hand #RC1456619145: Hold'em No Limit  ($0.05/$0.1) - 2023/04/07 11:13:18
Table 'RushAndCash3074405' 6-max Seat #1 is the button
Seat 1: 5b97ef9b ($22.52 in chips)
Seat 2: dfa890a6 ($49.84 in chips)
Seat 3: 358bee4c ($11.15 in chips)
Seat 4: Hero ($10.96 in chips)
Seat 5: 54cc5108 ($10.81 in chips)
Seat 6: 1c8b76f1 ($10 in chips)
dfa890a6: posts small blind $0.05
358bee4c: posts big blind $0.1
*** HOLE CARDS ***
Dealt to 5b97ef9b 
Dealt to dfa890a6 
Dealt to 358bee4c 
Dealt to Hero [Ks 4h]
Dealt to 54cc5108 
Dealt to 1c8b76f1 
Hero: folds
54cc5108: folds
1c8b76f1: raises $0.2 to $0.3
5b97ef9b: folds
dfa890a6: calls $0.25
358bee4c: calls $0.2
*** FLOP *** [Tc Th As]
dfa890a6: bets $0.1
358bee4c: calls $0.1
1c8b76f1: calls $0.1
*** TURN *** [Tc Th As] [4d]
dfa890a6: checks
358bee4c: checks
1c8b76f1: checks
*** RIVER *** [Tc Th As 4d] [Kd]
dfa890a6: checks
358bee4c: bets $0.4
1c8b76f1: folds
dfa890a6: folds
Uncalled bet ($0.4) returned to 358bee4c
*** SHOWDOWN ***
358bee4c collected $1.14 from pot
*** SUMMARY ***
Total pot $1.2 | Rake $0.06 | Jackpot $0 | Bingo $0 | Fortune $0
Board [Tc Th As 4d Kd]
Seat 1: 5b97ef9b (button) folded before Flop (didn't bet)
Seat 2: dfa890a6 (small blind) folded on the River
Seat 3: 358bee4c (big blind) won ($1.14)
Seat 4: Hero folded before Flop (didn't bet)
Seat 5: 54cc5108 folded before Flop (didn't bet)
Seat 6: 1c8b76f1 folded on the River


Poker Hand #RC1456619092: Hold'em No Limit  ($0.05/$0.1) - 2023/04/07 11:13:09
Table 'RushAndCash3074352' 6-max Seat #1 is the button
Seat 1: c699478f ($10.1 in chips)
Seat 2: 8582274b ($10 in chips)
Seat 3: f165af76 ($9.7 in chips)
Seat 4: c862b7f8 ($21.21 in chips)
Seat 5: 89baf59b ($10.55 in chips)
Seat 6: Hero ($10.96 in chips)
8582274b: posts small blind $0.05
f165af76: posts big blind $0.1
*** HOLE CARDS ***
Dealt to c699478f 
Dealt to 8582274b 
Dealt to f165af76 
Dealt to c862b7f8 
Dealt to 89baf59b 
Dealt to Hero [5h Jd]
c862b7f8: folds
89baf59b: folds
Hero: folds
c699478f: raises $0.15 to $0.25
8582274b: folds
f165af76: folds
Uncalled bet ($0.15) returned to c699478f
*** SHOWDOWN ***
c699478f collected $0.25 from pot
*** SUMMARY ***
Total pot $0.25 | Rake $0 | Jackpot $0 | Bingo $0 | Fortune $0
Seat 1: c699478f (button) collected ($0.25)
Seat 2: 8582274b (small blind) folded before Flop
Seat 3: f165af76 (big blind) folded before Flop
Seat 4: c862b7f8 folded before Flop (didn't bet)
Seat 5: 89baf59b folded before Flop (didn't bet)
Seat 6: Hero folded before Flop (didn't bet)


Poker Hand #RC1456619012: Hold'em No Limit  ($0.05/$0.1) - 2023/04/07 11:12:56
Table 'RushAndCash3074272' 6-max Seat #1 is the button
Seat 1: Hero ($10.81 in chips)
Seat 2: 1ce003d6 ($10.68 in chips)
Seat 3: c699478f ($10.2 in chips)
Seat 4: 44afbdfe ($10.41 in chips)
Seat 5: c739096b ($7.58 in chips)
Seat 6: 21657e08 ($10 in chips)
1ce003d6: posts small blind $0.05
c699478f: posts big blind $0.1
*** HOLE CARDS ***
Dealt to Hero [9h 9c]
Dealt to 1ce003d6 
Dealt to c699478f 
Dealt to 44afbdfe 
Dealt to c739096b 
Dealt to 21657e08 
44afbdfe: folds
c739096b: folds
21657e08: folds
Hero: raises $0.15 to $0.25
1ce003d6: folds
c699478f: folds
Uncalled bet ($0.15) returned to Hero
*** SHOWDOWN ***
Hero collected $0.25 from pot
*** SUMMARY ***
Total pot $0.25 | Rake $0 | Jackpot $0 | Bingo $0 | Fortune $0
Seat 1: Hero (button) collected ($0.25)
Seat 2: 1ce003d6 (small blind) folded before Flop
Seat 3: c699478f (big blind) folded before Flop
Seat 4: 44afbdfe folded before Flop (didn't bet)
Seat 5: c739096b folded before Flop (didn't bet)
Seat 6: 21657e08 folded before Flop (didn't bet)


Poker Hand #RC1456618919: Hold'em No Limit  ($0.05/$0.1) - 2023/04/07 11:12:42
Table 'RushAndCash3074179' 6-max Seat #1 is the button
Seat 1: 2781f57 ($14.68 in chips)
Seat 2: 3243ceee ($20.48 in chips)
Seat 3: Hero ($10.91 in chips)
Seat 4: ec55179 ($10.15 in chips)
Seat 5: c11a6a4f ($14.31 in chips)
Seat 6: 6e02d89c ($10 in chips)
3243ceee: posts small blind $0.05
Hero: posts big blind $0.1
*** HOLE CARDS ***
Dealt to 2781f57 
Dealt to 3243ceee 
Dealt to Hero [4s Jh]
Dealt to ec55179 
Dealt to c11a6a4f 
Dealt to 6e02d89c 
ec55179: folds
c11a6a4f: folds
6e02d89c: raises $0.13 to $0.23
2781f57: folds
3243ceee: folds
Hero: folds
Uncalled bet ($0.13) returned to 6e02d89c
*** SHOWDOWN ***
6e02d89c collected $0.25 from pot
*** SUMMARY ***
Total pot $0.25 | Rake $0 | Jackpot $0 | Bingo $0 | Fortune $0
Seat 1: 2781f57 (button) folded before Flop (didn't bet)
Seat 2: 3243ceee (small blind) folded before Flop
Seat 3: Hero (big blind) folded before Flop
Seat 4: ec55179 folded before Flop (didn't bet)
Seat 5: c11a6a4f folded before Flop (didn't bet)
Seat 6: 6e02d89c collected ($0.25)


Poker Hand #RC1456618706: Hold'em No Limit  ($0.05/$0.1) - 2023/04/07 11:12:08
Table 'RushAndCash3073966' 6-max Seat #1 is the button
Seat 1: 7aae144e ($11.93 in chips)
Seat 2: Hero ($10.64 in chips)
Seat 3: 3243ceee ($20.78 in chips)
Seat 4: a4380876 ($11.5 in chips)
Seat 5: be87951c ($13.22 in chips)
Seat 6: e3c32931 ($22.68 in chips)
Hero: posts small blind $0.05
3243ceee: posts big blind $0.1
*** HOLE CARDS ***
Dealt to 7aae144e 
Dealt to Hero [As 6s]
Dealt to 3243ceee 
Dealt to a4380876 
Dealt to be87951c 
Dealt to e3c32931 
a4380876: folds
be87951c: folds
e3c32931: folds
7aae144e: folds
Hero: raises $0.2 to $0.3
3243ceee: calls $0.2
*** FLOP *** [Jc 2d 2s]
Hero: checks
3243ceee: checks
*** TURN *** [Jc 2d 2s] [Ah]
Hero: checks
3243ceee: checks
*** RIVER *** [Jc 2d 2s Ah] [2h]
Hero: bets $0.3
3243ceee: folds
Uncalled bet ($0.3) returned to Hero
*** SHOWDOWN ***
Hero collected $0.57 from pot
*** SUMMARY ***
Total pot $0.6 | Rake $0.03 | Jackpot $0 | Bingo $0 | Fortune $0
Board [Jc 2d 2s Ah 2h]
Seat 1: 7aae144e (button) folded before Flop (didn't bet)
Seat 2: Hero (small blind) won ($0.57)
Seat 3: 3243ceee (big blind) folded on the River
Seat 4: a4380876 folded before Flop (didn't bet)
Seat 5: be87951c folded before Flop (didn't bet)
Seat 6: e3c32931 folded before Flop (didn't bet)


Poker Hand #RC1456618671: Hold'em No Limit  ($0.05/$0.1) - 2023/04/07 11:12:03
Table 'RushAndCash3073931' 6-max Seat #1 is the button
Seat 1: c1b510d9 ($77.65 in chips)
Seat 2: 1daea4eb ($5.99 in chips)
Seat 3: 9e18683b ($9.68 in chips)
Seat 4: Hero ($10.64 in chips)
Seat 5: 15707fae ($11.55 in chips)
Seat 6: 2bfd1b14 ($10.1 in chips)
1daea4eb: posts small blind $0.05
9e18683b: posts big blind $0.1
*** HOLE CARDS ***
Dealt to c1b510d9 
Dealt to 1daea4eb 
Dealt to 9e18683b 
Dealt to Hero [7c 5d]
Dealt to 15707fae 
Dealt to 2bfd1b14 
Hero: folds
15707fae: folds
2bfd1b14: folds
c1b510d9: raises $0.2 to $0.3
1daea4eb: folds
9e18683b: folds
Uncalled bet ($0.2) returned to c1b510d9
*** SHOWDOWN ***
c1b510d9 collected $0.25 from pot
*** SUMMARY ***
Total pot $0.25 | Rake $0 | Jackpot $0 | Bingo $0 | Fortune $0
Seat 1: c1b510d9 (button) collected ($0.25)
Seat 2: 1daea4eb (small blind) folded before Flop
Seat 3: 9e18683b (big blind) folded before Flop
Seat 4: Hero folded before Flop (didn't bet)
Seat 5: 15707fae folded before Flop (didn't bet)
Seat 6: 2bfd1b14 folded before Flop (didn't bet)


Poker Hand #RC1456618636: Hold'em No Limit  ($0.05/$0.1) - 2023/04/07 11:11:58
Table 'RushAndCash3073896' 6-max Seat #1 is the button
Seat 1: e6649e7b ($9.19 in chips)
Seat 2: 4e9d25bb ($11.05 in chips)
Seat 3: e06ed4ee ($11.03 in chips)
Seat 4: ce41d4dc ($11.43 in chips)
Seat 5: c739096b ($7.58 in chips)
Seat 6: Hero ($10.64 in chips)
4e9d25bb: posts small blind $0.05
e06ed4ee: posts big blind $0.1
*** HOLE CARDS ***
Dealt to e6649e7b 
Dealt to 4e9d25bb 
Dealt to e06ed4ee 
Dealt to ce41d4dc 
Dealt to c739096b 
Dealt to Hero [9h 2h]
ce41d4dc: folds
c739096b: folds
Hero: folds
e6649e7b: folds
4e9d25bb: folds
Uncalled bet ($0.05) returned to e06ed4ee
*** SHOWDOWN ***
e06ed4ee collected $0.1 from pot
*** SUMMARY ***
Total pot $0.1 | Rake $0 | Jackpot $0 | Bingo $0 | Fortune $0
Seat 1: e6649e7b (button) folded before Flop (didn't bet)
Seat 2: 4e9d25bb (small blind) folded before Flop
Seat 3: e06ed4ee (big blind) collected ($0.1)
Seat 4: ce41d4dc folded before Flop (didn't bet)
Seat 5: c739096b folded before Flop (didn't bet)
Seat 6: Hero folded before Flop (didn't bet)


Poker Hand #RC1456618580: Hold'em No Limit  ($0.05/$0.1) - 2023/04/07 11:11:49
Table 'RushAndCash3073840' 6-max Seat #1 is the button
Seat 1: 4e18b945 ($20.14 in chips)
Seat 2: c036e9a1 ($10.47 in chips)
Seat 3: 1de66650 ($16.78 in chips)
Seat 4: Hero ($10.64 in chips)
Seat 5: ce783e5 ($8.36 in chips)
Seat 6: 94a07562 ($41.73 in chips)
c036e9a1: posts small blind $0.05
1de66650: posts big blind $0.1
*** HOLE CARDS ***
Dealt to 4e18b945 
Dealt to c036e9a1 
Dealt to 1de66650 
Dealt to Hero [Qd 4c]
Dealt to ce783e5 
Dealt to 94a07562 
Hero: folds
ce783e5: raises $0.15 to $0.25
94a07562: folds
4e18b945: folds
c036e9a1: folds
1de66650: folds
Uncalled bet ($0.15) returned to ce783e5
*** SHOWDOWN ***
ce783e5 collected $0.25 from pot
*** SUMMARY ***
Total pot $0.25 | Rake $0 | Jackpot $0 | Bingo $0 | Fortune $0
Seat 1: 4e18b945 (button) folded before Flop (didn't bet)
Seat 2: c036e9a1 (small blind) folded before Flop
Seat 3: 1de66650 (big blind) folded before Flop
Seat 4: Hero folded before Flop (didn't bet)
Seat 5: ce783e5 collected ($0.25)
Seat 6: 94a07562 folded before Flop (didn't bet)


Poker Hand #RC1456618478: Hold'em No Limit  ($0.05/$0.1) - 2023/04/07 11:11:33
Table 'RushAndCash3073738' 6-max Seat #1 is the button
Seat 1: Hero ($10.49 in chips)
Seat 2: b19e7719 ($10.5 in chips)
Seat 3: 65f22aee ($24.08 in chips)
Seat 4: 306e0590 ($12.81 in chips)
Seat 5: 2af1e0bf ($10.4 in chips)
Seat 6: f8126b23 ($10 in chips)
b19e7719: posts small blind $0.05
65f22aee: posts big blind $0.1
*** HOLE CARDS ***
Dealt to Hero [Kh As]
Dealt to b19e7719 
Dealt to 65f22aee 
Dealt to 306e0590 
Dealt to 2af1e0bf 
Dealt to f8126b23 
306e0590: folds
2af1e0bf: folds
f8126b23: folds
Hero: raises $0.15 to $0.25
b19e7719: folds
65f22aee: folds
Uncalled bet ($0.15) returned to Hero
*** SHOWDOWN ***
Hero collected $0.25 from pot
*** SUMMARY ***
Total pot $0.25 | Rake $0 | Jackpot $0 | Bingo $0 | Fortune $0
Seat 1: Hero (button) collected ($0.25)
Seat 2: b19e7719 (small blind) folded before Flop
Seat 3: 65f22aee (big blind) folded before Flop
Seat 4: 306e0590 folded before Flop (didn't bet)
Seat 5: 2af1e0bf folded before Flop (didn't bet)
Seat 6: f8126b23 folded before Flop (didn't bet)


Poker Hand #RC1456618378: Hold'em No Limit  ($0.05/$0.1) - 2023/04/07 11:11:17
Table 'RushAndCash3073638' 6-max Seat #1 is the button
Seat 1: 61791e4a ($12.14 in chips)
Seat 2: Hero ($10.54 in chips)
Seat 3: 9d5b7c3d ($10.88 in chips)
Seat 4: 5fb06e70 ($10 in chips)
Seat 5: 9dbcc410 ($10 in chips)
Seat 6: cf259589 ($2.57 in chips)
Hero: posts small blind $0.05
9d5b7c3d: posts big blind $0.1
*** HOLE CARDS ***
Dealt to 61791e4a 
Dealt to Hero [9h Qh]
Dealt to 9d5b7c3d 
Dealt to 5fb06e70 
Dealt to 9dbcc410 
Dealt to cf259589 
5fb06e70: folds
9dbcc410: folds
cf259589: folds
61791e4a: raises $0.12 to $0.22
Hero: folds
9d5b7c3d: calls $0.12
*** FLOP *** [2h 7d Qc]
9d5b7c3d: checks
61791e4a: bets $0.17
9d5b7c3d: calls $0.17
*** TURN *** [2h 7d Qc] [6d]
9d5b7c3d: checks
61791e4a: bets $0.63
9d5b7c3d: folds
Uncalled bet ($0.63) returned to 61791e4a
*** SHOWDOWN ***
61791e4a collected $0.79 from pot
*** SUMMARY ***
Total pot $0.83 | Rake $0.04 | Jackpot $0 | Bingo $0 | Fortune $0
Board [2h 7d Qc 6d]
Seat 1: 61791e4a (button) won ($0.79)
Seat 2: Hero (small blind) folded before Flop
Seat 3: 9d5b7c3d (big blind) folded on the Turn
Seat 4: 5fb06e70 folded before Flop (didn't bet)
Seat 5: 9dbcc410 folded before Flop (didn't bet)
Seat 6: cf259589 folded before Flop (didn't bet)


Poker Hand #RC1456618339: Hold'em No Limit  ($0.05/$0.1) - 2023/04/07 11:11:11
Table 'RushAndCash3073599' 6-max Seat #1 is the button
Seat 1: ec145aa8 ($9.09 in chips)
Seat 2: 9bf4d213 ($16.51 in chips)
Seat 3: Hero ($10.64 in chips)
Seat 4: 3ed1e167 ($10.15 in chips)
Seat 5: faf131c1 ($10.63 in chips)
Seat 6: 719077a0 ($9.37 in chips)
9bf4d213: posts small blind $0.05
Hero: posts big blind $0.1
*** HOLE CARDS ***
Dealt to ec145aa8 
Dealt to 9bf4d213 
Dealt to Hero [2s 6d]
Dealt to 3ed1e167 
Dealt to faf131c1 
Dealt to 719077a0 
3ed1e167: folds
faf131c1: folds
719077a0: folds
ec145aa8: raises $0.1 to $0.2
9bf4d213: raises $0.8 to $1
Hero: folds
ec145aa8: folds
Uncalled bet ($0.8) returned to 9bf4d213
*** SHOWDOWN ***
9bf4d213 collected $0.48 from pot
*** SUMMARY ***
Total pot $0.5 | Rake $0.02 | Jackpot $0 | Bingo $0 | Fortune $0
Seat 1: ec145aa8 (button) folded before Flop
Seat 2: 9bf4d213 (small blind) collected ($0.48)
Seat 3: Hero (big blind) folded before Flop
Seat 4: 3ed1e167 folded before Flop (didn't bet)
Seat 5: faf131c1 folded before Flop (didn't bet)
Seat 6: 719077a0 folded before Flop (didn't bet)


Poker Hand #RC1456618075: Hold'em No Limit  ($0.05/$0.1) - 2023/04/07 11:10:23
Table 'RushAndCash3073335' 6-max Seat #1 is the button
Seat 1: 9955d467 ($1.43 in chips)
Seat 2: 38587f1a ($10 in chips)
Seat 3: 29970b33 ($14.53 in chips)
Seat 4: Hero ($9.35 in chips)
Seat 5: 61791e4a ($11.77 in chips)
Seat 6: 54409c02 ($16.62 in chips)
38587f1a: posts small blind $0.05
29970b33: posts big blind $0.1
*** HOLE CARDS ***
Dealt to 9955d467 
Dealt to 38587f1a 
Dealt to 29970b33 
Dealt to Hero [Ac As]
Dealt to 61791e4a 
Dealt to 54409c02 
Hero: raises $0.15 to $0.25
61791e4a: folds
54409c02: folds
9955d467: calls $0.25
38587f1a: folds
29970b33: folds
*** FLOP *** [8s 8d 2s]
Hero: bets $0.33
9955d467: raises $0.85 to $1.18 and is all-in
Hero: calls $0.85
9955d467: shows [Ts Ks] (Pair of Eights)
Hero: shows [Ac As] (Pair of Aces and Pair of Eights)
*** TURN *** [8s 8d 2s] [Ad]
*** RIVER *** [8s 8d 2s Ad] [Td]
*** SHOWDOWN ***
Hero collected $2.72 from pot
*** SUMMARY ***
Total pot $3.01 | Rake $0.14 | Jackpot $0.15 | Bingo $0 | Fortune $0
Board [8s 8d 2s Ad Td]
Seat 1: 9955d467 (button) showed [Ts Ks] and lost with Pair of Tens and Pair of Eights
Seat 2: 38587f1a (small blind) folded before Flop
Seat 3: 29970b33 (big blind) folded before Flop
Seat 4: Hero showed [Ac As] and won ($2.72) with Aces Full over Eights
Seat 5: 61791e4a folded before Flop (didn't bet)
Seat 6: 54409c02 folded before Flop (didn't bet)


Poker Hand #RC1456618033: Hold'em No Limit  ($0.05/$0.1) - 2023/04/07 11:10:17
Table 'RushAndCash3073293' 6-max Seat #1 is the button
Seat 1: 7f6dcfc1 ($12.68 in chips)
Seat 2: 3a37e8f2 ($12.64 in chips)
Seat 3: 528d16ff ($12.54 in chips)
Seat 4: 4f31bd64 ($15.33 in chips)
Seat 5: Hero ($9.35 in chips)
Seat 6: d0bbec8e ($10 in chips)
3a37e8f2: posts small blind $0.05
528d16ff: posts big blind $0.1
*** HOLE CARDS ***
Dealt to 7f6dcfc1 
Dealt to 3a37e8f2 
Dealt to 528d16ff 
Dealt to 4f31bd64 
Dealt to Hero [3d Qs]
Dealt to d0bbec8e 
4f31bd64: folds
Hero: folds
d0bbec8e: folds
7f6dcfc1: folds
3a37e8f2: folds
Uncalled bet ($0.05) returned to 528d16ff
*** SHOWDOWN ***
528d16ff collected $0.1 from pot
*** SUMMARY ***
Total pot $0.1 | Rake $0 | Jackpot $0 | Bingo $0 | Fortune $0
Seat 1: 7f6dcfc1 (button) folded before Flop (didn't bet)
Seat 2: 3a37e8f2 (small blind) folded before Flop
Seat 3: 528d16ff (big blind) collected ($0.1)
Seat 4: 4f31bd64 folded before Flop (didn't bet)
Seat 5: Hero folded before Flop (didn't bet)
Seat 6: d0bbec8e folded before Flop (didn't bet)


Poker Hand #RC1456617986: Hold'em No Limit  ($0.05/$0.1) - 2023/04/07 11:10:09
Table 'RushAndCash3073246' 6-max Seat #1 is the button
Seat 1: f3a0c5c7 ($9.42 in chips)
Seat 2: ec55179 ($12.04 in chips)
Seat 3: 960e6af4 ($10.8 in chips)
Seat 4: 6ecc4900 ($13.01 in chips)
Seat 5: Hero ($9.35 in chips)
Seat 6: eabbf486 ($22.53 in chips)
ec55179: posts small blind $0.05
960e6af4: posts big blind $0.1
*** HOLE CARDS ***
Dealt to f3a0c5c7 
Dealt to ec55179 
Dealt to 960e6af4 
Dealt to 6ecc4900 
Dealt to Hero [4c 9s]
Dealt to eabbf486 
6ecc4900: folds
Hero: folds
eabbf486: folds
f3a0c5c7: folds
ec55179: folds
Uncalled bet ($0.05) returned to 960e6af4
*** SHOWDOWN ***
960e6af4 collected $0.1 from pot
*** SUMMARY ***
Total pot $0.1 | Rake $0 | Jackpot $0 | Bingo $0 | Fortune $0
Seat 1: f3a0c5c7 (button) folded before Flop (didn't bet)
Seat 2: ec55179 (small blind) folded before Flop
Seat 3: 960e6af4 (big blind) collected ($0.1)
Seat 4: 6ecc4900 folded before Flop (didn't bet)
Seat 5: Hero folded before Flop (didn't bet)
Seat 6: eabbf486 folded before Flop (didn't bet)


Poker Hand #RC1456617860: Hold'em No Limit  ($0.05/$0.1) - 2023/04/07 11:09:47
Table 'RushAndCash3073120' 6-max Seat #1 is the button
Seat 1: ba4efd2e ($10.83 in chips)
Seat 2: Hero ($9.4 in chips)
Seat 3: b5998eb7 ($12.53 in chips)
Seat 4: ae48cca5 ($10.1 in chips)
Seat 5: f128ea02 ($13.01 in chips)
Seat 6: 316bafcf ($13.28 in chips)
Hero: posts small blind $0.05
b5998eb7: posts big blind $0.1
*** HOLE CARDS ***
Dealt to ba4efd2e 
Dealt to Hero [5c Ac]
Dealt to b5998eb7 
Dealt to ae48cca5 
Dealt to f128ea02 
Dealt to 316bafcf 
ae48cca5: raises $0.16 to $0.26
f128ea02: folds
316bafcf: folds
ba4efd2e: folds
Hero: folds
b5998eb7: calls $0.16
*** FLOP *** [Kd Js 2d]
b5998eb7: checks
ae48cca5: bets $0.4
b5998eb7: folds
Uncalled bet ($0.4) returned to ae48cca5
*** SHOWDOWN ***
ae48cca5 collected $0.55 from pot
*** SUMMARY ***
Total pot $0.57 | Rake $0.02 | Jackpot $0 | Bingo $0 | Fortune $0
Board [Kd Js 2d]
Seat 1: ba4efd2e (button) folded before Flop (didn't bet)
Seat 2: Hero (small blind) folded before Flop
Seat 3: b5998eb7 (big blind) folded on the Flop
Seat 4: ae48cca5 won ($0.55)
Seat 5: f128ea02 folded before Flop (didn't bet)
Seat 6: 316bafcf folded before Flop (didn't bet)


Poker Hand #RC1456617759: Hold'em No Limit  ($0.05/$0.1) - 2023/04/07 11:09:32
Table 'RushAndCash3073019' 6-max Seat #1 is the button
Seat 1: 8e3f904d ($14.18 in chips)
Seat 2: 58d73444 ($18.73 in chips)
Seat 3: Hero ($9.5 in chips)
Seat 4: 6acbb0ae ($10.2 in chips)
Seat 5: 89baf59b ($10.26 in chips)
Seat 6: d7d93175 ($34.04 in chips)
58d73444: posts small blind $0.05
Hero: posts big blind $0.1
*** HOLE CARDS ***
Dealt to 8e3f904d 
Dealt to 58d73444 
Dealt to Hero [7s 8c]
Dealt to 6acbb0ae 
Dealt to 89baf59b 
Dealt to d7d93175 
6acbb0ae: folds
89baf59b: raises $0.13 to $0.23
d7d93175: folds
8e3f904d: folds
58d73444: folds
Hero: folds
Uncalled bet ($0.13) returned to 89baf59b
*** SHOWDOWN ***
89baf59b collected $0.25 from pot
*** SUMMARY ***
Total pot $0.25 | Rake $0 | Jackpot $0 | Bingo $0 | Fortune $0
Seat 1: 8e3f904d (button) folded before Flop (didn't bet)
Seat 2: 58d73444 (small blind) folded before Flop
Seat 3: Hero (big blind) folded before Flop
Seat 4: 6acbb0ae folded before Flop (didn't bet)
Seat 5: 89baf59b collected ($0.25)
Seat 6: d7d93175 folded before Flop (didn't bet)


Poker Hand #RC1456617711: Hold'em No Limit  ($0.05/$0.1) - 2023/04/07 11:09:24
Table 'RushAndCash3072971' 6-max Seat #1 is the button
Seat 1: Hero ($9.5 in chips)
Seat 2: 3ed1e167 ($10.05 in chips)
Seat 3: 551cfce ($10 in chips)
Seat 4: 40609dda ($10 in chips)
Seat 5: 1598de61 ($19.4 in chips)
Seat 6: 1daea4eb ($12.24 in chips)
3ed1e167: posts small blind $0.05
551cfce: posts big blind $0.1
*** HOLE CARDS ***
Dealt to Hero [7c 2d]
Dealt to 3ed1e167 
Dealt to 551cfce 
Dealt to 40609dda 
Dealt to 1598de61 
Dealt to 1daea4eb 
40609dda: folds
1598de61: folds
1daea4eb: folds
Hero: folds
3ed1e167: raises $0.2 to $0.3
551cfce: raises $0.48 to $0.78
3ed1e167: calls $0.48
*** FLOP *** [5d 5c Th]
3ed1e167: checks
551cfce: bets $0.39
3ed1e167: calls $0.39
*** TURN *** [5d 5c Th] [Js]
3ed1e167: checks
551cfce: checks
*** RIVER *** [5d 5c Th Js] [7h]
3ed1e167: checks
551cfce: checks
3ed1e167: shows [6c 6s] (Pair of Sixes and Pair of Fives)
551cfce: shows [Ad 7d] (Pair of Sevens and Pair of Fives)
*** SHOWDOWN ***
551cfce collected $2.23 from pot
*** SUMMARY ***
Total pot $2.34 | Rake $0.11 | Jackpot $0 | Bingo $0 | Fortune $0
Board [5d 5c Th Js 7h]
Seat 1: Hero (button) folded before Flop (didn't bet)
Seat 2: 3ed1e167 (small blind) showed [6c 6s] and lost with Pair of Sixes and Pair of Fives
Seat 3: 551cfce (big blind) showed [Ad 7d] and won ($2.23) with Pair of Sevens and Pair of Fives
Seat 4: 40609dda folded before Flop (didn't bet)
Seat 5: 1598de61 folded before Flop (didn't bet)
Seat 6: 1daea4eb folded before Flop (didn't bet)


Poker Hand #RC1456617681: Hold'em No Limit  ($0.05/$0.1) - 2023/04/07 11:09:19
Table 'RushAndCash3072941' 6-max Seat #1 is the button
Seat 1: d17986b9 ($12.1 in chips)
Seat 2: ce783e5 ($9.9 in chips)
Seat 3: a5fa6241 ($3.02 in chips)
Seat 4: Hero ($9.5 in chips)
Seat 5: c036e9a1 ($10.02 in chips)
Seat 6: 55e0d2e6 ($4.74 in chips)
ce783e5: posts small blind $0.05
a5fa6241: posts big blind $0.1
*** HOLE CARDS ***
Dealt to d17986b9 
Dealt to ce783e5 
Dealt to a5fa6241 
Dealt to Hero [4d 6d]
Dealt to c036e9a1 
Dealt to 55e0d2e6 
Hero: folds
c036e9a1: folds
55e0d2e6: raises $0.1 to $0.2
d17986b9: raises $0.42 to $0.62
ce783e5: folds
a5fa6241: folds
55e0d2e6: raises $4.12 to $4.74 and is all-in
d17986b9: calls $4.12
55e0d2e6: shows [Js Ac]
d17986b9: shows [Ad Kc]
*** FLOP *** [2d Kd 5d]
*** TURN *** [2d Kd 5d] [4h]
*** RIVER *** [2d Kd 5d 4h] [Tc]
*** SHOWDOWN ***
d17986b9 collected $9.18 from pot
*** SUMMARY ***
Total pot $9.63 | Rake $0.3 | Jackpot $0.15 | Bingo $0 | Fortune $0
Board [2d Kd 5d 4h Tc]
Seat 1: d17986b9 (button) showed [Ad Kc] and won ($9.18) with Pair of Kings
Seat 2: ce783e5 (small blind) folded before Flop
Seat 3: a5fa6241 (big blind) folded before Flop
Seat 4: Hero folded before Flop (didn't bet)
Seat 5: c036e9a1 folded before Flop (didn't bet)
Seat 6: 55e0d2e6 showed [Js Ac] and lost with Ace-High


Poker Hand #RC1456617639: Hold'em No Limit  ($0.05/$0.1) - 2023/04/07 11:09:13
Table 'RushAndCash3072899' 6-max Seat #1 is the button
Seat 1: f8dcfabf ($11.72 in chips)
Seat 2: e6e4854a ($14.94 in chips)
Seat 3: 82849675 ($12.16 in chips)
Seat 4: 49d6d1f1 ($10.76 in chips)
Seat 5: b753fde4 ($10.1 in chips)
Seat 6: Hero ($9.5 in chips)
e6e4854a: posts small blind $0.05
82849675: posts big blind $0.1
*** HOLE CARDS ***
Dealt to f8dcfabf 
Dealt to e6e4854a 
Dealt to 82849675 
Dealt to 49d6d1f1 
Dealt to b753fde4 
Dealt to Hero [7s 9s]
49d6d1f1: folds
b753fde4: folds
Hero: folds
f8dcfabf: folds
e6e4854a: raises $0.2 to $0.3
82849675: folds
Uncalled bet ($0.2) returned to e6e4854a
*** SHOWDOWN ***
e6e4854a collected $0.2 from pot
*** SUMMARY ***
Total pot $0.2 | Rake $0 | Jackpot $0 | Bingo $0 | Fortune $0
Seat 1: f8dcfabf (button) folded before Flop (didn't bet)
Seat 2: e6e4854a (small blind) collected ($0.2)
Seat 3: 82849675 (big blind) folded before Flop
Seat 4: 49d6d1f1 folded before Flop (didn't bet)
Seat 5: b753fde4 folded before Flop (didn't bet)
Seat 6: Hero folded before Flop (didn't bet)


Poker Hand #RC1456617604: Hold'em No Limit  ($0.05/$0.1) - 2023/04/07 11:09:07
Table 'RushAndCash3072864' 6-max Seat #1 is the button
Seat 1: 33244062 ($15.33 in chips)
Seat 2: 85659f66 ($11.53 in chips)
Seat 3: 38dde3e4 ($9.4 in chips)
Seat 4: 82849675 ($12.16 in chips)
Seat 5: Hero ($9.5 in chips)
Seat 6: 6acbb0ae ($10.1 in chips)
85659f66: posts small blind $0.05
38dde3e4: posts big blind $0.1
*** HOLE CARDS ***
Dealt to 33244062 
Dealt to 85659f66 
Dealt to 38dde3e4 
Dealt to 82849675 
Dealt to Hero [Ks 3d]
Dealt to 6acbb0ae 
82849675: folds
Hero: folds
6acbb0ae: folds
33244062: folds
85659f66: raises $0.16 to $0.26
38dde3e4: folds
Uncalled bet ($0.16) returned to 85659f66
*** SHOWDOWN ***
85659f66 collected $0.2 from pot
*** SUMMARY ***
Total pot $0.2 | Rake $0 | Jackpot $0 | Bingo $0 | Fortune $0
Seat 1: 33244062 (button) folded before Flop (didn't bet)
Seat 2: 85659f66 (small blind) collected ($0.2)
Seat 3: 38dde3e4 (big blind) folded before Flop
Seat 4: 82849675 folded before Flop (didn't bet)
Seat 5: Hero folded before Flop (didn't bet)
Seat 6: 6acbb0ae folded before Flop (didn't bet)


Poker Hand #RC1456617533: Hold'em No Limit  ($0.05/$0.1) - 2023/04/07 11:08:55
Table 'RushAndCash3072793' 6-max Seat #1 is the button
Seat 1: Hero ($9.5 in chips)
Seat 2: 3f77e795 ($10.18 in chips)
Seat 3: f2008b23 ($21 in chips)
Seat 4: 28d6b5ec ($10.28 in chips)
Seat 5: e56c871f ($22.83 in chips)
Seat 6: 3ed1e167 ($10 in chips)
3f77e795: posts small blind $0.05
f2008b23: posts big blind $0.1
*** HOLE CARDS ***
Dealt to Hero [Kh 5d]
Dealt to 3f77e795 
Dealt to f2008b23 
Dealt to 28d6b5ec 
Dealt to e56c871f 
Dealt to 3ed1e167 
28d6b5ec: folds
e56c871f: folds
3ed1e167: raises $0.15 to $0.25
Hero: folds
3f77e795: folds
f2008b23: folds
Uncalled bet ($0.15) returned to 3ed1e167
*** SHOWDOWN ***
3ed1e167 collected $0.25 from pot
*** SUMMARY ***
Total pot $0.25 | Rake $0 | Jackpot $0 | Bingo $0 | Fortune $0
Seat 1: Hero (button) folded before Flop (didn't bet)
Seat 2: 3f77e795 (small blind) folded before Flop
Seat 3: f2008b23 (big blind) folded before Flop
Seat 4: 28d6b5ec folded before Flop (didn't bet)
Seat 5: e56c871f folded before Flop (didn't bet)
Seat 6: 3ed1e167 collected ($0.25)


Poker Hand #RC1456617470: Hold'em No Limit  ($0.05/$0.1) - 2023/04/07 11:08:43
Table 'RushAndCash3072730' 6-max Seat #1 is the button
Seat 1: c1b510d9 ($71.35 in chips)
Seat 2: Hero ($9.55 in chips)
Seat 3: be87951c ($12.97 in chips)
Seat 4: 9e18683b ($8.42 in chips)
Seat 5: f0ea8035 ($10.43 in chips)
Seat 6: 714be4e ($10.23 in chips)
Hero: posts small blind $0.05
be87951c: posts big blind $0.1
*** HOLE CARDS ***
Dealt to c1b510d9 
Dealt to Hero [3d As]
Dealt to be87951c 
Dealt to 9e18683b 
Dealt to f0ea8035 
Dealt to 714be4e 
9e18683b: raises $0.15 to $0.25
f0ea8035: folds
714be4e: folds
c1b510d9: calls $0.25
Hero: folds
be87951c: folds
*** FLOP *** [Qc 2c 2d]
9e18683b: checks
c1b510d9: bets $0.2
9e18683b: folds
Uncalled bet ($0.2) returned to c1b510d9
*** SHOWDOWN ***
c1b510d9 collected $0.62 from pot
*** SUMMARY ***
Total pot $0.65 | Rake $0.03 | Jackpot $0 | Bingo $0 | Fortune $0
Board [Qc 2c 2d]
Seat 1: c1b510d9 (button) won ($0.62)
Seat 2: Hero (small blind) folded before Flop
Seat 3: be87951c (big blind) folded before Flop
Seat 4: 9e18683b folded on the Flop
Seat 5: f0ea8035 folded before Flop (didn't bet)
Seat 6: 714be4e folded before Flop (didn't bet)


Poker Hand #RC1456617441: Hold'em No Limit  ($0.05/$0.1) - 2023/04/07 11:08:37
Table 'RushAndCash3072701' 6-max Seat #1 is the button
Seat 1: 493e703e ($10.55 in chips)
Seat 2: 8df60157 ($9.62 in chips)
Seat 3: Hero ($9.65 in chips)
Seat 4: 2e5aac5e ($7.65 in chips)
Seat 5: 67fe6f9 ($30.73 in chips)
Seat 6: 65b07678 ($13.5 in chips)
8df60157: posts small blind $0.05
Hero: posts big blind $0.1
*** HOLE CARDS ***
Dealt to 493e703e 
Dealt to 8df60157 
Dealt to Hero [Tc 4c]
Dealt to 2e5aac5e 
Dealt to 67fe6f9 
Dealt to 65b07678 
2e5aac5e: folds
67fe6f9: folds
65b07678: folds
493e703e: raises $0.13 to $0.23
8df60157: folds
Hero: folds
Uncalled bet ($0.13) returned to 493e703e
*** SHOWDOWN ***
493e703e collected $0.25 from pot
*** SUMMARY ***
Total pot $0.25 | Rake $0 | Jackpot $0 | Bingo $0 | Fortune $0
Seat 1: 493e703e (button) collected ($0.25)
Seat 2: 8df60157 (small blind) folded before Flop
Seat 3: Hero (big blind) folded before Flop
Seat 4: 2e5aac5e folded before Flop (didn't bet)
Seat 5: 67fe6f9 folded before Flop (didn't bet)
Seat 6: 65b07678 folded before Flop (didn't bet)


Poker Hand #RC1456617393: Hold'em No Limit  ($0.05/$0.1) - 2023/04/07 11:08:29
Table 'RushAndCash3072653' 6-max Seat #1 is the button
Seat 1: 7438d908 ($10 in chips)
Seat 2: 79c261ef ($8.18 in chips)
Seat 3: bf6f1943 ($12.75 in chips)
Seat 4: 180913a1 ($13.03 in chips)
Seat 5: 2e5aac5e ($7.65 in chips)
Seat 6: Hero ($9.65 in chips)
79c261ef: posts small blind $0.05
bf6f1943: posts big blind $0.1
*** HOLE CARDS ***
Dealt to 7438d908 
Dealt to 79c261ef 
Dealt to bf6f1943 
Dealt to 180913a1 
Dealt to 2e5aac5e 
Dealt to Hero [3h 6c]
180913a1: folds
2e5aac5e: folds
Hero: folds
7438d908: folds
79c261ef: raises $0.2 to $0.3
bf6f1943: calls $0.2
*** FLOP *** [Td Js 4c]
79c261ef: checks
bf6f1943: bets $0.24
79c261ef: folds
Uncalled bet ($0.24) returned to bf6f1943
*** SHOWDOWN ***
bf6f1943 collected $0.57 from pot
*** SUMMARY ***
Total pot $0.6 | Rake $0.03 | Jackpot $0 | Bingo $0 | Fortune $0
Board [Td Js 4c]
Seat 1: 7438d908 (button) folded before Flop (didn't bet)
Seat 2: 79c261ef (small blind) folded on the Flop
Seat 3: bf6f1943 (big blind) won ($0.57)
Seat 4: 180913a1 folded before Flop (didn't bet)
Seat 5: 2e5aac5e folded before Flop (didn't bet)
Seat 6: Hero folded before Flop (didn't bet)


Poker Hand #RC1456617355: Hold'em No Limit  ($0.05/$0.1) - 2023/04/07 11:08:21
Table 'RushAndCash3072615' 6-max Seat #1 is the button
Seat 1: 291e41f6 ($8.68 in chips)
Seat 2: 6ae156c6 ($16.81 in chips)
Seat 3: db09426a ($11.56 in chips)
Seat 4: 4e9d25bb ($10 in chips)
Seat 5: Hero ($9.65 in chips)
Seat 6: 65f22aee ($24.63 in chips)
6ae156c6: posts small blind $0.05
db09426a: posts big blind $0.1
*** HOLE CARDS ***
Dealt to 291e41f6 
Dealt to 6ae156c6 
Dealt to db09426a 
Dealt to 4e9d25bb 
Dealt to Hero [Kh 2s]
Dealt to 65f22aee 
4e9d25bb: folds
Hero: folds
65f22aee: folds
291e41f6: raises $0.1 to $0.2
6ae156c6: folds
db09426a: raises $0.75 to $0.95
291e41f6: folds
Uncalled bet ($0.75) returned to db09426a
*** SHOWDOWN ***
db09426a collected $0.43 from pot
*** SUMMARY ***
Total pot $0.45 | Rake $0.02 | Jackpot $0 | Bingo $0 | Fortune $0
Seat 1: 291e41f6 (button) folded before Flop
Seat 2: 6ae156c6 (small blind) folded before Flop
Seat 3: db09426a (big blind) collected ($0.43)
Seat 4: 4e9d25bb folded before Flop (didn't bet)
Seat 5: Hero folded before Flop (didn't bet)
Seat 6: 65f22aee folded before Flop (didn't bet)


Poker Hand #RC1456617322: Hold'em No Limit  ($0.05/$0.1) - 2023/04/07 11:08:16
Table 'RushAndCash3072582' 6-max Seat #1 is the button
Seat 1: bf65876e ($26.15 in chips)
Seat 2: 1dcb37c ($22.76 in chips)
Seat 3: cb8d16b1 ($5.79 in chips)
Seat 4: 960e6af4 ($9.85 in chips)
Seat 5: 9e18683b ($8.1 in chips)
Seat 6: Hero ($9.65 in chips)
1dcb37c: posts small blind $0.05
cb8d16b1: posts big blind $0.1
*** HOLE CARDS ***
Dealt to bf65876e 
Dealt to 1dcb37c 
Dealt to cb8d16b1 
Dealt to 960e6af4 
Dealt to 9e18683b 
Dealt to Hero [6d Qs]
960e6af4: folds
9e18683b: folds
Hero: folds
bf65876e: folds
1dcb37c: raises $0.2 to $0.3
cb8d16b1: folds
Uncalled bet ($0.2) returned to 1dcb37c
*** SHOWDOWN ***
1dcb37c collected $0.2 from pot
*** SUMMARY ***
Total pot $0.2 | Rake $0 | Jackpot $0 | Bingo $0 | Fortune $0
Seat 1: bf65876e (button) folded before Flop (didn't bet)
Seat 2: 1dcb37c (small blind) collected ($0.2)
Seat 3: cb8d16b1 (big blind) folded before Flop
Seat 4: 960e6af4 folded before Flop (didn't bet)
Seat 5: 9e18683b folded before Flop (didn't bet)
Seat 6: Hero folded before Flop (didn't bet)


Poker Hand #RC1456617240: Hold'em No Limit  ($0.05/$0.1) - 2023/04/07 11:08:03
Table 'RushAndCash3072500' 6-max Seat #1 is the button
Seat 1: e54f3083 ($22.46 in chips)
Seat 2: 1ac360f2 ($4.2 in chips)
Seat 3: 818c8f11 ($10.15 in chips)
Seat 4: b19e7719 ($10.13 in chips)
Seat 5: Hero ($9.5 in chips)
Seat 6: d8efb2d7 ($8.24 in chips)
1ac360f2: posts small blind $0.05
818c8f11: posts big blind $0.1
*** HOLE CARDS ***
Dealt to e54f3083 
Dealt to 1ac360f2 
Dealt to 818c8f11 
Dealt to b19e7719 
Dealt to Hero [Ks Js]
Dealt to d8efb2d7 
b19e7719: folds
Hero: raises $0.15 to $0.25
d8efb2d7: folds
e54f3083: folds
1ac360f2: folds
818c8f11: folds
Uncalled bet ($0.15) returned to Hero
*** SHOWDOWN ***
Hero collected $0.25 from pot
*** SUMMARY ***
Total pot $0.25 | Rake $0 | Jackpot $0 | Bingo $0 | Fortune $0
Seat 1: e54f3083 (button) folded before Flop (didn't bet)
Seat 2: 1ac360f2 (small blind) folded before Flop
Seat 3: 818c8f11 (big blind) folded before Flop
Seat 4: b19e7719 folded before Flop (didn't bet)
Seat 5: Hero collected ($0.25)
Seat 6: d8efb2d7 folded before Flop (didn't bet)


Poker Hand #RC1456617176: Hold'em No Limit  ($0.05/$0.1) - 2023/04/07 11:07:52
Table 'RushAndCash3072436' 6-max Seat #1 is the button
Seat 1: 7f6dcfc1 ($11.44 in chips)
Seat 2: Hero ($9.55 in chips)
Seat 3: a6f27b25 ($11.75 in chips)
Seat 4: c1b510d9 ($71.7 in chips)
Seat 5: e6e4854a ($14.87 in chips)
Seat 6: a355cc6f ($10.37 in chips)
Hero: posts small blind $0.05
a6f27b25: posts big blind $0.1
*** HOLE CARDS ***
Dealt to 7f6dcfc1 
Dealt to Hero [4d 8h]
Dealt to a6f27b25 
Dealt to c1b510d9 
Dealt to e6e4854a 
Dealt to a355cc6f 
c1b510d9: folds
e6e4854a: folds
a355cc6f: folds
7f6dcfc1: folds
Hero: folds
Uncalled bet ($0.05) returned to a6f27b25
*** SHOWDOWN ***
a6f27b25 collected $0.1 from pot
*** SUMMARY ***
Total pot $0.1 | Rake $0 | Jackpot $0 | Bingo $0 | Fortune $0
Seat 1: 7f6dcfc1 (button) folded before Flop (didn't bet)
Seat 2: Hero (small blind) folded before Flop
Seat 3: a6f27b25 (big blind) collected ($0.1)
Seat 4: c1b510d9 folded before Flop (didn't bet)
Seat 5: e6e4854a folded before Flop (didn't bet)
Seat 6: a355cc6f folded before Flop (didn't bet)


Poker Hand #RC1456617107: Hold'em No Limit  ($0.05/$0.1) - 2023/04/07 11:07:40
Table 'RushAndCash3072367' 6-max Seat #1 is the button
Seat 1: 12b746ee ($7.45 in chips)
Seat 2: 10f1f8b7 ($12.72 in chips)
Seat 3: Hero ($9.65 in chips)
Seat 4: d079ab29 ($11.86 in chips)
Seat 5: f583a6e3 ($13.73 in chips)
Seat 6: ec145aa8 ($9.27 in chips)
10f1f8b7: posts small blind $0.05
Hero: posts big blind $0.1
*** HOLE CARDS ***
Dealt to 12b746ee 
Dealt to 10f1f8b7 
Dealt to Hero [4c 2h]
Dealt to d079ab29 
Dealt to f583a6e3 
Dealt to ec145aa8 
d079ab29: folds
f583a6e3: folds
ec145aa8: folds
12b746ee: folds
10f1f8b7: raises $0.2 to $0.3
Hero: folds
Uncalled bet ($0.2) returned to 10f1f8b7
*** SHOWDOWN ***
10f1f8b7 collected $0.2 from pot
*** SUMMARY ***
Total pot $0.2 | Rake $0 | Jackpot $0 | Bingo $0 | Fortune $0
Seat 1: 12b746ee (button) folded before Flop (didn't bet)
Seat 2: 10f1f8b7 (small blind) collected ($0.2)
Seat 3: Hero (big blind) folded before Flop
Seat 4: d079ab29 folded before Flop (didn't bet)
Seat 5: f583a6e3 folded before Flop (didn't bet)
Seat 6: ec145aa8 folded before Flop (didn't bet)


Poker Hand #RC1456617078: Hold'em No Limit  ($0.05/$0.1) - 2023/04/07 11:07:36
Table 'RushAndCash3072338' 6-max Seat #1 is the button
Seat 1: Hero ($9.65 in chips)
Seat 2: 5ff232e6 ($10.3 in chips)
Seat 3: e6e85371 ($15.55 in chips)
Seat 4: 1ecdc8a8 ($10.23 in chips)
Seat 5: e81af2f2 ($10.23 in chips)
Seat 6: eeb55cdc ($11.1 in chips)
5ff232e6: posts small blind $0.05
e6e85371: posts big blind $0.1
*** HOLE CARDS ***
Dealt to Hero [2s Qc]
Dealt to 5ff232e6 
Dealt to e6e85371 
Dealt to 1ecdc8a8 
Dealt to e81af2f2 
Dealt to eeb55cdc 
1ecdc8a8: raises $0.1 to $0.2
e81af2f2: folds
eeb55cdc: folds
Hero: folds
5ff232e6: calls $0.15
e6e85371: folds
*** FLOP *** [3h 9c Ks]
5ff232e6: checks
1ecdc8a8: bets $0.17
5ff232e6: folds
Uncalled bet ($0.17) returned to 1ecdc8a8
*** SHOWDOWN ***
1ecdc8a8 collected $0.48 from pot
*** SUMMARY ***
Total pot $0.5 | Rake $0.02 | Jackpot $0 | Bingo $0 | Fortune $0
Board [3h 9c Ks]
Seat 1: Hero (button) folded before Flop (didn't bet)
Seat 2: 5ff232e6 (small blind) folded on the Flop
Seat 3: e6e85371 (big blind) folded before Flop
Seat 4: 1ecdc8a8 won ($0.48)
Seat 5: e81af2f2 folded before Flop (didn't bet)
Seat 6: eeb55cdc folded before Flop (didn't bet)


Poker Hand #RC1456616982: Hold'em No Limit  ($0.05/$0.1) - 2023/04/07 11:07:21
Table 'RushAndCash3072242' 6-max Seat #1 is the button
Seat 1: dda6ec44 ($8.91 in chips)
Seat 2: 27aebce3 ($6.79 in chips)
Seat 3: bac23024 ($11.96 in chips)
Seat 4: 2b71d61e ($17.72 in chips)
Seat 5: 86e14b08 ($11.82 in chips)
Seat 6: Hero ($9.5 in chips)
27aebce3: posts small blind $0.05
bac23024: posts big blind $0.1
*** HOLE CARDS ***
Dealt to dda6ec44 
Dealt to 27aebce3 
Dealt to bac23024 
Dealt to 2b71d61e 
Dealt to 86e14b08 
Dealt to Hero [Kh Qc]
2b71d61e: folds
86e14b08: folds
Hero: raises $0.15 to $0.25
dda6ec44: folds
27aebce3: folds
bac23024: folds
Uncalled bet ($0.15) returned to Hero
*** SHOWDOWN ***
Hero collected $0.25 from pot
*** SUMMARY ***
Total pot $0.25 | Rake $0 | Jackpot $0 | Bingo $0 | Fortune $0
Seat 1: dda6ec44 (button) folded before Flop (didn't bet)
Seat 2: 27aebce3 (small blind) folded before Flop
Seat 3: bac23024 (big blind) folded before Flop
Seat 4: 2b71d61e folded before Flop (didn't bet)
Seat 5: 86e14b08 folded before Flop (didn't bet)
Seat 6: Hero collected ($0.25)


Poker Hand #RC1456616923: Hold'em No Limit  ($0.05/$0.1) - 2023/04/07 11:07:11
Table 'RushAndCash3072183' 6-max Seat #1 is the button
Seat 1: 44ede168 ($9.22 in chips)
Seat 2: 9a5dcd03 ($16.41 in chips)
Seat 3: 58d73444 ($18.85 in chips)
Seat 4: 28b75ee6 ($13.22 in chips)
Seat 5: f56d4f3a ($6.87 in chips)
Seat 6: Hero ($9.35 in chips)
9a5dcd03: posts small blind $0.05
58d73444: posts big blind $0.1
*** HOLE CARDS ***
Dealt to 44ede168 
Dealt to 9a5dcd03 
Dealt to 58d73444 
Dealt to 28b75ee6 
Dealt to f56d4f3a 
Dealt to Hero [Ad Qd]
28b75ee6: folds
f56d4f3a: folds
Hero: raises $0.15 to $0.25
44ede168: folds
9a5dcd03: folds
58d73444: folds
Uncalled bet ($0.15) returned to Hero
*** SHOWDOWN ***
Hero collected $0.25 from pot
*** SUMMARY ***
Total pot $0.25 | Rake $0 | Jackpot $0 | Bingo $0 | Fortune $0
Seat 1: 44ede168 (button) folded before Flop (didn't bet)
Seat 2: 9a5dcd03 (small blind) folded before Flop
Seat 3: 58d73444 (big blind) folded before Flop
Seat 4: 28b75ee6 folded before Flop (didn't bet)
Seat 5: f56d4f3a folded before Flop (didn't bet)
Seat 6: Hero collected ($0.25)


Poker Hand #RC1456616862: Hold'em No Limit  ($0.05/$0.1) - 2023/04/07 11:07:01
Table 'RushAndCash3072122' 6-max Seat #1 is the button
Seat 1: Hero ($9.35 in chips)
Seat 2: 33ead1fe ($20.34 in chips)
Seat 3: 22090ba9 ($12.13 in chips)
Seat 4: ac4e0c1 ($10.22 in chips)
Seat 5: 161c0a0f ($15.11 in chips)
Seat 6: ad40d5c1 ($19.28 in chips)
33ead1fe: posts small blind $0.05
22090ba9: posts big blind $0.1
*** HOLE CARDS ***
Dealt to Hero [Qs 5c]
Dealt to 33ead1fe 
Dealt to 22090ba9 
Dealt to ac4e0c1 
Dealt to 161c0a0f 
Dealt to ad40d5c1 
ac4e0c1: raises $0.2 to $0.3
161c0a0f: raises $0.2 to $0.5
ad40d5c1: folds
Hero: folds
33ead1fe: folds
22090ba9: folds
ac4e0c1: calls $0.2
*** FLOP *** [5h 8c 9h]
ac4e0c1: checks
161c0a0f: bets $2.7
ac4e0c1: folds
Uncalled bet ($2.7) returned to 161c0a0f
*** SHOWDOWN ***
161c0a0f collected $1.1 from pot
*** SUMMARY ***
Total pot $1.15 | Rake $0.05 | Jackpot $0 | Bingo $0 | Fortune $0
Board [5h 8c 9h]
Seat 1: Hero (button) folded before Flop (didn't bet)
Seat 2: 33ead1fe (small blind) folded before Flop
Seat 3: 22090ba9 (big blind) folded before Flop
Seat 4: ac4e0c1 folded on the Flop
Seat 5: 161c0a0f won ($1.1)
Seat 6: ad40d5c1 folded before Flop (didn't bet)


Poker Hand #RC1456616834: Hold'em No Limit  ($0.05/$0.1) - 2023/04/07 11:06:57
Table 'RushAndCash3072094' 6-max Seat #1 is the button
Seat 1: 775bb54b ($11.39 in chips)
Seat 2: Hero ($9.25 in chips)
Seat 3: 12b746ee ($7.62 in chips)
Seat 4: 7ce91baf ($11.72 in chips)
Seat 5: a8cbccf5 ($10.3 in chips)
Seat 6: 9f34ebd5 ($15.69 in chips)
Hero: posts small blind $0.05
12b746ee: posts big blind $0.1
*** HOLE CARDS ***
Dealt to 775bb54b 
Dealt to Hero [8d 3h]
Dealt to 12b746ee 
Dealt to 7ce91baf 
Dealt to a8cbccf5 
Dealt to 9f34ebd5 
7ce91baf: folds
a8cbccf5: folds
9f34ebd5: folds
775bb54b: folds
Hero: folds
Uncalled bet ($0.05) returned to 12b746ee
*** SHOWDOWN ***
12b746ee collected $0.1 from pot
*** SUMMARY ***
Total pot $0.1 | Rake $0 | Jackpot $0 | Bingo $0 | Fortune $0
Seat 1: 775bb54b (button) folded before Flop (didn't bet)
Seat 2: Hero (small blind) folded before Flop
Seat 3: 12b746ee (big blind) collected ($0.1)
Seat 4: 7ce91baf folded before Flop (didn't bet)
Seat 5: a8cbccf5 folded before Flop (didn't bet)
Seat 6: 9f34ebd5 folded before Flop (didn't bet)


Poker Hand #RC1456616804: Hold'em No Limit  ($0.05/$0.1) - 2023/04/07 11:06:53
Table 'RushAndCash3072064' 6-max Seat #1 is the button
Seat 1: a6f27b25 ($11.75 in chips)
Seat 2: 91e3b5dc ($14.85 in chips)
Seat 3: Hero ($9.35 in chips)
Seat 4: 95442f06 ($15.75 in chips)
Seat 5: 958abe9a ($10.15 in chips)
Seat 6: 67fe6f9 ($31 in chips)
91e3b5dc: posts small blind $0.05
Hero: posts big blind $0.1
*** HOLE CARDS ***
Dealt to a6f27b25 
Dealt to 91e3b5dc 
Dealt to Hero [9h 4h]
Dealt to 95442f06 
Dealt to 958abe9a 
Dealt to 67fe6f9 
95442f06: folds
958abe9a: folds
67fe6f9: folds
a6f27b25: folds
91e3b5dc: folds
Uncalled bet ($0.05) returned to Hero
*** SHOWDOWN ***
Hero collected $0.1 from pot
*** SUMMARY ***
Total pot $0.1 | Rake $0 | Jackpot $0 | Bingo $0 | Fortune $0
Seat 1: a6f27b25 (button) folded before Flop (didn't bet)
Seat 2: 91e3b5dc (small blind) folded before Flop
Seat 3: Hero (big blind) collected ($0.1)
Seat 4: 95442f06 folded before Flop (didn't bet)
Seat 5: 958abe9a folded before Flop (didn't bet)
Seat 6: 67fe6f9 folded before Flop (didn't bet)


Poker Hand #RC1456616776: Hold'em No Limit  ($0.05/$0.1) - 2023/04/07 11:06:48
Table 'RushAndCash3072036' 6-max Seat #1 is the button
Seat 1: 58bc4163 ($24.51 in chips)
Seat 2: 8ed73182 ($13.28 in chips)
Seat 3: 6ecc4900 ($13.98 in chips)
Seat 4: Hero ($9.35 in chips)
Seat 5: 493e703e ($10.96 in chips)
Seat 6: bf65876e ($26.9 in chips)
8ed73182: posts small blind $0.05
6ecc4900: posts big blind $0.1
*** HOLE CARDS ***
Dealt to 58bc4163 
Dealt to 8ed73182 
Dealt to 6ecc4900 
Dealt to Hero [Kc 3h]
Dealt to 493e703e 
Dealt to bf65876e 
Hero: folds
493e703e: folds
bf65876e: folds
58bc4163: raises $0.2 to $0.3
8ed73182: calls $0.25
6ecc4900: folds
*** FLOP *** [6h 8s Qd]
8ed73182: checks
58bc4163: bets $0.2
8ed73182: calls $0.2
*** TURN *** [6h 8s Qd] [3d]
8ed73182: checks
58bc4163: checks
*** RIVER *** [6h 8s Qd 3d] [8h]
8ed73182: checks
58bc4163: bets $0.7
8ed73182: calls $0.7
58bc4163: shows [Tc Qc] (Pair of Queens and Pair of Eights)
8ed73182: shows [9s 9h] (Pair of Nines and Pair of Eights)
*** SHOWDOWN ***
58bc4163 collected $2.38 from pot
*** SUMMARY ***
Total pot $2.5 | Rake $0.12 | Jackpot $0 | Bingo $0 | Fortune $0
Board [6h 8s Qd 3d 8h]
Seat 1: 58bc4163 (button) showed [Tc Qc] and won ($2.38) with Pair of Queens and Pair of Eights
Seat 2: 8ed73182 (small blind) showed [9s 9h] and lost with Pair of Nines and Pair of Eights
Seat 3: 6ecc4900 (big blind) folded before Flop
Seat 4: Hero folded before Flop (didn't bet)
Seat 5: 493e703e folded before Flop (didn't bet)
Seat 6: bf65876e folded before Flop (didn't bet)


Poker Hand #RC1456616751: Hold'em No Limit  ($0.05/$0.1) - 2023/04/07 11:06:44
Table 'RushAndCash3072011' 6-max Seat #1 is the button
Seat 1: 6e02d89c ($10 in chips)
Seat 2: 1c6ccedc ($10.46 in chips)
Seat 3: 8ab2ecff ($10.48 in chips)
Seat 4: Hero ($9.35 in chips)
Seat 5: e7c4d09f ($12.18 in chips)
Seat 6: b0bba503 ($11.17 in chips)
1c6ccedc: posts small blind $0.05
8ab2ecff: posts big blind $0.1
*** HOLE CARDS ***
Dealt to 6e02d89c 
Dealt to 1c6ccedc 
Dealt to 8ab2ecff 
Dealt to Hero [Ac 5d]
Dealt to e7c4d09f 
Dealt to b0bba503 
Hero: folds
e7c4d09f: folds
b0bba503: folds
6e02d89c: folds
1c6ccedc: raises $0.25 to $0.35
8ab2ecff: folds
Uncalled bet ($0.25) returned to 1c6ccedc
*** SHOWDOWN ***
1c6ccedc collected $0.2 from pot
*** SUMMARY ***
Total pot $0.2 | Rake $0 | Jackpot $0 | Bingo $0 | Fortune $0
Seat 1: 6e02d89c (button) folded before Flop (didn't bet)
Seat 2: 1c6ccedc (small blind) collected ($0.2)
Seat 3: 8ab2ecff (big blind) folded before Flop
Seat 4: Hero folded before Flop (didn't bet)
Seat 5: e7c4d09f folded before Flop (didn't bet)
Seat 6: b0bba503 folded before Flop (didn't bet)


Poker Hand #RC1456616658: Hold'em No Limit  ($0.05/$0.1) - 2023/04/07 11:06:28
Table 'RushAndCash3071918' 6-max Seat #1 is the button
Seat 1: 358bee4c ($11.92 in chips)
Seat 2: 85ab0efa ($10.18 in chips)
Seat 3: f9b225c7 ($10.83 in chips)
Seat 4: 4fdad372 ($12.35 in chips)
Seat 5: 6fc0b2ab ($11.09 in chips)
Seat 6: Hero ($9.2 in chips)
85ab0efa: posts small blind $0.05
f9b225c7: posts big blind $0.1
*** HOLE CARDS ***
Dealt to 358bee4c 
Dealt to 85ab0efa 
Dealt to f9b225c7 
Dealt to 4fdad372 
Dealt to 6fc0b2ab 
Dealt to Hero [9s 9h]
4fdad372: folds
6fc0b2ab: folds
Hero: raises $0.15 to $0.25
358bee4c: folds
85ab0efa: folds
f9b225c7: folds
Uncalled bet ($0.15) returned to Hero
*** SHOWDOWN ***
Hero collected $0.25 from pot
*** SUMMARY ***
Total pot $0.25 | Rake $0 | Jackpot $0 | Bingo $0 | Fortune $0
Seat 1: 358bee4c (button) folded before Flop (didn't bet)
Seat 2: 85ab0efa (small blind) folded before Flop
Seat 3: f9b225c7 (big blind) folded before Flop
Seat 4: 4fdad372 folded before Flop (didn't bet)
Seat 5: 6fc0b2ab folded before Flop (didn't bet)
Seat 6: Hero collected ($0.25)


Poker Hand #RC1456616608: Hold'em No Limit  ($0.05/$0.1) - 2023/04/07 11:06:20
Table 'RushAndCash3071868' 6-max Seat #1 is the button
Seat 1: c31e8880 ($14.55 in chips)
Seat 2: Hero ($9.25 in chips)
Seat 3: b03e39fd ($10.09 in chips)
Seat 4: 2081246c ($10 in chips)
Seat 5: 7178d66f ($28.44 in chips)
Seat 6: 7719e9dd ($10.28 in chips)
Hero: posts small blind $0.05
b03e39fd: posts big blind $0.1
*** HOLE CARDS ***
Dealt to c31e8880 
Dealt to Hero [Tc 5c]
Dealt to b03e39fd 
Dealt to 2081246c 
Dealt to 7178d66f 
Dealt to 7719e9dd 
2081246c: folds
7178d66f: folds
7719e9dd: folds
c31e8880: folds
Hero: folds
Uncalled bet ($0.05) returned to b03e39fd
*** SHOWDOWN ***
b03e39fd collected $0.1 from pot
*** SUMMARY ***
Total pot $0.1 | Rake $0 | Jackpot $0 | Bingo $0 | Fortune $0
Seat 1: c31e8880 (button) folded before Flop (didn't bet)
Seat 2: Hero (small blind) folded before Flop
Seat 3: b03e39fd (big blind) collected ($0.1)
Seat 4: 2081246c folded before Flop (didn't bet)
Seat 5: 7178d66f folded before Flop (didn't bet)
Seat 6: 7719e9dd folded before Flop (didn't bet)


Poker Hand #RC1456616565: Hold'em No Limit  ($0.05/$0.1) - 2023/04/07 11:06:13
Table 'RushAndCash3071825' 6-max Seat #1 is the button
Seat 1: b6b2204f ($24.63 in chips)
Seat 2: 1ac360f2 ($3.9 in chips)
Seat 3: 89baf59b ($10.15 in chips)
Seat 4: Hero ($9.25 in chips)
Seat 5: 6031f161 ($13.29 in chips)
Seat 6: 1ce003d6 ($11.46 in chips)
1ac360f2: posts small blind $0.05
89baf59b: posts big blind $0.1
*** HOLE CARDS ***
Dealt to b6b2204f 
Dealt to 1ac360f2 
Dealt to 89baf59b 
Dealt to Hero [5c Jh]
Dealt to 6031f161 
Dealt to 1ce003d6 
Hero: folds
6031f161: folds
1ce003d6: folds
b6b2204f: folds
1ac360f2: folds
Uncalled bet ($0.05) returned to 89baf59b
*** SHOWDOWN ***
89baf59b collected $0.1 from pot
*** SUMMARY ***
Total pot $0.1 | Rake $0 | Jackpot $0 | Bingo $0 | Fortune $0
Seat 1: b6b2204f (button) folded before Flop (didn't bet)
Seat 2: 1ac360f2 (small blind) folded before Flop
Seat 3: 89baf59b (big blind) collected ($0.1)
Seat 4: Hero folded before Flop (didn't bet)
Seat 5: 6031f161 folded before Flop (didn't bet)
Seat 6: 1ce003d6 folded before Flop (didn't bet)


Poker Hand #RC1456616529: Hold'em No Limit  ($0.05/$0.1) - 2023/04/07 11:06:06
Table 'RushAndCash3071789' 6-max Seat #1 is the button
Seat 1: 391f89d3 ($11.47 in chips)
Seat 2: febdc50d ($13.08 in chips)
Seat 3: Hero ($9.35 in chips)
Seat 4: 7178d66f ($28.29 in chips)
Seat 5: 29376847 ($9.24 in chips)
Seat 6: 5b97ef9b ($21.51 in chips)
febdc50d: posts small blind $0.05
Hero: posts big blind $0.1
*** HOLE CARDS ***
Dealt to 391f89d3 
Dealt to febdc50d 
Dealt to Hero [3s Ad]
Dealt to 7178d66f 
Dealt to 29376847 
Dealt to 5b97ef9b 
7178d66f: raises $0.1 to $0.2
29376847: folds
5b97ef9b: folds
391f89d3: folds
febdc50d: folds
Hero: folds
Uncalled bet ($0.1) returned to 7178d66f
*** SHOWDOWN ***
7178d66f collected $0.25 from pot
*** SUMMARY ***
Total pot $0.25 | Rake $0 | Jackpot $0 | Bingo $0 | Fortune $0
Seat 1: 391f89d3 (button) folded before Flop (didn't bet)
Seat 2: febdc50d (small blind) folded before Flop
Seat 3: Hero (big blind) folded before Flop
Seat 4: 7178d66f collected ($0.25)
Seat 5: 29376847 folded before Flop (didn't bet)
Seat 6: 5b97ef9b folded before Flop (didn't bet)


Poker Hand #RC1456616498: Hold'em No Limit  ($0.05/$0.1) - 2023/04/07 11:06:01
Table 'RushAndCash3071758' 6-max Seat #1 is the button
Seat 1: Hero ($9.35 in chips)
Seat 2: 8fb0bf0e ($18.63 in chips)
Seat 3: 95442f06 ($16.19 in chips)
Seat 4: 91e3b5dc ($14.4 in chips)
Seat 5: 1905e80a ($10.76 in chips)
Seat 6: 8ed73182 ($13.38 in chips)
8fb0bf0e: posts small blind $0.05
95442f06: posts big blind $0.1
*** HOLE CARDS ***
Dealt to Hero [Qd 5s]
Dealt to 8fb0bf0e 
Dealt to 95442f06 
Dealt to 91e3b5dc 
Dealt to 1905e80a 
Dealt to 8ed73182 
91e3b5dc: raises $0.15 to $0.25
1905e80a: folds
8ed73182: folds
Hero: folds
8fb0bf0e: folds
95442f06: calls $0.15
*** FLOP *** [8s Ad 9h]
95442f06: checks
91e3b5dc: bets $0.19
95442f06: calls $0.19
*** TURN *** [8s Ad 9h] [7s]
95442f06: checks
91e3b5dc: checks
*** RIVER *** [8s Ad 9h 7s] [Ah]
95442f06: checks
91e3b5dc: checks
95442f06: shows [6h 7h] (Pair of Aces and Pair of Sevens)
91e3b5dc: shows [Qs Qc] (Pair of Aces and Pair of Queens)
*** SHOWDOWN ***
91e3b5dc collected $0.89 from pot
*** SUMMARY ***
Total pot $0.93 | Rake $0.04 | Jackpot $0 | Bingo $0 | Fortune $0
Board [8s Ad 9h 7s Ah]
Seat 1: Hero (button) folded before Flop (didn't bet)
Seat 2: 8fb0bf0e (small blind) folded before Flop
Seat 3: 95442f06 (big blind) showed [6h 7h] and lost with Pair of Aces and Pair of Sevens
Seat 4: 91e3b5dc showed [Qs Qc] and won ($0.89) with Pair of Aces and Pair of Queens
Seat 5: 1905e80a folded before Flop (didn't bet)
Seat 6: 8ed73182 folded before Flop (didn't bet)


Poker Hand #RC1456616469: Hold'em No Limit  ($0.05/$0.1) - 2023/04/07 11:05:56
Table 'RushAndCash3071729' 6-max Seat #1 is the button
Seat 1: 1dcb37c ($21.73 in chips)
Seat 2: f7ae6d9d ($10.32 in chips)
Seat 3: aa2d11d8 ($10 in chips)
Seat 4: Hero ($9.35 in chips)
Seat 5: 4fdad372 ($12.5 in chips)
Seat 6: bbe7e23e ($11.52 in chips)
f7ae6d9d: posts small blind $0.05
aa2d11d8: posts big blind $0.1
*** HOLE CARDS ***
Dealt to 1dcb37c 
Dealt to f7ae6d9d 
Dealt to aa2d11d8 
Dealt to Hero [Jc Ts]
Dealt to 4fdad372 
Dealt to bbe7e23e 
Hero: folds
4fdad372: folds
bbe7e23e: raises $0.15 to $0.25
1dcb37c: folds
f7ae6d9d: folds
aa2d11d8: folds
Uncalled bet ($0.15) returned to bbe7e23e
*** SHOWDOWN ***
bbe7e23e collected $0.25 from pot
*** SUMMARY ***
Total pot $0.25 | Rake $0 | Jackpot $0 | Bingo $0 | Fortune $0
Seat 1: 1dcb37c (button) folded before Flop (didn't bet)
Seat 2: f7ae6d9d (small blind) folded before Flop
Seat 3: aa2d11d8 (big blind) folded before Flop
Seat 4: Hero folded before Flop (didn't bet)
Seat 5: 4fdad372 folded before Flop (didn't bet)
Seat 6: bbe7e23e collected ($0.25)


Poker Hand #RC1456616335: Hold'em No Limit  ($0.05/$0.1) - 2023/04/07 11:05:33
Table 'RushAndCash3071595' 6-max Seat #1 is the button
Seat 1: 58d73444 ($19.23 in chips)
Seat 2: 1dcb37c ($21.41 in chips)
Seat 3: 2586712 ($10.62 in chips)
Seat 4: bb6436d6 ($11.68 in chips)
Seat 5: 749d3db3 ($20.29 in chips)
Seat 6: Hero ($9.6 in chips)
1dcb37c: posts small blind $0.05
2586712: posts big blind $0.1
*** HOLE CARDS ***
Dealt to 58d73444 
Dealt to 1dcb37c 
Dealt to 2586712 
Dealt to bb6436d6 
Dealt to 749d3db3 
Dealt to Hero [Kh 7h]
bb6436d6: folds
749d3db3: folds
Hero: raises $0.15 to $0.25
58d73444: folds
1dcb37c: raises $0.95 to $1.2
2586712: folds
Hero: folds
Uncalled bet ($0.95) returned to 1dcb37c
*** SHOWDOWN ***
1dcb37c collected $0.57 from pot
*** SUMMARY ***
Total pot $0.6 | Rake $0.03 | Jackpot $0 | Bingo $0 | Fortune $0
Seat 1: 58d73444 (button) folded before Flop (didn't bet)
Seat 2: 1dcb37c (small blind) collected ($0.57)
Seat 3: 2586712 (big blind) folded before Flop
Seat 4: bb6436d6 folded before Flop (didn't bet)
Seat 5: 749d3db3 folded before Flop (didn't bet)
Seat 6: Hero folded before Flop


Poker Hand #RC1456616300: Hold'em No Limit  ($0.05/$0.1) - 2023/04/07 11:05:28
Table 'RushAndCash3071560' 6-max Seat #1 is the button
Seat 1: 9f1dc264 ($10.15 in chips)
Seat 2: 22090ba9 ($11.96 in chips)
Seat 3: 76151276 ($12.97 in chips)
Seat 4: 2004b892 ($16.51 in chips)
Seat 5: Hero ($9.6 in chips)
Seat 6: 5ebc95db ($20.67 in chips)
22090ba9: posts small blind $0.05
76151276: posts big blind $0.1
*** HOLE CARDS ***
Dealt to 9f1dc264 
Dealt to 22090ba9 
Dealt to 76151276 
Dealt to 2004b892 
Dealt to Hero [9h 5d]
Dealt to 5ebc95db 
2004b892: folds
Hero: folds
5ebc95db: folds
9f1dc264: raises $0.13 to $0.23
22090ba9: folds
76151276: folds
Uncalled bet ($0.13) returned to 9f1dc264
*** SHOWDOWN ***
9f1dc264 collected $0.25 from pot
*** SUMMARY ***
Total pot $0.25 | Rake $0 | Jackpot $0 | Bingo $0 | Fortune $0
Seat 1: 9f1dc264 (button) collected ($0.25)
Seat 2: 22090ba9 (small blind) folded before Flop
Seat 3: 76151276 (big blind) folded before Flop
Seat 4: 2004b892 folded before Flop (didn't bet)
Seat 5: Hero folded before Flop (didn't bet)
Seat 6: 5ebc95db folded before Flop (didn't bet)


Poker Hand #RC1456616156: Hold'em No Limit  ($0.05/$0.1) - 2023/04/07 11:05:02
Table 'RushAndCash3071416' 6-max Seat #1 is the button
Seat 1: Hero ($9.85 in chips)
Seat 2: 5ebc95db ($20.35 in chips)
Seat 3: becc987e ($11.43 in chips)
Seat 4: bf6f1943 ($8.84 in chips)
Seat 5: d159fefc ($17.33 in chips)
Seat 6: 6ce1827e ($10.15 in chips)
5ebc95db: posts small blind $0.05
becc987e: posts big blind $0.1
*** HOLE CARDS ***
Dealt to Hero [7h Kc]
Dealt to 5ebc95db 
Dealt to becc987e 
Dealt to bf6f1943 
Dealt to d159fefc 
Dealt to 6ce1827e 
bf6f1943: folds
d159fefc: folds
6ce1827e: folds
Hero: raises $0.15 to $0.25
5ebc95db: raises $0.85 to $1.1
becc987e: folds
Hero: folds
Uncalled bet ($0.85) returned to 5ebc95db
*** SHOWDOWN ***
5ebc95db collected $0.57 from pot
*** SUMMARY ***
Total pot $0.6 | Rake $0.03 | Jackpot $0 | Bingo $0 | Fortune $0
Seat 1: Hero (button) folded before Flop
Seat 2: 5ebc95db (small blind) collected ($0.57)
Seat 3: becc987e (big blind) folded before Flop
Seat 4: bf6f1943 folded before Flop (didn't bet)
Seat 5: d159fefc folded before Flop (didn't bet)
Seat 6: 6ce1827e folded before Flop (didn't bet)


Poker Hand #RC1456616120: Hold'em No Limit  ($0.05/$0.1) - 2023/04/07 11:04:57
Table 'RushAndCash3071380' 6-max Seat #1 is the button
Seat 1: 67fe6f9 ($30.29 in chips)
Seat 2: Hero ($9.9 in chips)
Seat 3: 58bc4163 ($24.91 in chips)
Seat 4: e56c871f ($24.09 in chips)
Seat 5: 49bda4d6 ($35.79 in chips)
Seat 6: a6f27b25 ($11.5 in chips)
Hero: posts small blind $0.05
58bc4163: posts big blind $0.1
*** HOLE CARDS ***
Dealt to 67fe6f9 
Dealt to Hero [9h 7c]
Dealt to 58bc4163 
Dealt to e56c871f 
Dealt to 49bda4d6 
Dealt to a6f27b25 
e56c871f: folds
49bda4d6: folds
a6f27b25: raises $0.15 to $0.25
67fe6f9: folds
Hero: folds
58bc4163: folds
Uncalled bet ($0.15) returned to a6f27b25
*** SHOWDOWN ***
a6f27b25 collected $0.25 from pot
*** SUMMARY ***
Total pot $0.25 | Rake $0 | Jackpot $0 | Bingo $0 | Fortune $0
Seat 1: 67fe6f9 (button) folded before Flop (didn't bet)
Seat 2: Hero (small blind) folded before Flop
Seat 3: 58bc4163 (big blind) folded before Flop
Seat 4: e56c871f folded before Flop (didn't bet)
Seat 5: 49bda4d6 folded before Flop (didn't bet)
Seat 6: a6f27b25 collected ($0.25)


Poker Hand #RC1456616039: Hold'em No Limit  ($0.05/$0.1) - 2023/04/07 11:04:44
Table 'RushAndCash3071299' 6-max Seat #1 is the button
Seat 1: 9ffa7a49 ($10.1 in chips)
Seat 2: 4e18b945 ($21.98 in chips)
Seat 3: Hero ($10 in chips)
Seat 4: fe310807 ($7.74 in chips)
Seat 5: 36e1d3fb ($11.25 in chips)
Seat 6: 8723213f ($5.61 in chips)
4e18b945: posts small blind $0.05
Hero: posts big blind $0.1
*** HOLE CARDS ***
Dealt to 9ffa7a49 
Dealt to 4e18b945 
Dealt to Hero [7h Ks]
Dealt to fe310807 
Dealt to 36e1d3fb 
Dealt to 8723213f 
fe310807: folds
36e1d3fb: folds
8723213f: raises $0.3 to $0.4
9ffa7a49: folds
4e18b945: folds
Hero: folds
Uncalled bet ($0.3) returned to 8723213f
*** SHOWDOWN ***
8723213f collected $0.25 from pot
*** SUMMARY ***
Total pot $0.25 | Rake $0 | Jackpot $0 | Bingo $0 | Fortune $0
Seat 1: 9ffa7a49 (button) folded before Flop (didn't bet)
Seat 2: 4e18b945 (small blind) folded before Flop
Seat 3: Hero (big blind) folded before Flop
Seat 4: fe310807 folded before Flop (didn't bet)
Seat 5: 36e1d3fb folded before Flop (didn't bet)
Seat 6: 8723213f collected ($0.25)


