Poker Hand #RC1468524559: Hold'em No Limit  ($0.05/$0.1) - 2023/04/12 20:37:07
Table 'RushAndCash5649819' 6-max Seat #1 is the button
Seat 1: Hero ($15.15 in chips)
Seat 2: b19ec6d5 ($18.81 in chips)
Seat 3: 82ab461e ($11.15 in chips)
Seat 4: 58f27a02 ($14.19 in chips)
Seat 5: f9cc8093 ($12.05 in chips)
Seat 6: 397d1ccc ($12.94 in chips)
b19ec6d5: posts small blind $0.05
82ab461e: posts big blind $0.1
*** HOLE CARDS ***
Dealt to Hero [Qh Qc]
Dealt to b19ec6d5 
Dealt to 82ab461e 
Dealt to 58f27a02 
Dealt to f9cc8093 
Dealt to 397d1ccc 
58f27a02: folds
f9cc8093: raises $0.15 to $0.25
397d1ccc: folds
Hero: raises $0.54 to $0.79
b19ec6d5: folds
82ab461e: folds
f9cc8093: calls $0.54
*** FLOP *** [Jh 9c 2h]
f9cc8093: checks
Hero: bets $0.87
f9cc8093: calls $0.87
*** TURN *** [Jh 9c 2h] [Td]
f9cc8093: checks
Hero: bets $1.15
f9cc8093: raises $2.89 to $4.04
Hero: folds
Uncalled bet ($2.89) returned to f9cc8093
*** SHOWDOWN ***
f9cc8093 collected $5.34 from pot
*** SUMMARY ***
Total pot $5.77 | Rake $0.28 | Jackpot $0.15 | Bingo $0 | Fortune $0
Board [Jh 9c 2h Td]
Seat 1: Hero (button) folded on the Turn
Seat 2: b19ec6d5 (small blind) folded before Flop
Seat 3: 82ab461e (big blind) folded before Flop
Seat 4: 58f27a02 folded before Flop (didn't bet)
Seat 5: f9cc8093 won ($5.34)
Seat 6: 397d1ccc folded before Flop (didn't bet)


Poker Hand #RC1468524473: Hold'em No Limit  ($0.05/$0.1) - 2023/04/12 20:36:54
Table 'RushAndCash5649733' 6-max Seat #1 is the button
Seat 1: 9f97f6b4 ($10 in chips)
Seat 2: eea08caf ($15.82 in chips)
Seat 3: 648925e5 ($14.12 in chips)
Seat 4: f285a611 ($14.5 in chips)
Seat 5: Hero ($15.15 in chips)
Seat 6: c4bb24df ($12.63 in chips)
eea08caf: posts small blind $0.05
648925e5: posts big blind $0.1
*** HOLE CARDS ***
Dealt to 9f97f6b4 
Dealt to eea08caf 
Dealt to 648925e5 
Dealt to f285a611 
Dealt to Hero [Td 4h]
Dealt to c4bb24df 
f285a611: folds
Hero: folds
c4bb24df: folds
9f97f6b4: folds
eea08caf: folds
Uncalled bet ($0.05) returned to 648925e5
*** SHOWDOWN ***
648925e5 collected $0.1 from pot
*** SUMMARY ***
Total pot $0.1 | Rake $0 | Jackpot $0 | Bingo $0 | Fortune $0
Seat 1: 9f97f6b4 (button) folded before Flop (didn't bet)
Seat 2: eea08caf (small blind) folded before Flop
Seat 3: 648925e5 (big blind) collected ($0.1)
Seat 4: f285a611 folded before Flop (didn't bet)
Seat 5: Hero folded before Flop (didn't bet)
Seat 6: c4bb24df folded before Flop (didn't bet)


Poker Hand #RC1468524237: Hold'em No Limit  ($0.05/$0.1) - 2023/04/12 20:36:19
Table 'RushAndCash5649497' 6-max Seat #1 is the button
Seat 1: 3cb796b7 ($3.4 in chips)
Seat 2: 86263aac ($14.4 in chips)
Seat 3: Hero ($15.25 in chips)
Seat 4: fe38e83f ($23.36 in chips)
Seat 5: fc96f7a9 ($19.98 in chips)
Seat 6: 54c5b130 ($10.73 in chips)
86263aac: posts small blind $0.05
Hero: posts big blind $0.1
*** HOLE CARDS ***
Dealt to 3cb796b7 
Dealt to 86263aac 
Dealt to Hero [9h 8s]
Dealt to fe38e83f 
Dealt to fc96f7a9 
Dealt to 54c5b130 
fe38e83f: folds
fc96f7a9: folds
54c5b130: folds
3cb796b7: raises $0.2 to $0.3
86263aac: folds
Hero: folds
Uncalled bet ($0.2) returned to 3cb796b7
*** SHOWDOWN ***
3cb796b7 collected $0.25 from pot
*** SUMMARY ***
Total pot $0.25 | Rake $0 | Jackpot $0 | Bingo $0 | Fortune $0
Seat 1: 3cb796b7 (button) collected ($0.25)
Seat 2: 86263aac (small blind) folded before Flop
Seat 3: Hero (big blind) folded before Flop
Seat 4: fe38e83f folded before Flop (didn't bet)
Seat 5: fc96f7a9 folded before Flop (didn't bet)
Seat 6: 54c5b130 folded before Flop (didn't bet)


Poker Hand #RC1468524068: Hold'em No Limit  ($0.05/$0.1) - 2023/04/12 20:35:56
Table 'RushAndCash5649328' 6-max Seat #1 is the button
Seat 1: 4879373b ($2.65 in chips)
Seat 2: e02a71a2 ($1.96 in chips)
Seat 3: 43a0ecf8 ($11.97 in chips)
Seat 4: Hero ($15.25 in chips)
Seat 5: 8ff25254 ($5.04 in chips)
Seat 6: 2ebda5bf ($8.92 in chips)
e02a71a2: posts small blind $0.05
43a0ecf8: posts big blind $0.1
*** HOLE CARDS ***
Dealt to 4879373b 
Dealt to e02a71a2 
Dealt to 43a0ecf8 
Dealt to Hero [Qd 6d]
Dealt to 8ff25254 
Dealt to 2ebda5bf 
Hero: folds
8ff25254: folds
2ebda5bf: raises $0.15 to $0.25
4879373b: folds
e02a71a2: folds
43a0ecf8: folds
Uncalled bet ($0.15) returned to 2ebda5bf
*** SHOWDOWN ***
2ebda5bf collected $0.25 from pot
*** SUMMARY ***
Total pot $0.25 | Rake $0 | Jackpot $0 | Bingo $0 | Fortune $0
Seat 1: 4879373b (button) folded before Flop (didn't bet)
Seat 2: e02a71a2 (small blind) folded before Flop
Seat 3: 43a0ecf8 (big blind) folded before Flop
Seat 4: Hero folded before Flop (didn't bet)
Seat 5: 8ff25254 folded before Flop (didn't bet)
Seat 6: 2ebda5bf collected ($0.25)


Poker Hand #RC1468523989: Hold'em No Limit  ($0.05/$0.1) - 2023/04/12 20:35:42
Table 'RushAndCash5649249' 6-max Seat #1 is the button
Seat 1: 24d15127 ($9.85 in chips)
Seat 2: fffa8208 ($10 in chips)
Seat 3: Hero ($15.35 in chips)
Seat 4: f0e3600d ($11.54 in chips)
Seat 5: bb03a8cb ($11.72 in chips)
Seat 6: 107f293 ($10.64 in chips)
fffa8208: posts small blind $0.05
Hero: posts big blind $0.1
*** HOLE CARDS ***
Dealt to 24d15127 
Dealt to fffa8208 
Dealt to Hero [2d 4s]
Dealt to f0e3600d 
Dealt to bb03a8cb 
Dealt to 107f293 
f0e3600d: raises $0.15 to $0.25
bb03a8cb: folds
107f293: folds
24d15127: folds
fffa8208: raises $0.9 to $1.15
Hero: folds
f0e3600d: folds
Uncalled bet ($0.9) returned to fffa8208
*** SHOWDOWN ***
fffa8208 collected $0.57 from pot
*** SUMMARY ***
Total pot $0.6 | Rake $0.03 | Jackpot $0 | Bingo $0 | Fortune $0
Seat 1: 24d15127 (button) folded before Flop (didn't bet)
Seat 2: fffa8208 (small blind) collected ($0.57)
Seat 3: Hero (big blind) folded before Flop
Seat 4: f0e3600d folded before Flop
Seat 5: bb03a8cb folded before Flop (didn't bet)
Seat 6: 107f293 folded before Flop (didn't bet)


Poker Hand #RC1468523952: Hold'em No Limit  ($0.05/$0.1) - 2023/04/12 20:35:36
Table 'RushAndCash5649212' 6-max Seat #1 is the button
Seat 1: c16d9eef ($9.33 in chips)
Seat 2: Hero ($15.4 in chips)
Seat 3: 304ecc19 ($10 in chips)
Seat 4: dbce33ce ($10.38 in chips)
Seat 5: 1bd3bc3d ($20.06 in chips)
Seat 6: 956bff6d ($11.49 in chips)
Hero: posts small blind $0.05
304ecc19: posts big blind $0.1
*** HOLE CARDS ***
Dealt to c16d9eef 
Dealt to Hero [7s 9h]
Dealt to 304ecc19 
Dealt to dbce33ce 
Dealt to 1bd3bc3d 
Dealt to 956bff6d 
dbce33ce: folds
1bd3bc3d: folds
956bff6d: raises $0.15 to $0.25
c16d9eef: folds
Hero: folds
304ecc19: folds
Uncalled bet ($0.15) returned to 956bff6d
*** SHOWDOWN ***
956bff6d collected $0.25 from pot
*** SUMMARY ***
Total pot $0.25 | Rake $0 | Jackpot $0 | Bingo $0 | Fortune $0
Seat 1: c16d9eef (button) folded before Flop (didn't bet)
Seat 2: Hero (small blind) folded before Flop
Seat 3: 304ecc19 (big blind) folded before Flop
Seat 4: dbce33ce folded before Flop (didn't bet)
Seat 5: 1bd3bc3d folded before Flop (didn't bet)
Seat 6: 956bff6d collected ($0.25)


Poker Hand #RC1468523894: Hold'em No Limit  ($0.05/$0.1) - 2023/04/12 20:35:27
Table 'RushAndCash5649154' 6-max Seat #1 is the button
Seat 1: 8201bb47 ($10.32 in chips)
Seat 2: 4a72cc16 ($9.1 in chips)
Seat 3: 8adf6002 ($10 in chips)
Seat 4: be609cfd ($10 in chips)
Seat 5: Hero ($15.25 in chips)
Seat 6: ef71cf31 ($8.96 in chips)
4a72cc16: posts small blind $0.05
8adf6002: posts big blind $0.1
*** HOLE CARDS ***
Dealt to 8201bb47 
Dealt to 4a72cc16 
Dealt to 8adf6002 
Dealt to be609cfd 
Dealt to Hero [6h Ac]
Dealt to ef71cf31 
be609cfd: folds
Hero: raises $0.15 to $0.25
ef71cf31: folds
8201bb47: folds
4a72cc16: folds
8adf6002: folds
Uncalled bet ($0.15) returned to Hero
*** SHOWDOWN ***
Hero collected $0.25 from pot
*** SUMMARY ***
Total pot $0.25 | Rake $0 | Jackpot $0 | Bingo $0 | Fortune $0
Seat 1: 8201bb47 (button) folded before Flop (didn't bet)
Seat 2: 4a72cc16 (small blind) folded before Flop
Seat 3: 8adf6002 (big blind) folded before Flop
Seat 4: be609cfd folded before Flop (didn't bet)
Seat 5: Hero collected ($0.25)
Seat 6: ef71cf31 folded before Flop (didn't bet)


Poker Hand #RC1468523850: Hold'em No Limit  ($0.05/$0.1) - 2023/04/12 20:35:20
Table 'RushAndCash5649110' 6-max Seat #1 is the button
Seat 1: Hero ($15.25 in chips)
Seat 2: 7c507e93 ($17.07 in chips)
Seat 3: 3bf969ff ($22.05 in chips)
Seat 4: 35d7c81 ($25.19 in chips)
Seat 5: 3cbc9d6 ($11.33 in chips)
Seat 6: 5d5a5867 ($25.09 in chips)
7c507e93: posts small blind $0.05
3bf969ff: posts big blind $0.1
*** HOLE CARDS ***
Dealt to Hero [Qh 3h]
Dealt to 7c507e93 
Dealt to 3bf969ff 
Dealt to 35d7c81 
Dealt to 3cbc9d6 
Dealt to 5d5a5867 
35d7c81: folds
3cbc9d6: folds
5d5a5867: folds
Hero: folds
7c507e93: raises $0.15 to $0.25
3bf969ff: folds
Uncalled bet ($0.15) returned to 7c507e93
*** SHOWDOWN ***
7c507e93 collected $0.2 from pot
*** SUMMARY ***
Total pot $0.2 | Rake $0 | Jackpot $0 | Bingo $0 | Fortune $0
Seat 1: Hero (button) folded before Flop (didn't bet)
Seat 2: 7c507e93 (small blind) collected ($0.2)
Seat 3: 3bf969ff (big blind) folded before Flop
Seat 4: 35d7c81 folded before Flop (didn't bet)
Seat 5: 3cbc9d6 folded before Flop (didn't bet)
Seat 6: 5d5a5867 folded before Flop (didn't bet)


Poker Hand #RC1468521765: Hold'em No Limit  ($0.05/$0.1) - 2023/04/12 20:29:43
Table 'RushAndCash5647025' 6-max Seat #1 is the button
Seat 1: 30a97434 ($11.69 in chips)
Seat 2: 3cb796b7 ($5.36 in chips)
Seat 3: 17c2e1bf ($11.17 in chips)
Seat 4: 5e52cdce ($11.84 in chips)
Seat 5: Hero ($15.25 in chips)
Seat 6: 8896c7b9 ($13.25 in chips)
3cb796b7: posts small blind $0.05
17c2e1bf: posts big blind $0.1
*** HOLE CARDS ***
Dealt to 30a97434 
Dealt to 3cb796b7 
Dealt to 17c2e1bf 
Dealt to 5e52cdce 
Dealt to Hero [8c Td]
Dealt to 8896c7b9 
5e52cdce: folds
Hero: folds
8896c7b9: folds
30a97434: raises $0.15 to $0.25
3cb796b7: folds
17c2e1bf: calls $0.15
*** FLOP *** [Kc Ac Th]
17c2e1bf: checks
30a97434: bets $0.19
17c2e1bf: calls $0.19
*** TURN *** [Kc Ac Th] [4c]
17c2e1bf: checks
30a97434: checks
*** RIVER *** [Kc Ac Th 4c] [8h]
17c2e1bf: bets $0.5
30a97434: calls $0.5
17c2e1bf: shows [5c 7c] (Ace High Flush)
30a97434: shows [Ks Qs] (Pair of Kings)
*** SHOWDOWN ***
17c2e1bf collected $1.84 from pot
*** SUMMARY ***
Total pot $1.93 | Rake $0.09 | Jackpot $0 | Bingo $0 | Fortune $0
Board [Kc Ac Th 4c 8h]
Seat 1: 30a97434 (button) showed [Ks Qs] and lost with Pair of Kings
Seat 2: 3cb796b7 (small blind) folded before Flop
Seat 3: 17c2e1bf (big blind) showed [5c 7c] and won ($1.84) with Ace High Flush
Seat 4: 5e52cdce folded before Flop (didn't bet)
Seat 5: Hero folded before Flop (didn't bet)
Seat 6: 8896c7b9 folded before Flop (didn't bet)


Poker Hand #RC1468521717: Hold'em No Limit  ($0.05/$0.1) - 2023/04/12 20:29:35
Table 'RushAndCash5646977' 6-max Seat #1 is the button
Seat 1: 5b1ddb4b ($3.67 in chips)
Seat 2: 1c97f776 ($9.71 in chips)
Seat 3: 99a7bc39 ($11.21 in chips)
Seat 4: Hero ($15.25 in chips)
Seat 5: af8346aa ($14.47 in chips)
Seat 6: de40ad35 ($13.2 in chips)
1c97f776: posts small blind $0.05
99a7bc39: posts big blind $0.1
*** HOLE CARDS ***
Dealt to 5b1ddb4b 
Dealt to 1c97f776 
Dealt to 99a7bc39 
Dealt to Hero [Kh 3c]
Dealt to af8346aa 
Dealt to de40ad35 
Hero: folds
af8346aa: folds
de40ad35: folds
5b1ddb4b: folds
1c97f776: folds
Uncalled bet ($0.05) returned to 99a7bc39
*** SHOWDOWN ***
99a7bc39 collected $0.1 from pot
*** SUMMARY ***
Total pot $0.1 | Rake $0 | Jackpot $0 | Bingo $0 | Fortune $0
Seat 1: 5b1ddb4b (button) folded before Flop (didn't bet)
Seat 2: 1c97f776 (small blind) folded before Flop
Seat 3: 99a7bc39 (big blind) collected ($0.1)
Seat 4: Hero folded before Flop (didn't bet)
Seat 5: af8346aa folded before Flop (didn't bet)
Seat 6: de40ad35 folded before Flop (didn't bet)


Poker Hand #RC1468521110: Hold'em No Limit  ($0.05/$0.1) - 2023/04/12 20:28:06
Table 'RushAndCash5646370' 6-max Seat #1 is the button
Seat 1: 605c7d9c ($23.35 in chips)
Seat 2: af8346aa ($14.45 in chips)
Seat 3: 1da744d3 ($12.57 in chips)
Seat 4: 7f1c7377 ($14.39 in chips)
Seat 5: Hero ($15.23 in chips)
Seat 6: 9f97f6b4 ($10.4 in chips)
af8346aa: posts small blind $0.05
1da744d3: posts big blind $0.1
*** HOLE CARDS ***
Dealt to 605c7d9c 
Dealt to af8346aa 
Dealt to 1da744d3 
Dealt to 7f1c7377 
Dealt to Hero [Ah 9d]
Dealt to 9f97f6b4 
7f1c7377: folds
Hero: raises $0.15 to $0.25
9f97f6b4: folds
605c7d9c: folds
af8346aa: calls $0.2
1da744d3: folds
*** FLOP *** [5h Td 9h]
af8346aa: checks
Hero: checks
*** TURN *** [5h Td 9h] [5d]
af8346aa: bets $0.3
Hero: calls $0.3
*** RIVER *** [5h Td 9h 5d] [Kh]
af8346aa: checks
Hero: checks
af8346aa: shows [9s As] (Pair of Nines and Pair of Fives)
Hero: shows [Ah 9d] (Pair of Nines and Pair of Fives)
*** SHOWDOWN ***
af8346aa collected $0.57 from pot
Hero collected $0.57 from pot
*** SUMMARY ***
Total pot $1.2 | Rake $0.06 | Jackpot $0 | Bingo $0 | Fortune $0
Board [5h Td 9h 5d Kh]
Seat 1: 605c7d9c (button) folded before Flop (didn't bet)
Seat 2: af8346aa (small blind) showed [9s As] and won ($0.57) with Pair of Nines and Pair of Fives
Seat 3: 1da744d3 (big blind) folded before Flop
Seat 4: 7f1c7377 folded before Flop (didn't bet)
Seat 5: Hero showed [Ah 9d] and won ($0.57) with Pair of Nines and Pair of Fives
Seat 6: 9f97f6b4 folded before Flop (didn't bet)


Poker Hand #RC1468521043: Hold'em No Limit  ($0.05/$0.1) - 2023/04/12 20:27:56
Table 'RushAndCash5646303' 6-max Seat #1 is the button
Seat 1: 6d8fecca ($10.15 in chips)
Seat 2: f347cc26 ($16.05 in chips)
Seat 3: Hero ($15.33 in chips)
Seat 4: 25133b10 ($10.71 in chips)
Seat 5: dc85c784 ($10.64 in chips)
Seat 6: 4529c4b ($14.41 in chips)
f347cc26: posts small blind $0.05
Hero: posts big blind $0.1
*** HOLE CARDS ***
Dealt to 6d8fecca 
Dealt to f347cc26 
Dealt to Hero [Td 7d]
Dealt to 25133b10 
Dealt to dc85c784 
Dealt to 4529c4b 
25133b10: folds
dc85c784: folds
4529c4b: folds
6d8fecca: raises $0.15 to $0.25
f347cc26: folds
Hero: folds
Uncalled bet ($0.15) returned to 6d8fecca
*** SHOWDOWN ***
6d8fecca collected $0.25 from pot
*** SUMMARY ***
Total pot $0.25 | Rake $0 | Jackpot $0 | Bingo $0 | Fortune $0
Seat 1: 6d8fecca (button) collected ($0.25)
Seat 2: f347cc26 (small blind) folded before Flop
Seat 3: Hero (big blind) folded before Flop
Seat 4: 25133b10 folded before Flop (didn't bet)
Seat 5: dc85c784 folded before Flop (didn't bet)
Seat 6: 4529c4b folded before Flop (didn't bet)


Poker Hand #RC1468520991: Hold'em No Limit  ($0.05/$0.1) - 2023/04/12 20:27:48
Table 'RushAndCash5646251' 6-max Seat #1 is the button
Seat 1: 4529c4b ($14.41 in chips)
Seat 2: e7af1474 ($13 in chips)
Seat 3: f347cc26 ($16.15 in chips)
Seat 4: Hero ($15.33 in chips)
Seat 5: 16e733a5 ($45.62 in chips)
Seat 6: 25fdd2c9 ($15.18 in chips)
e7af1474: posts small blind $0.05
f347cc26: posts big blind $0.1
*** HOLE CARDS ***
Dealt to 4529c4b 
Dealt to e7af1474 
Dealt to f347cc26 
Dealt to Hero [3s 2s]
Dealt to 16e733a5 
Dealt to 25fdd2c9 
Hero: folds
16e733a5: folds
25fdd2c9: folds
4529c4b: folds
e7af1474: raises $0.15 to $0.25
f347cc26: folds
Uncalled bet ($0.15) returned to e7af1474
*** SHOWDOWN ***
e7af1474 collected $0.2 from pot
*** SUMMARY ***
Total pot $0.2 | Rake $0 | Jackpot $0 | Bingo $0 | Fortune $0
Seat 1: 4529c4b (button) folded before Flop (didn't bet)
Seat 2: e7af1474 (small blind) collected ($0.2)
Seat 3: f347cc26 (big blind) folded before Flop
Seat 4: Hero folded before Flop (didn't bet)
Seat 5: 16e733a5 folded before Flop (didn't bet)
Seat 6: 25fdd2c9 folded before Flop (didn't bet)


Poker Hand #RC1468520561: Hold'em No Limit  ($0.05/$0.1) - 2023/04/12 20:26:41
Table 'RushAndCash5645821' 6-max Seat #1 is the button
Seat 1: e993246b ($10.05 in chips)
Seat 2: 745a4c17 ($10 in chips)
Seat 3: 7b659e41 ($4 in chips)
Seat 4: f82167c ($9.17 in chips)
Seat 5: Hero ($14.96 in chips)
Seat 6: ab0123fa ($12.08 in chips)
745a4c17: posts small blind $0.05
7b659e41: posts big blind $0.1
*** HOLE CARDS ***
Dealt to e993246b 
Dealt to 745a4c17 
Dealt to 7b659e41 
Dealt to f82167c 
Dealt to Hero [8c 8h]
Dealt to ab0123fa 
f82167c: folds
Hero: raises $0.15 to $0.25
ab0123fa: folds
e993246b: calls $0.25
745a4c17: folds
7b659e41: folds
*** FLOP *** [7s Jc 4c]
Hero: checks
e993246b: checks
*** TURN *** [7s Jc 4c] [4h]
Hero: bets $0.33
e993246b: folds
Uncalled bet ($0.33) returned to Hero
*** SHOWDOWN ***
Hero collected $0.62 from pot
*** SUMMARY ***
Total pot $0.65 | Rake $0.03 | Jackpot $0 | Bingo $0 | Fortune $0
Board [7s Jc 4c 4h]
Seat 1: e993246b (button) folded on the Turn
Seat 2: 745a4c17 (small blind) folded before Flop
Seat 3: 7b659e41 (big blind) folded before Flop
Seat 4: f82167c folded before Flop (didn't bet)
Seat 5: Hero won ($0.62)
Seat 6: ab0123fa folded before Flop (didn't bet)


Poker Hand #RC1468520439: Hold'em No Limit  ($0.05/$0.1) - 2023/04/12 20:26:23
Table 'RushAndCash5645699' 6-max Seat #1 is the button
Seat 1: 76b30415 ($13.48 in chips)
Seat 2: 3877af71 ($18.95 in chips)
Seat 3: 86263aac ($10 in chips)
Seat 4: b5f4024a ($10.23 in chips)
Seat 5: Hero ($14.96 in chips)
Seat 6: 89d77966 ($14.44 in chips)
3877af71: posts small blind $0.05
86263aac: posts big blind $0.1
*** HOLE CARDS ***
Dealt to 76b30415 
Dealt to 3877af71 
Dealt to 86263aac 
Dealt to b5f4024a 
Dealt to Hero [Jh 2c]
Dealt to 89d77966 
b5f4024a: raises $0.11 to $0.21
Hero: folds
89d77966: folds
76b30415: folds
3877af71: folds
86263aac: folds
Uncalled bet ($0.11) returned to b5f4024a
*** SHOWDOWN ***
b5f4024a collected $0.25 from pot
*** SUMMARY ***
Total pot $0.25 | Rake $0 | Jackpot $0 | Bingo $0 | Fortune $0
Seat 1: 76b30415 (button) folded before Flop (didn't bet)
Seat 2: 3877af71 (small blind) folded before Flop
Seat 3: 86263aac (big blind) folded before Flop
Seat 4: b5f4024a collected ($0.25)
Seat 5: Hero folded before Flop (didn't bet)
Seat 6: 89d77966 folded before Flop (didn't bet)


Poker Hand #RC1468520313: Hold'em No Limit  ($0.05/$0.1) - 2023/04/12 20:26:03
Table 'RushAndCash5645573' 6-max Seat #1 is the button
Seat 1: 7aa7f476 ($11.05 in chips)
Seat 2: Hero ($15.01 in chips)
Seat 3: 5b34f2fa ($22.26 in chips)
Seat 4: 80afa4d1 ($10 in chips)
Seat 5: 4ad160bb ($10 in chips)
Seat 6: a92ce884 ($10.56 in chips)
Hero: posts small blind $0.05
5b34f2fa: posts big blind $0.1
*** HOLE CARDS ***
Dealt to 7aa7f476 
Dealt to Hero [6h Ts]
Dealt to 5b34f2fa 
Dealt to 80afa4d1 
Dealt to 4ad160bb 
Dealt to a92ce884 
80afa4d1: folds
4ad160bb: folds
a92ce884: raises $0.15 to $0.25
7aa7f476: folds
Hero: folds
5b34f2fa: folds
Uncalled bet ($0.15) returned to a92ce884
*** SHOWDOWN ***
a92ce884 collected $0.25 from pot
*** SUMMARY ***
Total pot $0.25 | Rake $0 | Jackpot $0 | Bingo $0 | Fortune $0
Seat 1: 7aa7f476 (button) folded before Flop (didn't bet)
Seat 2: Hero (small blind) folded before Flop
Seat 3: 5b34f2fa (big blind) folded before Flop
Seat 4: 80afa4d1 folded before Flop (didn't bet)
Seat 5: 4ad160bb folded before Flop (didn't bet)
Seat 6: a92ce884 collected ($0.25)


Poker Hand #RC1468519804: Hold'em No Limit  ($0.05/$0.1) - 2023/04/12 20:24:50
Table 'RushAndCash5645064' 6-max Seat #1 is the button
Seat 1: Hero ($15.84 in chips)
Seat 2: 8d949448 ($11.78 in chips)
Seat 3: 1b214f81 ($17.9 in chips)
Seat 4: 8265d782 ($10 in chips)
Seat 5: 89d77966 ($13.22 in chips)
Seat 6: 7aa7f476 ($11.3 in chips)
8d949448: posts small blind $0.05
1b214f81: posts big blind $0.1
*** HOLE CARDS ***
Dealt to Hero [5d 4d]
Dealt to 8d949448 
Dealt to 1b214f81 
Dealt to 8265d782 
Dealt to 89d77966 
Dealt to 7aa7f476 
8265d782: folds
89d77966: calls $0.1
7aa7f476: calls $0.1
Hero: calls $0.1
8d949448: folds
1b214f81: checks
*** FLOP *** [5c 3c 7d]
1b214f81: checks
89d77966: bets $0.15
7aa7f476: calls $0.15
Hero: calls $0.15
1b214f81: folds
*** TURN *** [5c 3c 7d] [Ac]
89d77966: checks
7aa7f476: checks
Hero: checks
*** RIVER *** [5c 3c 7d Ac] [Ad]
89d77966: checks
7aa7f476: checks
Hero: bets $0.73
89d77966: calls $0.73
7aa7f476: folds
Hero: shows [5d 4d] (Pair of Aces and Pair of Fives)
89d77966: shows [Kc Kh] (Pair of Aces and Pair of Kings)
*** SHOWDOWN ***
89d77966 collected $2.25 from pot
*** SUMMARY ***
Total pot $2.36 | Rake $0.11 | Jackpot $0 | Bingo $0 | Fortune $0
Board [5c 3c 7d Ac Ad]
Seat 1: Hero (button) showed [5d 4d] and lost with Pair of Aces and Pair of Fives
Seat 2: 8d949448 (small blind) folded before Flop
Seat 3: 1b214f81 (big blind) folded on the Flop
Seat 4: 8265d782 folded before Flop (didn't bet)
Seat 5: 89d77966 showed [Kc Kh] and won ($2.25) with Pair of Aces and Pair of Kings
Seat 6: 7aa7f476 folded on the River


Poker Hand #RC1468519774: Hold'em No Limit  ($0.05/$0.1) - 2023/04/12 20:24:46
Table 'RushAndCash5645034' 6-max Seat #1 is the button
Seat 1: 69a86d21 ($14.49 in chips)
Seat 2: d3d83101 ($10.05 in chips)
Seat 3: Hero ($15.94 in chips)
Seat 4: df434f7c ($4 in chips)
Seat 5: 1e0fb20e ($25.45 in chips)
Seat 6: d4fe74b7 ($15.24 in chips)
d3d83101: posts small blind $0.05
Hero: posts big blind $0.1
*** HOLE CARDS ***
Dealt to 69a86d21 
Dealt to d3d83101 
Dealt to Hero [Td 3d]
Dealt to df434f7c 
Dealt to 1e0fb20e 
Dealt to d4fe74b7 
df434f7c: folds
1e0fb20e: folds
d4fe74b7: folds
69a86d21: folds
d3d83101: folds
Uncalled bet ($0.05) returned to Hero
*** SHOWDOWN ***
Hero collected $0.1 from pot
*** SUMMARY ***
Total pot $0.1 | Rake $0 | Jackpot $0 | Bingo $0 | Fortune $0
Seat 1: 69a86d21 (button) folded before Flop (didn't bet)
Seat 2: d3d83101 (small blind) folded before Flop
Seat 3: Hero (big blind) collected ($0.1)
Seat 4: df434f7c folded before Flop (didn't bet)
Seat 5: 1e0fb20e folded before Flop (didn't bet)
Seat 6: d4fe74b7 folded before Flop (didn't bet)


Poker Hand #RC1468519743: Hold'em No Limit  ($0.05/$0.1) - 2023/04/12 20:24:42
Table 'RushAndCash5645003' 6-max Seat #1 is the button
Seat 1: 3a2d2163 ($19.64 in chips)
Seat 2: Hero ($15.99 in chips)
Seat 3: a84e6d0a ($22.45 in chips)
Seat 4: cb634ea4 ($10 in chips)
Seat 5: aecde197 ($7.65 in chips)
Seat 6: da4e056f ($8.3 in chips)
Hero: posts small blind $0.05
a84e6d0a: posts big blind $0.1
*** HOLE CARDS ***
Dealt to 3a2d2163 
Dealt to Hero [2d 7h]
Dealt to a84e6d0a 
Dealt to cb634ea4 
Dealt to aecde197 
Dealt to da4e056f 
cb634ea4: raises $0.15 to $0.25
aecde197: folds
da4e056f: folds
3a2d2163: folds
Hero: folds
a84e6d0a: calls $0.15
*** FLOP *** [9s 8h Kh]
a84e6d0a: checks
cb634ea4: bets $0.16
a84e6d0a: calls $0.16
*** TURN *** [9s 8h Kh] [7c]
a84e6d0a: checks
cb634ea4: checks
*** RIVER *** [9s 8h Kh 7c] [Kc]
a84e6d0a: bets $0.66
cb634ea4: calls $0.66
a84e6d0a: shows [Jh Kd] (Three Kings)
cb634ea4: shows [8c Ac] (Pair of Kings and Pair of Eights)
*** SHOWDOWN ***
a84e6d0a collected $2.08 from pot
*** SUMMARY ***
Total pot $2.19 | Rake $0.11 | Jackpot $0 | Bingo $0 | Fortune $0
Board [9s 8h Kh 7c Kc]
Seat 1: 3a2d2163 (button) folded before Flop (didn't bet)
Seat 2: Hero (small blind) folded before Flop
Seat 3: a84e6d0a (big blind) showed [Jh Kd] and won ($2.08) with Three Kings
Seat 4: cb634ea4 showed [8c Ac] and lost with Pair of Kings and Pair of Eights
Seat 5: aecde197 folded before Flop (didn't bet)
Seat 6: da4e056f folded before Flop (didn't bet)


Poker Hand #RC1468519700: Hold'em No Limit  ($0.05/$0.1) - 2023/04/12 20:24:36
Table 'RushAndCash5644960' 6-max Seat #1 is the button
Seat 1: d75305a5 ($10 in chips)
Seat 2: 1e05a0ee ($7.08 in chips)
Seat 3: 5f90a7f9 ($10.45 in chips)
Seat 4: 389f0ebe ($11 in chips)
Seat 5: Hero ($15.99 in chips)
Seat 6: 5cf3cbba ($10.15 in chips)
1e05a0ee: posts small blind $0.05
5f90a7f9: posts big blind $0.1
*** HOLE CARDS ***
Dealt to d75305a5 
Dealt to 1e05a0ee 
Dealt to 5f90a7f9 
Dealt to 389f0ebe 
Dealt to Hero [7c Td]
Dealt to 5cf3cbba 
389f0ebe: folds
Hero: folds
5cf3cbba: folds
d75305a5: folds
1e05a0ee: folds
Uncalled bet ($0.05) returned to 5f90a7f9
*** SHOWDOWN ***
5f90a7f9 collected $0.1 from pot
*** SUMMARY ***
Total pot $0.1 | Rake $0 | Jackpot $0 | Bingo $0 | Fortune $0
Seat 1: d75305a5 (button) folded before Flop (didn't bet)
Seat 2: 1e05a0ee (small blind) folded before Flop
Seat 3: 5f90a7f9 (big blind) collected ($0.1)
Seat 4: 389f0ebe folded before Flop (didn't bet)
Seat 5: Hero folded before Flop (didn't bet)
Seat 6: 5cf3cbba folded before Flop (didn't bet)


Poker Hand #RC1468519652: Hold'em No Limit  ($0.05/$0.1) - 2023/04/12 20:24:29
Table 'RushAndCash5644912' 6-max Seat #1 is the button
Seat 1: 92ee9abb ($11.92 in chips)
Seat 2: 27c922fe ($41.18 in chips)
Seat 3: Hero ($16.09 in chips)
Seat 4: e0c2d06d ($11.84 in chips)
Seat 5: 5cf3cbba ($10.15 in chips)
Seat 6: 11bc2d8 ($5.94 in chips)
27c922fe: posts small blind $0.05
Hero: posts big blind $0.1
*** HOLE CARDS ***
Dealt to 92ee9abb 
Dealt to 27c922fe 
Dealt to Hero [Ts 6h]
Dealt to e0c2d06d 
Dealt to 5cf3cbba 
Dealt to 11bc2d8 
e0c2d06d: folds
5cf3cbba: folds
11bc2d8: calls $0.1
92ee9abb: raises $0.27 to $0.37
27c922fe: folds
Hero: folds
11bc2d8: calls $0.27
*** FLOP *** [Kc 4d Jh]
11bc2d8: checks
92ee9abb: bets $0.3
11bc2d8: calls $0.3
*** TURN *** [Kc 4d Jh] [Kh]
11bc2d8: checks
92ee9abb: checks
*** RIVER *** [Kc 4d Jh Kh] [2h]
11bc2d8: bets $0.5
92ee9abb: calls $0.5
11bc2d8: shows [Tc As] (Pair of Kings)
92ee9abb: shows [8h 8d] (Pair of Kings and Pair of Eights)
*** SHOWDOWN ***
92ee9abb collected $2.37 from pot
*** SUMMARY ***
Total pot $2.49 | Rake $0.12 | Jackpot $0 | Bingo $0 | Fortune $0
Board [Kc 4d Jh Kh 2h]
Seat 1: 92ee9abb (button) showed [8h 8d] and won ($2.37) with Pair of Kings and Pair of Eights
Seat 2: 27c922fe (small blind) folded before Flop
Seat 3: Hero (big blind) folded before Flop
Seat 4: e0c2d06d folded before Flop (didn't bet)
Seat 5: 5cf3cbba folded before Flop (didn't bet)
Seat 6: 11bc2d8 showed [Tc As] and lost with Pair of Kings


Poker Hand #RC1468519615: Hold'em No Limit  ($0.05/$0.1) - 2023/04/12 20:24:25
Table 'RushAndCash5644875' 6-max Seat #1 is the button
Seat 1: 92ee9abb ($11.92 in chips)
Seat 2: fb1c8b9d ($14.52 in chips)
Seat 3: b1797ef8 ($9.62 in chips)
Seat 4: Hero ($16.09 in chips)
Seat 5: effd023b ($25.27 in chips)
Seat 6: 57e1fa5 ($18.57 in chips)
fb1c8b9d: posts small blind $0.05
b1797ef8: posts big blind $0.1
*** HOLE CARDS ***
Dealt to 92ee9abb 
Dealt to fb1c8b9d 
Dealt to b1797ef8 
Dealt to Hero [5s 7s]
Dealt to effd023b 
Dealt to 57e1fa5 
Hero: folds
effd023b: folds
57e1fa5: raises $0.15 to $0.25
92ee9abb: folds
fb1c8b9d: folds
b1797ef8: folds
Uncalled bet ($0.15) returned to 57e1fa5
*** SHOWDOWN ***
57e1fa5 collected $0.25 from pot
*** SUMMARY ***
Total pot $0.25 | Rake $0 | Jackpot $0 | Bingo $0 | Fortune $0
Seat 1: 92ee9abb (button) folded before Flop (didn't bet)
Seat 2: fb1c8b9d (small blind) folded before Flop
Seat 3: b1797ef8 (big blind) folded before Flop
Seat 4: Hero folded before Flop (didn't bet)
Seat 5: effd023b folded before Flop (didn't bet)
Seat 6: 57e1fa5 collected ($0.25)


Poker Hand #RC1468519562: Hold'em No Limit  ($0.05/$0.1) - 2023/04/12 20:24:17
Table 'RushAndCash5644822' 6-max Seat #1 is the button
Seat 1: Hero ($16.09 in chips)
Seat 2: b574e05 ($26.66 in chips)
Seat 3: 6731b985 ($11.79 in chips)
Seat 4: e3aea5cc ($9.57 in chips)
Seat 5: 1c8bc73d ($15.17 in chips)
Seat 6: 1aca80ca ($11.52 in chips)
b574e05: posts small blind $0.05
6731b985: posts big blind $0.1
*** HOLE CARDS ***
Dealt to Hero [2c 9d]
Dealt to b574e05 
Dealt to 6731b985 
Dealt to e3aea5cc 
Dealt to 1c8bc73d 
Dealt to 1aca80ca 
e3aea5cc: folds
1c8bc73d: folds
1aca80ca: folds
Hero: folds
b574e05: folds
Uncalled bet ($0.05) returned to 6731b985
*** SHOWDOWN ***
6731b985 collected $0.1 from pot
*** SUMMARY ***
Total pot $0.1 | Rake $0 | Jackpot $0 | Bingo $0 | Fortune $0
Seat 1: Hero (button) folded before Flop (didn't bet)
Seat 2: b574e05 (small blind) folded before Flop
Seat 3: 6731b985 (big blind) collected ($0.1)
Seat 4: e3aea5cc folded before Flop (didn't bet)
Seat 5: 1c8bc73d folded before Flop (didn't bet)
Seat 6: 1aca80ca folded before Flop (didn't bet)


Poker Hand #RC1468519524: Hold'em No Limit  ($0.05/$0.1) - 2023/04/12 20:24:11
Table 'RushAndCash5644784' 6-max Seat #1 is the button
Seat 1: Hero ($16.09 in chips)
Seat 2: 2897976f ($11.07 in chips)
Seat 3: 88fdb29e ($7.91 in chips)
Seat 4: 60d0b096 ($19.3 in chips)
Seat 5: 8adf6002 ($10.18 in chips)
Seat 6: 350ec37e ($42.1 in chips)
2897976f: posts small blind $0.05
88fdb29e: posts big blind $0.1
*** HOLE CARDS ***
Dealt to Hero [9d 4s]
Dealt to 2897976f 
Dealt to 88fdb29e 
Dealt to 60d0b096 
Dealt to 8adf6002 
Dealt to 350ec37e 
60d0b096: raises $0.15 to $0.25
8adf6002: folds
350ec37e: folds
Hero: folds
2897976f: folds
88fdb29e: calls $0.15
*** FLOP *** [9s 4h Qd]
88fdb29e: checks
60d0b096: bets $0.28
88fdb29e: calls $0.28
*** TURN *** [9s 4h Qd] [4d]
88fdb29e: checks
60d0b096: checks
*** RIVER *** [9s 4h Qd 4d] [2c]
88fdb29e: checks
60d0b096: bets $0.56
88fdb29e: calls $0.56
60d0b096: shows [Qc Jc] (Pair of Queens and Pair of Fours)
88fdb29e: shows [7h 7d] (Pair of Sevens and Pair of Fours)
*** SHOWDOWN ***
60d0b096 collected $2.12 from pot
*** SUMMARY ***
Total pot $2.23 | Rake $0.11 | Jackpot $0 | Bingo $0 | Fortune $0
Board [9s 4h Qd 4d 2c]
Seat 1: Hero (button) folded before Flop (didn't bet)
Seat 2: 2897976f (small blind) folded before Flop
Seat 3: 88fdb29e (big blind) showed [7h 7d] and lost with Pair of Sevens and Pair of Fours
Seat 4: 60d0b096 showed [Qc Jc] and won ($2.12) with Pair of Queens and Pair of Fours
Seat 5: 8adf6002 folded before Flop (didn't bet)
Seat 6: 350ec37e folded before Flop (didn't bet)


Poker Hand #RC1468519494: Hold'em No Limit  ($0.05/$0.1) - 2023/04/12 20:24:06
Table 'RushAndCash5644754' 6-max Seat #1 is the button
Seat 1: c2d5028f ($12.19 in chips)
Seat 2: 5f771fd4 ($10.23 in chips)
Seat 3: 4f983e28 ($10.7 in chips)
Seat 4: Hero ($16.09 in chips)
Seat 5: 2121db44 ($13.45 in chips)
Seat 6: dea71518 ($13.8 in chips)
5f771fd4: posts small blind $0.05
4f983e28: posts big blind $0.1
*** HOLE CARDS ***
Dealt to c2d5028f 
Dealt to 5f771fd4 
Dealt to 4f983e28 
Dealt to Hero [As 4d]
Dealt to 2121db44 
Dealt to dea71518 
Hero: folds
2121db44: folds
dea71518: folds
c2d5028f: folds
5f771fd4: raises $0.2 to $0.3
4f983e28: calls $0.2
*** FLOP *** [4h Td 5s]
5f771fd4: checks
4f983e28: bets $0.4
5f771fd4: folds
Uncalled bet ($0.4) returned to 4f983e28
*** SHOWDOWN ***
4f983e28 collected $0.57 from pot
*** SUMMARY ***
Total pot $0.6 | Rake $0.03 | Jackpot $0 | Bingo $0 | Fortune $0
Board [4h Td 5s]
Seat 1: c2d5028f (button) folded before Flop (didn't bet)
Seat 2: 5f771fd4 (small blind) folded on the Flop
Seat 3: 4f983e28 (big blind) won ($0.57)
Seat 4: Hero folded before Flop (didn't bet)
Seat 5: 2121db44 folded before Flop (didn't bet)
Seat 6: dea71518 folded before Flop (didn't bet)


Poker Hand #RC1468519381: Hold'em No Limit  ($0.05/$0.1) - 2023/04/12 20:23:50
Table 'RushAndCash5644641' 6-max Seat #1 is the button
Seat 1: 11f4e324 ($19.45 in chips)
Seat 2: 25133b10 ($11.48 in chips)
Seat 3: 8c845fa8 ($21.69 in chips)
Seat 4: 7b0eeb66 ($30.4 in chips)
Seat 5: d9a8ef ($10 in chips)
Seat 6: Hero ($16.09 in chips)
25133b10: posts small blind $0.05
8c845fa8: posts big blind $0.1
*** HOLE CARDS ***
Dealt to 11f4e324 
Dealt to 25133b10 
Dealt to 8c845fa8 
Dealt to 7b0eeb66 
Dealt to d9a8ef 
Dealt to Hero [2c Ts]
7b0eeb66: folds
d9a8ef: raises $0.15 to $0.25
Hero: folds
11f4e324: folds
25133b10: folds
8c845fa8: folds
Uncalled bet ($0.15) returned to d9a8ef
*** SHOWDOWN ***
d9a8ef collected $0.25 from pot
*** SUMMARY ***
Total pot $0.25 | Rake $0 | Jackpot $0 | Bingo $0 | Fortune $0
Seat 1: 11f4e324 (button) folded before Flop (didn't bet)
Seat 2: 25133b10 (small blind) folded before Flop
Seat 3: 8c845fa8 (big blind) folded before Flop
Seat 4: 7b0eeb66 folded before Flop (didn't bet)
Seat 5: d9a8ef collected ($0.25)
Seat 6: Hero folded before Flop (didn't bet)


Poker Hand #RC1468519352: Hold'em No Limit  ($0.05/$0.1) - 2023/04/12 20:23:46
Table 'RushAndCash5644612' 6-max Seat #1 is the button
Seat 1: b3d8788c ($15.45 in chips)
Seat 2: 55c94a9b ($3.11 in chips)
Seat 3: acc311b8 ($11.19 in chips)
Seat 4: be609cfd ($10.31 in chips)
Seat 5: 7c4c4ed8 ($11.57 in chips)
Seat 6: Hero ($16.09 in chips)
55c94a9b: posts small blind $0.05
acc311b8: posts big blind $0.1
*** HOLE CARDS ***
Dealt to b3d8788c 
Dealt to 55c94a9b 
Dealt to acc311b8 
Dealt to be609cfd 
Dealt to 7c4c4ed8 
Dealt to Hero [Kd 2s]
be609cfd: raises $0.15 to $0.25
7c4c4ed8: folds
Hero: folds
b3d8788c: folds
55c94a9b: raises $0.45 to $0.7
acc311b8: folds
be609cfd: folds
Uncalled bet ($0.45) returned to 55c94a9b
*** SHOWDOWN ***
55c94a9b collected $0.57 from pot
*** SUMMARY ***
Total pot $0.6 | Rake $0.03 | Jackpot $0 | Bingo $0 | Fortune $0
Seat 1: b3d8788c (button) folded before Flop (didn't bet)
Seat 2: 55c94a9b (small blind) collected ($0.57)
Seat 3: acc311b8 (big blind) folded before Flop
Seat 4: be609cfd folded before Flop
Seat 5: 7c4c4ed8 folded before Flop (didn't bet)
Seat 6: Hero folded before Flop (didn't bet)


Poker Hand #RC1468519237: Hold'em No Limit  ($0.05/$0.1) - 2023/04/12 20:23:31
Table 'RushAndCash5644497' 6-max Seat #1 is the button
Seat 1: 9f3d0bed ($8.19 in chips)
Seat 2: Hero ($16.14 in chips)
Seat 3: 593f09d7 ($10.15 in chips)
Seat 4: 23102071 ($40.95 in chips)
Seat 5: 11f4e324 ($19.6 in chips)
Seat 6: 17c2e1bf ($10.63 in chips)
Hero: posts small blind $0.05
593f09d7: posts big blind $0.1
*** HOLE CARDS ***
Dealt to 9f3d0bed 
Dealt to Hero [4h 9s]
Dealt to 593f09d7 
Dealt to 23102071 
Dealt to 11f4e324 
Dealt to 17c2e1bf 
23102071: folds
11f4e324: folds
17c2e1bf: folds
9f3d0bed: raises $0.15 to $0.25
Hero: folds
593f09d7: calls $0.15
*** FLOP *** [Ts 3h 7d]
593f09d7: checks
9f3d0bed: checks
*** TURN *** [Ts 3h 7d] [2d]
593f09d7: checks
9f3d0bed: checks
*** RIVER *** [Ts 3h 7d 2d] [Qd]
593f09d7: checks
9f3d0bed: bets $0.28
593f09d7: folds
Uncalled bet ($0.28) returned to 9f3d0bed
*** SHOWDOWN ***
9f3d0bed collected $0.53 from pot
*** SUMMARY ***
Total pot $0.55 | Rake $0.02 | Jackpot $0 | Bingo $0 | Fortune $0
Board [Ts 3h 7d 2d Qd]
Seat 1: 9f3d0bed (button) won ($0.53)
Seat 2: Hero (small blind) folded before Flop
Seat 3: 593f09d7 (big blind) folded on the River
Seat 4: 23102071 folded before Flop (didn't bet)
Seat 5: 11f4e324 folded before Flop (didn't bet)
Seat 6: 17c2e1bf folded before Flop (didn't bet)


Poker Hand #RC1468519192: Hold'em No Limit  ($0.05/$0.1) - 2023/04/12 20:23:24
Table 'RushAndCash5644452' 6-max Seat #1 is the button
Seat 1: 1dbd3c8e ($16.69 in chips)
Seat 2: 499d6d5f ($10.73 in chips)
Seat 3: 1bfa336f ($25.62 in chips)
Seat 4: 39b5c546 ($20.8 in chips)
Seat 5: 6a485947 ($13.73 in chips)
Seat 6: Hero ($16.14 in chips)
499d6d5f: posts small blind $0.05
1bfa336f: posts big blind $0.1
*** HOLE CARDS ***
Dealt to 1dbd3c8e 
Dealt to 499d6d5f 
Dealt to 1bfa336f 
Dealt to 39b5c546 
Dealt to 6a485947 
Dealt to Hero [3d As]
39b5c546: folds
6a485947: raises $0.1 to $0.2
Hero: folds
1dbd3c8e: raises $0.5 to $0.7
499d6d5f: raises $1.3 to $2
1bfa336f: folds
6a485947: folds
1dbd3c8e: folds
Uncalled bet ($1.3) returned to 499d6d5f
*** SHOWDOWN ***
499d6d5f collected $1.62 from pot
*** SUMMARY ***
Total pot $1.7 | Rake $0.08 | Jackpot $0 | Bingo $0 | Fortune $0
Seat 1: 1dbd3c8e (button) folded before Flop
Seat 2: 499d6d5f (small blind) collected ($1.62)
Seat 3: 1bfa336f (big blind) folded before Flop
Seat 4: 39b5c546 folded before Flop (didn't bet)
Seat 5: 6a485947 folded before Flop
Seat 6: Hero folded before Flop (didn't bet)


Poker Hand #RC1468519156: Hold'em No Limit  ($0.05/$0.1) - 2023/04/12 20:23:19
Table 'RushAndCash5644416' 6-max Seat #1 is the button
Seat 1: 4749fc8f ($10 in chips)
Seat 2: Hero ($16.19 in chips)
Seat 3: 6b0672b7 ($11.75 in chips)
Seat 4: 1bfa336f ($25.62 in chips)
Seat 5: 64b56deb ($14.22 in chips)
Seat 6: bb03a8cb ($10.79 in chips)
Hero: posts small blind $0.05
6b0672b7: posts big blind $0.1
*** HOLE CARDS ***
Dealt to 4749fc8f 
Dealt to Hero [Jd 2h]
Dealt to 6b0672b7 
Dealt to 1bfa336f 
Dealt to 64b56deb 
Dealt to bb03a8cb 
1bfa336f: folds
64b56deb: folds
bb03a8cb: folds
4749fc8f: folds
Hero: folds
Uncalled bet ($0.05) returned to 6b0672b7
*** SHOWDOWN ***
6b0672b7 collected $0.1 from pot
*** SUMMARY ***
Total pot $0.1 | Rake $0 | Jackpot $0 | Bingo $0 | Fortune $0
Seat 1: 4749fc8f (button) folded before Flop (didn't bet)
Seat 2: Hero (small blind) folded before Flop
Seat 3: 6b0672b7 (big blind) collected ($0.1)
Seat 4: 1bfa336f folded before Flop (didn't bet)
Seat 5: 64b56deb folded before Flop (didn't bet)
Seat 6: bb03a8cb folded before Flop (didn't bet)


Poker Hand #RC1468518951: Hold'em No Limit  ($0.05/$0.1) - 2023/04/12 20:22:49
Table 'RushAndCash5644211' 6-max Seat #1 is the button
Seat 1: e2b096c ($26.29 in chips)
Seat 2: 175b4d0a ($8.96 in chips)
Seat 3: 1bfa336f ($25.87 in chips)
Seat 4: b33fc0a1 ($12.13 in chips)
Seat 5: Hero ($15.91 in chips)
Seat 6: 1bd3bc3d ($26.36 in chips)
175b4d0a: posts small blind $0.05
1bfa336f: posts big blind $0.1
*** HOLE CARDS ***
Dealt to e2b096c 
Dealt to 175b4d0a 
Dealt to 1bfa336f 
Dealt to b33fc0a1 
Dealt to Hero [Ks Qd]
Dealt to 1bd3bc3d 
b33fc0a1: folds
Hero: raises $0.15 to $0.25
1bd3bc3d: folds
e2b096c: folds
175b4d0a: folds
1bfa336f: calls $0.15
*** FLOP *** [2h Kh 7c]
1bfa336f: checks
Hero: bets $0.28
1bfa336f: folds
Uncalled bet ($0.28) returned to Hero
*** SHOWDOWN ***
Hero collected $0.53 from pot
*** SUMMARY ***
Total pot $0.55 | Rake $0.02 | Jackpot $0 | Bingo $0 | Fortune $0
Board [2h Kh 7c]
Seat 1: e2b096c (button) folded before Flop (didn't bet)
Seat 2: 175b4d0a (small blind) folded before Flop
Seat 3: 1bfa336f (big blind) folded on the Flop
Seat 4: b33fc0a1 folded before Flop (didn't bet)
Seat 5: Hero won ($0.53)
Seat 6: 1bd3bc3d folded before Flop (didn't bet)


Poker Hand #RC1468518832: Hold'em No Limit  ($0.05/$0.1) - 2023/04/12 20:22:33
Table 'RushAndCash5644092' 6-max Seat #1 is the button
Seat 1: 2dbced2f ($10 in chips)
Seat 2: 3db474fe ($10.4 in chips)
Seat 3: Hero ($16.01 in chips)
Seat 4: 5f771fd4 ($10 in chips)
Seat 5: 7ea645ce ($21.04 in chips)
Seat 6: f562e714 ($20.2 in chips)
3db474fe: posts small blind $0.05
Hero: posts big blind $0.1
*** HOLE CARDS ***
Dealt to 2dbced2f 
Dealt to 3db474fe 
Dealt to Hero [Kh 2d]
Dealt to 5f771fd4 
Dealt to 7ea645ce 
Dealt to f562e714 
5f771fd4: folds
7ea645ce: folds
f562e714: folds
2dbced2f: folds
3db474fe: calls $0.05
Hero: checks
*** FLOP *** [Ah 9c Ks]
3db474fe: bets $0.1
Hero: folds
Uncalled bet ($0.1) returned to 3db474fe
*** SHOWDOWN ***
3db474fe collected $0.19 from pot
*** SUMMARY ***
Total pot $0.2 | Rake $0.01 | Jackpot $0 | Bingo $0 | Fortune $0
Board [Ah 9c Ks]
Seat 1: 2dbced2f (button) folded before Flop (didn't bet)
Seat 2: 3db474fe (small blind) won ($0.19)
Seat 3: Hero (big blind) folded on the Flop
Seat 4: 5f771fd4 folded before Flop (didn't bet)
Seat 5: 7ea645ce folded before Flop (didn't bet)
Seat 6: f562e714 folded before Flop (didn't bet)


Poker Hand #RC1468518324: Hold'em No Limit  ($0.05/$0.1) - 2023/04/12 20:21:18
Table 'RushAndCash5643584' 6-max Seat #1 is the button
Seat 1: bda61405 ($9.93 in chips)
Seat 2: bacbd01c ($10.24 in chips)
Seat 3: Hero ($9.26 in chips)
Seat 4: e1ce2bc6 ($7.15 in chips)
Seat 5: ad456f0f ($12.44 in chips)
Seat 6: 9184a70c ($19.62 in chips)
bacbd01c: posts small blind $0.05
Hero: posts big blind $0.1
*** HOLE CARDS ***
Dealt to bda61405 
Dealt to bacbd01c 
Dealt to Hero [Ks Kc]
Dealt to e1ce2bc6 
Dealt to ad456f0f 
Dealt to 9184a70c 
e1ce2bc6: raises $0.15 to $0.25
ad456f0f: folds
9184a70c: folds
bda61405: folds
bacbd01c: folds
Hero: raises $0.7 to $0.95
e1ce2bc6: raises $1.47 to $2.42
Hero: raises $4.83 to $7.25
e1ce2bc6: calls $4.73 and is all-in
Uncalled bet ($0.1) returned to Hero
Hero: shows [Ks Kc]
e1ce2bc6: shows [Qs Qd]
*** FLOP *** [Kh As 6h]
*** TURN *** [Kh As 6h] [Jc]
*** RIVER *** [Kh As 6h Jc] [7h]
*** SHOWDOWN ***
Hero collected $13.9 from pot
*** SUMMARY ***
Total pot $14.35 | Rake $0.3 | Jackpot $0.15 | Bingo $0 | Fortune $0
Board [Kh As 6h Jc 7h]
Seat 1: bda61405 (button) folded before Flop (didn't bet)
Seat 2: bacbd01c (small blind) folded before Flop
Seat 3: Hero (big blind) showed [Ks Kc] and won ($13.9) with Three Kings
Seat 4: e1ce2bc6 showed [Qs Qd] and lost with Pair of Queens
Seat 5: ad456f0f folded before Flop (didn't bet)
Seat 6: 9184a70c folded before Flop (didn't bet)


Poker Hand #RC1468518262: Hold'em No Limit  ($0.05/$0.1) - 2023/04/12 20:21:09
Table 'RushAndCash5643522' 6-max Seat #1 is the button
Seat 1: Hero ($9.26 in chips)
Seat 2: e993246b ($16 in chips)
Seat 3: be7cb01 ($11.8 in chips)
Seat 4: af8346aa ($14.9 in chips)
Seat 5: 2a36911b ($13.78 in chips)
Seat 6: ebd59a32 ($28.17 in chips)
e993246b: posts small blind $0.05
be7cb01: posts big blind $0.1
*** HOLE CARDS ***
Dealt to Hero [2h Th]
Dealt to e993246b 
Dealt to be7cb01 
Dealt to af8346aa 
Dealt to 2a36911b 
Dealt to ebd59a32 
af8346aa: folds
2a36911b: folds
ebd59a32: raises $0.12 to $0.22
Hero: folds
e993246b: folds
be7cb01: raises $0.78 to $1
ebd59a32: folds
Uncalled bet ($0.78) returned to be7cb01
*** SHOWDOWN ***
be7cb01 collected $0.47 from pot
*** SUMMARY ***
Total pot $0.49 | Rake $0.02 | Jackpot $0 | Bingo $0 | Fortune $0
Seat 1: Hero (button) folded before Flop (didn't bet)
Seat 2: e993246b (small blind) folded before Flop
Seat 3: be7cb01 (big blind) collected ($0.47)
Seat 4: af8346aa folded before Flop (didn't bet)
Seat 5: 2a36911b folded before Flop (didn't bet)
Seat 6: ebd59a32 folded before Flop


Poker Hand #RC1468518234: Hold'em No Limit  ($0.05/$0.1) - 2023/04/12 20:21:05
Table 'RushAndCash5643494' 6-max Seat #1 is the button
Seat 1: e993246b ($16 in chips)
Seat 2: e890c622 ($16.74 in chips)
Seat 3: f60e92b5 ($2.98 in chips)
Seat 4: Hero ($9.26 in chips)
Seat 5: ece632f6 ($47.5 in chips)
Seat 6: 61f5628c ($11.36 in chips)
e890c622: posts small blind $0.05
f60e92b5: posts big blind $0.1
*** HOLE CARDS ***
Dealt to e993246b 
Dealt to e890c622 
Dealt to f60e92b5 
Dealt to Hero [Qs 3h]
Dealt to ece632f6 
Dealt to 61f5628c 
Hero: folds
ece632f6: raises $0.15 to $0.25
61f5628c: folds
e993246b: folds
e890c622: folds
f60e92b5: folds
Uncalled bet ($0.15) returned to ece632f6
*** SHOWDOWN ***
ece632f6 collected $0.25 from pot
*** SUMMARY ***
Total pot $0.25 | Rake $0 | Jackpot $0 | Bingo $0 | Fortune $0
Seat 1: e993246b (button) folded before Flop (didn't bet)
Seat 2: e890c622 (small blind) folded before Flop
Seat 3: f60e92b5 (big blind) folded before Flop
Seat 4: Hero folded before Flop (didn't bet)
Seat 5: ece632f6 collected ($0.25)
Seat 6: 61f5628c folded before Flop (didn't bet)


Poker Hand #RC1468518199: Hold'em No Limit  ($0.05/$0.1) - 2023/04/12 20:20:59
Table 'RushAndCash5643459' 6-max Seat #1 is the button
Seat 1: 6f973e4e ($10 in chips)
Seat 2: dfe9b225 ($8.99 in chips)
Seat 3: 94413495 ($12.71 in chips)
Seat 4: 50ce1268 ($25.32 in chips)
Seat 5: Hero ($9.26 in chips)
Seat 6: 453a5b2c ($27.48 in chips)
dfe9b225: posts small blind $0.05
94413495: posts big blind $0.1
*** HOLE CARDS ***
Dealt to 6f973e4e 
Dealt to dfe9b225 
Dealt to 94413495 
Dealt to 50ce1268 
Dealt to Hero [Qh 5c]
Dealt to 453a5b2c 
50ce1268: folds
Hero: folds
453a5b2c: folds
6f973e4e: raises $0.1 to $0.2
dfe9b225: folds
94413495: folds
Uncalled bet ($0.1) returned to 6f973e4e
*** SHOWDOWN ***
6f973e4e collected $0.25 from pot
*** SUMMARY ***
Total pot $0.25 | Rake $0 | Jackpot $0 | Bingo $0 | Fortune $0
Seat 1: 6f973e4e (button) collected ($0.25)
Seat 2: dfe9b225 (small blind) folded before Flop
Seat 3: 94413495 (big blind) folded before Flop
Seat 4: 50ce1268 folded before Flop (didn't bet)
Seat 5: Hero folded before Flop (didn't bet)
Seat 6: 453a5b2c folded before Flop (didn't bet)


Poker Hand #RC1468518134: Hold'em No Limit  ($0.05/$0.1) - 2023/04/12 20:20:49
Table 'RushAndCash5643394' 6-max Seat #1 is the button
Seat 1: 5f771fd4 ($10.29 in chips)
Seat 2: Hero ($9.31 in chips)
Seat 3: 657707dc ($7.41 in chips)
Seat 4: 2bf4fb2c ($11.11 in chips)
Seat 5: 1b08eafd ($11.53 in chips)
Seat 6: 5f2d2af ($10 in chips)
Hero: posts small blind $0.05
657707dc: posts big blind $0.1
*** HOLE CARDS ***
Dealt to 5f771fd4 
Dealt to Hero [Ks 6s]
Dealt to 657707dc 
Dealt to 2bf4fb2c 
Dealt to 1b08eafd 
Dealt to 5f2d2af 
2bf4fb2c: folds
1b08eafd: folds
5f2d2af: raises $0.2 to $0.3
5f771fd4: folds
Hero: folds
657707dc: calls $0.2
*** FLOP *** [3c 9h 4h]
657707dc: checks
5f2d2af: bets $0.45
657707dc: calls $0.45
*** TURN *** [3c 9h 4h] [6c]
657707dc: checks
5f2d2af: bets $1
657707dc: folds
Uncalled bet ($1) returned to 5f2d2af
*** SHOWDOWN ***
5f2d2af collected $1.48 from pot
*** SUMMARY ***
Total pot $1.55 | Rake $0.07 | Jackpot $0 | Bingo $0 | Fortune $0
Board [3c 9h 4h 6c]
Seat 1: 5f771fd4 (button) folded before Flop (didn't bet)
Seat 2: Hero (small blind) folded before Flop
Seat 3: 657707dc (big blind) folded on the Turn
Seat 4: 2bf4fb2c folded before Flop (didn't bet)
Seat 5: 1b08eafd folded before Flop (didn't bet)
Seat 6: 5f2d2af won ($1.48)


Poker Hand #RC1468518101: Hold'em No Limit  ($0.05/$0.1) - 2023/04/12 20:20:44
Table 'RushAndCash5643361' 6-max Seat #1 is the button
Seat 1: 84ae99a4 ($49.18 in chips)
Seat 2: dce1ab41 ($10.57 in chips)
Seat 3: 75982620 ($9.68 in chips)
Seat 4: 6731b985 ($11.09 in chips)
Seat 5: 8a37c1cd ($15.73 in chips)
Seat 6: Hero ($9.31 in chips)
dce1ab41: posts small blind $0.05
75982620: posts big blind $0.1
*** HOLE CARDS ***
Dealt to 84ae99a4 
Dealt to dce1ab41 
Dealt to 75982620 
Dealt to 6731b985 
Dealt to 8a37c1cd 
Dealt to Hero [3s Td]
6731b985: folds
8a37c1cd: folds
Hero: folds
84ae99a4: folds
dce1ab41: raises $0.2 to $0.3
75982620: folds
Uncalled bet ($0.2) returned to dce1ab41
*** SHOWDOWN ***
dce1ab41 collected $0.2 from pot
*** SUMMARY ***
Total pot $0.2 | Rake $0 | Jackpot $0 | Bingo $0 | Fortune $0
Seat 1: 84ae99a4 (button) folded before Flop (didn't bet)
Seat 2: dce1ab41 (small blind) collected ($0.2)
Seat 3: 75982620 (big blind) folded before Flop
Seat 4: 6731b985 folded before Flop (didn't bet)
Seat 5: 8a37c1cd folded before Flop (didn't bet)
Seat 6: Hero folded before Flop (didn't bet)


Poker Hand #RC1468518033: Hold'em No Limit  ($0.05/$0.1) - 2023/04/12 20:20:33
Table 'RushAndCash5643293' 6-max Seat #1 is the button
Seat 1: Hero ($9.31 in chips)
Seat 2: 16f2521a ($10.87 in chips)
Seat 3: 5aeaa886 ($52.17 in chips)
Seat 4: 7337880e ($5.82 in chips)
Seat 5: af9f76e1 ($31.34 in chips)
Seat 6: 9f3d0bed ($8.2 in chips)
16f2521a: posts small blind $0.05
5aeaa886: posts big blind $0.1
*** HOLE CARDS ***
Dealt to Hero [7d Kc]
Dealt to 16f2521a 
Dealt to 5aeaa886 
Dealt to 7337880e 
Dealt to af9f76e1 
Dealt to 9f3d0bed 
7337880e: raises $0.15 to $0.25
af9f76e1: folds
9f3d0bed: folds
Hero: folds
16f2521a: folds
5aeaa886: folds
Uncalled bet ($0.15) returned to 7337880e
*** SHOWDOWN ***
7337880e collected $0.25 from pot
*** SUMMARY ***
Total pot $0.25 | Rake $0 | Jackpot $0 | Bingo $0 | Fortune $0
Seat 1: Hero (button) folded before Flop (didn't bet)
Seat 2: 16f2521a (small blind) folded before Flop
Seat 3: 5aeaa886 (big blind) folded before Flop
Seat 4: 7337880e collected ($0.25)
Seat 5: af9f76e1 folded before Flop (didn't bet)
Seat 6: 9f3d0bed folded before Flop (didn't bet)


Poker Hand #RC1468517945: Hold'em No Limit  ($0.05/$0.1) - 2023/04/12 20:20:21
Table 'RushAndCash5643205' 6-max Seat #1 is the button
Seat 1: 90a824e2 ($10.58 in chips)
Seat 2: Hero ($9.36 in chips)
Seat 3: 1fe1fa8a ($10.99 in chips)
Seat 4: ff764f02 ($10 in chips)
Seat 5: 7c4c4ed8 ($12.8 in chips)
Seat 6: 89dd6b86 ($30.39 in chips)
Hero: posts small blind $0.05
1fe1fa8a: posts big blind $0.1
*** HOLE CARDS ***
Dealt to 90a824e2 
Dealt to Hero [4s 9h]
Dealt to 1fe1fa8a 
Dealt to ff764f02 
Dealt to 7c4c4ed8 
Dealt to 89dd6b86 
ff764f02: folds
7c4c4ed8: folds
89dd6b86: raises $0.15 to $0.25
90a824e2: raises $0.49 to $0.74
Hero: folds
1fe1fa8a: folds
89dd6b86: calls $0.49
*** FLOP *** [6s Ah 4d]
89dd6b86: checks
90a824e2: bets $0.4
89dd6b86: calls $0.4
*** TURN *** [6s Ah 4d] [Td]
89dd6b86: checks
90a824e2: checks
*** RIVER *** [6s Ah 4d Td] [Kc]
89dd6b86: checks
90a824e2: bets $1.22
89dd6b86: folds
Uncalled bet ($1.22) returned to 90a824e2
*** SHOWDOWN ***
90a824e2 collected $2.31 from pot
*** SUMMARY ***
Total pot $2.43 | Rake $0.12 | Jackpot $0 | Bingo $0 | Fortune $0
Board [6s Ah 4d Td Kc]
Seat 1: 90a824e2 (button) won ($2.31)
Seat 2: Hero (small blind) folded before Flop
Seat 3: 1fe1fa8a (big blind) folded before Flop
Seat 4: ff764f02 folded before Flop (didn't bet)
Seat 5: 7c4c4ed8 folded before Flop (didn't bet)
Seat 6: 89dd6b86 folded on the River


Poker Hand #RC1468517909: Hold'em No Limit  ($0.05/$0.1) - 2023/04/12 20:20:16
Table 'RushAndCash5643169' 6-max Seat #1 is the button
Seat 1: e56a7ec5 ($10.65 in chips)
Seat 2: 9cb9df83 ($12.76 in chips)
Seat 3: 1ddf185d ($35.51 in chips)
Seat 4: Hero ($9.36 in chips)
Seat 5: 3565b659 ($10.68 in chips)
Seat 6: 151df353 ($11.18 in chips)
9cb9df83: posts small blind $0.05
1ddf185d: posts big blind $0.1
*** HOLE CARDS ***
Dealt to e56a7ec5 
Dealt to 9cb9df83 
Dealt to 1ddf185d 
Dealt to Hero [5h 3d]
Dealt to 3565b659 
Dealt to 151df353 
Hero: folds
3565b659: folds
151df353: raises $0.15 to $0.25
e56a7ec5: calls $0.25
9cb9df83: folds
1ddf185d: folds
*** FLOP *** [8h Js 7c]
151df353: checks
e56a7ec5: bets $0.35
151df353: folds
Uncalled bet ($0.35) returned to e56a7ec5
*** SHOWDOWN ***
e56a7ec5 collected $0.62 from pot
*** SUMMARY ***
Total pot $0.65 | Rake $0.03 | Jackpot $0 | Bingo $0 | Fortune $0
Board [8h Js 7c]
Seat 1: e56a7ec5 (button) won ($0.62)
Seat 2: 9cb9df83 (small blind) folded before Flop
Seat 3: 1ddf185d (big blind) folded before Flop
Seat 4: Hero folded before Flop (didn't bet)
Seat 5: 3565b659 folded before Flop (didn't bet)
Seat 6: 151df353 folded on the Flop


Poker Hand #RC1468517868: Hold'em No Limit  ($0.05/$0.1) - 2023/04/12 20:20:10
Table 'RushAndCash5643128' 6-max Seat #1 is the button
Seat 1: a8fd0a2 ($23.37 in chips)
Seat 2: 64b56deb ($12.39 in chips)
Seat 3: 73b214f0 ($18.5 in chips)
Seat 4: be22c06b ($10.95 in chips)
Seat 5: bb03a8cb ($10 in chips)
Seat 6: Hero ($9.36 in chips)
64b56deb: posts small blind $0.05
73b214f0: posts big blind $0.1
*** HOLE CARDS ***
Dealt to a8fd0a2 
Dealt to 64b56deb 
Dealt to 73b214f0 
Dealt to be22c06b 
Dealt to bb03a8cb 
Dealt to Hero [Tc 7s]
be22c06b: folds
bb03a8cb: folds
Hero: folds
a8fd0a2: folds
64b56deb: calls $0.05
73b214f0: checks
*** FLOP *** [8d 3d 9h]
64b56deb: checks
73b214f0: bets $0.2
64b56deb: folds
Uncalled bet ($0.2) returned to 73b214f0
*** SHOWDOWN ***
73b214f0 collected $0.19 from pot
*** SUMMARY ***
Total pot $0.2 | Rake $0.01 | Jackpot $0 | Bingo $0 | Fortune $0
Board [8d 3d 9h]
Seat 1: a8fd0a2 (button) folded before Flop (didn't bet)
Seat 2: 64b56deb (small blind) folded on the Flop
Seat 3: 73b214f0 (big blind) won ($0.19)
Seat 4: be22c06b folded before Flop (didn't bet)
Seat 5: bb03a8cb folded before Flop (didn't bet)
Seat 6: Hero folded before Flop (didn't bet)


Poker Hand #RC1468517818: Hold'em No Limit  ($0.05/$0.1) - 2023/04/12 20:20:04
Table 'RushAndCash5643078' 6-max Seat #1 is the button
Seat 1: d515bbfc ($16.19 in chips)
Seat 2: 6a2cb94f ($10.16 in chips)
Seat 3: 4f3dda93 ($10 in chips)
Seat 4: f1210a3a ($10.51 in chips)
Seat 5: Hero ($9.36 in chips)
Seat 6: 99d0f955 ($10.16 in chips)
6a2cb94f: posts small blind $0.05
4f3dda93: posts big blind $0.1
*** HOLE CARDS ***
Dealt to d515bbfc 
Dealt to 6a2cb94f 
Dealt to 4f3dda93 
Dealt to f1210a3a 
Dealt to Hero [7s Ah]
Dealt to 99d0f955 
f1210a3a: raises $0.1 to $0.2
Hero: folds
99d0f955: folds
d515bbfc: folds
6a2cb94f: folds
4f3dda93: folds
Uncalled bet ($0.1) returned to f1210a3a
*** SHOWDOWN ***
f1210a3a collected $0.25 from pot
*** SUMMARY ***
Total pot $0.25 | Rake $0 | Jackpot $0 | Bingo $0 | Fortune $0
Seat 1: d515bbfc (button) folded before Flop (didn't bet)
Seat 2: 6a2cb94f (small blind) folded before Flop
Seat 3: 4f3dda93 (big blind) folded before Flop
Seat 4: f1210a3a collected ($0.25)
Seat 5: Hero folded before Flop (didn't bet)
Seat 6: 99d0f955 folded before Flop (didn't bet)


Poker Hand #RC1468517729: Hold'em No Limit  ($0.05/$0.1) - 2023/04/12 20:19:53
Table 'RushAndCash5642989' 6-max Seat #1 is the button
Seat 1: e1ce2bc6 ($6.62 in chips)
Seat 2: 56830f69 ($17.02 in chips)
Seat 3: 395d6489 ($14.55 in chips)
Seat 4: 28120b91 ($33.16 in chips)
Seat 5: Hero ($9.36 in chips)
Seat 6: 87e4509b ($5.41 in chips)
56830f69: posts small blind $0.05
395d6489: posts big blind $0.1
*** HOLE CARDS ***
Dealt to e1ce2bc6 
Dealt to 56830f69 
Dealt to 395d6489 
Dealt to 28120b91 
Dealt to Hero [Kh 4s]
Dealt to 87e4509b 
28120b91: folds
Hero: folds
87e4509b: calls $0.1
e1ce2bc6: folds
56830f69: folds
395d6489: checks
*** FLOP *** [Kd Ks 9s]
395d6489: checks
87e4509b: bets $0.2
395d6489: folds
Uncalled bet ($0.2) returned to 87e4509b
*** SHOWDOWN ***
87e4509b collected $0.24 from pot
*** SUMMARY ***
Total pot $0.25 | Rake $0.01 | Jackpot $0 | Bingo $0 | Fortune $0
Board [Kd Ks 9s]
Seat 1: e1ce2bc6 (button) folded before Flop (didn't bet)
Seat 2: 56830f69 (small blind) folded before Flop
Seat 3: 395d6489 (big blind) folded on the Flop
Seat 4: 28120b91 folded before Flop (didn't bet)
Seat 5: Hero folded before Flop (didn't bet)
Seat 6: 87e4509b won ($0.24)


Poker Hand #RC1468517686: Hold'em No Limit  ($0.05/$0.1) - 2023/04/12 20:19:47
Table 'RushAndCash5642946' 6-max Seat #1 is the button
Seat 1: e30d0961 ($10.56 in chips)
Seat 2: 6fc95293 ($13.74 in chips)
Seat 3: 3993f515 ($10.15 in chips)
Seat 4: 228c269b ($10.05 in chips)
Seat 5: Hero ($9.36 in chips)
Seat 6: 7c507e93 ($22.95 in chips)
6fc95293: posts small blind $0.05
3993f515: posts big blind $0.1
*** HOLE CARDS ***
Dealt to e30d0961 
Dealt to 6fc95293 
Dealt to 3993f515 
Dealt to 228c269b 
Dealt to Hero [3c 5s]
Dealt to 7c507e93 
228c269b: folds
Hero: folds
7c507e93: raises $0.15 to $0.25
e30d0961: folds
6fc95293: folds
3993f515: folds
Uncalled bet ($0.15) returned to 7c507e93
*** SHOWDOWN ***
7c507e93 collected $0.25 from pot
*** SUMMARY ***
Total pot $0.25 | Rake $0 | Jackpot $0 | Bingo $0 | Fortune $0
Seat 1: e30d0961 (button) folded before Flop (didn't bet)
Seat 2: 6fc95293 (small blind) folded before Flop
Seat 3: 3993f515 (big blind) folded before Flop
Seat 4: 228c269b folded before Flop (didn't bet)
Seat 5: Hero folded before Flop (didn't bet)
Seat 6: 7c507e93 collected ($0.25)


Poker Hand #RC1468517583: Hold'em No Limit  ($0.05/$0.1) - 2023/04/12 20:19:30
Table 'RushAndCash5642843' 6-max Seat #1 is the button
Seat 1: 29f16b6 ($9.85 in chips)
Seat 2: 788526ea ($9.9 in chips)
Seat 3: Hero ($9.46 in chips)
Seat 4: 58f27a02 ($13.9 in chips)
Seat 5: 5f90a7f9 ($10.64 in chips)
Seat 6: bab5c484 ($15.73 in chips)
788526ea: posts small blind $0.05
Hero: posts big blind $0.1
*** HOLE CARDS ***
Dealt to 29f16b6 
Dealt to 788526ea 
Dealt to Hero [6h 9c]
Dealt to 58f27a02 
Dealt to 5f90a7f9 
Dealt to bab5c484 
58f27a02: folds
5f90a7f9: folds
bab5c484: raises $0.2 to $0.3
29f16b6: folds
788526ea: folds
Hero: folds
Uncalled bet ($0.2) returned to bab5c484
*** SHOWDOWN ***
bab5c484 collected $0.25 from pot
*** SUMMARY ***
Total pot $0.25 | Rake $0 | Jackpot $0 | Bingo $0 | Fortune $0
Seat 1: 29f16b6 (button) folded before Flop (didn't bet)
Seat 2: 788526ea (small blind) folded before Flop
Seat 3: Hero (big blind) folded before Flop
Seat 4: 58f27a02 folded before Flop (didn't bet)
Seat 5: 5f90a7f9 folded before Flop (didn't bet)
Seat 6: bab5c484 collected ($0.25)


Poker Hand #RC1468517532: Hold'em No Limit  ($0.05/$0.1) - 2023/04/12 20:19:21
Table 'RushAndCash5642792' 6-max Seat #1 is the button
Seat 1: c699f643 ($11.71 in chips)
Seat 2: 11782e2e ($16.26 in chips)
Seat 3: 24d15127 ($9.73 in chips)
Seat 4: 8422d863 ($10.02 in chips)
Seat 5: 675acca2 ($18.9 in chips)
Seat 6: Hero ($9.46 in chips)
11782e2e: posts small blind $0.05
24d15127: posts big blind $0.1
*** HOLE CARDS ***
Dealt to c699f643 
Dealt to 11782e2e 
Dealt to 24d15127 
Dealt to 8422d863 
Dealt to 675acca2 
Dealt to Hero [6h Kd]
8422d863: folds
675acca2: raises $0.12 to $0.22
Hero: folds
c699f643: folds
11782e2e: folds
24d15127: calls $0.12
*** FLOP *** [Th 5c Qd]
24d15127: checks
675acca2: bets $0.17
24d15127: calls $0.17
*** TURN *** [Th 5c Qd] [3d]
24d15127: checks
675acca2: bets $0.42
24d15127: folds
Uncalled bet ($0.42) returned to 675acca2
*** SHOWDOWN ***
675acca2 collected $0.79 from pot
*** SUMMARY ***
Total pot $0.83 | Rake $0.04 | Jackpot $0 | Bingo $0 | Fortune $0
Board [Th 5c Qd 3d]
Seat 1: c699f643 (button) folded before Flop (didn't bet)
Seat 2: 11782e2e (small blind) folded before Flop
Seat 3: 24d15127 (big blind) folded on the Turn
Seat 4: 8422d863 folded before Flop (didn't bet)
Seat 5: 675acca2 won ($0.79)
Seat 6: Hero folded before Flop (didn't bet)


Poker Hand #RC1468517099: Hold'em No Limit  ($0.05/$0.1) - 2023/04/12 20:18:18
Table 'RushAndCash5642359' 6-max Seat #1 is the button
Seat 1: 24d15127 ($9.98 in chips)
Seat 2: 845cccfb ($18.46 in chips)
Seat 3: 675acca2 ($19.15 in chips)
Seat 4: 6a864416 ($13.9 in chips)
Seat 5: Hero ($8.95 in chips)
Seat 6: 17c2e1bf ($10 in chips)
845cccfb: posts small blind $0.05
675acca2: posts big blind $0.1
*** HOLE CARDS ***
Dealt to 24d15127 
Dealt to 845cccfb 
Dealt to 675acca2 
Dealt to 6a864416 
Dealt to Hero [Ac Kh]
Dealt to 17c2e1bf 
6a864416: folds
Hero: raises $0.15 to $0.25
17c2e1bf: folds
24d15127: calls $0.25
845cccfb: folds
675acca2: calls $0.15
*** FLOP *** [9d 7h 4c]
675acca2: checks
Hero: checks
24d15127: checks
*** TURN *** [9d 7h 4c] [5h]
675acca2: checks
Hero: checks
24d15127: checks
*** RIVER *** [9d 7h 4c 5h] [2s]
675acca2: checks
Hero: checks
24d15127: checks
675acca2: shows [Th Ah] (Ace-High)
Hero: shows [Ac Kh] (Ace-High)
24d15127: shows [Jh As] (Ace-High)
*** SHOWDOWN ***
Hero collected $0.76 from pot
*** SUMMARY ***
Total pot $0.8 | Rake $0.04 | Jackpot $0 | Bingo $0 | Fortune $0
Board [9d 7h 4c 5h 2s]
Seat 1: 24d15127 (button) showed [Jh As] and lost with Ace-High
Seat 2: 845cccfb (small blind) folded before Flop
Seat 3: 675acca2 (big blind) showed [Th Ah] and lost with Ace-High
Seat 4: 6a864416 folded before Flop (didn't bet)
Seat 5: Hero showed [Ac Kh] and won ($0.76) with Ace-High
Seat 6: 17c2e1bf folded before Flop (didn't bet)


Poker Hand #RC1468517061: Hold'em No Limit  ($0.05/$0.1) - 2023/04/12 20:18:14
Table 'RushAndCash5642321' 6-max Seat #1 is the button
Seat 1: Hero ($8.95 in chips)
Seat 2: 11f4e324 ($10 in chips)
Seat 3: 7b0eeb66 ($28.34 in chips)
Seat 4: f91770b0 ($10.58 in chips)
Seat 5: 834f1c7a ($14.52 in chips)
Seat 6: 9a542d3b ($10.07 in chips)
11f4e324: posts small blind $0.05
7b0eeb66: posts big blind $0.1
*** HOLE CARDS ***
Dealt to Hero [4d Jd]
Dealt to 11f4e324 
Dealt to 7b0eeb66 
Dealt to f91770b0 
Dealt to 834f1c7a 
Dealt to 9a542d3b 
f91770b0: folds
834f1c7a: calls $0.1
9a542d3b: folds
Hero: folds
11f4e324: folds
7b0eeb66: checks
*** FLOP *** [7c 3s Tc]
7b0eeb66: checks
834f1c7a: bets $0.8
7b0eeb66: calls $0.8
*** TURN *** [7c 3s Tc] [Qd]
7b0eeb66: checks
834f1c7a: checks
*** RIVER *** [7c 3s Tc Qd] [3d]
7b0eeb66: checks
834f1c7a: bets $0.93
7b0eeb66: calls $0.93
834f1c7a: shows [9h Th] (Pair of Tens and Pair of Treys)
7b0eeb66: shows [Kh Td] (Pair of Tens and Pair of Treys)
*** SHOWDOWN ***
7b0eeb66 collected $3.39 from pot
*** SUMMARY ***
Total pot $3.71 | Rake $0.17 | Jackpot $0.15 | Bingo $0 | Fortune $0
Board [7c 3s Tc Qd 3d]
Seat 1: Hero (button) folded before Flop (didn't bet)
Seat 2: 11f4e324 (small blind) folded before Flop
Seat 3: 7b0eeb66 (big blind) showed [Kh Td] and won ($3.39) with Pair of Tens and Pair of Treys
Seat 4: f91770b0 folded before Flop (didn't bet)
Seat 5: 834f1c7a showed [9h Th] and lost with Pair of Tens and Pair of Treys
Seat 6: 9a542d3b folded before Flop (didn't bet)


Poker Hand #RC1468517003: Hold'em No Limit  ($0.05/$0.1) - 2023/04/12 20:18:05
Table 'RushAndCash5642263' 6-max Seat #1 is the button
Seat 1: 5cd3b3ff ($2.78 in chips)
Seat 2: Hero ($9 in chips)
Seat 3: f2b01908 ($13.68 in chips)
Seat 4: 3a7c545c ($12.93 in chips)
Seat 5: cb634ea4 ($10.98 in chips)
Seat 6: 9f3d0bed ($9.85 in chips)
Hero: posts small blind $0.05
f2b01908: posts big blind $0.1
*** HOLE CARDS ***
Dealt to 5cd3b3ff 
Dealt to Hero [2h Td]
Dealt to f2b01908 
Dealt to 3a7c545c 
Dealt to cb634ea4 
Dealt to 9f3d0bed 
3a7c545c: folds
cb634ea4: folds
9f3d0bed: raises $0.15 to $0.25
5cd3b3ff: folds
Hero: folds
f2b01908: folds
Uncalled bet ($0.15) returned to 9f3d0bed
*** SHOWDOWN ***
9f3d0bed collected $0.25 from pot
*** SUMMARY ***
Total pot $0.25 | Rake $0 | Jackpot $0 | Bingo $0 | Fortune $0
Seat 1: 5cd3b3ff (button) folded before Flop (didn't bet)
Seat 2: Hero (small blind) folded before Flop
Seat 3: f2b01908 (big blind) folded before Flop
Seat 4: 3a7c545c folded before Flop (didn't bet)
Seat 5: cb634ea4 folded before Flop (didn't bet)
Seat 6: 9f3d0bed collected ($0.25)


Poker Hand #RC1468516512: Hold'em No Limit  ($0.05/$0.1) - 2023/04/12 20:16:50
Table 'RushAndCash5641772' 6-max Seat #1 is the button
Seat 1: Hero ($9 in chips)
Seat 2: 73bb4504 ($13.35 in chips)
Seat 3: 4f4a9fff ($12.96 in chips)
Seat 4: 3c761ec9 ($2.42 in chips)
Seat 5: 3993f515 ($10 in chips)
Seat 6: 69ea70e ($19.67 in chips)
73bb4504: posts small blind $0.05
4f4a9fff: posts big blind $0.1
*** HOLE CARDS ***
Dealt to Hero [5d Jh]
Dealt to 73bb4504 
Dealt to 4f4a9fff 
Dealt to 3c761ec9 
Dealt to 3993f515 
Dealt to 69ea70e 
3c761ec9: calls $0.1
3993f515: folds
69ea70e: raises $0.1 to $0.2
Hero: folds
73bb4504: folds
4f4a9fff: folds
3c761ec9: raises $0.19 to $0.39
69ea70e: calls $0.19
*** FLOP *** [8h 3h 2s]
3c761ec9: bets $0.7
69ea70e: folds
Uncalled bet ($0.7) returned to 3c761ec9
*** SHOWDOWN ***
3c761ec9 collected $0.89 from pot
*** SUMMARY ***
Total pot $0.93 | Rake $0.04 | Jackpot $0 | Bingo $0 | Fortune $0
Board [8h 3h 2s]
Seat 1: Hero (button) folded before Flop (didn't bet)
Seat 2: 73bb4504 (small blind) folded before Flop
Seat 3: 4f4a9fff (big blind) folded before Flop
Seat 4: 3c761ec9 won ($0.89)
Seat 5: 3993f515 folded before Flop (didn't bet)
Seat 6: 69ea70e folded on the Flop


Poker Hand #RC1468516211: Hold'em No Limit  ($0.05/$0.1) - 2023/04/12 20:16:02
Table 'RushAndCash5641471' 6-max Seat #1 is the button
Seat 1: f1ef9ba6 ($15.33 in chips)
Seat 2: 7c0743ba ($16.52 in chips)
Seat 3: Hero ($8.77 in chips)
Seat 4: f4056998 ($15.07 in chips)
Seat 5: 59a9bc80 ($20.52 in chips)
Seat 6: 5c3d5a26 ($13.21 in chips)
7c0743ba: posts small blind $0.05
Hero: posts big blind $0.1
*** HOLE CARDS ***
Dealt to f1ef9ba6 
Dealt to 7c0743ba 
Dealt to Hero [Ac Ah]
Dealt to f4056998 
Dealt to 59a9bc80 
Dealt to 5c3d5a26 
f4056998: folds
59a9bc80: folds
5c3d5a26: folds
f1ef9ba6: folds
7c0743ba: raises $0.15 to $0.25
Hero: raises $0.43 to $0.68
7c0743ba: folds
Uncalled bet ($0.43) returned to Hero
*** SHOWDOWN ***
Hero collected $0.48 from pot
*** SUMMARY ***
Total pot $0.5 | Rake $0.02 | Jackpot $0 | Bingo $0 | Fortune $0
Seat 1: f1ef9ba6 (button) folded before Flop (didn't bet)
Seat 2: 7c0743ba (small blind) folded before Flop
Seat 3: Hero (big blind) collected ($0.48)
Seat 4: f4056998 folded before Flop (didn't bet)
Seat 5: 59a9bc80 folded before Flop (didn't bet)
Seat 6: 5c3d5a26 folded before Flop (didn't bet)


Poker Hand #RC1468516180: Hold'em No Limit  ($0.05/$0.1) - 2023/04/12 20:15:58
Table 'RushAndCash5641440' 6-max Seat #1 is the button
Seat 1: d21a5b36 ($10.18 in chips)
Seat 2: 8201bb47 ($10.3 in chips)
Seat 3: 5abbddb9 ($11.83 in chips)
Seat 4: Hero ($8.77 in chips)
Seat 5: 558b160d ($10 in chips)
Seat 6: 151df353 ($10.91 in chips)
8201bb47: posts small blind $0.05
5abbddb9: posts big blind $0.1
*** HOLE CARDS ***
Dealt to d21a5b36 
Dealt to 8201bb47 
Dealt to 5abbddb9 
Dealt to Hero [Td Qc]
Dealt to 558b160d 
Dealt to 151df353 
Hero: folds
558b160d: folds
151df353: folds
d21a5b36: folds
8201bb47: folds
Uncalled bet ($0.05) returned to 5abbddb9
*** SHOWDOWN ***
5abbddb9 collected $0.1 from pot
*** SUMMARY ***
Total pot $0.1 | Rake $0 | Jackpot $0 | Bingo $0 | Fortune $0
Seat 1: d21a5b36 (button) folded before Flop (didn't bet)
Seat 2: 8201bb47 (small blind) folded before Flop
Seat 3: 5abbddb9 (big blind) collected ($0.1)
Seat 4: Hero folded before Flop (didn't bet)
Seat 5: 558b160d folded before Flop (didn't bet)
Seat 6: 151df353 folded before Flop (didn't bet)


Poker Hand #RC1468516118: Hold'em No Limit  ($0.05/$0.1) - 2023/04/12 20:15:49
Table 'RushAndCash5641378' 6-max Seat #1 is the button
Seat 1: c16d9eef ($10.13 in chips)
Seat 2: a4df0197 ($10 in chips)
Seat 3: e890c622 ($16.25 in chips)
Seat 4: 5aeaa886 ($49.28 in chips)
Seat 5: 8265d782 ($10 in chips)
Seat 6: Hero ($8.77 in chips)
a4df0197: posts small blind $0.05
e890c622: posts big blind $0.1
*** HOLE CARDS ***
Dealt to c16d9eef 
Dealt to a4df0197 
Dealt to e890c622 
Dealt to 5aeaa886 
Dealt to 8265d782 
Dealt to Hero [2h 7s]
5aeaa886: folds
8265d782: folds
Hero: folds
c16d9eef: raises $0.1 to $0.2
a4df0197: folds
e890c622: calls $0.1
*** FLOP *** [8s 9h 2d]
e890c622: checks
c16d9eef: bets $0.34
e890c622: calls $0.34
*** TURN *** [8s 9h 2d] [Ac]
e890c622: checks
c16d9eef: bets $0.38
e890c622: folds
Uncalled bet ($0.38) returned to c16d9eef
*** SHOWDOWN ***
c16d9eef collected $1.08 from pot
*** SUMMARY ***
Total pot $1.13 | Rake $0.05 | Jackpot $0 | Bingo $0 | Fortune $0
Board [8s 9h 2d Ac]
Seat 1: c16d9eef (button) won ($1.08)
Seat 2: a4df0197 (small blind) folded before Flop
Seat 3: e890c622 (big blind) folded on the Turn
Seat 4: 5aeaa886 folded before Flop (didn't bet)
Seat 5: 8265d782 folded before Flop (didn't bet)
Seat 6: Hero folded before Flop (didn't bet)


Poker Hand #RC1468516033: Hold'em No Limit  ($0.05/$0.1) - 2023/04/12 20:15:36
Table 'RushAndCash5641293' 6-max Seat #1 is the button
Seat 1: Hero ($8.77 in chips)
Seat 2: 12989685 ($13.15 in chips)
Seat 3: a84e6d0a ($25.16 in chips)
Seat 4: bc2622a4 ($10 in chips)
Seat 5: 8c14a2e9 ($12.98 in chips)
Seat 6: b33fc0a1 ($7.84 in chips)
12989685: posts small blind $0.05
a84e6d0a: posts big blind $0.1
*** HOLE CARDS ***
Dealt to Hero [5d 3h]
Dealt to 12989685 
Dealt to a84e6d0a 
Dealt to bc2622a4 
Dealt to 8c14a2e9 
Dealt to b33fc0a1 
bc2622a4: folds
8c14a2e9: folds
b33fc0a1: folds
Hero: folds
12989685: folds
Uncalled bet ($0.05) returned to a84e6d0a
*** SHOWDOWN ***
a84e6d0a collected $0.1 from pot
*** SUMMARY ***
Total pot $0.1 | Rake $0 | Jackpot $0 | Bingo $0 | Fortune $0
Seat 1: Hero (button) folded before Flop (didn't bet)
Seat 2: 12989685 (small blind) folded before Flop
Seat 3: a84e6d0a (big blind) collected ($0.1)
Seat 4: bc2622a4 folded before Flop (didn't bet)
Seat 5: 8c14a2e9 folded before Flop (didn't bet)
Seat 6: b33fc0a1 folded before Flop (didn't bet)


Poker Hand #RC1468515831: Hold'em No Limit  ($0.05/$0.1) - 2023/04/12 20:15:06
Table 'RushAndCash5641091' 6-max Seat #1 is the button
Seat 1: 9eff61da ($12.62 in chips)
Seat 2: 95c853c0 ($9.81 in chips)
Seat 3: Hero ($8.49 in chips)
Seat 4: 25fdd2c9 ($18.81 in chips)
Seat 5: 856c7f5e ($20.99 in chips)
Seat 6: 4ad160bb ($10.7 in chips)
95c853c0: posts small blind $0.05
Hero: posts big blind $0.1
*** HOLE CARDS ***
Dealt to 9eff61da 
Dealt to 95c853c0 
Dealt to Hero [Kh Kd]
Dealt to 25fdd2c9 
Dealt to 856c7f5e 
Dealt to 4ad160bb 
25fdd2c9: folds
856c7f5e: folds
4ad160bb: raises $0.15 to $0.25
9eff61da: folds
95c853c0: folds
Hero: raises $0.75 to $1
4ad160bb: folds
Uncalled bet ($0.75) returned to Hero
*** SHOWDOWN ***
Hero collected $0.53 from pot
*** SUMMARY ***
Total pot $0.55 | Rake $0.02 | Jackpot $0 | Bingo $0 | Fortune $0
Seat 1: 9eff61da (button) folded before Flop (didn't bet)
Seat 2: 95c853c0 (small blind) folded before Flop
Seat 3: Hero (big blind) collected ($0.53)
Seat 4: 25fdd2c9 folded before Flop (didn't bet)
Seat 5: 856c7f5e folded before Flop (didn't bet)
Seat 6: 4ad160bb folded before Flop


Poker Hand #RC1468515702: Hold'em No Limit  ($0.05/$0.1) - 2023/04/12 20:14:46
Table 'RushAndCash5640962' 6-max Seat #1 is the button
Seat 1: ed31397e ($23.98 in chips)
Seat 2: 7324a1a7 ($10.15 in chips)
Seat 3: 5cd3b3ff ($6.12 in chips)
Seat 4: Hero ($8.49 in chips)
Seat 5: 621ac3c5 ($11.51 in chips)
Seat 6: d7bba46a ($19.45 in chips)
7324a1a7: posts small blind $0.05
5cd3b3ff: posts big blind $0.1
*** HOLE CARDS ***
Dealt to ed31397e 
Dealt to 7324a1a7 
Dealt to 5cd3b3ff 
Dealt to Hero [7s 8c]
Dealt to 621ac3c5 
Dealt to d7bba46a 
Hero: folds
621ac3c5: folds
d7bba46a: folds
ed31397e: raises $0.15 to $0.25
7324a1a7: folds
5cd3b3ff: calls $0.15
*** FLOP *** [Ad 9s 3c]
5cd3b3ff: checks
ed31397e: checks
*** TURN *** [Ad 9s 3c] [4h]
5cd3b3ff: checks
ed31397e: checks
*** RIVER *** [Ad 9s 3c 4h] [Js]
5cd3b3ff: bets $0.42
ed31397e: folds
Uncalled bet ($0.42) returned to 5cd3b3ff
*** SHOWDOWN ***
5cd3b3ff collected $0.53 from pot
*** SUMMARY ***
Total pot $0.55 | Rake $0.02 | Jackpot $0 | Bingo $0 | Fortune $0
Board [Ad 9s 3c 4h Js]
Seat 1: ed31397e (button) folded on the River
Seat 2: 7324a1a7 (small blind) folded before Flop
Seat 3: 5cd3b3ff (big blind) won ($0.53)
Seat 4: Hero folded before Flop (didn't bet)
Seat 5: 621ac3c5 folded before Flop (didn't bet)
Seat 6: d7bba46a folded before Flop (didn't bet)


Poker Hand #RC1468515645: Hold'em No Limit  ($0.05/$0.1) - 2023/04/12 20:14:38
Table 'RushAndCash5640905' 6-max Seat #1 is the button
Seat 1: 3a2d2163 ($17.46 in chips)
Seat 2: Hero ($8.54 in chips)
Seat 3: fe9635b ($5.69 in chips)
Seat 4: 7da14548 ($29.86 in chips)
Seat 5: a57f4f73 ($9.57 in chips)
Seat 6: 845cccfb ($17.66 in chips)
Hero: posts small blind $0.05
fe9635b: posts big blind $0.1
*** HOLE CARDS ***
Dealt to 3a2d2163 
Dealt to Hero [3s 6c]
Dealt to fe9635b 
Dealt to 7da14548 
Dealt to a57f4f73 
Dealt to 845cccfb 
7da14548: calls $0.1
a57f4f73: folds
845cccfb: folds
3a2d2163: folds
Hero: folds
fe9635b: checks
*** FLOP *** [Ac Ks 2h]
fe9635b: checks
7da14548: bets $0.1
fe9635b: folds
Uncalled bet ($0.1) returned to 7da14548
*** SHOWDOWN ***
7da14548 collected $0.24 from pot
*** SUMMARY ***
Total pot $0.25 | Rake $0.01 | Jackpot $0 | Bingo $0 | Fortune $0
Board [Ac Ks 2h]
Seat 1: 3a2d2163 (button) folded before Flop (didn't bet)
Seat 2: Hero (small blind) folded before Flop
Seat 3: fe9635b (big blind) folded on the Flop
Seat 4: 7da14548 won ($0.24)
Seat 5: a57f4f73 folded before Flop (didn't bet)
Seat 6: 845cccfb folded before Flop (didn't bet)


Poker Hand #RC1468515593: Hold'em No Limit  ($0.05/$0.1) - 2023/04/12 20:14:31
Table 'RushAndCash5640853' 6-max Seat #1 is the button
Seat 1: 70b35c60 ($11.41 in chips)
Seat 2: 9ad1b1c5 ($9.2 in chips)
Seat 3: 12989685 ($13 in chips)
Seat 4: 96c91b50 ($8.44 in chips)
Seat 5: Hero ($8.54 in chips)
Seat 6: b5d23219 ($8.04 in chips)
9ad1b1c5: posts small blind $0.05
12989685: posts big blind $0.1
*** HOLE CARDS ***
Dealt to 70b35c60 
Dealt to 9ad1b1c5 
Dealt to 12989685 
Dealt to 96c91b50 
Dealt to Hero [5d Ks]
Dealt to b5d23219 
96c91b50: folds
Hero: folds
b5d23219: folds
70b35c60: folds
9ad1b1c5: folds
Uncalled bet ($0.05) returned to 12989685
*** SHOWDOWN ***
12989685 collected $0.1 from pot
*** SUMMARY ***
Total pot $0.1 | Rake $0 | Jackpot $0 | Bingo $0 | Fortune $0
Seat 1: 70b35c60 (button) folded before Flop (didn't bet)
Seat 2: 9ad1b1c5 (small blind) folded before Flop
Seat 3: 12989685 (big blind) collected ($0.1)
Seat 4: 96c91b50 folded before Flop (didn't bet)
Seat 5: Hero folded before Flop (didn't bet)
Seat 6: b5d23219 folded before Flop (didn't bet)


Poker Hand #RC1468515233: Hold'em No Limit  ($0.05/$0.1) - 2023/04/12 20:13:40
Table 'RushAndCash5640493' 6-max Seat #1 is the button
Seat 1: 96078acc ($13.69 in chips)
Seat 2: 28bebede ($19.9 in chips)
Seat 3: Hero ($8.96 in chips)
Seat 4: 10368913 ($11.72 in chips)
Seat 5: 5741655e ($11.45 in chips)
Seat 6: 9ad8e031 ($7.13 in chips)
28bebede: posts small blind $0.05
Hero: posts big blind $0.1
*** HOLE CARDS ***
Dealt to 96078acc 
Dealt to 28bebede 
Dealt to Hero [3h Ah]
Dealt to 10368913 
Dealt to 5741655e 
Dealt to 9ad8e031 
10368913: folds
5741655e: folds
9ad8e031: folds
96078acc: raises $0.14 to $0.24
28bebede: folds
Hero: calls $0.14
*** FLOP *** [3s 5d Kc]
Hero: checks
96078acc: bets $0.18
Hero: calls $0.18
*** TURN *** [3s 5d Kc] [9c]
Hero: checks
96078acc: bets $0.4
Hero: folds
Uncalled bet ($0.4) returned to 96078acc
*** SHOWDOWN ***
96078acc collected $0.84 from pot
*** SUMMARY ***
Total pot $0.89 | Rake $0.05 | Jackpot $0 | Bingo $0 | Fortune $0
Board [3s 5d Kc 9c]
Seat 1: 96078acc (button) won ($0.84)
Seat 2: 28bebede (small blind) folded before Flop
Seat 3: Hero (big blind) folded on the Turn
Seat 4: 10368913 folded before Flop (didn't bet)
Seat 5: 5741655e folded before Flop (didn't bet)
Seat 6: 9ad8e031 folded before Flop (didn't bet)


Poker Hand #RC1468514908: Hold'em No Limit  ($0.05/$0.1) - 2023/04/12 20:12:50
Table 'RushAndCash5640168' 6-max Seat #1 is the button
Seat 1: 8c7fd7ce ($21.54 in chips)
Seat 2: 3bf969ff ($17.48 in chips)
Seat 3: Hero ($8.73 in chips)
Seat 4: 1270374a ($9.9 in chips)
Seat 5: 9ad8e031 ($7.33 in chips)
Seat 6: 85c99be5 ($10.01 in chips)
3bf969ff: posts small blind $0.05
Hero: posts big blind $0.1
*** HOLE CARDS ***
Dealt to 8c7fd7ce 
Dealt to 3bf969ff 
Dealt to Hero [Js 8s]
Dealt to 1270374a 
Dealt to 9ad8e031 
Dealt to 85c99be5 
1270374a: folds
9ad8e031: raises $0.1 to $0.2
85c99be5: folds
8c7fd7ce: folds
3bf969ff: folds
Hero: calls $0.1
*** FLOP *** [Qh Ks Jh]
Hero: checks
9ad8e031: checks
*** TURN *** [Qh Ks Jh] [Qc]
Hero: checks
9ad8e031: checks
*** RIVER *** [Qh Ks Jh Qc] [Ts]
Hero: checks
9ad8e031: checks
Hero: shows [Js 8s] (Pair of Queens and Pair of Jacks)
9ad8e031: shows [5h 6h] (Pair of Queens)
*** SHOWDOWN ***
Hero collected $0.43 from pot
*** SUMMARY ***
Total pot $0.45 | Rake $0.02 | Jackpot $0 | Bingo $0 | Fortune $0
Board [Qh Ks Jh Qc Ts]
Seat 1: 8c7fd7ce (button) folded before Flop (didn't bet)
Seat 2: 3bf969ff (small blind) folded before Flop
Seat 3: Hero (big blind) showed [Js 8s] and won ($0.43) with Pair of Queens and Pair of Jacks
Seat 4: 1270374a folded before Flop (didn't bet)
Seat 5: 9ad8e031 showed [5h 6h] and lost with Pair of Queens
Seat 6: 85c99be5 folded before Flop (didn't bet)


Poker Hand #RC1468514850: Hold'em No Limit  ($0.05/$0.1) - 2023/04/12 20:12:41
Table 'RushAndCash5640110' 6-max Seat #1 is the button
Seat 1: e1e70277 ($13.54 in chips)
Seat 2: Hero ($8.78 in chips)
Seat 3: 70b35c60 ($11.56 in chips)
Seat 4: f0edb76 ($5.61 in chips)
Seat 5: 27df0055 ($44.8 in chips)
Seat 6: fdbc3c51 ($10 in chips)
Hero: posts small blind $0.05
70b35c60: posts big blind $0.1
*** HOLE CARDS ***
Dealt to e1e70277 
Dealt to Hero [Qh 4c]
Dealt to 70b35c60 
Dealt to f0edb76 
Dealt to 27df0055 
Dealt to fdbc3c51 
f0edb76: raises $0.2 to $0.3
27df0055: raises $0.6 to $0.9
fdbc3c51: folds
e1e70277: folds
Hero: folds
70b35c60: folds
f0edb76: calls $0.6
*** FLOP *** [Jc 2c 7d]
f0edb76: checks
27df0055: checks
*** TURN *** [Jc 2c 7d] [8d]
f0edb76: bets $0.65
27df0055: folds
Uncalled bet ($0.65) returned to f0edb76
*** SHOWDOWN ***
f0edb76 collected $1.86 from pot
*** SUMMARY ***
Total pot $1.95 | Rake $0.09 | Jackpot $0 | Bingo $0 | Fortune $0
Board [Jc 2c 7d 8d]
Seat 1: e1e70277 (button) folded before Flop (didn't bet)
Seat 2: Hero (small blind) folded before Flop
Seat 3: 70b35c60 (big blind) folded before Flop
Seat 4: f0edb76 won ($1.86)
Seat 5: 27df0055 folded on the Turn
Seat 6: fdbc3c51 folded before Flop (didn't bet)


Poker Hand #RC1468514804: Hold'em No Limit  ($0.05/$0.1) - 2023/04/12 20:12:34
Table 'RushAndCash5640064' 6-max Seat #1 is the button
Seat 1: de2bd812 ($16.35 in chips)
Seat 2: b0c50057 ($25.93 in chips)
Seat 3: 87a60c0d ($12.15 in chips)
Seat 4: 7e2a88c4 ($9.63 in chips)
Seat 5: Hero ($8.78 in chips)
Seat 6: 7e259126 ($10 in chips)
b0c50057: posts small blind $0.05
87a60c0d: posts big blind $0.1
*** HOLE CARDS ***
Dealt to de2bd812 
Dealt to b0c50057 
Dealt to 87a60c0d 
Dealt to 7e2a88c4 
Dealt to Hero [8d 5c]
Dealt to 7e259126 
7e2a88c4: raises $0.12 to $0.22
Hero: folds
7e259126: calls $0.22
de2bd812: folds
b0c50057: folds
87a60c0d: folds
*** FLOP *** [9d Jd Tc]
7e2a88c4: bets $0.3
7e259126: calls $0.3
*** TURN *** [9d Jd Tc] [2h]
7e2a88c4: bets $0.9
7e259126: calls $0.9
*** RIVER *** [9d Jd Tc 2h] [Qc]
7e2a88c4: bets $0.99
7e259126: folds
Uncalled bet ($0.99) returned to 7e2a88c4
*** SHOWDOWN ***
7e2a88c4 collected $2.84 from pot
*** SUMMARY ***
Total pot $2.99 | Rake $0.15 | Jackpot $0 | Bingo $0 | Fortune $0
Board [9d Jd Tc 2h Qc]
Seat 1: de2bd812 (button) folded before Flop (didn't bet)
Seat 2: b0c50057 (small blind) folded before Flop
Seat 3: 87a60c0d (big blind) folded before Flop
Seat 4: 7e2a88c4 won ($2.84)
Seat 5: Hero folded before Flop (didn't bet)
Seat 6: 7e259126 folded on the River


Poker Hand #RC1468514776: Hold'em No Limit  ($0.05/$0.1) - 2023/04/12 20:12:30
Table 'RushAndCash5640036' 6-max Seat #1 is the button
Seat 1: a8ee82b3 ($10 in chips)
Seat 2: 57e1fa5 ($14.38 in chips)
Seat 3: a1965f04 ($10.69 in chips)
Seat 4: 84d649e7 ($10.06 in chips)
Seat 5: 21843fff ($9.82 in chips)
Seat 6: Hero ($8.78 in chips)
57e1fa5: posts small blind $0.05
a1965f04: posts big blind $0.1
*** HOLE CARDS ***
Dealt to a8ee82b3 
Dealt to 57e1fa5 
Dealt to a1965f04 
Dealt to 84d649e7 
Dealt to 21843fff 
Dealt to Hero [5d 4c]
84d649e7: folds
21843fff: raises $0.1 to $0.2
Hero: folds
a8ee82b3: folds
57e1fa5: folds
a1965f04: folds
Uncalled bet ($0.1) returned to 21843fff
*** SHOWDOWN ***
21843fff collected $0.25 from pot
*** SUMMARY ***
Total pot $0.25 | Rake $0 | Jackpot $0 | Bingo $0 | Fortune $0
Seat 1: a8ee82b3 (button) folded before Flop (didn't bet)
Seat 2: 57e1fa5 (small blind) folded before Flop
Seat 3: a1965f04 (big blind) folded before Flop
Seat 4: 84d649e7 folded before Flop (didn't bet)
Seat 5: 21843fff collected ($0.25)
Seat 6: Hero folded before Flop (didn't bet)


Poker Hand #RC1468484740: Hold'em No Limit  ($0.05/$0.1) - 2023/04/12 20:12:24
Table 'RushAndCash5640000' 6-max Seat #1 is the button
Seat 1: Hero ($8.78 in chips)
Seat 2: 7b6a87a3 ($10.93 in chips)
Seat 3: 277b779 ($15.76 in chips)
Seat 4: 7ea645ce ($19.3 in chips)
Seat 5: ef15a3f4 ($9.32 in chips)
Seat 6: 5aeaa886 ($48.83 in chips)
7b6a87a3: posts small blind $0.05
277b779: posts big blind $0.1
*** HOLE CARDS ***
Dealt to Hero [Kd 5c]
Dealt to 7b6a87a3 
Dealt to 277b779 
Dealt to 7ea645ce 
Dealt to ef15a3f4 
Dealt to 5aeaa886 
7ea645ce: folds
ef15a3f4: folds
5aeaa886: raises $0.15 to $0.25
Hero: folds
7b6a87a3: folds
277b779: calls $0.15
*** FLOP *** [2d 4s Jc]
277b779: checks
5aeaa886: bets $0.19
277b779: raises $0.38 to $0.57
5aeaa886: calls $0.38
*** TURN *** [2d 4s Jc] [5d]
277b779: checks
5aeaa886: bets $1.12
277b779: folds
Uncalled bet ($1.12) returned to 5aeaa886
*** SHOWDOWN ***
5aeaa886 collected $1.59 from pot
*** SUMMARY ***
Total pot $1.69 | Rake $0.1 | Jackpot $0 | Bingo $0 | Fortune $0
Board [2d 4s Jc 5d]
Seat 1: Hero (button) folded before Flop (didn't bet)
Seat 2: 7b6a87a3 (small blind) folded before Flop
Seat 3: 277b779 (big blind) folded on the Turn
Seat 4: 7ea645ce folded before Flop (didn't bet)
Seat 5: ef15a3f4 folded before Flop (didn't bet)
Seat 6: 5aeaa886 won ($1.59)


Poker Hand #RC1468484711: Hold'em No Limit  ($0.05/$0.1) - 2023/04/12 20:12:19
Table 'RushAndCash5639971' 6-max Seat #1 is the button
Seat 1: 1ddf185d ($36.8 in chips)
Seat 2: 1d817480 ($10.13 in chips)
Seat 3: 8dd6c8de ($5.23 in chips)
Seat 4: 3a0b1130 ($34.66 in chips)
Seat 5: Hero ($8.78 in chips)
Seat 6: a8006b6a ($10.15 in chips)
1d817480: posts small blind $0.05
8dd6c8de: posts big blind $0.1
*** HOLE CARDS ***
Dealt to 1ddf185d 
Dealt to 1d817480 
Dealt to 8dd6c8de 
Dealt to 3a0b1130 
Dealt to Hero [2h 5c]
Dealt to a8006b6a 
3a0b1130: folds
Hero: folds
a8006b6a: folds
1ddf185d: raises $0.1 to $0.2
1d817480: folds
8dd6c8de: folds
Uncalled bet ($0.1) returned to 1ddf185d
*** SHOWDOWN ***
1ddf185d collected $0.25 from pot
*** SUMMARY ***
Total pot $0.25 | Rake $0 | Jackpot $0 | Bingo $0 | Fortune $0
Seat 1: 1ddf185d (button) collected ($0.25)
Seat 2: 1d817480 (small blind) folded before Flop
Seat 3: 8dd6c8de (big blind) folded before Flop
Seat 4: 3a0b1130 folded before Flop (didn't bet)
Seat 5: Hero folded before Flop (didn't bet)
Seat 6: a8006b6a folded before Flop (didn't bet)


Poker Hand #RC1468484636: Hold'em No Limit  ($0.05/$0.1) - 2023/04/12 20:12:09
Table 'RushAndCash5639896' 6-max Seat #1 is the button
Seat 1: Hero ($8.78 in chips)
Seat 2: 84d649e7 ($10.16 in chips)
Seat 3: eab214be ($17.59 in chips)
Seat 4: e1ee5383 ($12.18 in chips)
Seat 5: 6d8fecca ($10.22 in chips)
Seat 6: a2f03845 ($13.55 in chips)
84d649e7: posts small blind $0.05
eab214be: posts big blind $0.1
*** HOLE CARDS ***
Dealt to Hero [7c Js]
Dealt to 84d649e7 
Dealt to eab214be 
Dealt to e1ee5383 
Dealt to 6d8fecca 
Dealt to a2f03845 
e1ee5383: folds
6d8fecca: folds
a2f03845: raises $0.15 to $0.25
Hero: folds
84d649e7: folds
eab214be: folds
Uncalled bet ($0.15) returned to a2f03845
*** SHOWDOWN ***
a2f03845 collected $0.25 from pot
*** SUMMARY ***
Total pot $0.25 | Rake $0 | Jackpot $0 | Bingo $0 | Fortune $0
Seat 1: Hero (button) folded before Flop (didn't bet)
Seat 2: 84d649e7 (small blind) folded before Flop
Seat 3: eab214be (big blind) folded before Flop
Seat 4: e1ee5383 folded before Flop (didn't bet)
Seat 5: 6d8fecca folded before Flop (didn't bet)
Seat 6: a2f03845 collected ($0.25)


Poker Hand #RC1468484208: Hold'em No Limit  ($0.05/$0.1) - 2023/04/12 20:11:04
Table 'RushAndCash5639468' 6-max Seat #1 is the button
Seat 1: 5cd3b3ff ($9.52 in chips)
Seat 2: f5068bd1 ($12.05 in chips)
Seat 3: Hero ($10.05 in chips)
Seat 4: fc7e5666 ($9.8 in chips)
Seat 5: 5b34f2fa ($29.52 in chips)
Seat 6: e1ee5383 ($10.99 in chips)
f5068bd1: posts small blind $0.05
Hero: posts big blind $0.1
*** HOLE CARDS ***
Dealt to 5cd3b3ff 
Dealt to f5068bd1 
Dealt to Hero [7c Ad]
Dealt to fc7e5666 
Dealt to 5b34f2fa 
Dealt to e1ee5383 
fc7e5666: folds
5b34f2fa: folds
e1ee5383: raises $0.15 to $0.25
5cd3b3ff: folds
f5068bd1: folds
Hero: calls $0.15
*** FLOP *** [6s As 2c]
Hero: bets $0.28
e1ee5383: calls $0.28
*** TURN *** [6s As 2c] [4d]
Hero: checks
e1ee5383: bets $0.74
Hero: calls $0.74
*** RIVER *** [6s As 2c 4d] [9d]
Hero: checks
e1ee5383: bets $2.4
Hero: folds
Uncalled bet ($2.4) returned to e1ee5383
*** SHOWDOWN ***
e1ee5383 collected $2.46 from pot
*** SUMMARY ***
Total pot $2.59 | Rake $0.13 | Jackpot $0 | Bingo $0 | Fortune $0
Board [6s As 2c 4d 9d]
Seat 1: 5cd3b3ff (button) folded before Flop (didn't bet)
Seat 2: f5068bd1 (small blind) folded before Flop
Seat 3: Hero (big blind) folded on the River
Seat 4: fc7e5666 folded before Flop (didn't bet)
Seat 5: 5b34f2fa folded before Flop (didn't bet)
Seat 6: e1ee5383 won ($2.46)


Poker Hand #RC1468484058: Hold'em No Limit  ($0.05/$0.1) - 2023/04/12 20:10:42
Table 'RushAndCash5639318' 6-max Seat #1 is the button
Seat 1: fb1c8b9d ($11.77 in chips)
Seat 2: 16748df0 ($12.79 in chips)
Seat 3: 90a824e2 ($10 in chips)
Seat 4: 99a7bc39 ($11.08 in chips)
Seat 5: a1f82121 ($29.67 in chips)
Seat 6: Hero ($10.05 in chips)
16748df0: posts small blind $0.05
90a824e2: posts big blind $0.1
*** HOLE CARDS ***
Dealt to fb1c8b9d 
Dealt to 16748df0 
Dealt to 90a824e2 
Dealt to 99a7bc39 
Dealt to a1f82121 
Dealt to Hero [Ks 5s]
99a7bc39: raises $0.13 to $0.23
a1f82121: raises $0.52 to $0.75
Hero: folds
fb1c8b9d: folds
16748df0: folds
90a824e2: folds
99a7bc39: folds
Uncalled bet ($0.52) returned to a1f82121
*** SHOWDOWN ***
a1f82121 collected $0.58 from pot
*** SUMMARY ***
Total pot $0.61 | Rake $0.03 | Jackpot $0 | Bingo $0 | Fortune $0
Seat 1: fb1c8b9d (button) folded before Flop (didn't bet)
Seat 2: 16748df0 (small blind) folded before Flop
Seat 3: 90a824e2 (big blind) folded before Flop
Seat 4: 99a7bc39 folded before Flop
Seat 5: a1f82121 collected ($0.58)
Seat 6: Hero folded before Flop (didn't bet)


Poker Hand #RC1468483918: Hold'em No Limit  ($0.05/$0.1) - 2023/04/12 20:10:24
Table 'RushAndCash5639178' 6-max Seat #1 is the button
Seat 1: 21843fff ($8.91 in chips)
Seat 2: Hero ($10.1 in chips)
Seat 3: b5906e8f ($13.22 in chips)
Seat 4: 5741655e ($10.37 in chips)
Seat 5: c16d9eef ($10.63 in chips)
Seat 6: 1aca80ca ($11.98 in chips)
Hero: posts small blind $0.05
b5906e8f: posts big blind $0.1
*** HOLE CARDS ***
Dealt to 21843fff 
Dealt to Hero [8d 5d]
Dealt to b5906e8f 
Dealt to 5741655e 
Dealt to c16d9eef 
Dealt to 1aca80ca 
5741655e: raises $0.2 to $0.3
c16d9eef: folds
1aca80ca: calls $0.3
21843fff: folds
Hero: folds
b5906e8f: calls $0.2
*** FLOP *** [3s Kh 6c]
b5906e8f: checks
5741655e: bets $0.32
1aca80ca: raises $0.8 to $1.12
b5906e8f: folds
5741655e: folds
Uncalled bet ($0.8) returned to 1aca80ca
*** SHOWDOWN ***
1aca80ca collected $1.51 from pot
*** SUMMARY ***
Total pot $1.59 | Rake $0.08 | Jackpot $0 | Bingo $0 | Fortune $0
Board [3s Kh 6c]
Seat 1: 21843fff (button) folded before Flop (didn't bet)
Seat 2: Hero (small blind) folded before Flop
Seat 3: b5906e8f (big blind) folded on the Flop
Seat 4: 5741655e folded on the Flop
Seat 5: c16d9eef folded before Flop (didn't bet)
Seat 6: 1aca80ca won ($1.51)


Poker Hand #RC1468483875: Hold'em No Limit  ($0.05/$0.1) - 2023/04/12 20:10:17
Table 'RushAndCash5639135' 6-max Seat #1 is the button
Seat 1: 9ad1b1c5 ($3.12 in chips)
Seat 2: ddaf0c7c ($10 in chips)
Seat 3: 4746e56d ($13.83 in chips)
Seat 4: Hero ($10.1 in chips)
Seat 5: d86a9fe5 ($12.04 in chips)
Seat 6: 69ea70e ($12.97 in chips)
ddaf0c7c: posts small blind $0.05
4746e56d: posts big blind $0.1
*** HOLE CARDS ***
Dealt to 9ad1b1c5 
Dealt to ddaf0c7c 
Dealt to 4746e56d 
Dealt to Hero [9c 3d]
Dealt to d86a9fe5 
Dealt to 69ea70e 
Hero: folds
d86a9fe5: folds
69ea70e: raises $0.15 to $0.25
9ad1b1c5: raises $0.51 to $0.76
ddaf0c7c: folds
4746e56d: folds
69ea70e: calls $0.51
*** FLOP *** [2s 9s 6s]
69ea70e: checks
9ad1b1c5: bets $0.61
69ea70e: raises $2.61 to $3.22
9ad1b1c5: calls $1.75 and is all-in
Uncalled bet ($0.86) returned to 69ea70e
69ea70e: shows [3s 3c] (Pair of Treys)
9ad1b1c5: shows [Td Ac] (Ace-High)
*** FIRST TURN *** [2s 9s 6s] [Ks]
*** FIRST RIVER *** [2s 9s 6s Ks] [Qc]
*** SECOND TURN *** [2s 9s 6s] [9d]
*** SECOND RIVER *** [2s 9s 6s 9d] [8d]
*** FIRST SHOWDOWN ***
69ea70e collected $2.97 from pot
*** SECOND SHOWDOWN ***
69ea70e collected $2.97 from pot
*** SUMMARY ***
Total pot $6.39 | Rake $0.3 | Jackpot $0.15 | Bingo $0 | Fortune $0
Hand was run two times
FIRST Board [2s 9s 6s Ks Qc]
SECOND Board [9d 8d]
Seat 1: 9ad1b1c5 (button) showed [Td Ac] and lost with Ace-High, and lost
Seat 2: ddaf0c7c (small blind) folded before Flop
Seat 3: 4746e56d (big blind) folded before Flop
Seat 4: Hero folded before Flop (didn't bet)
Seat 5: d86a9fe5 folded before Flop (didn't bet)
Seat 6: 69ea70e showed [3s 3c] and won ($2.97) with King High Flush, and won ($2.97)


Poker Hand #RC1468483843: Hold'em No Limit  ($0.05/$0.1) - 2023/04/12 20:10:12
Table 'RushAndCash5639103' 6-max Seat #1 is the button
Seat 1: 10ba4419 ($8.66 in chips)
Seat 2: c19f477d ($15.84 in chips)
Seat 3: 1d49ad0a ($10.52 in chips)
Seat 4: Hero ($10.1 in chips)
Seat 5: 3abb9434 ($10.75 in chips)
Seat 6: f91770b0 ($10.15 in chips)
c19f477d: posts small blind $0.05
1d49ad0a: posts big blind $0.1
*** HOLE CARDS ***
Dealt to 10ba4419 
Dealt to c19f477d 
Dealt to 1d49ad0a 
Dealt to Hero [Kd 3s]
Dealt to 3abb9434 
Dealt to f91770b0 
Hero: folds
3abb9434: folds
f91770b0: folds
10ba4419: folds
c19f477d: folds
Uncalled bet ($0.05) returned to 1d49ad0a
*** SHOWDOWN ***
1d49ad0a collected $0.1 from pot
*** SUMMARY ***
Total pot $0.1 | Rake $0 | Jackpot $0 | Bingo $0 | Fortune $0
Seat 1: 10ba4419 (button) folded before Flop (didn't bet)
Seat 2: c19f477d (small blind) folded before Flop
Seat 3: 1d49ad0a (big blind) collected ($0.1)
Seat 4: Hero folded before Flop (didn't bet)
Seat 5: 3abb9434 folded before Flop (didn't bet)
Seat 6: f91770b0 folded before Flop (didn't bet)


Poker Hand #RC1468483760: Hold'em No Limit  ($0.05/$0.1) - 2023/04/12 20:09:59
Table 'RushAndCash5639020' 6-max Seat #1 is the button
Seat 1: be7cb01 ($10 in chips)
Seat 2: 450f42d6 ($10 in chips)
Seat 3: e7af1474 ($10.81 in chips)
Seat 4: 972258d6 ($11.2 in chips)
Seat 5: f26b4fc8 ($12.59 in chips)
Seat 6: Hero ($10.1 in chips)
450f42d6: posts small blind $0.05
e7af1474: posts big blind $0.1
*** HOLE CARDS ***
Dealt to be7cb01 
Dealt to 450f42d6 
Dealt to e7af1474 
Dealt to 972258d6 
Dealt to f26b4fc8 
Dealt to Hero [Jc Qs]
972258d6: raises $0.15 to $0.25
f26b4fc8: calls $0.25
Hero: folds
be7cb01: calls $0.25
450f42d6: folds
e7af1474: folds
*** FLOP *** [Qh Qc 3d]
972258d6: bets $0.3
f26b4fc8: folds
be7cb01: calls $0.3
*** TURN *** [Qh Qc 3d] [5d]
972258d6: checks
be7cb01: bets $0.5
972258d6: calls $0.5
*** RIVER *** [Qh Qc 3d 5d] [Qd]
972258d6: checks
be7cb01: checks
972258d6: shows [Ks Ad] (Three Queens)
be7cb01: shows [6h 6d] (Queens Full over Sixes)
*** SHOWDOWN ***
be7cb01 collected $2.38 from pot
*** SUMMARY ***
Total pot $2.5 | Rake $0.12 | Jackpot $0 | Bingo $0 | Fortune $0
Board [Qh Qc 3d 5d Qd]
Seat 1: be7cb01 (button) showed [6h 6d] and won ($2.38) with Queens Full over Sixes
Seat 2: 450f42d6 (small blind) folded before Flop
Seat 3: e7af1474 (big blind) folded before Flop
Seat 4: 972258d6 showed [Ks Ad] and lost with Three Queens
Seat 5: f26b4fc8 folded on the Flop
Seat 6: Hero folded before Flop (didn't bet)


Poker Hand #RC1468483712: Hold'em No Limit  ($0.05/$0.1) - 2023/04/12 20:09:52
Table 'RushAndCash5638972' 6-max Seat #1 is the button
Seat 1: f91770b0 ($10 in chips)
Seat 2: Hero ($10.15 in chips)
Seat 3: 59ba9529 ($25.01 in chips)
Seat 4: eea08caf ($13.89 in chips)
Seat 5: 8954ad8e ($12.66 in chips)
Seat 6: a739f12a ($11.67 in chips)
Hero: posts small blind $0.05
59ba9529: posts big blind $0.1
*** HOLE CARDS ***
Dealt to f91770b0 
Dealt to Hero [Ts 4s]
Dealt to 59ba9529 
Dealt to eea08caf 
Dealt to 8954ad8e 
Dealt to a739f12a 
eea08caf: folds
8954ad8e: folds
a739f12a: folds
f91770b0: raises $0.12 to $0.22
Hero: folds
59ba9529: folds
Uncalled bet ($0.12) returned to f91770b0
*** SHOWDOWN ***
f91770b0 collected $0.25 from pot
*** SUMMARY ***
Total pot $0.25 | Rake $0 | Jackpot $0 | Bingo $0 | Fortune $0
Seat 1: f91770b0 (button) collected ($0.25)
Seat 2: Hero (small blind) folded before Flop
Seat 3: 59ba9529 (big blind) folded before Flop
Seat 4: eea08caf folded before Flop (didn't bet)
Seat 5: 8954ad8e folded before Flop (didn't bet)
Seat 6: a739f12a folded before Flop (didn't bet)


Poker Hand #RC1468483673: Hold'em No Limit  ($0.05/$0.1) - 2023/04/12 20:09:47
Table 'RushAndCash5638933' 6-max Seat #1 is the button
Seat 1: faba8d6f ($10.28 in chips)
Seat 2: 96078acc ($11.96 in chips)
Seat 3: 97c5e0fb ($5.19 in chips)
Seat 4: 6108a2fc ($21.47 in chips)
Seat 5: Hero ($10.15 in chips)
Seat 6: cebca560 ($10.13 in chips)
96078acc: posts small blind $0.05
97c5e0fb: posts big blind $0.1
*** HOLE CARDS ***
Dealt to faba8d6f 
Dealt to 96078acc 
Dealt to 97c5e0fb 
Dealt to 6108a2fc 
Dealt to Hero [7c 2c]
Dealt to cebca560 
6108a2fc: folds
Hero: folds
cebca560: folds
faba8d6f: raises $0.15 to $0.25
96078acc: folds
97c5e0fb: raises $0.66 to $0.91
faba8d6f: calls $0.66
*** FLOP *** [5d 2h Ad]
97c5e0fb: bets $1.31
faba8d6f: calls $1.31
*** TURN *** [5d 2h Ad] [Tc]
97c5e0fb: bets $2.97 and is all-in
faba8d6f: calls $2.97
97c5e0fb: shows [Qc Kc] (Ace-High)
faba8d6f: shows [Ks As] (Pair of Aces)
*** RIVER *** [5d 2h Ad Tc] [6c]
*** SHOWDOWN ***
faba8d6f collected $9.98 from pot
*** SUMMARY ***
Total pot $10.43 | Rake $0.3 | Jackpot $0.15 | Bingo $0 | Fortune $0
Board [5d 2h Ad Tc 6c]
Seat 1: faba8d6f (button) showed [Ks As] and won ($9.98) with Pair of Aces
Seat 2: 96078acc (small blind) folded before Flop
Seat 3: 97c5e0fb (big blind) showed [Qc Kc] and lost with Ace-High
Seat 4: 6108a2fc folded before Flop (didn't bet)
Seat 5: Hero folded before Flop (didn't bet)
Seat 6: cebca560 folded before Flop (didn't bet)


Poker Hand #RC1468483581: Hold'em No Limit  ($0.05/$0.1) - 2023/04/12 20:09:34
Table 'RushAndCash5638841' 6-max Seat #1 is the button
Seat 1: 902bf00a ($25.76 in chips)
Seat 2: 9b7ee6c3 ($10 in chips)
Seat 3: 1b43483 ($10.66 in chips)
Seat 4: 94cdf99f ($10 in chips)
Seat 5: Hero ($10.15 in chips)
Seat 6: 7c507e93 ($22.19 in chips)
9b7ee6c3: posts small blind $0.05
1b43483: posts big blind $0.1
*** HOLE CARDS ***
Dealt to 902bf00a 
Dealt to 9b7ee6c3 
Dealt to 1b43483 
Dealt to 94cdf99f 
Dealt to Hero [5d As]
Dealt to 7c507e93 
94cdf99f: folds
Hero: folds
7c507e93: raises $0.15 to $0.25
902bf00a: folds
9b7ee6c3: folds
1b43483: folds
Uncalled bet ($0.15) returned to 7c507e93
*** SHOWDOWN ***
7c507e93 collected $0.25 from pot
*** SUMMARY ***
Total pot $0.25 | Rake $0 | Jackpot $0 | Bingo $0 | Fortune $0
Seat 1: 902bf00a (button) folded before Flop (didn't bet)
Seat 2: 9b7ee6c3 (small blind) folded before Flop
Seat 3: 1b43483 (big blind) folded before Flop
Seat 4: 94cdf99f folded before Flop (didn't bet)
Seat 5: Hero folded before Flop (didn't bet)
Seat 6: 7c507e93 collected ($0.25)


Poker Hand #RC1468483548: Hold'em No Limit  ($0.05/$0.1) - 2023/04/12 20:09:30
Table 'RushAndCash5638808' 6-max Seat #1 is the button
Seat 1: Hero ($10.15 in chips)
Seat 2: 1e05a0ee ($7.19 in chips)
Seat 3: 6173bd66 ($25.3 in chips)
Seat 4: 6aa925b1 ($4.17 in chips)
Seat 5: 8c14a2e9 ($16 in chips)
Seat 6: 4e661c11 ($10.57 in chips)
1e05a0ee: posts small blind $0.05
6173bd66: posts big blind $0.1
*** HOLE CARDS ***
Dealt to Hero [Qc 2h]
Dealt to 1e05a0ee 
Dealt to 6173bd66 
Dealt to 6aa925b1 
Dealt to 8c14a2e9 
Dealt to 4e661c11 
6aa925b1: folds
8c14a2e9: folds
4e661c11: folds
Hero: folds
1e05a0ee: folds
Uncalled bet ($0.05) returned to 6173bd66
*** SHOWDOWN ***
6173bd66 collected $0.1 from pot
*** SUMMARY ***
Total pot $0.1 | Rake $0 | Jackpot $0 | Bingo $0 | Fortune $0
Seat 1: Hero (button) folded before Flop (didn't bet)
Seat 2: 1e05a0ee (small blind) folded before Flop
Seat 3: 6173bd66 (big blind) collected ($0.1)
Seat 4: 6aa925b1 folded before Flop (didn't bet)
Seat 5: 8c14a2e9 folded before Flop (didn't bet)
Seat 6: 4e661c11 folded before Flop (didn't bet)


Poker Hand #RC1468483414: Hold'em No Limit  ($0.05/$0.1) - 2023/04/12 20:09:11
Table 'RushAndCash5638674' 6-max Seat #1 is the button
Seat 1: e872750d ($38.16 in chips)
Seat 2: 96845e24 ($9.54 in chips)
Seat 3: Hero ($10.25 in chips)
Seat 4: c7de008a ($21.56 in chips)
Seat 5: 22ce7a0d ($34.37 in chips)
Seat 6: 44e40150 ($12.46 in chips)
96845e24: posts small blind $0.05
Hero: posts big blind $0.1
*** HOLE CARDS ***
Dealt to e872750d 
Dealt to 96845e24 
Dealt to Hero [Ah 2s]
Dealt to c7de008a 
Dealt to 22ce7a0d 
Dealt to 44e40150 
c7de008a: folds
22ce7a0d: folds
44e40150: folds
e872750d: folds
96845e24: raises $0.15 to $0.25
Hero: folds
Uncalled bet ($0.15) returned to 96845e24
*** SHOWDOWN ***
96845e24 collected $0.2 from pot
*** SUMMARY ***
Total pot $0.2 | Rake $0 | Jackpot $0 | Bingo $0 | Fortune $0
Seat 1: e872750d (button) folded before Flop (didn't bet)
Seat 2: 96845e24 (small blind) collected ($0.2)
Seat 3: Hero (big blind) folded before Flop
Seat 4: c7de008a folded before Flop (didn't bet)
Seat 5: 22ce7a0d folded before Flop (didn't bet)
Seat 6: 44e40150 folded before Flop (didn't bet)


Poker Hand #RC1468483366: Hold'em No Limit  ($0.05/$0.1) - 2023/04/12 20:09:04
Table 'RushAndCash5638626' 6-max Seat #1 is the button
Seat 1: 98129362 ($9.7 in chips)
Seat 2: Hero ($10.3 in chips)
Seat 3: 6a4e9d9c ($12.31 in chips)
Seat 4: 4d1011ed ($10.26 in chips)
Seat 5: 60b4dc53 ($8.41 in chips)
Seat 6: 7dae5caa ($10.15 in chips)
Hero: posts small blind $0.05
6a4e9d9c: posts big blind $0.1
*** HOLE CARDS ***
Dealt to 98129362 
Dealt to Hero [6c 7d]
Dealt to 6a4e9d9c 
Dealt to 4d1011ed 
Dealt to 60b4dc53 
Dealt to 7dae5caa 
4d1011ed: raises $0.12 to $0.22
60b4dc53: folds
7dae5caa: folds
98129362: folds
Hero: folds
6a4e9d9c: folds
Uncalled bet ($0.12) returned to 4d1011ed
*** SHOWDOWN ***
4d1011ed collected $0.25 from pot
*** SUMMARY ***
Total pot $0.25 | Rake $0 | Jackpot $0 | Bingo $0 | Fortune $0
Seat 1: 98129362 (button) folded before Flop (didn't bet)
Seat 2: Hero (small blind) folded before Flop
Seat 3: 6a4e9d9c (big blind) folded before Flop
Seat 4: 4d1011ed collected ($0.25)
Seat 5: 60b4dc53 folded before Flop (didn't bet)
Seat 6: 7dae5caa folded before Flop (didn't bet)


Poker Hand #RC1468483186: Hold'em No Limit  ($0.05/$0.1) - 2023/04/12 20:08:38
Table 'RushAndCash5638446' 6-max Seat #1 is the button
Seat 1: a6133ad2 ($17.78 in chips)
Seat 2: 67a81530 ($10.85 in chips)
Seat 3: 73bb4504 ($14.82 in chips)
Seat 4: acc311b8 ($13.84 in chips)
Seat 5: Hero ($10.15 in chips)
Seat 6: 85b7299e ($19.56 in chips)
67a81530: posts small blind $0.05
73bb4504: posts big blind $0.1
*** HOLE CARDS ***
Dealt to a6133ad2 
Dealt to 67a81530 
Dealt to 73bb4504 
Dealt to acc311b8 
Dealt to Hero [Ah Qs]
Dealt to 85b7299e 
acc311b8: folds
Hero: raises $0.15 to $0.25
85b7299e: folds
a6133ad2: folds
67a81530: folds
73bb4504: folds
Uncalled bet ($0.15) returned to Hero
*** SHOWDOWN ***
Hero collected $0.25 from pot
*** SUMMARY ***
Total pot $0.25 | Rake $0 | Jackpot $0 | Bingo $0 | Fortune $0
Seat 1: a6133ad2 (button) folded before Flop (didn't bet)
Seat 2: 67a81530 (small blind) folded before Flop
Seat 3: 73bb4504 (big blind) folded before Flop
Seat 4: acc311b8 folded before Flop (didn't bet)
Seat 5: Hero collected ($0.25)
Seat 6: 85b7299e folded before Flop (didn't bet)


Poker Hand #RC1468483161: Hold'em No Limit  ($0.05/$0.1) - 2023/04/12 20:08:33
Table 'RushAndCash5638421' 6-max Seat #1 is the button
Seat 1: Hero ($10.15 in chips)
Seat 2: 75fa02f3 ($10.72 in chips)
Seat 3: f89d54f1 ($60.15 in chips)
Seat 4: 499d6d5f ($17.76 in chips)
Seat 5: 1d49ad0a ($10.22 in chips)
Seat 6: 67bd748f ($9.28 in chips)
75fa02f3: posts small blind $0.05
f89d54f1: posts big blind $0.1
*** HOLE CARDS ***
Dealt to Hero [8d 3d]
Dealt to 75fa02f3 
Dealt to f89d54f1 
Dealt to 499d6d5f 
Dealt to 1d49ad0a 
Dealt to 67bd748f 
499d6d5f: folds
1d49ad0a: folds
67bd748f: folds
Hero: folds
75fa02f3: folds
Uncalled bet ($0.05) returned to f89d54f1
*** SHOWDOWN ***
f89d54f1 collected $0.1 from pot
*** SUMMARY ***
Total pot $0.1 | Rake $0 | Jackpot $0 | Bingo $0 | Fortune $0
Seat 1: Hero (button) folded before Flop (didn't bet)
Seat 2: 75fa02f3 (small blind) folded before Flop
Seat 3: f89d54f1 (big blind) collected ($0.1)
Seat 4: 499d6d5f folded before Flop (didn't bet)
Seat 5: 1d49ad0a folded before Flop (didn't bet)
Seat 6: 67bd748f folded before Flop (didn't bet)


Poker Hand #RC1468483113: Hold'em No Limit  ($0.05/$0.1) - 2023/04/12 20:08:26
Table 'RushAndCash5638373' 6-max Seat #1 is the button
Seat 1: 3bf969ff ($17.33 in chips)
Seat 2: 5d5a5867 ($19.8 in chips)
Seat 3: 667f1eb8 ($12.93 in chips)
Seat 4: dce1ab41 ($10.15 in chips)
Seat 5: 207a1dc6 ($10 in chips)
Seat 6: Hero ($10.15 in chips)
5d5a5867: posts small blind $0.05
667f1eb8: posts big blind $0.1
*** HOLE CARDS ***
Dealt to 3bf969ff 
Dealt to 5d5a5867 
Dealt to 667f1eb8 
Dealt to dce1ab41 
Dealt to 207a1dc6 
Dealt to Hero [Td 6d]
dce1ab41: folds
207a1dc6: folds
Hero: folds
3bf969ff: folds
5d5a5867: raises $0.2 to $0.3
667f1eb8: calls $0.2
*** FLOP *** [5h 3s 3h]
5d5a5867: bets $0.3
667f1eb8: folds
Uncalled bet ($0.3) returned to 5d5a5867
*** SHOWDOWN ***
5d5a5867 collected $0.57 from pot
*** SUMMARY ***
Total pot $0.6 | Rake $0.03 | Jackpot $0 | Bingo $0 | Fortune $0
Board [5h 3s 3h]
Seat 1: 3bf969ff (button) folded before Flop (didn't bet)
Seat 2: 5d5a5867 (small blind) won ($0.57)
Seat 3: 667f1eb8 (big blind) folded on the Flop
Seat 4: dce1ab41 folded before Flop (didn't bet)
Seat 5: 207a1dc6 folded before Flop (didn't bet)
Seat 6: Hero folded before Flop (didn't bet)


Poker Hand #RC1468482998: Hold'em No Limit  ($0.05/$0.1) - 2023/04/12 20:08:10
Table 'RushAndCash5638258' 6-max Seat #1 is the button
Seat 1: 47cc6071 ($7.04 in chips)
Seat 2: 472289a8 ($16.45 in chips)
Seat 3: Hero ($10.25 in chips)
Seat 4: 69df284d ($13.71 in chips)
Seat 5: 7c6c369d ($13.8 in chips)
Seat 6: fe539d18 ($13.98 in chips)
472289a8: posts small blind $0.05
Hero: posts big blind $0.1
*** HOLE CARDS ***
Dealt to 47cc6071 
Dealt to 472289a8 
Dealt to Hero [Ts 7s]
Dealt to 69df284d 
Dealt to 7c6c369d 
Dealt to fe539d18 
69df284d: folds
7c6c369d: folds
fe539d18: raises $0.15 to $0.25
47cc6071: folds
472289a8: calls $0.2
Hero: folds
*** FLOP *** [5h 6h 3d]
472289a8: checks
fe539d18: checks
*** TURN *** [5h 6h 3d] [Th]
472289a8: bets $0.4
fe539d18: calls $0.4
*** RIVER *** [5h 6h 3d Th] [Kh]
472289a8: bets $1.2
fe539d18: folds
Uncalled bet ($1.2) returned to 472289a8
*** SHOWDOWN ***
472289a8 collected $1.33 from pot
*** SUMMARY ***
Total pot $1.4 | Rake $0.07 | Jackpot $0 | Bingo $0 | Fortune $0
Board [5h 6h 3d Th Kh]
Seat 1: 47cc6071 (button) folded before Flop (didn't bet)
Seat 2: 472289a8 (small blind) won ($1.33)
Seat 3: Hero (big blind) folded before Flop
Seat 4: 69df284d folded before Flop (didn't bet)
Seat 5: 7c6c369d folded before Flop (didn't bet)
Seat 6: fe539d18 folded on the River


Poker Hand #RC1468482961: Hold'em No Limit  ($0.05/$0.1) - 2023/04/12 20:08:05
Table 'RushAndCash5638221' 6-max Seat #1 is the button
Seat 1: 89b315a3 ($10.26 in chips)
Seat 2: ac8b5fce ($10.57 in chips)
Seat 3: 204655c8 ($10 in chips)
Seat 4: Hero ($10.25 in chips)
Seat 5: 21ea41da ($56.99 in chips)
Seat 6: a2f03845 ($11.68 in chips)
ac8b5fce: posts small blind $0.05
204655c8: posts big blind $0.1
*** HOLE CARDS ***
Dealt to 89b315a3 
Dealt to ac8b5fce 
Dealt to 204655c8 
Dealt to Hero [Ks 8c]
Dealt to 21ea41da 
Dealt to a2f03845 
Hero: folds
21ea41da: raises $0.15 to $0.25
a2f03845: folds
89b315a3: folds
ac8b5fce: raises $0.5 to $0.75
204655c8: folds
21ea41da: calls $0.5
*** FLOP *** [3h Jd 7h]
ac8b5fce: bets $0.8
21ea41da: calls $0.8
*** TURN *** [3h Jd 7h] [4d]
ac8b5fce: checks
21ea41da: bets $2.4
ac8b5fce: calls $2.4
*** RIVER *** [3h Jd 7h 4d] [Jc]
ac8b5fce: checks
21ea41da: checks
ac8b5fce: shows [Kc Kd] (Pair of Kings and Pair of Jacks)
21ea41da: shows [As Qc] (Pair of Jacks)
*** SHOWDOWN ***
ac8b5fce collected $7.55 from pot
*** SUMMARY ***
Total pot $8 | Rake $0.3 | Jackpot $0.15 | Bingo $0 | Fortune $0
Board [3h Jd 7h 4d Jc]
Seat 1: 89b315a3 (button) folded before Flop (didn't bet)
Seat 2: ac8b5fce (small blind) showed [Kc Kd] and won ($7.55) with Pair of Kings and Pair of Jacks
Seat 3: 204655c8 (big blind) folded before Flop
Seat 4: Hero folded before Flop (didn't bet)
Seat 5: 21ea41da showed [As Qc] and lost with Pair of Jacks
Seat 6: a2f03845 folded before Flop (didn't bet)


Poker Hand #RC1468482685: Hold'em No Limit  ($0.05/$0.1) - 2023/04/12 20:07:23
Table 'RushAndCash5637945' 6-max Seat #1 is the button
Seat 1: Hero ($9.36 in chips)
Seat 2: f4c4e1e6 ($9.72 in chips)
Seat 3: 67bd748f ($9.33 in chips)
Seat 4: fc7e5666 ($10 in chips)
Seat 5: 89b315a3 ($10.46 in chips)
Seat 6: 5b79b78e ($10.15 in chips)
f4c4e1e6: posts small blind $0.05
67bd748f: posts big blind $0.1
*** HOLE CARDS ***
Dealt to Hero [Qd Qc]
Dealt to f4c4e1e6 
Dealt to 67bd748f 
Dealt to fc7e5666 
Dealt to 89b315a3 
Dealt to 5b79b78e 
fc7e5666: folds
89b315a3: raises $0.1 to $0.2
5b79b78e: raises $0.42 to $0.62
Hero: raises $0.9 to $1.52
f4c4e1e6: folds
67bd748f: folds
89b315a3: folds
5b79b78e: folds
Uncalled bet ($0.9) returned to Hero
*** SHOWDOWN ***
Hero collected $1.51 from pot
*** SUMMARY ***
Total pot $1.59 | Rake $0.08 | Jackpot $0 | Bingo $0 | Fortune $0
Seat 1: Hero (button) collected ($1.51)
Seat 2: f4c4e1e6 (small blind) folded before Flop
Seat 3: 67bd748f (big blind) folded before Flop
Seat 4: fc7e5666 folded before Flop (didn't bet)
Seat 5: 89b315a3 folded before Flop
Seat 6: 5b79b78e folded before Flop


Poker Hand #RC1468482595: Hold'em No Limit  ($0.05/$0.1) - 2023/04/12 20:07:09
Table 'RushAndCash5637855' 6-max Seat #1 is the button
Seat 1: 5fa5be03 ($19.09 in chips)
Seat 2: 8b7966f0 ($10.05 in chips)
Seat 3: Hero ($9.46 in chips)
Seat 4: bb03a8cb ($10.22 in chips)
Seat 5: 3877af71 ($20.85 in chips)
Seat 6: e2b096c ($24.97 in chips)
8b7966f0: posts small blind $0.05
Hero: posts big blind $0.1
*** HOLE CARDS ***
Dealt to 5fa5be03 
Dealt to 8b7966f0 
Dealt to Hero [9d 6d]
Dealt to bb03a8cb 
Dealt to 3877af71 
Dealt to e2b096c 
bb03a8cb: folds
3877af71: folds
e2b096c: folds
5fa5be03: raises $0.12 to $0.22
8b7966f0: folds
Hero: folds
Uncalled bet ($0.12) returned to 5fa5be03
*** SHOWDOWN ***
5fa5be03 collected $0.25 from pot
*** SUMMARY ***
Total pot $0.25 | Rake $0 | Jackpot $0 | Bingo $0 | Fortune $0
Seat 1: 5fa5be03 (button) collected ($0.25)
Seat 2: 8b7966f0 (small blind) folded before Flop
Seat 3: Hero (big blind) folded before Flop
Seat 4: bb03a8cb folded before Flop (didn't bet)
Seat 5: 3877af71 folded before Flop (didn't bet)
Seat 6: e2b096c folded before Flop (didn't bet)


Poker Hand #RC1468482414: Hold'em No Limit  ($0.05/$0.1) - 2023/04/12 20:06:41
Table 'RushAndCash5637674' 6-max Seat #1 is the button
Seat 1: 1a385958 ($17.63 in chips)
Seat 2: 5e0ca113 ($13.97 in chips)
Seat 3: e2b096c ($24.69 in chips)
Seat 4: 6f973e4e ($10 in chips)
Seat 5: 9a17558 ($17.47 in chips)
Seat 6: Hero ($9.71 in chips)
5e0ca113: posts small blind $0.05
e2b096c: posts big blind $0.1
*** HOLE CARDS ***
Dealt to 1a385958 
Dealt to 5e0ca113 
Dealt to e2b096c 
Dealt to 6f973e4e 
Dealt to 9a17558 
Dealt to Hero [8h 7h]
6f973e4e: folds
9a17558: folds
Hero: raises $0.15 to $0.25
1a385958: folds
5e0ca113: folds
e2b096c: raises $0.75 to $1
Hero: folds
Uncalled bet ($0.75) returned to e2b096c
*** SHOWDOWN ***
e2b096c collected $0.53 from pot
*** SUMMARY ***
Total pot $0.55 | Rake $0.02 | Jackpot $0 | Bingo $0 | Fortune $0
Seat 1: 1a385958 (button) folded before Flop (didn't bet)
Seat 2: 5e0ca113 (small blind) folded before Flop
Seat 3: e2b096c (big blind) collected ($0.53)
Seat 4: 6f973e4e folded before Flop (didn't bet)
Seat 5: 9a17558 folded before Flop (didn't bet)
Seat 6: Hero folded before Flop


Poker Hand #RC1468482325: Hold'em No Limit  ($0.05/$0.1) - 2023/04/12 20:06:28
Table 'RushAndCash5637585' 6-max Seat #1 is the button
Seat 1: 242388b5 ($17.33 in chips)
Seat 2: Hero ($9.61 in chips)
Seat 3: 3abb9434 ($13.49 in chips)
Seat 4: a8fd0a2 ($17.1 in chips)
Seat 5: f9e2637 ($11.18 in chips)
Seat 6: 970b7167 ($11.82 in chips)
Hero: posts small blind $0.05
3abb9434: posts big blind $0.1
*** HOLE CARDS ***
Dealt to 242388b5 
Dealt to Hero [Jd Tc]
Dealt to 3abb9434 
Dealt to a8fd0a2 
Dealt to f9e2637 
Dealt to 970b7167 
a8fd0a2: folds
f9e2637: folds
970b7167: folds
242388b5: folds
Hero: raises $0.2 to $0.3
3abb9434: folds
Uncalled bet ($0.2) returned to Hero
*** SHOWDOWN ***
Hero collected $0.2 from pot
*** SUMMARY ***
Total pot $0.2 | Rake $0 | Jackpot $0 | Bingo $0 | Fortune $0
Seat 1: 242388b5 (button) folded before Flop (didn't bet)
Seat 2: Hero (small blind) collected ($0.2)
Seat 3: 3abb9434 (big blind) folded before Flop
Seat 4: a8fd0a2 folded before Flop (didn't bet)
Seat 5: f9e2637 folded before Flop (didn't bet)
Seat 6: 970b7167 folded before Flop (didn't bet)


Poker Hand #RC1468482258: Hold'em No Limit  ($0.05/$0.1) - 2023/04/12 20:06:18
Table 'RushAndCash5637518' 6-max Seat #1 is the button
Seat 1: 327f372c ($20.14 in chips)
Seat 2: 14695476 ($24.94 in chips)
Seat 3: d4b5f518 ($12.02 in chips)
Seat 4: bdd8009d ($8 in chips)
Seat 5: Hero ($9.61 in chips)
Seat 6: 7a0d85e2 ($19.52 in chips)
14695476: posts small blind $0.05
d4b5f518: posts big blind $0.1
*** HOLE CARDS ***
Dealt to 327f372c 
Dealt to 14695476 
Dealt to d4b5f518 
Dealt to bdd8009d 
Dealt to Hero [Ad 3s]
Dealt to 7a0d85e2 
bdd8009d: raises $0.15 to $0.25
Hero: folds
7a0d85e2: folds
327f372c: folds
14695476: folds
d4b5f518: folds
Uncalled bet ($0.15) returned to bdd8009d
*** SHOWDOWN ***
bdd8009d collected $0.25 from pot
*** SUMMARY ***
Total pot $0.25 | Rake $0 | Jackpot $0 | Bingo $0 | Fortune $0
Seat 1: 327f372c (button) folded before Flop (didn't bet)
Seat 2: 14695476 (small blind) folded before Flop
Seat 3: d4b5f518 (big blind) folded before Flop
Seat 4: bdd8009d collected ($0.25)
Seat 5: Hero folded before Flop (didn't bet)
Seat 6: 7a0d85e2 folded before Flop (didn't bet)


Poker Hand #RC1468482231: Hold'em No Limit  ($0.05/$0.1) - 2023/04/12 20:06:13
Table 'RushAndCash5637491' 6-max Seat #1 is the button
Seat 1: 3d9dd182 ($48.95 in chips)
Seat 2: 1ad6b081 ($12.62 in chips)
Seat 3: 76903f44 ($24.65 in chips)
Seat 4: Hero ($9.61 in chips)
Seat 5: 8e2c0828 ($10 in chips)
Seat 6: fe9635b ($2.37 in chips)
1ad6b081: posts small blind $0.05
76903f44: posts big blind $0.1
*** HOLE CARDS ***
Dealt to 3d9dd182 
Dealt to 1ad6b081 
Dealt to 76903f44 
Dealt to Hero [Jh Qc]
Dealt to 8e2c0828 
Dealt to fe9635b 
Hero: folds
8e2c0828: folds
fe9635b: folds
3d9dd182: folds
1ad6b081: folds
Uncalled bet ($0.05) returned to 76903f44
*** SHOWDOWN ***
76903f44 collected $0.1 from pot
*** SUMMARY ***
Total pot $0.1 | Rake $0 | Jackpot $0 | Bingo $0 | Fortune $0
Seat 1: 3d9dd182 (button) folded before Flop (didn't bet)
Seat 2: 1ad6b081 (small blind) folded before Flop
Seat 3: 76903f44 (big blind) collected ($0.1)
Seat 4: Hero folded before Flop (didn't bet)
Seat 5: 8e2c0828 folded before Flop (didn't bet)
Seat 6: fe9635b folded before Flop (didn't bet)


Poker Hand #RC1468481785: Hold'em No Limit  ($0.05/$0.1) - 2023/04/12 20:05:02
Table 'RushAndCash5637045' 6-max Seat #1 is the button
Seat 1: fb836f3e ($15.52 in chips)
Seat 2: Hero ($9.8 in chips)
Seat 3: fe9635b ($2.57 in chips)
Seat 4: 293e887f ($12.37 in chips)
Seat 5: 1d49ad0a ($8.72 in chips)
Seat 6: 8201bb47 ($10.15 in chips)
Hero: posts small blind $0.05
fe9635b: posts big blind $0.1
*** HOLE CARDS ***
Dealt to fb836f3e 
Dealt to Hero [5s Ad]
Dealt to fe9635b 
Dealt to 293e887f 
Dealt to 1d49ad0a 
Dealt to 8201bb47 
293e887f: folds
1d49ad0a: folds
8201bb47: folds
fb836f3e: folds
Hero: raises $0.2 to $0.3
fe9635b: raises $0.2 to $0.5
Hero: calls $0.2
*** FLOP *** [Ac 7d Ah]
Hero: checks
fe9635b: checks
*** TURN *** [Ac 7d Ah] [8d]
Hero: bets $0.5
fe9635b: raises $0.66 to $1.16
Hero: raises $1.1 to $2.26
fe9635b: calls $0.91 and is all-in
Uncalled bet ($0.19) returned to Hero
Hero: shows [5s Ad] (Three Aces)
fe9635b: shows [As Jc] (Three Aces)
*** RIVER *** [Ac 7d Ah 8d] [7s]
*** SHOWDOWN ***
Hero collected $2.38 from pot
fe9635b collected $2.37 from pot
*** SUMMARY ***
Total pot $5.14 | Rake $0.24 | Jackpot $0.15 | Bingo $0 | Fortune $0
Board [Ac 7d Ah 8d 7s]
Seat 1: fb836f3e (button) folded before Flop (didn't bet)
Seat 2: Hero (small blind) showed [5s Ad] and won ($2.38) with Aces Full over Sevens
Seat 3: fe9635b (big blind) showed [As Jc] and won ($2.37) with Aces Full over Sevens
Seat 4: 293e887f folded before Flop (didn't bet)
Seat 5: 1d49ad0a folded before Flop (didn't bet)
Seat 6: 8201bb47 folded before Flop (didn't bet)


Poker Hand #RC1468481741: Hold'em No Limit  ($0.05/$0.1) - 2023/04/12 20:04:55
Table 'RushAndCash5637001' 6-max Seat #1 is the button
Seat 1: 5aeaa886 ($48.19 in chips)
Seat 2: 21843fff ($7.33 in chips)
Seat 3: 3a17217b ($10 in chips)
Seat 4: 85b7299e ($12.81 in chips)
Seat 5: d84ae7a0 ($4.73 in chips)
Seat 6: Hero ($9.8 in chips)
21843fff: posts small blind $0.05
3a17217b: posts big blind $0.1
*** HOLE CARDS ***
Dealt to 5aeaa886 
Dealt to 21843fff 
Dealt to 3a17217b 
Dealt to 85b7299e 
Dealt to d84ae7a0 
Dealt to Hero [4h 2d]
85b7299e: folds
d84ae7a0: raises $0.25 to $0.35
Hero: folds
5aeaa886: folds
21843fff: folds
3a17217b: folds
Uncalled bet ($0.25) returned to d84ae7a0
*** SHOWDOWN ***
d84ae7a0 collected $0.25 from pot
*** SUMMARY ***
Total pot $0.25 | Rake $0 | Jackpot $0 | Bingo $0 | Fortune $0
Seat 1: 5aeaa886 (button) folded before Flop (didn't bet)
Seat 2: 21843fff (small blind) folded before Flop
Seat 3: 3a17217b (big blind) folded before Flop
Seat 4: 85b7299e folded before Flop (didn't bet)
Seat 5: d84ae7a0 collected ($0.25)
Seat 6: Hero folded before Flop (didn't bet)


Poker Hand #RC1468481558: Hold'em No Limit  ($0.05/$0.1) - 2023/04/12 20:04:25
Table 'RushAndCash5636818' 6-max Seat #1 is the button
Seat 1: 4746e56d ($14.65 in chips)
Seat 2: 647bfc77 ($8.08 in chips)
Seat 3: 21843fff ($7.58 in chips)
Seat 4: Hero ($9.29 in chips)
Seat 5: d45b1cc1 ($14.64 in chips)
Seat 6: 6aa925b1 ($7.37 in chips)
647bfc77: posts small blind $0.05
21843fff: posts big blind $0.1
*** HOLE CARDS ***
Dealt to 4746e56d 
Dealt to 647bfc77 
Dealt to 21843fff 
Dealt to Hero [Kh Qc]
Dealt to d45b1cc1 
Dealt to 6aa925b1 
Hero: raises $0.15 to $0.25
d45b1cc1: folds
6aa925b1: folds
4746e56d: calls $0.25
647bfc77: folds
21843fff: calls $0.15
*** FLOP *** [6h Kc 6c]
21843fff: checks
Hero: bets $0.35
4746e56d: folds
21843fff: folds
Uncalled bet ($0.35) returned to Hero
*** SHOWDOWN ***
Hero collected $0.76 from pot
*** SUMMARY ***
Total pot $0.8 | Rake $0.04 | Jackpot $0 | Bingo $0 | Fortune $0
Board [6h Kc 6c]
Seat 1: 4746e56d (button) folded on the Flop
Seat 2: 647bfc77 (small blind) folded before Flop
Seat 3: 21843fff (big blind) folded on the Flop
Seat 4: Hero won ($0.76)
Seat 5: d45b1cc1 folded before Flop (didn't bet)
Seat 6: 6aa925b1 folded before Flop (didn't bet)


Poker Hand #RC1468480488: Hold'em No Limit  ($0.05/$0.1) - 2023/04/12 20:01:43
Table 'RushAndCash5635748' 6-max Seat #1 is the button
Seat 1: 76b30415 ($12.89 in chips)
Seat 2: 8e2c0828 ($12.47 in chips)
Seat 3: 41975fdb ($10.27 in chips)
Seat 4: 2fd3265 ($10 in chips)
Seat 5: 10ba4419 ($6.91 in chips)
Seat 6: Hero ($9.37 in chips)
8e2c0828: posts small blind $0.05
41975fdb: posts big blind $0.1
*** HOLE CARDS ***
Dealt to 76b30415 
Dealt to 8e2c0828 
Dealt to 41975fdb 
Dealt to 2fd3265 
Dealt to 10ba4419 
Dealt to Hero [6c 5c]
2fd3265: raises $0.15 to $0.25
10ba4419: folds
Hero: calls $0.25
76b30415: folds
8e2c0828: folds
41975fdb: folds
*** FLOP *** [3c 2s 5d]
2fd3265: bets $0.45
Hero: calls $0.45
*** TURN *** [3c 2s 5d] [Ks]
2fd3265: bets $1.05
Hero: calls $1.05
*** RIVER *** [3c 2s 5d Ks] [Kh]
2fd3265: checks
Hero: checks
2fd3265: shows [5s 6s] (Pair of Kings and Pair of Fives)
Hero: shows [6c 5c] (Pair of Kings and Pair of Fives)
*** SHOWDOWN ***
2fd3265 collected $1.67 from pot
Hero collected $1.67 from pot
*** SUMMARY ***
Total pot $3.65 | Rake $0.16 | Jackpot $0.15 | Bingo $0 | Fortune $0
Board [3c 2s 5d Ks Kh]
Seat 1: 76b30415 (button) folded before Flop (didn't bet)
Seat 2: 8e2c0828 (small blind) folded before Flop
Seat 3: 41975fdb (big blind) folded before Flop
Seat 4: 2fd3265 showed [5s 6s] and won ($1.67) with Pair of Kings and Pair of Fives
Seat 5: 10ba4419 folded before Flop (didn't bet)
Seat 6: Hero showed [6c 5c] and won ($1.67) with Pair of Kings and Pair of Fives


Poker Hand #RC1468480453: Hold'em No Limit  ($0.05/$0.1) - 2023/04/12 20:01:38
Table 'RushAndCash5635713' 6-max Seat #1 is the button
Seat 1: Hero ($9.37 in chips)
Seat 2: a25a136 ($11.48 in chips)
Seat 3: ece632f6 ($33.78 in chips)
Seat 4: d755c17e ($27.55 in chips)
Seat 5: ec1dba90 ($19.3 in chips)
Seat 6: e0256840 ($10.25 in chips)
a25a136: posts small blind $0.05
ece632f6: posts big blind $0.1
*** HOLE CARDS ***
Dealt to Hero [5c 7h]
Dealt to a25a136 
Dealt to ece632f6 
Dealt to d755c17e 
Dealt to ec1dba90 
Dealt to e0256840 
d755c17e: raises $0.14 to $0.24
ec1dba90: folds
e0256840: folds
Hero: folds
a25a136: folds
ece632f6: folds
Uncalled bet ($0.14) returned to d755c17e
*** SHOWDOWN ***
d755c17e collected $0.25 from pot
*** SUMMARY ***
Total pot $0.25 | Rake $0 | Jackpot $0 | Bingo $0 | Fortune $0
Seat 1: Hero (button) folded before Flop (didn't bet)
Seat 2: a25a136 (small blind) folded before Flop
Seat 3: ece632f6 (big blind) folded before Flop
Seat 4: d755c17e collected ($0.25)
Seat 5: ec1dba90 folded before Flop (didn't bet)
Seat 6: e0256840 folded before Flop (didn't bet)


Poker Hand #RC1468480422: Hold'em No Limit  ($0.05/$0.1) - 2023/04/12 20:01:33
Table 'RushAndCash5635682' 6-max Seat #1 is the button
Seat 1: 10ba4419 ($6.91 in chips)
Seat 2: Hero ($9.42 in chips)
Seat 3: fb836f3e ($15.63 in chips)
Seat 4: 8e2c0828 ($12.47 in chips)
Seat 5: 2af80087 ($9.22 in chips)
Seat 6: 1da744d3 ($11.03 in chips)
Hero: posts small blind $0.05
fb836f3e: posts big blind $0.1
*** HOLE CARDS ***
Dealt to 10ba4419 
Dealt to Hero [Ts 4s]
Dealt to fb836f3e 
Dealt to 8e2c0828 
Dealt to 2af80087 
Dealt to 1da744d3 
8e2c0828: folds
2af80087: folds
1da744d3: raises $0.13 to $0.23
10ba4419: folds
Hero: folds
fb836f3e: folds
Uncalled bet ($0.13) returned to 1da744d3
*** SHOWDOWN ***
1da744d3 collected $0.25 from pot
*** SUMMARY ***
Total pot $0.25 | Rake $0 | Jackpot $0 | Bingo $0 | Fortune $0
Seat 1: 10ba4419 (button) folded before Flop (didn't bet)
Seat 2: Hero (small blind) folded before Flop
Seat 3: fb836f3e (big blind) folded before Flop
Seat 4: 8e2c0828 folded before Flop (didn't bet)
Seat 5: 2af80087 folded before Flop (didn't bet)
Seat 6: 1da744d3 collected ($0.25)


Poker Hand #RC1468480358: Hold'em No Limit  ($0.05/$0.1) - 2023/04/12 20:01:24
Table 'RushAndCash5635618' 6-max Seat #1 is the button
Seat 1: b9c3c978 ($10 in chips)
Seat 2: 3696275b ($17.73 in chips)
Seat 3: Hero ($9.52 in chips)
Seat 4: a1f82121 ($30.57 in chips)
Seat 5: d21a5b36 ($13.99 in chips)
Seat 6: fc96f7a9 ($22.07 in chips)
3696275b: posts small blind $0.05
Hero: posts big blind $0.1
*** HOLE CARDS ***
Dealt to b9c3c978 
Dealt to 3696275b 
Dealt to Hero [Tc 5d]
Dealt to a1f82121 
Dealt to d21a5b36 
Dealt to fc96f7a9 
a1f82121: folds
d21a5b36: folds
fc96f7a9: folds
b9c3c978: raises $0.15 to $0.25
3696275b: folds
Hero: folds
Uncalled bet ($0.15) returned to b9c3c978
*** SHOWDOWN ***
b9c3c978 collected $0.25 from pot
*** SUMMARY ***
Total pot $0.25 | Rake $0 | Jackpot $0 | Bingo $0 | Fortune $0
Seat 1: b9c3c978 (button) collected ($0.25)
Seat 2: 3696275b (small blind) folded before Flop
Seat 3: Hero (big blind) folded before Flop
Seat 4: a1f82121 folded before Flop (didn't bet)
Seat 5: d21a5b36 folded before Flop (didn't bet)
Seat 6: fc96f7a9 folded before Flop (didn't bet)


Poker Hand #RC1468480322: Hold'em No Limit  ($0.05/$0.1) - 2023/04/12 20:01:19
Table 'RushAndCash5635582' 6-max Seat #1 is the button
Seat 1: 936e20d7 ($28.04 in chips)
Seat 2: 3993f515 ($10.05 in chips)
Seat 3: 90a824e2 ($10 in chips)
Seat 4: Hero ($9.52 in chips)
Seat 5: 60226904 ($10 in chips)
Seat 6: 9a3609e8 ($4.84 in chips)
3993f515: posts small blind $0.05
90a824e2: posts big blind $0.1
*** HOLE CARDS ***
Dealt to 936e20d7 
Dealt to 3993f515 
Dealt to 90a824e2 
Dealt to Hero [Jc 6c]
Dealt to 60226904 
Dealt to 9a3609e8 
Hero: folds
60226904: raises $0.15 to $0.25
9a3609e8: folds
936e20d7: raises $0.65 to $0.9
3993f515: folds
90a824e2: folds
60226904: calls $0.65
*** FLOP *** [Jd 6s Qd]
60226904: checks
936e20d7: bets $0.98
60226904: folds
Uncalled bet ($0.98) returned to 936e20d7
*** SHOWDOWN ***
936e20d7 collected $1.86 from pot
*** SUMMARY ***
Total pot $1.95 | Rake $0.09 | Jackpot $0 | Bingo $0 | Fortune $0
Board [Jd 6s Qd]
Seat 1: 936e20d7 (button) won ($1.86)
Seat 2: 3993f515 (small blind) folded before Flop
Seat 3: 90a824e2 (big blind) folded before Flop
Seat 4: Hero folded before Flop (didn't bet)
Seat 5: 60226904 folded on the Flop
Seat 6: 9a3609e8 folded before Flop (didn't bet)


Poker Hand #RC1468480256: Hold'em No Limit  ($0.05/$0.1) - 2023/04/12 20:01:09
Table 'RushAndCash5635516' 6-max Seat #1 is the button
Seat 1: Hero ($9.52 in chips)
Seat 2: a42dd805 ($14.66 in chips)
Seat 3: 94cdf99f ($10 in chips)
Seat 4: d094b028 ($19.03 in chips)
Seat 5: 453a5b2c ($26.91 in chips)
Seat 6: eccb141 ($21.27 in chips)
a42dd805: posts small blind $0.05
94cdf99f: posts big blind $0.1
*** HOLE CARDS ***
Dealt to Hero [Tc 4h]
Dealt to a42dd805 
Dealt to 94cdf99f 
Dealt to d094b028 
Dealt to 453a5b2c 
Dealt to eccb141 
d094b028: folds
453a5b2c: folds
eccb141: raises $0.15 to $0.25
Hero: folds
a42dd805: folds
94cdf99f: folds
Uncalled bet ($0.15) returned to eccb141
*** SHOWDOWN ***
eccb141 collected $0.25 from pot
*** SUMMARY ***
Total pot $0.25 | Rake $0 | Jackpot $0 | Bingo $0 | Fortune $0
Seat 1: Hero (button) folded before Flop (didn't bet)
Seat 2: a42dd805 (small blind) folded before Flop
Seat 3: 94cdf99f (big blind) folded before Flop
Seat 4: d094b028 folded before Flop (didn't bet)
Seat 5: 453a5b2c folded before Flop (didn't bet)
Seat 6: eccb141 collected ($0.25)


Poker Hand #RC1468480191: Hold'em No Limit  ($0.05/$0.1) - 2023/04/12 20:00:59
Table 'RushAndCash5635451' 6-max Seat #1 is the button
Seat 1: 58f27a02 ($14.06 in chips)
Seat 2: d3d83101 ($10.2 in chips)
Seat 3: Hero ($9.62 in chips)
Seat 4: 6aba0c18 ($28.59 in chips)
Seat 5: 27df0055 ($40.59 in chips)
Seat 6: ca2de999 ($10.11 in chips)
d3d83101: posts small blind $0.05
Hero: posts big blind $0.1
*** HOLE CARDS ***
Dealt to 58f27a02 
Dealt to d3d83101 
Dealt to Hero [9s 4c]
Dealt to 6aba0c18 
Dealt to 27df0055 
Dealt to ca2de999 
6aba0c18: folds
27df0055: raises $0.1 to $0.2
ca2de999: folds
58f27a02: folds
d3d83101: folds
Hero: folds
Uncalled bet ($0.1) returned to 27df0055
*** SHOWDOWN ***
27df0055 collected $0.25 from pot
*** SUMMARY ***
Total pot $0.25 | Rake $0 | Jackpot $0 | Bingo $0 | Fortune $0
Seat 1: 58f27a02 (button) folded before Flop (didn't bet)
Seat 2: d3d83101 (small blind) folded before Flop
Seat 3: Hero (big blind) folded before Flop
Seat 4: 6aba0c18 folded before Flop (didn't bet)
Seat 5: 27df0055 collected ($0.25)
Seat 6: ca2de999 folded before Flop (didn't bet)


Poker Hand #RC1468480154: Hold'em No Limit  ($0.05/$0.1) - 2023/04/12 20:00:53
Table 'RushAndCash5635414' 6-max Seat #1 is the button
Seat 1: 3067e5a8 ($10.24 in chips)
Seat 2: 280e3bda ($33.21 in chips)
Seat 3: 1b08eafd ($10.7 in chips)
Seat 4: f285a611 ($10.15 in chips)
Seat 5: dc715600 ($20.17 in chips)
Seat 6: Hero ($9.62 in chips)
280e3bda: posts small blind $0.05
1b08eafd: posts big blind $0.1
*** HOLE CARDS ***
Dealt to 3067e5a8 
Dealt to 280e3bda 
Dealt to 1b08eafd 
Dealt to f285a611 
Dealt to dc715600 
Dealt to Hero [7c 6d]
f285a611: raises $0.1 to $0.2
dc715600: folds
Hero: folds
3067e5a8: folds
280e3bda: folds
1b08eafd: calls $0.1
*** FLOP *** [8c 4d Qc]
1b08eafd: checks
f285a611: bets $0.12
1b08eafd: folds
Uncalled bet ($0.12) returned to f285a611
*** SHOWDOWN ***
f285a611 collected $0.43 from pot
*** SUMMARY ***
Total pot $0.45 | Rake $0.02 | Jackpot $0 | Bingo $0 | Fortune $0
Board [8c 4d Qc]
Seat 1: 3067e5a8 (button) folded before Flop (didn't bet)
Seat 2: 280e3bda (small blind) folded before Flop
Seat 3: 1b08eafd (big blind) folded on the Flop
Seat 4: f285a611 won ($0.43)
Seat 5: dc715600 folded before Flop (didn't bet)
Seat 6: Hero folded before Flop (didn't bet)


Poker Hand #RC1468480106: Hold'em No Limit  ($0.05/$0.1) - 2023/04/12 20:00:46
Table 'RushAndCash5635366' 6-max Seat #1 is the button
Seat 1: 228c269b ($10 in chips)
Seat 2: f9e2637 ($11.54 in chips)
Seat 3: 8fee621f ($20.19 in chips)
Seat 4: 20ca98c2 ($12.13 in chips)
Seat 5: e8f4aae7 ($11.96 in chips)
Seat 6: Hero ($9.62 in chips)
f9e2637: posts small blind $0.05
8fee621f: posts big blind $0.1
*** HOLE CARDS ***
Dealt to 228c269b 
Dealt to f9e2637 
Dealt to 8fee621f 
Dealt to 20ca98c2 
Dealt to e8f4aae7 
Dealt to Hero [5c 3c]
20ca98c2: raises $0.15 to $0.25
e8f4aae7: folds
Hero: folds
228c269b: folds
f9e2637: raises $0.9 to $1.15
8fee621f: folds
20ca98c2: raises $1.3 to $2.45
f9e2637: folds
Uncalled bet ($1.3) returned to 20ca98c2
*** SHOWDOWN ***
20ca98c2 collected $2.28 from pot
*** SUMMARY ***
Total pot $2.4 | Rake $0.12 | Jackpot $0 | Bingo $0 | Fortune $0
Seat 1: 228c269b (button) folded before Flop (didn't bet)
Seat 2: f9e2637 (small blind) folded before Flop
Seat 3: 8fee621f (big blind) folded before Flop
Seat 4: 20ca98c2 collected ($2.28)
Seat 5: e8f4aae7 folded before Flop (didn't bet)
Seat 6: Hero folded before Flop (didn't bet)


Poker Hand #RC1468480071: Hold'em No Limit  ($0.05/$0.1) - 2023/04/12 20:00:41
Table 'RushAndCash5635331' 6-max Seat #1 is the button
Seat 1: 7019a139 ($14.45 in chips)
Seat 2: Hero ($9.67 in chips)
Seat 3: 7494dd8b ($8.31 in chips)
Seat 4: 3a2d2163 ($11.82 in chips)
Seat 5: 9f567eca ($14.26 in chips)
Seat 6: 1196c7f7 ($9.8 in chips)
Hero: posts small blind $0.05
7494dd8b: posts big blind $0.1
*** HOLE CARDS ***
Dealt to 7019a139 
Dealt to Hero [3s 6d]
Dealt to 7494dd8b 
Dealt to 3a2d2163 
Dealt to 9f567eca 
Dealt to 1196c7f7 
3a2d2163: folds
9f567eca: raises $0.15 to $0.25
1196c7f7: folds
7019a139: folds
Hero: folds
7494dd8b: folds
Uncalled bet ($0.15) returned to 9f567eca
*** SHOWDOWN ***
9f567eca collected $0.25 from pot
*** SUMMARY ***
Total pot $0.25 | Rake $0 | Jackpot $0 | Bingo $0 | Fortune $0
Seat 1: 7019a139 (button) folded before Flop (didn't bet)
Seat 2: Hero (small blind) folded before Flop
Seat 3: 7494dd8b (big blind) folded before Flop
Seat 4: 3a2d2163 folded before Flop (didn't bet)
Seat 5: 9f567eca collected ($0.25)
Seat 6: 1196c7f7 folded before Flop (didn't bet)


Poker Hand #RC1468479520: Hold'em No Limit  ($0.05/$0.1) - 2023/04/12 19:59:21
Table 'RushAndCash5634780' 6-max Seat #1 is the button
Seat 1: Hero ($9.67 in chips)
Seat 2: 8a37c1cd ($10 in chips)
Seat 3: 8fee621f ($20.06 in chips)
Seat 4: f5f45243 ($32.76 in chips)
Seat 5: 56a3772c ($10.72 in chips)
Seat 6: 4ad160bb ($10.37 in chips)
8a37c1cd: posts small blind $0.05
8fee621f: posts big blind $0.1
*** HOLE CARDS ***
Dealt to Hero [Kd 6h]
Dealt to 8a37c1cd 
Dealt to 8fee621f 
Dealt to f5f45243 
Dealt to 56a3772c 
Dealt to 4ad160bb 
f5f45243: raises $0.15 to $0.25
56a3772c: folds
4ad160bb: folds
Hero: folds
8a37c1cd: folds
8fee621f: folds
Uncalled bet ($0.15) returned to f5f45243
*** SHOWDOWN ***
f5f45243 collected $0.25 from pot
*** SUMMARY ***
Total pot $0.25 | Rake $0 | Jackpot $0 | Bingo $0 | Fortune $0
Seat 1: Hero (button) folded before Flop (didn't bet)
Seat 2: 8a37c1cd (small blind) folded before Flop
Seat 3: 8fee621f (big blind) folded before Flop
Seat 4: f5f45243 collected ($0.25)
Seat 5: 56a3772c folded before Flop (didn't bet)
Seat 6: 4ad160bb folded before Flop (didn't bet)


Poker Hand #RC1468479448: Hold'em No Limit  ($0.05/$0.1) - 2023/04/12 19:59:12
Table 'RushAndCash5634708' 6-max Seat #1 is the button
Seat 1: Hero ($9.67 in chips)
Seat 2: 20662d8d ($9.9 in chips)
Seat 3: b4b7e4e ($10 in chips)
Seat 4: 4cce4b91 ($13.75 in chips)
Seat 5: 90b414a9 ($19.1 in chips)
Seat 6: 3696275b ($17.88 in chips)
20662d8d: posts small blind $0.05
b4b7e4e: posts big blind $0.1
*** HOLE CARDS ***
Dealt to Hero [3d 7d]
Dealt to 20662d8d 
Dealt to b4b7e4e 
Dealt to 4cce4b91 
Dealt to 90b414a9 
Dealt to 3696275b 
4cce4b91: folds
90b414a9: raises $0.15 to $0.25
3696275b: folds
Hero: folds
20662d8d: folds
b4b7e4e: folds
Uncalled bet ($0.15) returned to 90b414a9
*** SHOWDOWN ***
90b414a9 collected $0.25 from pot
*** SUMMARY ***
Total pot $0.25 | Rake $0 | Jackpot $0 | Bingo $0 | Fortune $0
Seat 1: Hero (button) folded before Flop (didn't bet)
Seat 2: 20662d8d (small blind) folded before Flop
Seat 3: b4b7e4e (big blind) folded before Flop
Seat 4: 4cce4b91 folded before Flop (didn't bet)
Seat 5: 90b414a9 collected ($0.25)
Seat 6: 3696275b folded before Flop (didn't bet)


Poker Hand #RC1468479363: Hold'em No Limit  ($0.05/$0.1) - 2023/04/12 19:59:01
Table 'RushAndCash5634623' 6-max Seat #1 is the button
Seat 1: 22ce7a0d ($23.64 in chips)
Seat 2: 845cccfb ($21.6 in chips)
Seat 3: Hero ($9.77 in chips)
Seat 4: 3877af71 ($12.75 in chips)
Seat 5: 6d8fecca ($9.93 in chips)
Seat 6: 327f372c ($10.85 in chips)
845cccfb: posts small blind $0.05
Hero: posts big blind $0.1
*** HOLE CARDS ***
Dealt to 22ce7a0d 
Dealt to 845cccfb 
Dealt to Hero [7s 5c]
Dealt to 3877af71 
Dealt to 6d8fecca 
Dealt to 327f372c 
3877af71: folds
6d8fecca: folds
327f372c: raises $0.15 to $0.25
22ce7a0d: folds
845cccfb: folds
Hero: folds
Uncalled bet ($0.15) returned to 327f372c
*** SHOWDOWN ***
327f372c collected $0.25 from pot
*** SUMMARY ***
Total pot $0.25 | Rake $0 | Jackpot $0 | Bingo $0 | Fortune $0
Seat 1: 22ce7a0d (button) folded before Flop (didn't bet)
Seat 2: 845cccfb (small blind) folded before Flop
Seat 3: Hero (big blind) folded before Flop
Seat 4: 3877af71 folded before Flop (didn't bet)
Seat 5: 6d8fecca folded before Flop (didn't bet)
Seat 6: 327f372c collected ($0.25)


Poker Hand #RC1468479303: Hold'em No Limit  ($0.05/$0.1) - 2023/04/12 19:58:51
Table 'RushAndCash5634563' 6-max Seat #1 is the button
Seat 1: 32215bf1 ($9.25 in chips)
Seat 2: acc311b8 ($15.98 in chips)
Seat 3: 9ad8e031 ($7.44 in chips)
Seat 4: 31fdab54 ($11.94 in chips)
Seat 5: Hero ($9.77 in chips)
Seat 6: 16748df0 ($12.43 in chips)
acc311b8: posts small blind $0.05
9ad8e031: posts big blind $0.1
*** HOLE CARDS ***
Dealt to 32215bf1 
Dealt to acc311b8 
Dealt to 9ad8e031 
Dealt to 31fdab54 
Dealt to Hero [5h 7d]
Dealt to 16748df0 
31fdab54: folds
Hero: folds
16748df0: folds
32215bf1: folds
acc311b8: folds
Uncalled bet ($0.05) returned to 9ad8e031
*** SHOWDOWN ***
9ad8e031 collected $0.1 from pot
*** SUMMARY ***
Total pot $0.1 | Rake $0 | Jackpot $0 | Bingo $0 | Fortune $0
Seat 1: 32215bf1 (button) folded before Flop (didn't bet)
Seat 2: acc311b8 (small blind) folded before Flop
Seat 3: 9ad8e031 (big blind) collected ($0.1)
Seat 4: 31fdab54 folded before Flop (didn't bet)
Seat 5: Hero folded before Flop (didn't bet)
Seat 6: 16748df0 folded before Flop (didn't bet)


Poker Hand #RC1468479234: Hold'em No Limit  ($0.05/$0.1) - 2023/04/12 19:58:40
Table 'RushAndCash5634494' 6-max Seat #1 is the button
Seat 1: 8eded1ba ($8.97 in chips)
Seat 2: 6882a6d9 ($10.88 in chips)
Seat 3: eb14124c ($7.96 in chips)
Seat 4: 3236819 ($10.25 in chips)
Seat 5: e872750d ($31.06 in chips)
Seat 6: Hero ($9.77 in chips)
6882a6d9: posts small blind $0.05
eb14124c: posts big blind $0.1
*** HOLE CARDS ***
Dealt to 8eded1ba 
Dealt to 6882a6d9 
Dealt to eb14124c 
Dealt to 3236819 
Dealt to e872750d 
Dealt to Hero [9s Ad]
3236819: folds
e872750d: raises $0.1 to $0.2
Hero: folds
8eded1ba: folds
6882a6d9: folds
eb14124c: folds
Uncalled bet ($0.1) returned to e872750d
*** SHOWDOWN ***
e872750d collected $0.25 from pot
*** SUMMARY ***
Total pot $0.25 | Rake $0 | Jackpot $0 | Bingo $0 | Fortune $0
Seat 1: 8eded1ba (button) folded before Flop (didn't bet)
Seat 2: 6882a6d9 (small blind) folded before Flop
Seat 3: eb14124c (big blind) folded before Flop
Seat 4: 3236819 folded before Flop (didn't bet)
Seat 5: e872750d collected ($0.25)
Seat 6: Hero folded before Flop (didn't bet)


Poker Hand #RC1468479191: Hold'em No Limit  ($0.05/$0.1) - 2023/04/12 19:58:34
Table 'RushAndCash5634451' 6-max Seat #1 is the button
Seat 1: 7c0743ba ($11.32 in chips)
Seat 2: 6112daa1 ($10 in chips)
Seat 3: 9046cd3b ($14.81 in chips)
Seat 4: 7eb32471 ($25.48 in chips)
Seat 5: Hero ($9.77 in chips)
Seat 6: 108eb71 ($22.73 in chips)
6112daa1: posts small blind $0.05
9046cd3b: posts big blind $0.1
*** HOLE CARDS ***
Dealt to 7c0743ba 
Dealt to 6112daa1 
Dealt to 9046cd3b 
Dealt to 7eb32471 
Dealt to Hero [9s 4h]
Dealt to 108eb71 
7eb32471: folds
Hero: folds
108eb71: folds
7c0743ba: raises $0.12 to $0.22
6112daa1: folds
9046cd3b: calls $0.12
*** FLOP *** [Js 8h 2h]
9046cd3b: checks
7c0743ba: checks
*** TURN *** [Js 8h 2h] [Ad]
9046cd3b: checks
7c0743ba: bets $0.17
9046cd3b: calls $0.17
*** RIVER *** [Js 8h 2h Ad] [5c]
9046cd3b: checks
7c0743ba: checks
9046cd3b: shows [Kh 9h] (Ace-High)
7c0743ba: shows [2d 6d] (Pair of Twos)
*** SHOWDOWN ***
7c0743ba collected $0.79 from pot
*** SUMMARY ***
Total pot $0.83 | Rake $0.04 | Jackpot $0 | Bingo $0 | Fortune $0
Board [Js 8h 2h Ad 5c]
Seat 1: 7c0743ba (button) showed [2d 6d] and won ($0.79) with Pair of Twos
Seat 2: 6112daa1 (small blind) folded before Flop
Seat 3: 9046cd3b (big blind) showed [Kh 9h] and lost with Ace-High
Seat 4: 7eb32471 folded before Flop (didn't bet)
Seat 5: Hero folded before Flop (didn't bet)
Seat 6: 108eb71 folded before Flop (didn't bet)


Poker Hand #RC1468478920: Hold'em No Limit  ($0.05/$0.1) - 2023/04/12 19:57:51
Table 'RushAndCash5634180' 6-max Seat #1 is the button
Seat 1: e33e588d ($8.65 in chips)
Seat 2: Hero ($9.5 in chips)
Seat 3: 9184a70c ($10 in chips)
Seat 4: cdaec459 ($10 in chips)
Seat 5: fe9635b ($2.64 in chips)
Seat 6: 228c269b ($10.28 in chips)
Hero: posts small blind $0.05
9184a70c: posts big blind $0.1
*** HOLE CARDS ***
Dealt to e33e588d 
Dealt to Hero [8d 7d]
Dealt to 9184a70c 
Dealt to cdaec459 
Dealt to fe9635b 
Dealt to 228c269b 
cdaec459: folds
fe9635b: folds
228c269b: folds
e33e588d: folds
Hero: raises $0.2 to $0.3
9184a70c: calls $0.2
*** FLOP *** [5d 6h 2h]
Hero: bets $0.3
9184a70c: folds
Uncalled bet ($0.3) returned to Hero
*** SHOWDOWN ***
Hero collected $0.57 from pot
*** SUMMARY ***
Total pot $0.6 | Rake $0.03 | Jackpot $0 | Bingo $0 | Fortune $0
Board [5d 6h 2h]
Seat 1: e33e588d (button) folded before Flop (didn't bet)
Seat 2: Hero (small blind) won ($0.57)
Seat 3: 9184a70c (big blind) folded on the Flop
Seat 4: cdaec459 folded before Flop (didn't bet)
Seat 5: fe9635b folded before Flop (didn't bet)
Seat 6: 228c269b folded before Flop (didn't bet)


Poker Hand #RC1468478869: Hold'em No Limit  ($0.05/$0.1) - 2023/04/12 19:57:44
Table 'RushAndCash5634129' 6-max Seat #1 is the button
Seat 1: 3e9ad104 ($10.05 in chips)
Seat 2: b6769e32 ($10 in chips)
Seat 3: d56de772 ($12.35 in chips)
Seat 4: 6108a2fc ($20.42 in chips)
Seat 5: Hero ($9.5 in chips)
Seat 6: 6698a695 ($10.44 in chips)
b6769e32: posts small blind $0.05
d56de772: posts big blind $0.1
*** HOLE CARDS ***
Dealt to 3e9ad104 
Dealt to b6769e32 
Dealt to d56de772 
Dealt to 6108a2fc 
Dealt to Hero [Kd 2s]
Dealt to 6698a695 
6108a2fc: folds
Hero: folds
6698a695: folds
3e9ad104: folds
b6769e32: raises $0.2 to $0.3
d56de772: calls $0.2
*** FLOP *** [8d 3h Ts]
b6769e32: checks
d56de772: checks
*** TURN *** [8d 3h Ts] [7c]
b6769e32: bets $0.45
d56de772: folds
Uncalled bet ($0.45) returned to b6769e32
*** SHOWDOWN ***
b6769e32 collected $0.57 from pot
*** SUMMARY ***
Total pot $0.6 | Rake $0.03 | Jackpot $0 | Bingo $0 | Fortune $0
Board [8d 3h Ts 7c]
Seat 1: 3e9ad104 (button) folded before Flop (didn't bet)
Seat 2: b6769e32 (small blind) won ($0.57)
Seat 3: d56de772 (big blind) folded on the Turn
Seat 4: 6108a2fc folded before Flop (didn't bet)
Seat 5: Hero folded before Flop (didn't bet)
Seat 6: 6698a695 folded before Flop (didn't bet)


Poker Hand #RC1468478836: Hold'em No Limit  ($0.05/$0.1) - 2023/04/12 19:57:38
Table 'RushAndCash5634096' 6-max Seat #1 is the button
Seat 1: e748ac59 ($11.11 in chips)
Seat 2: 74b2edd8 ($5.37 in chips)
Seat 3: a84e6d0a ($22.23 in chips)
Seat 4: Hero ($9.5 in chips)
Seat 5: d1706681 ($12.37 in chips)
Seat 6: 85b7299e ($16.38 in chips)
74b2edd8: posts small blind $0.05
a84e6d0a: posts big blind $0.1
*** HOLE CARDS ***
Dealt to e748ac59 
Dealt to 74b2edd8 
Dealt to a84e6d0a 
Dealt to Hero [6d 2h]
Dealt to d1706681 
Dealt to 85b7299e 
Hero: folds
d1706681: raises $0.15 to $0.25
85b7299e: folds
e748ac59: folds
74b2edd8: folds
a84e6d0a: folds
Uncalled bet ($0.15) returned to d1706681
*** SHOWDOWN ***
d1706681 collected $0.25 from pot
*** SUMMARY ***
Total pot $0.25 | Rake $0 | Jackpot $0 | Bingo $0 | Fortune $0
Seat 1: e748ac59 (button) folded before Flop (didn't bet)
Seat 2: 74b2edd8 (small blind) folded before Flop
Seat 3: a84e6d0a (big blind) folded before Flop
Seat 4: Hero folded before Flop (didn't bet)
Seat 5: d1706681 collected ($0.25)
Seat 6: 85b7299e folded before Flop (didn't bet)


Poker Hand #RC1468478698: Hold'em No Limit  ($0.05/$0.1) - 2023/04/12 19:57:18
Table 'RushAndCash5633958' 6-max Seat #1 is the button
Seat 1: a26ad7e4 ($14.25 in chips)
Seat 2: 90cc4827 ($19.38 in chips)
Seat 3: 80bc8d78 ($38.24 in chips)
Seat 4: e0410485 ($11.98 in chips)
Seat 5: 7355acdd ($10 in chips)
Seat 6: Hero ($9.5 in chips)
90cc4827: posts small blind $0.05
80bc8d78: posts big blind $0.1
*** HOLE CARDS ***
Dealt to a26ad7e4 
Dealt to 90cc4827 
Dealt to 80bc8d78 
Dealt to e0410485 
Dealt to 7355acdd 
Dealt to Hero [3h Jc]
e0410485: folds
7355acdd: folds
Hero: folds
a26ad7e4: raises $0.15 to $0.25
90cc4827: folds
80bc8d78: folds
Uncalled bet ($0.15) returned to a26ad7e4
*** SHOWDOWN ***
a26ad7e4 collected $0.25 from pot
*** SUMMARY ***
Total pot $0.25 | Rake $0 | Jackpot $0 | Bingo $0 | Fortune $0
Seat 1: a26ad7e4 (button) collected ($0.25)
Seat 2: 90cc4827 (small blind) folded before Flop
Seat 3: 80bc8d78 (big blind) folded before Flop
Seat 4: e0410485 folded before Flop (didn't bet)
Seat 5: 7355acdd folded before Flop (didn't bet)
Seat 6: Hero folded before Flop (didn't bet)


Poker Hand #RC1468478652: Hold'em No Limit  ($0.05/$0.1) - 2023/04/12 19:57:11
Table 'RushAndCash5633912' 6-max Seat #1 is the button
Seat 1: 3a2d2163 ($12.22 in chips)
Seat 2: 31093ad0 ($11.4 in chips)
Seat 3: e5e9aa2d ($9.17 in chips)
Seat 4: 51443629 ($12.49 in chips)
Seat 5: Hero ($9.5 in chips)
Seat 6: 44e40150 ($13.4 in chips)
31093ad0: posts small blind $0.05
e5e9aa2d: posts big blind $0.1
*** HOLE CARDS ***
Dealt to 3a2d2163 
Dealt to 31093ad0 
Dealt to e5e9aa2d 
Dealt to 51443629 
Dealt to Hero [6s Th]
Dealt to 44e40150 
51443629: folds
Hero: folds
44e40150: raises $0.15 to $0.25
3a2d2163: folds
31093ad0: folds
e5e9aa2d: folds
Uncalled bet ($0.15) returned to 44e40150
*** SHOWDOWN ***
44e40150 collected $0.25 from pot
*** SUMMARY ***
Total pot $0.25 | Rake $0 | Jackpot $0 | Bingo $0 | Fortune $0
Seat 1: 3a2d2163 (button) folded before Flop (didn't bet)
Seat 2: 31093ad0 (small blind) folded before Flop
Seat 3: e5e9aa2d (big blind) folded before Flop
Seat 4: 51443629 folded before Flop (didn't bet)
Seat 5: Hero folded before Flop (didn't bet)
Seat 6: 44e40150 collected ($0.25)


Poker Hand #RC1468478387: Hold'em No Limit  ($0.05/$0.1) - 2023/04/12 19:56:32
Table 'RushAndCash5633647' 6-max Seat #1 is the button
Seat 1: 5d11d9c8 ($10.15 in chips)
Seat 2: e5e9aa2d ($8.85 in chips)
Seat 3: f347cc26 ($10.07 in chips)
Seat 4: 4e661c11 ($10.99 in chips)
Seat 5: 6b90c7e0 ($10.97 in chips)
Seat 6: Hero ($9.75 in chips)
e5e9aa2d: posts small blind $0.05
f347cc26: posts big blind $0.1
*** HOLE CARDS ***
Dealt to 5d11d9c8 
Dealt to e5e9aa2d 
Dealt to f347cc26 
Dealt to 4e661c11 
Dealt to 6b90c7e0 
Dealt to Hero [7c As]
4e661c11: folds
6b90c7e0: folds
Hero: raises $0.15 to $0.25
5d11d9c8: folds
e5e9aa2d: raises $0.45 to $0.7
f347cc26: folds
Hero: folds
Uncalled bet ($0.45) returned to e5e9aa2d
*** SHOWDOWN ***
e5e9aa2d collected $0.57 from pot
*** SUMMARY ***
Total pot $0.6 | Rake $0.03 | Jackpot $0 | Bingo $0 | Fortune $0
Seat 1: 5d11d9c8 (button) folded before Flop (didn't bet)
Seat 2: e5e9aa2d (small blind) collected ($0.57)
Seat 3: f347cc26 (big blind) folded before Flop
Seat 4: 4e661c11 folded before Flop (didn't bet)
Seat 5: 6b90c7e0 folded before Flop (didn't bet)
Seat 6: Hero folded before Flop


Poker Hand #RC1468478349: Hold'em No Limit  ($0.05/$0.1) - 2023/04/12 19:56:26
Table 'RushAndCash5633609' 6-max Seat #1 is the button
Seat 1: Hero ($9.75 in chips)
Seat 2: d5fd1a33 ($16.4 in chips)
Seat 3: 55972646 ($8.6 in chips)
Seat 4: 649515ae ($11.37 in chips)
Seat 5: ebd59a32 ($18.28 in chips)
Seat 6: 2b3a6ab0 ($8.83 in chips)
d5fd1a33: posts small blind $0.05
55972646: posts big blind $0.1
*** HOLE CARDS ***
Dealt to Hero [3s 9d]
Dealt to d5fd1a33 
Dealt to 55972646 
Dealt to 649515ae 
Dealt to ebd59a32 
Dealt to 2b3a6ab0 
649515ae: folds
ebd59a32: folds
2b3a6ab0: folds
Hero: folds
d5fd1a33: folds
Uncalled bet ($0.05) returned to 55972646
*** SHOWDOWN ***
55972646 collected $0.1 from pot
*** SUMMARY ***
Total pot $0.1 | Rake $0 | Jackpot $0 | Bingo $0 | Fortune $0
Seat 1: Hero (button) folded before Flop (didn't bet)
Seat 2: d5fd1a33 (small blind) folded before Flop
Seat 3: 55972646 (big blind) collected ($0.1)
Seat 4: 649515ae folded before Flop (didn't bet)
Seat 5: ebd59a32 folded before Flop (didn't bet)
Seat 6: 2b3a6ab0 folded before Flop (didn't bet)


Poker Hand #RC1468478230: Hold'em No Limit  ($0.05/$0.1) - 2023/04/12 19:56:07
Table 'RushAndCash5633490' 6-max Seat #1 is the button
Seat 1: e263d619 ($10.47 in chips)
Seat 2: Hero ($9.8 in chips)
Seat 3: 4e661c11 ($11.09 in chips)
Seat 4: f2f4ab6b ($26.03 in chips)
Seat 5: d4483568 ($23.76 in chips)
Seat 6: 76903f44 ($6.28 in chips)
Hero: posts small blind $0.05
4e661c11: posts big blind $0.1
*** HOLE CARDS ***
Dealt to e263d619 
Dealt to Hero [8h 6d]
Dealt to 4e661c11 
Dealt to f2f4ab6b 
Dealt to d4483568 
Dealt to 76903f44 
f2f4ab6b: raises $0.2 to $0.3
d4483568: folds
76903f44: calls $0.3
e263d619: folds
Hero: folds
4e661c11: folds
*** FLOP *** [3d 5c Ks]
f2f4ab6b: checks
76903f44: checks
*** TURN *** [3d 5c Ks] [3c]
f2f4ab6b: bets $0.25
76903f44: folds
Uncalled bet ($0.25) returned to f2f4ab6b
*** SHOWDOWN ***
f2f4ab6b collected $0.72 from pot
*** SUMMARY ***
Total pot $0.75 | Rake $0.03 | Jackpot $0 | Bingo $0 | Fortune $0
Board [3d 5c Ks 3c]
Seat 1: e263d619 (button) folded before Flop (didn't bet)
Seat 2: Hero (small blind) folded before Flop
Seat 3: 4e661c11 (big blind) folded before Flop
Seat 4: f2f4ab6b won ($0.72)
Seat 5: d4483568 folded before Flop (didn't bet)
Seat 6: 76903f44 folded on the Turn


Poker Hand #RC1468478181: Hold'em No Limit  ($0.05/$0.1) - 2023/04/12 19:55:59
Table 'RushAndCash5633441' 6-max Seat #1 is the button
Seat 1: 3696275b ($18.03 in chips)
Seat 2: 9354ac02 ($10.94 in chips)
Seat 3: Hero ($9.75 in chips)
Seat 4: dfe9b225 ($9.93 in chips)
Seat 5: 27c3301e ($24.3 in chips)
Seat 6: e748ac59 ($9.9 in chips)
9354ac02: posts small blind $0.05
Hero: posts big blind $0.1
*** HOLE CARDS ***
Dealt to 3696275b 
Dealt to 9354ac02 
Dealt to Hero [Jh 4c]
Dealt to dfe9b225 
Dealt to 27c3301e 
Dealt to e748ac59 
dfe9b225: folds
27c3301e: folds
e748ac59: folds
3696275b: folds
9354ac02: folds
Uncalled bet ($0.05) returned to Hero
*** SHOWDOWN ***
Hero collected $0.1 from pot
*** SUMMARY ***
Total pot $0.1 | Rake $0 | Jackpot $0 | Bingo $0 | Fortune $0
Seat 1: 3696275b (button) folded before Flop (didn't bet)
Seat 2: 9354ac02 (small blind) folded before Flop
Seat 3: Hero (big blind) collected ($0.1)
Seat 4: dfe9b225 folded before Flop (didn't bet)
Seat 5: 27c3301e folded before Flop (didn't bet)
Seat 6: e748ac59 folded before Flop (didn't bet)


Poker Hand #RC1468477954: Hold'em No Limit  ($0.05/$0.1) - 2023/04/12 19:55:24
Table 'RushAndCash5633214' 6-max Seat #1 is the button
Seat 1: dfe9b225 ($10.13 in chips)
Seat 2: d4483568 ($22.99 in chips)
Seat 3: 6c0fda6b ($11 in chips)
Seat 4: e2b096c ($12.9 in chips)
Seat 5: e748ac59 ($10.1 in chips)
Seat 6: Hero ($9.14 in chips)
d4483568: posts small blind $0.05
6c0fda6b: posts big blind $0.1
*** HOLE CARDS ***
Dealt to dfe9b225 
Dealt to d4483568 
Dealt to 6c0fda6b 
Dealt to e2b096c 
Dealt to e748ac59 
Dealt to Hero [7c 8c]
e2b096c: folds
e748ac59: raises $0.1 to $0.2
Hero: calls $0.2
dfe9b225: calls $0.2
d4483568: folds
6c0fda6b: calls $0.1
*** FLOP *** [6c Td Th]
6c0fda6b: checks
e748ac59: checks
Hero: bets $0.43
dfe9b225: folds
6c0fda6b: folds
e748ac59: folds
Uncalled bet ($0.43) returned to Hero
*** SHOWDOWN ***
Hero collected $0.81 from pot
*** SUMMARY ***
Total pot $0.85 | Rake $0.04 | Jackpot $0 | Bingo $0 | Fortune $0
Board [6c Td Th]
Seat 1: dfe9b225 (button) folded on the Flop
Seat 2: d4483568 (small blind) folded before Flop
Seat 3: 6c0fda6b (big blind) folded on the Flop
Seat 4: e2b096c folded before Flop (didn't bet)
Seat 5: e748ac59 folded on the Flop
Seat 6: Hero won ($0.81)


Poker Hand #RC1468477917: Hold'em No Limit  ($0.05/$0.1) - 2023/04/12 19:55:18
Table 'RushAndCash5633177' 6-max Seat #1 is the button
Seat 1: f9d9e12c ($2.36 in chips)
Seat 2: d755c17e ($24.86 in chips)
Seat 3: 743868c4 ($7.44 in chips)
Seat 4: Hero ($9.14 in chips)
Seat 5: 76d263d2 ($13.79 in chips)
Seat 6: e890c622 ($15.67 in chips)
d755c17e: posts small blind $0.05
743868c4: posts big blind $0.1
*** HOLE CARDS ***
Dealt to f9d9e12c 
Dealt to d755c17e 
Dealt to 743868c4 
Dealt to Hero [7c Tc]
Dealt to 76d263d2 
Dealt to e890c622 
Hero: folds
76d263d2: folds
e890c622: folds
f9d9e12c: raises $0.1 to $0.2
d755c17e: folds
743868c4: calls $0.1
*** FLOP *** [Qs 6c Th]
743868c4: checks
f9d9e12c: checks
*** TURN *** [Qs 6c Th] [9h]
743868c4: checks
f9d9e12c: checks
*** RIVER *** [Qs 6c Th 9h] [Qd]
743868c4: bets $0.15
f9d9e12c: calls $0.15
743868c4: shows [3c 9c] (Pair of Queens and Pair of Nines)
f9d9e12c: shows [Ah Ks] (Pair of Queens)
*** SHOWDOWN ***
743868c4 collected $0.72 from pot
*** SUMMARY ***
Total pot $0.75 | Rake $0.03 | Jackpot $0 | Bingo $0 | Fortune $0
Board [Qs 6c Th 9h Qd]
Seat 1: f9d9e12c (button) showed [Ah Ks] and lost with Pair of Queens
Seat 2: d755c17e (small blind) folded before Flop
Seat 3: 743868c4 (big blind) showed [3c 9c] and won ($0.72) with Pair of Queens and Pair of Nines
Seat 4: Hero folded before Flop (didn't bet)
Seat 5: 76d263d2 folded before Flop (didn't bet)
Seat 6: e890c622 folded before Flop (didn't bet)


Poker Hand #RC1468477859: Hold'em No Limit  ($0.05/$0.1) - 2023/04/12 19:55:09
Table 'RushAndCash5633119' 6-max Seat #1 is the button
Seat 1: 8954ad8e ($10 in chips)
Seat 2: Hero ($9.19 in chips)
Seat 3: 7f26736f ($16.29 in chips)
Seat 4: eccb141 ($17.25 in chips)
Seat 5: 68fafa57 ($10.91 in chips)
Seat 6: e3ffd0f3 ($8.15 in chips)
Hero: posts small blind $0.05
7f26736f: posts big blind $0.1
*** HOLE CARDS ***
Dealt to 8954ad8e 
Dealt to Hero [7s 9d]
Dealt to 7f26736f 
Dealt to eccb141 
Dealt to 68fafa57 
Dealt to e3ffd0f3 
eccb141: folds
68fafa57: folds
e3ffd0f3: folds
8954ad8e: folds
Hero: folds
Uncalled bet ($0.05) returned to 7f26736f
*** SHOWDOWN ***
7f26736f collected $0.1 from pot
*** SUMMARY ***
Total pot $0.1 | Rake $0 | Jackpot $0 | Bingo $0 | Fortune $0
Seat 1: 8954ad8e (button) folded before Flop (didn't bet)
Seat 2: Hero (small blind) folded before Flop
Seat 3: 7f26736f (big blind) collected ($0.1)
Seat 4: eccb141 folded before Flop (didn't bet)
Seat 5: 68fafa57 folded before Flop (didn't bet)
Seat 6: e3ffd0f3 folded before Flop (didn't bet)


Poker Hand #RC1468477764: Hold'em No Limit  ($0.05/$0.1) - 2023/04/12 19:54:56
Table 'RushAndCash5633024' 6-max Seat #1 is the button
Seat 1: 49df31c9 ($13.98 in chips)
Seat 2: e100ba5a ($9.95 in chips)
Seat 3: 3664fec9 ($10.49 in chips)
Seat 4: a8ee82b3 ($10.27 in chips)
Seat 5: 6a485947 ($10.05 in chips)
Seat 6: Hero ($9.19 in chips)
e100ba5a: posts small blind $0.05
3664fec9: posts big blind $0.1
*** HOLE CARDS ***
Dealt to 49df31c9 
Dealt to e100ba5a 
Dealt to 3664fec9 
Dealt to a8ee82b3 
Dealt to 6a485947 
Dealt to Hero [7s 9d]
a8ee82b3: folds
6a485947: folds
Hero: folds
49df31c9: folds
e100ba5a: folds
Uncalled bet ($0.05) returned to 3664fec9
*** SHOWDOWN ***
3664fec9 collected $0.1 from pot
*** SUMMARY ***
Total pot $0.1 | Rake $0 | Jackpot $0 | Bingo $0 | Fortune $0
Seat 1: 49df31c9 (button) folded before Flop (didn't bet)
Seat 2: e100ba5a (small blind) folded before Flop
Seat 3: 3664fec9 (big blind) collected ($0.1)
Seat 4: a8ee82b3 folded before Flop (didn't bet)
Seat 5: 6a485947 folded before Flop (didn't bet)
Seat 6: Hero folded before Flop (didn't bet)


Poker Hand #RC1468477732: Hold'em No Limit  ($0.05/$0.1) - 2023/04/12 19:54:51
Table 'RushAndCash5632992' 6-max Seat #1 is the button
Seat 1: 76d263d2 ($14.02 in chips)
Seat 2: 4d2a11f5 ($30.18 in chips)
Seat 3: Hero ($9.29 in chips)
Seat 4: 31fdab54 ($12.05 in chips)
Seat 5: 3a0b1130 ($32.52 in chips)
Seat 6: dc354280 ($33.9 in chips)
4d2a11f5: posts small blind $0.05
Hero: posts big blind $0.1
*** HOLE CARDS ***
Dealt to 76d263d2 
Dealt to 4d2a11f5 
Dealt to Hero [2c Td]
Dealt to 31fdab54 
Dealt to 3a0b1130 
Dealt to dc354280 
31fdab54: folds
3a0b1130: folds
dc354280: raises $0.13 to $0.23
76d263d2: folds
4d2a11f5: folds
Hero: folds
Uncalled bet ($0.13) returned to dc354280
*** SHOWDOWN ***
dc354280 collected $0.25 from pot
*** SUMMARY ***
Total pot $0.25 | Rake $0 | Jackpot $0 | Bingo $0 | Fortune $0
Seat 1: 76d263d2 (button) folded before Flop (didn't bet)
Seat 2: 4d2a11f5 (small blind) folded before Flop
Seat 3: Hero (big blind) folded before Flop
Seat 4: 31fdab54 folded before Flop (didn't bet)
Seat 5: 3a0b1130 folded before Flop (didn't bet)
Seat 6: dc354280 collected ($0.25)


Poker Hand #RC1468477601: Hold'em No Limit  ($0.05/$0.1) - 2023/04/12 19:54:31
Table 'RushAndCash5632861' 6-max Seat #1 is the button
Seat 1: e3ffd0f3 ($8.45 in chips)
Seat 2: 8c1bbb0b ($15.73 in chips)
Seat 3: 228c269b ($10.03 in chips)
Seat 4: 33a16d50 ($10.39 in chips)
Seat 5: eea8112 ($7.84 in chips)
Seat 6: Hero ($8.96 in chips)
8c1bbb0b: posts small blind $0.05
228c269b: posts big blind $0.1
*** HOLE CARDS ***
Dealt to e3ffd0f3 
Dealt to 8c1bbb0b 
Dealt to 228c269b 
Dealt to 33a16d50 
Dealt to eea8112 
Dealt to Hero [Jh Ah]
33a16d50: folds
eea8112: raises $0.1 to $0.2
Hero: raises $0.42 to $0.62
e3ffd0f3: folds
8c1bbb0b: folds
228c269b: folds
eea8112: folds
Uncalled bet ($0.42) returned to Hero
*** SHOWDOWN ***
Hero collected $0.53 from pot
*** SUMMARY ***
Total pot $0.55 | Rake $0.02 | Jackpot $0 | Bingo $0 | Fortune $0
Seat 1: e3ffd0f3 (button) folded before Flop (didn't bet)
Seat 2: 8c1bbb0b (small blind) folded before Flop
Seat 3: 228c269b (big blind) folded before Flop
Seat 4: 33a16d50 folded before Flop (didn't bet)
Seat 5: eea8112 folded before Flop
Seat 6: Hero collected ($0.53)


Poker Hand #RC1468477432: Hold'em No Limit  ($0.05/$0.1) - 2023/04/12 19:54:05
Table 'RushAndCash5632692' 6-max Seat #1 is the button
Seat 1: Hero ($8.96 in chips)
Seat 2: 6e0b38a4 ($12.22 in chips)
Seat 3: 20ca98c2 ($10.9 in chips)
Seat 4: 28120b91 ($4 in chips)
Seat 5: 108eb71 ($22.74 in chips)
Seat 6: ba59797 ($4.43 in chips)
6e0b38a4: posts small blind $0.05
20ca98c2: posts big blind $0.1
*** HOLE CARDS ***
Dealt to Hero [6d 7d]
Dealt to 6e0b38a4 
Dealt to 20ca98c2 
Dealt to 28120b91 
Dealt to 108eb71 
Dealt to ba59797 
28120b91: folds
108eb71: folds
ba59797: raises $0.25 to $0.35
Hero: folds
6e0b38a4: folds
20ca98c2: folds
Uncalled bet ($0.25) returned to ba59797
*** SHOWDOWN ***
ba59797 collected $0.25 from pot
*** SUMMARY ***
Total pot $0.25 | Rake $0 | Jackpot $0 | Bingo $0 | Fortune $0
Seat 1: Hero (button) folded before Flop (didn't bet)
Seat 2: 6e0b38a4 (small blind) folded before Flop
Seat 3: 20ca98c2 (big blind) folded before Flop
Seat 4: 28120b91 folded before Flop (didn't bet)
Seat 5: 108eb71 folded before Flop (didn't bet)
Seat 6: ba59797 collected ($0.25)


Poker Hand #RC1468477401: Hold'em No Limit  ($0.05/$0.1) - 2023/04/12 19:54:00
Table 'RushAndCash5632661' 6-max Seat #1 is the button
Seat 1: 79cb81d7 ($10 in chips)
Seat 2: 6fc95293 ($6.51 in chips)
Seat 3: 13d9285a ($9.93 in chips)
Seat 4: 60d0b096 ($14.75 in chips)
Seat 5: Hero ($8.96 in chips)
Seat 6: 460e0a46 ($10.3 in chips)
6fc95293: posts small blind $0.05
13d9285a: posts big blind $0.1
*** HOLE CARDS ***
Dealt to 79cb81d7 
Dealt to 6fc95293 
Dealt to 13d9285a 
Dealt to 60d0b096 
Dealt to Hero [Jc 4s]
Dealt to 460e0a46 
60d0b096: folds
Hero: folds
460e0a46: raises $0.15 to $0.25
79cb81d7: folds
6fc95293: folds
13d9285a: calls $0.15
*** FLOP *** [Jh 8d 6s]
13d9285a: checks
460e0a46: bets $0.2
13d9285a: folds
Uncalled bet ($0.2) returned to 460e0a46
*** SHOWDOWN ***
460e0a46 collected $0.53 from pot
*** SUMMARY ***
Total pot $0.55 | Rake $0.02 | Jackpot $0 | Bingo $0 | Fortune $0
Board [Jh 8d 6s]
Seat 1: 79cb81d7 (button) folded before Flop (didn't bet)
Seat 2: 6fc95293 (small blind) folded before Flop
Seat 3: 13d9285a (big blind) folded on the Flop
Seat 4: 60d0b096 folded before Flop (didn't bet)
Seat 5: Hero folded before Flop (didn't bet)
Seat 6: 460e0a46 won ($0.53)


Poker Hand #RC1468477346: Hold'em No Limit  ($0.05/$0.1) - 2023/04/12 19:53:51
Table 'RushAndCash5632606' 6-max Seat #1 is the button
Seat 1: Hero ($8.96 in chips)
Seat 2: 668dc72a ($14.92 in chips)
Seat 3: ad456f0f ($12.82 in chips)
Seat 4: 8796732 ($5.2 in chips)
Seat 5: 27df0055 ($32.59 in chips)
Seat 6: 93af2464 ($15.8 in chips)
668dc72a: posts small blind $0.05
ad456f0f: posts big blind $0.1
*** HOLE CARDS ***
Dealt to Hero [Qd Ts]
Dealt to 668dc72a 
Dealt to ad456f0f 
Dealt to 8796732 
Dealt to 27df0055 
Dealt to 93af2464 
8796732: raises $0.12 to $0.22
27df0055: folds
93af2464: folds
Hero: folds
668dc72a: folds
ad456f0f: calls $0.12
*** FLOP *** [7h 5c 9h]
ad456f0f: checks
8796732: checks
*** TURN *** [7h 5c 9h] [7d]
ad456f0f: checks
8796732: bets $0.25
ad456f0f: calls $0.25
*** RIVER *** [7h 5c 9h 7d] [4h]
ad456f0f: checks
8796732: checks
ad456f0f: shows [As Jh] (Pair of Sevens)
8796732: shows [Qh Jc] (Pair of Sevens)
*** SHOWDOWN ***
ad456f0f collected $0.94 from pot
*** SUMMARY ***
Total pot $0.99 | Rake $0.05 | Jackpot $0 | Bingo $0 | Fortune $0
Board [7h 5c 9h 7d 4h]
Seat 1: Hero (button) folded before Flop (didn't bet)
Seat 2: 668dc72a (small blind) folded before Flop
Seat 3: ad456f0f (big blind) showed [As Jh] and won ($0.94) with Pair of Sevens
Seat 4: 8796732 showed [Qh Jc] and lost with Pair of Sevens
Seat 5: 27df0055 folded before Flop (didn't bet)
Seat 6: 93af2464 folded before Flop (didn't bet)


Poker Hand #RC1468477250: Hold'em No Limit  ($0.05/$0.1) - 2023/04/12 19:53:38
Table 'RushAndCash5632510' 6-max Seat #1 is the button
Seat 1: 7c632f7f ($13.61 in chips)
Seat 2: Hero ($9.01 in chips)
Seat 3: 39b5c546 ($22.93 in chips)
Seat 4: e225898 ($10.6 in chips)
Seat 5: f9cc8093 ($11.41 in chips)
Seat 6: 5e0ca113 ($10 in chips)
Hero: posts small blind $0.05
39b5c546: posts big blind $0.1
*** HOLE CARDS ***
Dealt to 7c632f7f 
Dealt to Hero [4c Jd]
Dealt to 39b5c546 
Dealt to e225898 
Dealt to f9cc8093 
Dealt to 5e0ca113 
e225898: raises $0.2 to $0.3
f9cc8093: folds
5e0ca113: folds
7c632f7f: calls $0.3
Hero: folds
39b5c546: folds
*** FLOP *** [2s 3h Ts]
e225898: bets $0.25
7c632f7f: calls $0.25
*** TURN *** [2s 3h Ts] [9d]
e225898: bets $0.65
7c632f7f: calls $0.65
*** RIVER *** [2s 3h Ts 9d] [6s]
e225898: bets $1.3
7c632f7f: folds
Uncalled bet ($1.3) returned to e225898
*** SHOWDOWN ***
e225898 collected $2.43 from pot
*** SUMMARY ***
Total pot $2.55 | Rake $0.12 | Jackpot $0 | Bingo $0 | Fortune $0
Board [2s 3h Ts 9d 6s]
Seat 1: 7c632f7f (button) folded on the River
Seat 2: Hero (small blind) folded before Flop
Seat 3: 39b5c546 (big blind) folded before Flop
Seat 4: e225898 won ($2.43)
Seat 5: f9cc8093 folded before Flop (didn't bet)
Seat 6: 5e0ca113 folded before Flop (didn't bet)


Poker Hand #RC1468477133: Hold'em No Limit  ($0.05/$0.1) - 2023/04/12 19:53:19
Table 'RushAndCash5632393' 6-max Seat #1 is the button
Seat 1: 6d5254ff ($12.52 in chips)
Seat 2: 57b5f4da ($10 in chips)
Seat 3: Hero ($9.11 in chips)
Seat 4: 856c7f5e ($10.96 in chips)
Seat 5: ef855eb5 ($10.33 in chips)
Seat 6: bdd8009d ($9.25 in chips)
57b5f4da: posts small blind $0.05
Hero: posts big blind $0.1
*** HOLE CARDS ***
Dealt to 6d5254ff 
Dealt to 57b5f4da 
Dealt to Hero [9d Kh]
Dealt to 856c7f5e 
Dealt to ef855eb5 
Dealt to bdd8009d 
856c7f5e: folds
ef855eb5: folds
bdd8009d: folds
6d5254ff: raises $0.15 to $0.25
57b5f4da: folds
Hero: folds
Uncalled bet ($0.15) returned to 6d5254ff
*** SHOWDOWN ***
6d5254ff collected $0.25 from pot
*** SUMMARY ***
Total pot $0.25 | Rake $0 | Jackpot $0 | Bingo $0 | Fortune $0
Seat 1: 6d5254ff (button) collected ($0.25)
Seat 2: 57b5f4da (small blind) folded before Flop
Seat 3: Hero (big blind) folded before Flop
Seat 4: 856c7f5e folded before Flop (didn't bet)
Seat 5: ef855eb5 folded before Flop (didn't bet)
Seat 6: bdd8009d folded before Flop (didn't bet)


Poker Hand #RC1468477075: Hold'em No Limit  ($0.05/$0.1) - 2023/04/12 19:53:11
Table 'RushAndCash5632335' 6-max Seat #1 is the button
Seat 1: 27c3301e ($17.08 in chips)
Seat 2: e1e70277 ($10.33 in chips)
Seat 3: 45005b34 ($10 in chips)
Seat 4: Hero ($9.11 in chips)
Seat 5: 57e1fa5 ($10 in chips)
Seat 6: e748ac59 ($12.81 in chips)
e1e70277: posts small blind $0.05
45005b34: posts big blind $0.1
*** HOLE CARDS ***
Dealt to 27c3301e 
Dealt to e1e70277 
Dealt to 45005b34 
Dealt to Hero [5h Td]
Dealt to 57e1fa5 
Dealt to e748ac59 
Hero: folds
57e1fa5: folds
e748ac59: folds
27c3301e: folds
e1e70277: folds
Uncalled bet ($0.05) returned to 45005b34
*** SHOWDOWN ***
45005b34 collected $0.1 from pot
*** SUMMARY ***
Total pot $0.1 | Rake $0 | Jackpot $0 | Bingo $0 | Fortune $0
Seat 1: 27c3301e (button) folded before Flop (didn't bet)
Seat 2: e1e70277 (small blind) folded before Flop
Seat 3: 45005b34 (big blind) collected ($0.1)
Seat 4: Hero folded before Flop (didn't bet)
Seat 5: 57e1fa5 folded before Flop (didn't bet)
Seat 6: e748ac59 folded before Flop (didn't bet)


Poker Hand #RC1468477041: Hold'em No Limit  ($0.05/$0.1) - 2023/04/12 19:53:06
Table 'RushAndCash5632301' 6-max Seat #1 is the button
Seat 1: 25fdd2c9 ($10.57 in chips)
Seat 2: 6108a2fc ($17.92 in chips)
Seat 3: 50ce1268 ($25.31 in chips)
Seat 4: Hero ($9.11 in chips)
Seat 5: 8954ad8e ($10 in chips)
Seat 6: 73bb4504 ($11.86 in chips)
6108a2fc: posts small blind $0.05
50ce1268: posts big blind $0.1
*** HOLE CARDS ***
Dealt to 25fdd2c9 
Dealt to 6108a2fc 
Dealt to 50ce1268 
Dealt to Hero [9d 6h]
Dealt to 8954ad8e 
Dealt to 73bb4504 
Hero: folds
8954ad8e: folds
73bb4504: folds
25fdd2c9: folds
6108a2fc: folds
Uncalled bet ($0.05) returned to 50ce1268
*** SHOWDOWN ***
50ce1268 collected $0.1 from pot
*** SUMMARY ***
Total pot $0.1 | Rake $0 | Jackpot $0 | Bingo $0 | Fortune $0
Seat 1: 25fdd2c9 (button) folded before Flop (didn't bet)
Seat 2: 6108a2fc (small blind) folded before Flop
Seat 3: 50ce1268 (big blind) collected ($0.1)
Seat 4: Hero folded before Flop (didn't bet)
Seat 5: 8954ad8e folded before Flop (didn't bet)
Seat 6: 73bb4504 folded before Flop (didn't bet)


Poker Hand #RC1468476989: Hold'em No Limit  ($0.05/$0.1) - 2023/04/12 19:52:58
Table 'RushAndCash5632249' 6-max Seat #1 is the button
Seat 1: 4f4a9fff ($10.48 in chips)
Seat 2: 8c986fe3 ($10 in chips)
Seat 3: Hero ($9.06 in chips)
Seat 4: 80bc8d78 ($38.98 in chips)
Seat 5: ea8dd84 ($13.02 in chips)
Seat 6: 902bf00a ($18.1 in chips)
8c986fe3: posts small blind $0.05
Hero: posts big blind $0.1
*** HOLE CARDS ***
Dealt to 4f4a9fff 
Dealt to 8c986fe3 
Dealt to Hero [3h As]
Dealt to 80bc8d78 
Dealt to ea8dd84 
Dealt to 902bf00a 
80bc8d78: folds
ea8dd84: folds
902bf00a: folds
4f4a9fff: folds
8c986fe3: folds
Uncalled bet ($0.05) returned to Hero
*** SHOWDOWN ***
Hero collected $0.1 from pot
*** SUMMARY ***
Total pot $0.1 | Rake $0 | Jackpot $0 | Bingo $0 | Fortune $0
Seat 1: 4f4a9fff (button) folded before Flop (didn't bet)
Seat 2: 8c986fe3 (small blind) folded before Flop
Seat 3: Hero (big blind) collected ($0.1)
Seat 4: 80bc8d78 folded before Flop (didn't bet)
Seat 5: ea8dd84 folded before Flop (didn't bet)
Seat 6: 902bf00a folded before Flop (didn't bet)


Poker Hand #RC1468476924: Hold'em No Limit  ($0.05/$0.1) - 2023/04/12 19:52:48
Table 'RushAndCash5632184' 6-max Seat #1 is the button
Seat 1: 7925680e ($10 in chips)
Seat 2: Hero ($9.11 in chips)
Seat 3: 7bb73f96 ($10.37 in chips)
Seat 4: 3067e5a8 ($11.42 in chips)
Seat 5: bec07344 ($21.01 in chips)
Seat 6: 12bea6d6 ($12.2 in chips)
Hero: posts small blind $0.05
7bb73f96: posts big blind $0.1
*** HOLE CARDS ***
Dealt to 7925680e 
Dealt to Hero [Ks 7s]
Dealt to 7bb73f96 
Dealt to 3067e5a8 
Dealt to bec07344 
Dealt to 12bea6d6 
3067e5a8: folds
bec07344: folds
12bea6d6: folds
7925680e: raises $0.2 to $0.3
Hero: folds
7bb73f96: folds
Uncalled bet ($0.2) returned to 7925680e
*** SHOWDOWN ***
7925680e collected $0.25 from pot
*** SUMMARY ***
Total pot $0.25 | Rake $0 | Jackpot $0 | Bingo $0 | Fortune $0
Seat 1: 7925680e (button) collected ($0.25)
Seat 2: Hero (small blind) folded before Flop
Seat 3: 7bb73f96 (big blind) folded before Flop
Seat 4: 3067e5a8 folded before Flop (didn't bet)
Seat 5: bec07344 folded before Flop (didn't bet)
Seat 6: 12bea6d6 folded before Flop (didn't bet)


Poker Hand #RC1468476883: Hold'em No Limit  ($0.05/$0.1) - 2023/04/12 19:52:42
Table 'RushAndCash5632143' 6-max Seat #1 is the button
Seat 1: 6173bd66 ($20.31 in chips)
Seat 2: 9e66cd6f ($26.3 in chips)
Seat 3: 792c39fa ($9.24 in chips)
Seat 4: Hero ($9.11 in chips)
Seat 5: dff3ca78 ($10.3 in chips)
Seat 6: 1b214f81 ($21.25 in chips)
9e66cd6f: posts small blind $0.05
792c39fa: posts big blind $0.1
*** HOLE CARDS ***
Dealt to 6173bd66 
Dealt to 9e66cd6f 
Dealt to 792c39fa 
Dealt to Hero [4s Jh]
Dealt to dff3ca78 
Dealt to 1b214f81 
Hero: folds
dff3ca78: folds
1b214f81: folds
6173bd66: folds
9e66cd6f: folds
Uncalled bet ($0.05) returned to 792c39fa
*** SHOWDOWN ***
792c39fa collected $0.1 from pot
*** SUMMARY ***
Total pot $0.1 | Rake $0 | Jackpot $0 | Bingo $0 | Fortune $0
Seat 1: 6173bd66 (button) folded before Flop (didn't bet)
Seat 2: 9e66cd6f (small blind) folded before Flop
Seat 3: 792c39fa (big blind) collected ($0.1)
Seat 4: Hero folded before Flop (didn't bet)
Seat 5: dff3ca78 folded before Flop (didn't bet)
Seat 6: 1b214f81 folded before Flop (didn't bet)


Poker Hand #RC1468476847: Hold'em No Limit  ($0.05/$0.1) - 2023/04/12 19:52:37
Table 'RushAndCash5632107' 6-max Seat #1 is the button
Seat 1: d7bba46a ($20.77 in chips)
Seat 2: 190c0832 ($10.43 in chips)
Seat 3: 5b34f2fa ($28.98 in chips)
Seat 4: Hero ($9.11 in chips)
Seat 5: 16e733a5 ($27.43 in chips)
Seat 6: 789916a1 ($26.64 in chips)
190c0832: posts small blind $0.05
5b34f2fa: posts big blind $0.1
*** HOLE CARDS ***
Dealt to d7bba46a 
Dealt to 190c0832 
Dealt to 5b34f2fa 
Dealt to Hero [7c 8d]
Dealt to 16e733a5 
Dealt to 789916a1 
Hero: folds
16e733a5: folds
789916a1: folds
d7bba46a: raises $0.1 to $0.2
190c0832: folds
5b34f2fa: folds
Uncalled bet ($0.1) returned to d7bba46a
*** SHOWDOWN ***
d7bba46a collected $0.25 from pot
*** SUMMARY ***
Total pot $0.25 | Rake $0 | Jackpot $0 | Bingo $0 | Fortune $0
Seat 1: d7bba46a (button) collected ($0.25)
Seat 2: 190c0832 (small blind) folded before Flop
Seat 3: 5b34f2fa (big blind) folded before Flop
Seat 4: Hero folded before Flop (didn't bet)
Seat 5: 16e733a5 folded before Flop (didn't bet)
Seat 6: 789916a1 folded before Flop (didn't bet)


Poker Hand #RC1468476707: Hold'em No Limit  ($0.05/$0.1) - 2023/04/12 19:52:15
Table 'RushAndCash5631967' 6-max Seat #1 is the button
Seat 1: 5aeaa886 ($43.63 in chips)
Seat 2: Hero ($9.16 in chips)
Seat 3: 6b90c7e0 ($12.27 in chips)
Seat 4: fe9635b ($3.79 in chips)
Seat 5: 16963edf ($14.05 in chips)
Seat 6: 12bea6d6 ($12.35 in chips)
Hero: posts small blind $0.05
6b90c7e0: posts big blind $0.1
*** HOLE CARDS ***
Dealt to 5aeaa886 
Dealt to Hero [Kc 3d]
Dealt to 6b90c7e0 
Dealt to fe9635b 
Dealt to 16963edf 
Dealt to 12bea6d6 
fe9635b: folds
16963edf: raises $0.1 to $0.2
12bea6d6: folds
5aeaa886: folds
Hero: folds
6b90c7e0: folds
Uncalled bet ($0.1) returned to 16963edf
*** SHOWDOWN ***
16963edf collected $0.25 from pot
*** SUMMARY ***
Total pot $0.25 | Rake $0 | Jackpot $0 | Bingo $0 | Fortune $0
Seat 1: 5aeaa886 (button) folded before Flop (didn't bet)
Seat 2: Hero (small blind) folded before Flop
Seat 3: 6b90c7e0 (big blind) folded before Flop
Seat 4: fe9635b folded before Flop (didn't bet)
Seat 5: 16963edf collected ($0.25)
Seat 6: 12bea6d6 folded before Flop (didn't bet)


Poker Hand #RC1468476622: Hold'em No Limit  ($0.05/$0.1) - 2023/04/12 19:52:02
Table 'RushAndCash5631882' 6-max Seat #1 is the button
Seat 1: Hero ($9.16 in chips)
Seat 2: b9c3c978 ($10.05 in chips)
Seat 3: 499d6d5f ($10.19 in chips)
Seat 4: ece632f6 ($29.95 in chips)
Seat 5: 293e887f ($10 in chips)
Seat 6: e8514e5c ($5.15 in chips)
b9c3c978: posts small blind $0.05
499d6d5f: posts big blind $0.1
*** HOLE CARDS ***
Dealt to Hero [3c 9d]
Dealt to b9c3c978 
Dealt to 499d6d5f 
Dealt to ece632f6 
Dealt to 293e887f 
Dealt to e8514e5c 
ece632f6: folds
293e887f: folds
e8514e5c: folds
Hero: folds
b9c3c978: raises $0.2 to $0.3
499d6d5f: calls $0.2
*** FLOP *** [7c 8h 9s]
b9c3c978: checks
499d6d5f: bets $0.46
b9c3c978: calls $0.46
*** TURN *** [7c 8h 9s] [Th]
b9c3c978: checks
499d6d5f: checks
*** RIVER *** [7c 8h 9s Th] [Tc]
b9c3c978: bets $1.14
499d6d5f: folds
Uncalled bet ($1.14) returned to b9c3c978
*** SHOWDOWN ***
b9c3c978 collected $1.45 from pot
*** SUMMARY ***
Total pot $1.52 | Rake $0.07 | Jackpot $0 | Bingo $0 | Fortune $0
Board [7c 8h 9s Th Tc]
Seat 1: Hero (button) folded before Flop (didn't bet)
Seat 2: b9c3c978 (small blind) won ($1.45)
Seat 3: 499d6d5f (big blind) folded on the River
Seat 4: ece632f6 folded before Flop (didn't bet)
Seat 5: 293e887f folded before Flop (didn't bet)
Seat 6: e8514e5c folded before Flop (didn't bet)


Poker Hand #RC1468476577: Hold'em No Limit  ($0.05/$0.1) - 2023/04/12 19:51:55
Table 'RushAndCash5631837' 6-max Seat #1 is the button
Seat 1: a26c9ff2 ($10.44 in chips)
Seat 2: 16963edf ($13.95 in chips)
Seat 3: e50e1200 ($10.53 in chips)
Seat 4: 36906f4d ($12.71 in chips)
Seat 5: Hero ($9.16 in chips)
Seat 6: 4cce4b91 ($14.25 in chips)
16963edf: posts small blind $0.05
e50e1200: posts big blind $0.1
*** HOLE CARDS ***
Dealt to a26c9ff2 
Dealt to 16963edf 
Dealt to e50e1200 
Dealt to 36906f4d 
Dealt to Hero [3c 8s]
Dealt to 4cce4b91 
36906f4d: folds
Hero: folds
4cce4b91: folds
a26c9ff2: folds
16963edf: raises $0.1 to $0.2
e50e1200: folds
Uncalled bet ($0.1) returned to 16963edf
*** SHOWDOWN ***
16963edf collected $0.2 from pot
*** SUMMARY ***
Total pot $0.2 | Rake $0 | Jackpot $0 | Bingo $0 | Fortune $0
Seat 1: a26c9ff2 (button) folded before Flop (didn't bet)
Seat 2: 16963edf (small blind) collected ($0.2)
Seat 3: e50e1200 (big blind) folded before Flop
Seat 4: 36906f4d folded before Flop (didn't bet)
Seat 5: Hero folded before Flop (didn't bet)
Seat 6: 4cce4b91 folded before Flop (didn't bet)


Poker Hand #RC1468476491: Hold'em No Limit  ($0.05/$0.1) - 2023/04/12 19:51:41
Table 'RushAndCash5631751' 6-max Seat #1 is the button
Seat 1: 5fb98e48 ($10 in chips)
Seat 2: 3025b93e ($8.61 in chips)
Seat 3: 1bd3bc3d ($17.04 in chips)
Seat 4: Hero ($9.16 in chips)
Seat 5: c80f3b05 ($10 in chips)
Seat 6: 2ade30d4 ($10.72 in chips)
3025b93e: posts small blind $0.05
1bd3bc3d: posts big blind $0.1
*** HOLE CARDS ***
Dealt to 5fb98e48 
Dealt to 3025b93e 
Dealt to 1bd3bc3d 
Dealt to Hero [2d 8c]
Dealt to c80f3b05 
Dealt to 2ade30d4 
Hero: folds
c80f3b05: folds
2ade30d4: raises $0.15 to $0.25
5fb98e48: folds
3025b93e: calls $0.2
1bd3bc3d: folds
*** FLOP *** [Jd 6c 4d]
3025b93e: checks
2ade30d4: bets $0.32
3025b93e: calls $0.32
*** TURN *** [Jd 6c 4d] [6s]
3025b93e: checks
2ade30d4: checks
*** RIVER *** [Jd 6c 4d 6s] [Ts]
3025b93e: bets $1.24
2ade30d4: folds
Uncalled bet ($1.24) returned to 3025b93e
*** SHOWDOWN ***
3025b93e collected $1.18 from pot
*** SUMMARY ***
Total pot $1.24 | Rake $0.06 | Jackpot $0 | Bingo $0 | Fortune $0
Board [Jd 6c 4d 6s Ts]
Seat 1: 5fb98e48 (button) folded before Flop (didn't bet)
Seat 2: 3025b93e (small blind) won ($1.18)
Seat 3: 1bd3bc3d (big blind) folded before Flop
Seat 4: Hero folded before Flop (didn't bet)
Seat 5: c80f3b05 folded before Flop (didn't bet)
Seat 6: 2ade30d4 folded on the River


Poker Hand #RC1468476461: Hold'em No Limit  ($0.05/$0.1) - 2023/04/12 19:51:37
Table 'RushAndCash5631721' 6-max Seat #1 is the button
Seat 1: 3bf969ff ($21.9 in chips)
Seat 2: 3c143a1a ($10.23 in chips)
Seat 3: 50ce1268 ($26.36 in chips)
Seat 4: 918df6f8 ($12.75 in chips)
Seat 5: d58546bd ($11.4 in chips)
Seat 6: Hero ($9.16 in chips)
3c143a1a: posts small blind $0.05
50ce1268: posts big blind $0.1
*** HOLE CARDS ***
Dealt to 3bf969ff 
Dealt to 3c143a1a 
Dealt to 50ce1268 
Dealt to 918df6f8 
Dealt to d58546bd 
Dealt to Hero [4h 8h]
918df6f8: folds
d58546bd: raises $0.15 to $0.25
Hero: folds
3bf969ff: folds
3c143a1a: raises $0.6 to $0.85
50ce1268: folds
d58546bd: calls $0.6
*** FLOP *** [Jh 3s 5d]
3c143a1a: bets $0.6
d58546bd: calls $0.6
*** TURN *** [Jh 3s 5d] [Jd]
3c143a1a: bets $1.5
d58546bd: calls $1.5
*** RIVER *** [Jh 3s 5d Jd] [9s]
3c143a1a: checks
d58546bd: checks
3c143a1a: shows [Kh Ad] (Pair of Jacks)
d58546bd: shows [8s 8c] (Pair of Jacks and Pair of Eights)
*** SHOWDOWN ***
d58546bd collected $5.56 from pot
*** SUMMARY ***
Total pot $6 | Rake $0.29 | Jackpot $0.15 | Bingo $0 | Fortune $0
Board [Jh 3s 5d Jd 9s]
Seat 1: 3bf969ff (button) folded before Flop (didn't bet)
Seat 2: 3c143a1a (small blind) showed [Kh Ad] and lost with Pair of Jacks
Seat 3: 50ce1268 (big blind) folded before Flop
Seat 4: 918df6f8 folded before Flop (didn't bet)
Seat 5: d58546bd showed [8s 8c] and won ($5.56) with Pair of Jacks and Pair of Eights
Seat 6: Hero folded before Flop (didn't bet)


Poker Hand #RC1468476378: Hold'em No Limit  ($0.05/$0.1) - 2023/04/12 19:51:25
Table 'RushAndCash5631638' 6-max Seat #1 is the button
Seat 1: 65fbcad6 ($15.65 in chips)
Seat 2: 1bd3bc3d ($17.09 in chips)
Seat 3: Hero ($9.11 in chips)
Seat 4: 76b30415 ($11.49 in chips)
Seat 5: 854615fb ($13.88 in chips)
Seat 6: 7d6041fb ($19.58 in chips)
1bd3bc3d: posts small blind $0.05
Hero: posts big blind $0.1
*** HOLE CARDS ***
Dealt to 65fbcad6 
Dealt to 1bd3bc3d 
Dealt to Hero [7s 9c]
Dealt to 76b30415 
Dealt to 854615fb 
Dealt to 7d6041fb 
76b30415: folds
854615fb: folds
7d6041fb: folds
65fbcad6: folds
1bd3bc3d: folds
Uncalled bet ($0.05) returned to Hero
*** SHOWDOWN ***
Hero collected $0.1 from pot
*** SUMMARY ***
Total pot $0.1 | Rake $0 | Jackpot $0 | Bingo $0 | Fortune $0
Seat 1: 65fbcad6 (button) folded before Flop (didn't bet)
Seat 2: 1bd3bc3d (small blind) folded before Flop
Seat 3: Hero (big blind) collected ($0.1)
Seat 4: 76b30415 folded before Flop (didn't bet)
Seat 5: 854615fb folded before Flop (didn't bet)
Seat 6: 7d6041fb folded before Flop (didn't bet)


Poker Hand #RC1468476288: Hold'em No Limit  ($0.05/$0.1) - 2023/04/12 19:51:12
Table 'RushAndCash5631548' 6-max Seat #1 is the button
Seat 1: Hero ($9.11 in chips)
Seat 2: 4a5be5a7 ($18.61 in chips)
Seat 3: 65b99640 ($10.56 in chips)
Seat 4: 89b315a3 ($11.91 in chips)
Seat 5: 7f642ff9 ($10 in chips)
Seat 6: 62169933 ($18.36 in chips)
4a5be5a7: posts small blind $0.05
65b99640: posts big blind $0.1
*** HOLE CARDS ***
Dealt to Hero [Td 6d]
Dealt to 4a5be5a7 
Dealt to 65b99640 
Dealt to 89b315a3 
Dealt to 7f642ff9 
Dealt to 62169933 
89b315a3: folds
7f642ff9: raises $0.1 to $0.2
62169933: folds
Hero: folds
4a5be5a7: folds
65b99640: folds
Uncalled bet ($0.1) returned to 7f642ff9
*** SHOWDOWN ***
7f642ff9 collected $0.25 from pot
*** SUMMARY ***
Total pot $0.25 | Rake $0 | Jackpot $0 | Bingo $0 | Fortune $0
Seat 1: Hero (button) folded before Flop (didn't bet)
Seat 2: 4a5be5a7 (small blind) folded before Flop
Seat 3: 65b99640 (big blind) folded before Flop
Seat 4: 89b315a3 folded before Flop (didn't bet)
Seat 5: 7f642ff9 collected ($0.25)
Seat 6: 62169933 folded before Flop (didn't bet)


Poker Hand #RC1468476194: Hold'em No Limit  ($0.05/$0.1) - 2023/04/12 19:50:58
Table 'RushAndCash5631454' 6-max Seat #1 is the button
Seat 1: Hero ($9.11 in chips)
Seat 2: f8fc3336 ($10.2 in chips)
Seat 3: afe72a6f ($10.35 in chips)
Seat 4: d7bba46a ($19.54 in chips)
Seat 5: a29e4660 ($8.9 in chips)
Seat 6: 36906f4d ($12.49 in chips)
f8fc3336: posts small blind $0.05
afe72a6f: posts big blind $0.1
*** HOLE CARDS ***
Dealt to Hero [5d 5h]
Dealt to f8fc3336 
Dealt to afe72a6f 
Dealt to d7bba46a 
Dealt to a29e4660 
Dealt to 36906f4d 
d7bba46a: raises $0.1 to $0.2
a29e4660: raises $0.55 to $0.75
36906f4d: folds
Hero: folds
f8fc3336: folds
afe72a6f: folds
d7bba46a: calls $0.55
*** FLOP *** [3c 6d 9c]
d7bba46a: checks
a29e4660: bets $0.83
d7bba46a: calls $0.83
*** TURN *** [3c 6d 9c] [7h]
d7bba46a: checks
a29e4660: checks
*** RIVER *** [3c 6d 9c 7h] [Jd]
d7bba46a: checks
a29e4660: checks
d7bba46a: shows [Qs Qc] (Pair of Queens)
a29e4660: shows [Ah Kc] (Ace-High)
*** SHOWDOWN ***
d7bba46a collected $3.01 from pot
*** SUMMARY ***
Total pot $3.31 | Rake $0.15 | Jackpot $0.15 | Bingo $0 | Fortune $0
Board [3c 6d 9c 7h Jd]
Seat 1: Hero (button) folded before Flop (didn't bet)
Seat 2: f8fc3336 (small blind) folded before Flop
Seat 3: afe72a6f (big blind) folded before Flop
Seat 4: d7bba46a showed [Qs Qc] and won ($3.01) with Pair of Queens
Seat 5: a29e4660 showed [Ah Kc] and lost with Ace-High
Seat 6: 36906f4d folded before Flop (didn't bet)


Poker Hand #RC1468476137: Hold'em No Limit  ($0.05/$0.1) - 2023/04/12 19:50:48
Table 'RushAndCash5631397' 6-max Seat #1 is the button
Seat 1: 5b34f2fa ($29.38 in chips)
Seat 2: a26ad7e4 ($14.87 in chips)
Seat 3: 7ca2a701 ($10.57 in chips)
Seat 4: 9c1322da ($11.25 in chips)
Seat 5: Hero ($9.11 in chips)
Seat 6: de2bd812 ($10.35 in chips)
a26ad7e4: posts small blind $0.05
7ca2a701: posts big blind $0.1
*** HOLE CARDS ***
Dealt to 5b34f2fa 
Dealt to a26ad7e4 
Dealt to 7ca2a701 
Dealt to 9c1322da 
Dealt to Hero [5s Ad]
Dealt to de2bd812 
9c1322da: folds
Hero: folds
de2bd812: raises $0.15 to $0.25
5b34f2fa: folds
a26ad7e4: folds
7ca2a701: folds
Uncalled bet ($0.15) returned to de2bd812
*** SHOWDOWN ***
de2bd812 collected $0.25 from pot
*** SUMMARY ***
Total pot $0.25 | Rake $0 | Jackpot $0 | Bingo $0 | Fortune $0
Seat 1: 5b34f2fa (button) folded before Flop (didn't bet)
Seat 2: a26ad7e4 (small blind) folded before Flop
Seat 3: 7ca2a701 (big blind) folded before Flop
Seat 4: 9c1322da folded before Flop (didn't bet)
Seat 5: Hero folded before Flop (didn't bet)
Seat 6: de2bd812 collected ($0.25)


Poker Hand #RC1468476107: Hold'em No Limit  ($0.05/$0.1) - 2023/04/12 19:50:44
Table 'RushAndCash5631367' 6-max Seat #1 is the button
Seat 1: c889e4ef ($10 in chips)
Seat 2: Hero ($9.16 in chips)
Seat 3: 83a7bdb5 ($24.76 in chips)
Seat 4: 190c0832 ($10 in chips)
Seat 5: b574e05 ($18.14 in chips)
Seat 6: 499d6d5f ($10.39 in chips)
Hero: posts small blind $0.05
83a7bdb5: posts big blind $0.1
*** HOLE CARDS ***
Dealt to c889e4ef 
Dealt to Hero [2c 7s]
Dealt to 83a7bdb5 
Dealt to 190c0832 
Dealt to b574e05 
Dealt to 499d6d5f 
190c0832: folds
b574e05: folds
499d6d5f: folds
c889e4ef: folds
Hero: folds
Uncalled bet ($0.05) returned to 83a7bdb5
*** SHOWDOWN ***
83a7bdb5 collected $0.1 from pot
*** SUMMARY ***
Total pot $0.1 | Rake $0 | Jackpot $0 | Bingo $0 | Fortune $0
Seat 1: c889e4ef (button) folded before Flop (didn't bet)
Seat 2: Hero (small blind) folded before Flop
Seat 3: 83a7bdb5 (big blind) collected ($0.1)
Seat 4: 190c0832 folded before Flop (didn't bet)
Seat 5: b574e05 folded before Flop (didn't bet)
Seat 6: 499d6d5f folded before Flop (didn't bet)


Poker Hand #RC1468476041: Hold'em No Limit  ($0.05/$0.1) - 2023/04/12 19:50:34
Table 'RushAndCash5631301' 6-max Seat #1 is the button
Seat 1: cbef83ae ($11.85 in chips)
Seat 2: 1615ea37 ($10.05 in chips)
Seat 3: d879b64c ($10 in chips)
Seat 4: 1f36317 ($8.81 in chips)
Seat 5: Hero ($9.16 in chips)
Seat 6: 28bebede ($18.45 in chips)
1615ea37: posts small blind $0.05
d879b64c: posts big blind $0.1
*** HOLE CARDS ***
Dealt to cbef83ae 
Dealt to 1615ea37 
Dealt to d879b64c 
Dealt to 1f36317 
Dealt to Hero [Jd 3s]
Dealt to 28bebede 
1f36317: folds
Hero: folds
28bebede: folds
cbef83ae: folds
1615ea37: folds
Uncalled bet ($0.05) returned to d879b64c
*** SHOWDOWN ***
d879b64c collected $0.1 from pot
*** SUMMARY ***
Total pot $0.1 | Rake $0 | Jackpot $0 | Bingo $0 | Fortune $0
Seat 1: cbef83ae (button) folded before Flop (didn't bet)
Seat 2: 1615ea37 (small blind) folded before Flop
Seat 3: d879b64c (big blind) collected ($0.1)
Seat 4: 1f36317 folded before Flop (didn't bet)
Seat 5: Hero folded before Flop (didn't bet)
Seat 6: 28bebede folded before Flop (didn't bet)


Poker Hand #RC1468476012: Hold'em No Limit  ($0.05/$0.1) - 2023/04/12 19:50:29
Table 'RushAndCash5631272' 6-max Seat #1 is the button
Seat 1: 647bfc77 ($16.65 in chips)
Seat 2: 3d38b9f4 ($10.4 in chips)
Seat 3: 558b160d ($12.01 in chips)
Seat 4: 1970fd2 ($9.58 in chips)
Seat 5: a8ee82b3 ($10.97 in chips)
Seat 6: Hero ($9.16 in chips)
3d38b9f4: posts small blind $0.05
558b160d: posts big blind $0.1
*** HOLE CARDS ***
Dealt to 647bfc77 
Dealt to 3d38b9f4 
Dealt to 558b160d 
Dealt to 1970fd2 
Dealt to a8ee82b3 
Dealt to Hero [3h 8h]
1970fd2: folds
a8ee82b3: raises $0.15 to $0.25
Hero: folds
647bfc77: folds
3d38b9f4: calls $0.2
558b160d: folds
*** FLOP *** [4s 7h Qd]
3d38b9f4: checks
a8ee82b3: bets $0.14
3d38b9f4: raises $0.44 to $0.58
a8ee82b3: folds
Uncalled bet ($0.44) returned to 3d38b9f4
*** SHOWDOWN ***
3d38b9f4 collected $0.84 from pot
*** SUMMARY ***
Total pot $0.88 | Rake $0.04 | Jackpot $0 | Bingo $0 | Fortune $0
Board [4s 7h Qd]
Seat 1: 647bfc77 (button) folded before Flop (didn't bet)
Seat 2: 3d38b9f4 (small blind) won ($0.84)
Seat 3: 558b160d (big blind) folded before Flop
Seat 4: 1970fd2 folded before Flop (didn't bet)
Seat 5: a8ee82b3 folded on the Flop
Seat 6: Hero folded before Flop (didn't bet)


Poker Hand #RC1468475978: Hold'em No Limit  ($0.05/$0.1) - 2023/04/12 19:50:23
Table 'RushAndCash5631238' 6-max Seat #1 is the button
Seat 1: 96c309b0 ($37.31 in chips)
Seat 2: e33e588d ($12.36 in chips)
Seat 3: 45005b34 ($10 in chips)
Seat 4: 7f8397d4 ($9.3 in chips)
Seat 5: Hero ($9.16 in chips)
Seat 6: 52c0e247 ($12.49 in chips)
e33e588d: posts small blind $0.05
45005b34: posts big blind $0.1
*** HOLE CARDS ***
Dealt to 96c309b0 
Dealt to e33e588d 
Dealt to 45005b34 
Dealt to 7f8397d4 
Dealt to Hero [2h 4d]
Dealt to 52c0e247 
7f8397d4: folds
Hero: folds
52c0e247: raises $0.2 to $0.3
96c309b0: folds
e33e588d: folds
45005b34: folds
Uncalled bet ($0.2) returned to 52c0e247
*** SHOWDOWN ***
52c0e247 collected $0.25 from pot
*** SUMMARY ***
Total pot $0.25 | Rake $0 | Jackpot $0 | Bingo $0 | Fortune $0
Seat 1: 96c309b0 (button) folded before Flop (didn't bet)
Seat 2: e33e588d (small blind) folded before Flop
Seat 3: 45005b34 (big blind) folded before Flop
Seat 4: 7f8397d4 folded before Flop (didn't bet)
Seat 5: Hero folded before Flop (didn't bet)
Seat 6: 52c0e247 collected ($0.25)


Poker Hand #RC1468475867: Hold'em No Limit  ($0.05/$0.1) - 2023/04/12 19:50:05
Table 'RushAndCash5631127' 6-max Seat #1 is the button
Seat 1: d094b028 ($13.2 in chips)
Seat 2: 67a81530 ($22.66 in chips)
Seat 3: 5c3d5a26 ($12.22 in chips)
Seat 4: Hero ($9.01 in chips)
Seat 5: d755c17e ($25.63 in chips)
Seat 6: d58546bd ($11.33 in chips)
67a81530: posts small blind $0.05
5c3d5a26: posts big blind $0.1
*** HOLE CARDS ***
Dealt to d094b028 
Dealt to 67a81530 
Dealt to 5c3d5a26 
Dealt to Hero [Ad Jc]
Dealt to d755c17e 
Dealt to d58546bd 
Hero: raises $0.15 to $0.25
d755c17e: folds
d58546bd: folds
d094b028: folds
67a81530: folds
5c3d5a26: folds
Uncalled bet ($0.15) returned to Hero
*** SHOWDOWN ***
Hero collected $0.25 from pot
*** SUMMARY ***
Total pot $0.25 | Rake $0 | Jackpot $0 | Bingo $0 | Fortune $0
Seat 1: d094b028 (button) folded before Flop (didn't bet)
Seat 2: 67a81530 (small blind) folded before Flop
Seat 3: 5c3d5a26 (big blind) folded before Flop
Seat 4: Hero collected ($0.25)
Seat 5: d755c17e folded before Flop (didn't bet)
Seat 6: d58546bd folded before Flop (didn't bet)


Poker Hand #RC1468475799: Hold'em No Limit  ($0.05/$0.1) - 2023/04/12 19:49:56
Table 'RushAndCash5631059' 6-max Seat #1 is the button
Seat 1: bec07344 ($21.08 in chips)
Seat 2: Hero ($9.06 in chips)
Seat 3: ee5b04c9 ($7.86 in chips)
Seat 4: 8ec4a9e7 ($11.18 in chips)
Seat 5: fe9635b ($5 in chips)
Seat 6: 5144bae4 ($38.44 in chips)
Hero: posts small blind $0.05
ee5b04c9: posts big blind $0.1
*** HOLE CARDS ***
Dealt to bec07344 
Dealt to Hero [Jc 5c]
Dealt to ee5b04c9 
Dealt to 8ec4a9e7 
Dealt to fe9635b 
Dealt to 5144bae4 
8ec4a9e7: folds
fe9635b: folds
5144bae4: folds
bec07344: folds
Hero: folds
Uncalled bet ($0.05) returned to ee5b04c9
*** SHOWDOWN ***
ee5b04c9 collected $0.1 from pot
*** SUMMARY ***
Total pot $0.1 | Rake $0 | Jackpot $0 | Bingo $0 | Fortune $0
Seat 1: bec07344 (button) folded before Flop (didn't bet)
Seat 2: Hero (small blind) folded before Flop
Seat 3: ee5b04c9 (big blind) collected ($0.1)
Seat 4: 8ec4a9e7 folded before Flop (didn't bet)
Seat 5: fe9635b folded before Flop (didn't bet)
Seat 6: 5144bae4 folded before Flop (didn't bet)


Poker Hand #RC1468475750: Hold'em No Limit  ($0.05/$0.1) - 2023/04/12 19:49:49
Table 'RushAndCash5631010' 6-max Seat #1 is the button
Seat 1: 173973 ($11.1 in chips)
Seat 2: 4a3f8962 ($2.5 in chips)
Seat 3: Hero ($9.16 in chips)
Seat 4: a25a136 ($10.73 in chips)
Seat 5: 32d38263 ($14.11 in chips)
Seat 6: dc715600 ($18.84 in chips)
4a3f8962: posts small blind $0.05
Hero: posts big blind $0.1
*** HOLE CARDS ***
Dealt to 173973 
Dealt to 4a3f8962 
Dealt to Hero [3s 9s]
Dealt to a25a136 
Dealt to 32d38263 
Dealt to dc715600 
a25a136: folds
32d38263: folds
dc715600: raises $0.15 to $0.25
173973: folds
4a3f8962: folds
Hero: folds
Uncalled bet ($0.15) returned to dc715600
*** SHOWDOWN ***
dc715600 collected $0.25 from pot
*** SUMMARY ***
Total pot $0.25 | Rake $0 | Jackpot $0 | Bingo $0 | Fortune $0
Seat 1: 173973 (button) folded before Flop (didn't bet)
Seat 2: 4a3f8962 (small blind) folded before Flop
Seat 3: Hero (big blind) folded before Flop
Seat 4: a25a136 folded before Flop (didn't bet)
Seat 5: 32d38263 folded before Flop (didn't bet)
Seat 6: dc715600 collected ($0.25)


Poker Hand #RC1468475719: Hold'em No Limit  ($0.05/$0.1) - 2023/04/12 19:49:44
Table 'RushAndCash5630979' 6-max Seat #1 is the button
Seat 1: dbd20385 ($11.19 in chips)
Seat 2: e3460403 ($10.23 in chips)
Seat 3: 845cccfb ($14.41 in chips)
Seat 4: effd023b ($10 in chips)
Seat 5: aeed83 ($14.23 in chips)
Seat 6: Hero ($9.16 in chips)
e3460403: posts small blind $0.05
845cccfb: posts big blind $0.1
*** HOLE CARDS ***
Dealt to dbd20385 
Dealt to e3460403 
Dealt to 845cccfb 
Dealt to effd023b 
Dealt to aeed83 
Dealt to Hero [3h 4h]
effd023b: folds
aeed83: raises $0.15 to $0.25
Hero: folds
dbd20385: folds
e3460403: folds
845cccfb: raises $0.82 to $1.07
aeed83: calls $0.82
*** FLOP *** [8d Js Qs]
845cccfb: bets $0.75
aeed83: folds
Uncalled bet ($0.75) returned to 845cccfb
*** SHOWDOWN ***
845cccfb collected $2.06 from pot
*** SUMMARY ***
Total pot $2.19 | Rake $0.13 | Jackpot $0 | Bingo $0 | Fortune $0
Board [8d Js Qs]
Seat 1: dbd20385 (button) folded before Flop (didn't bet)
Seat 2: e3460403 (small blind) folded before Flop
Seat 3: 845cccfb (big blind) won ($2.06)
Seat 4: effd023b folded before Flop (didn't bet)
Seat 5: aeed83 folded on the Flop
Seat 6: Hero folded before Flop (didn't bet)


Poker Hand #RC1468475690: Hold'em No Limit  ($0.05/$0.1) - 2023/04/12 19:49:40
Table 'RushAndCash5630950' 6-max Seat #1 is the button
Seat 1: 5ad0a89e ($10 in chips)
Seat 2: 8f1cbb8d ($4.05 in chips)
Seat 3: Hero ($9.26 in chips)
Seat 4: e993246b ($10 in chips)
Seat 5: 76d263d2 ($10 in chips)
Seat 6: d7bba46a ($19.76 in chips)
8f1cbb8d: posts small blind $0.05
Hero: posts big blind $0.1
*** HOLE CARDS ***
Dealt to 5ad0a89e 
Dealt to 8f1cbb8d 
Dealt to Hero [4d Jc]
Dealt to e993246b 
Dealt to 76d263d2 
Dealt to d7bba46a 
e993246b: folds
76d263d2: folds
d7bba46a: raises $0.1 to $0.2
5ad0a89e: folds
8f1cbb8d: calls $0.15
Hero: folds
*** FLOP *** [Ac Ks Ad]
8f1cbb8d: checks
d7bba46a: checks
*** TURN *** [Ac Ks Ad] [4h]
8f1cbb8d: bets $0.25
d7bba46a: calls $0.25
*** RIVER *** [Ac Ks Ad 4h] [8h]
8f1cbb8d: checks
d7bba46a: checks
8f1cbb8d: shows [3h Kh] (Pair of Aces and Pair of Kings)
d7bba46a: shows [Td Ts] (Pair of Aces and Pair of Tens)
*** SHOWDOWN ***
8f1cbb8d collected $0.95 from pot
*** SUMMARY ***
Total pot $1 | Rake $0.05 | Jackpot $0 | Bingo $0 | Fortune $0
Board [Ac Ks Ad 4h 8h]
Seat 1: 5ad0a89e (button) folded before Flop (didn't bet)
Seat 2: 8f1cbb8d (small blind) showed [3h Kh] and won ($0.95) with Pair of Aces and Pair of Kings
Seat 3: Hero (big blind) folded before Flop
Seat 4: e993246b folded before Flop (didn't bet)
Seat 5: 76d263d2 folded before Flop (didn't bet)
Seat 6: d7bba46a showed [Td Ts] and lost with Pair of Aces and Pair of Tens


Poker Hand #RC1468475585: Hold'em No Limit  ($0.05/$0.1) - 2023/04/12 19:49:25
Table 'RushAndCash5630845' 6-max Seat #1 is the button
Seat 1: Hero ($9.11 in chips)
Seat 2: cc12baf6 ($14.17 in chips)
Seat 3: e7cb78b1 ($10.3 in chips)
Seat 4: bec07344 ($20.81 in chips)
Seat 5: e0d7b1d2 ($10 in chips)
Seat 6: ba59797 ($5.83 in chips)
cc12baf6: posts small blind $0.05
e7cb78b1: posts big blind $0.1
*** HOLE CARDS ***
Dealt to Hero [Kd Qs]
Dealt to cc12baf6 
Dealt to e7cb78b1 
Dealt to bec07344 
Dealt to e0d7b1d2 
Dealt to ba59797 
bec07344: folds
e0d7b1d2: folds
ba59797: folds
Hero: raises $0.15 to $0.25
cc12baf6: folds
e7cb78b1: folds
Uncalled bet ($0.15) returned to Hero
*** SHOWDOWN ***
Hero collected $0.25 from pot
*** SUMMARY ***
Total pot $0.25 | Rake $0 | Jackpot $0 | Bingo $0 | Fortune $0
Seat 1: Hero (button) collected ($0.25)
Seat 2: cc12baf6 (small blind) folded before Flop
Seat 3: e7cb78b1 (big blind) folded before Flop
Seat 4: bec07344 folded before Flop (didn't bet)
Seat 5: e0d7b1d2 folded before Flop (didn't bet)
Seat 6: ba59797 folded before Flop (didn't bet)


Poker Hand #RC1468475546: Hold'em No Limit  ($0.05/$0.1) - 2023/04/12 19:49:19
Table 'RushAndCash5630806' 6-max Seat #1 is the button
Seat 1: faba8d6f ($10 in chips)
Seat 2: 771009e5 ($10.22 in chips)
Seat 3: f562e714 ($13.01 in chips)
Seat 4: 6108a2fc ($15.67 in chips)
Seat 5: 52140b86 ($8.81 in chips)
Seat 6: Hero ($9.11 in chips)
771009e5: posts small blind $0.05
f562e714: posts big blind $0.1
*** HOLE CARDS ***
Dealt to faba8d6f 
Dealt to 771009e5 
Dealt to f562e714 
Dealt to 6108a2fc 
Dealt to 52140b86 
Dealt to Hero [7s Th]
6108a2fc: raises $0.15 to $0.25
52140b86: folds
Hero: folds
faba8d6f: folds
771009e5: raises $0.6 to $0.85
f562e714: folds
6108a2fc: folds
Uncalled bet ($0.6) returned to 771009e5
*** SHOWDOWN ***
771009e5 collected $0.57 from pot
*** SUMMARY ***
Total pot $0.6 | Rake $0.03 | Jackpot $0 | Bingo $0 | Fortune $0
Seat 1: faba8d6f (button) folded before Flop (didn't bet)
Seat 2: 771009e5 (small blind) collected ($0.57)
Seat 3: f562e714 (big blind) folded before Flop
Seat 4: 6108a2fc folded before Flop
Seat 5: 52140b86 folded before Flop (didn't bet)
Seat 6: Hero folded before Flop (didn't bet)


Poker Hand #RC1468475497: Hold'em No Limit  ($0.05/$0.1) - 2023/04/12 19:49:12
Table 'RushAndCash5630757' 6-max Seat #1 is the button
Seat 1: Hero ($9.11 in chips)
Seat 2: 67a81530 ($22.22 in chips)
Seat 3: 71dbcb0e ($7.82 in chips)
Seat 4: 280e3bda ($28.19 in chips)
Seat 5: 4d0c21a6 ($9.6 in chips)
Seat 6: d3c4014a ($19.9 in chips)
67a81530: posts small blind $0.05
71dbcb0e: posts big blind $0.1
*** HOLE CARDS ***
Dealt to Hero [5s 4d]
Dealt to 67a81530 
Dealt to 71dbcb0e 
Dealt to 280e3bda 
Dealt to 4d0c21a6 
Dealt to d3c4014a 
280e3bda: folds
4d0c21a6: folds
d3c4014a: folds
Hero: folds
67a81530: calls $0.05
71dbcb0e: checks
*** FLOP *** [Ts Qc 2s]
67a81530: bets $0.1
71dbcb0e: folds
Uncalled bet ($0.1) returned to 67a81530
*** SHOWDOWN ***
67a81530 collected $0.19 from pot
*** SUMMARY ***
Total pot $0.2 | Rake $0.01 | Jackpot $0 | Bingo $0 | Fortune $0
Board [Ts Qc 2s]
Seat 1: Hero (button) folded before Flop (didn't bet)
Seat 2: 67a81530 (small blind) won ($0.19)
Seat 3: 71dbcb0e (big blind) folded on the Flop
Seat 4: 280e3bda folded before Flop (didn't bet)
Seat 5: 4d0c21a6 folded before Flop (didn't bet)
Seat 6: d3c4014a folded before Flop (didn't bet)


Poker Hand #RC1468475427: Hold'em No Limit  ($0.05/$0.1) - 2023/04/12 19:49:02
Table 'RushAndCash5630687' 6-max Seat #1 is the button
Seat 1: 3e9ad104 ($10.56 in chips)
Seat 2: Hero ($9.16 in chips)
Seat 3: a8f2b2f8 ($31 in chips)
Seat 4: e4c97335 ($57.76 in chips)
Seat 5: f52f2ead ($18.36 in chips)
Seat 6: 41e94b43 ($11.19 in chips)
Hero: posts small blind $0.05
a8f2b2f8: posts big blind $0.1
*** HOLE CARDS ***
Dealt to 3e9ad104 
Dealt to Hero [Tc 7h]
Dealt to a8f2b2f8 
Dealt to e4c97335 
Dealt to f52f2ead 
Dealt to 41e94b43 
e4c97335: raises $0.2 to $0.3
f52f2ead: folds
41e94b43: folds
3e9ad104: folds
Hero: folds
a8f2b2f8: folds
Uncalled bet ($0.2) returned to e4c97335
*** SHOWDOWN ***
e4c97335 collected $0.25 from pot
*** SUMMARY ***
Total pot $0.25 | Rake $0 | Jackpot $0 | Bingo $0 | Fortune $0
Seat 1: 3e9ad104 (button) folded before Flop (didn't bet)
Seat 2: Hero (small blind) folded before Flop
Seat 3: a8f2b2f8 (big blind) folded before Flop
Seat 4: e4c97335 collected ($0.25)
Seat 5: f52f2ead folded before Flop (didn't bet)
Seat 6: 41e94b43 folded before Flop (didn't bet)


Poker Hand #RC1468475346: Hold'em No Limit  ($0.05/$0.1) - 2023/04/12 19:48:48
Table 'RushAndCash5630606' 6-max Seat #1 is the button
Seat 1: 7e41fde3 ($10.72 in chips)
Seat 2: 8d22595a ($16.72 in chips)
Seat 3: Hero ($9.11 in chips)
Seat 4: 89dd6b86 ($15.57 in chips)
Seat 5: d4483568 ($11.84 in chips)
Seat 6: 28012238 ($10.1 in chips)
8d22595a: posts small blind $0.05
Hero: posts big blind $0.1
*** HOLE CARDS ***
Dealt to 7e41fde3 
Dealt to 8d22595a 
Dealt to Hero [6h 5h]
Dealt to 89dd6b86 
Dealt to d4483568 
Dealt to 28012238 
89dd6b86: folds
d4483568: folds
28012238: folds
7e41fde3: folds
8d22595a: folds
Uncalled bet ($0.05) returned to Hero
*** SHOWDOWN ***
Hero collected $0.1 from pot
*** SUMMARY ***
Total pot $0.1 | Rake $0 | Jackpot $0 | Bingo $0 | Fortune $0
Seat 1: 7e41fde3 (button) folded before Flop (didn't bet)
Seat 2: 8d22595a (small blind) folded before Flop
Seat 3: Hero (big blind) collected ($0.1)
Seat 4: 89dd6b86 folded before Flop (didn't bet)
Seat 5: d4483568 folded before Flop (didn't bet)
Seat 6: 28012238 folded before Flop (didn't bet)


Poker Hand #RC1468475311: Hold'em No Limit  ($0.05/$0.1) - 2023/04/12 19:48:42
Table 'RushAndCash5630571' 6-max Seat #1 is the button
Seat 1: 1c97f776 ($12.38 in chips)
Seat 2: 7fa9fd71 ($24.99 in chips)
Seat 3: e66d7e43 ($10.1 in chips)
Seat 4: 4a5be5a7 ($18.51 in chips)
Seat 5: Hero ($9.11 in chips)
Seat 6: 9a17558 ($10 in chips)
7fa9fd71: posts small blind $0.05
e66d7e43: posts big blind $0.1
*** HOLE CARDS ***
Dealt to 1c97f776 
Dealt to 7fa9fd71 
Dealt to e66d7e43 
Dealt to 4a5be5a7 
Dealt to Hero [9d 6h]
Dealt to 9a17558 
4a5be5a7: folds
Hero: folds
9a17558: folds
1c97f776: folds
7fa9fd71: raises $0.2 to $0.3
e66d7e43: raises $0.6 to $0.9
7fa9fd71: calls $0.6
*** FLOP *** [8c Qd 4c]
7fa9fd71: checks
e66d7e43: bets $1.03
7fa9fd71: calls $1.03
*** TURN *** [8c Qd 4c] [Qs]
7fa9fd71: checks
e66d7e43: bets $2.21
7fa9fd71: calls $2.21
*** RIVER *** [8c Qd 4c Qs] [Ad]
7fa9fd71: checks
e66d7e43: checks
7fa9fd71: shows [Qh Kc] (Three Queens)
e66d7e43: shows [Ac 3c] (Pair of Aces and Pair of Queens)
*** SHOWDOWN ***
7fa9fd71 collected $7.83 from pot
*** SUMMARY ***
Total pot $8.28 | Rake $0.3 | Jackpot $0.15 | Bingo $0 | Fortune $0
Board [8c Qd 4c Qs Ad]
Seat 1: 1c97f776 (button) folded before Flop (didn't bet)
Seat 2: 7fa9fd71 (small blind) showed [Qh Kc] and won ($7.83) with Three Queens
Seat 3: e66d7e43 (big blind) showed [Ac 3c] and lost with Pair of Aces and Pair of Queens
Seat 4: 4a5be5a7 folded before Flop (didn't bet)
Seat 5: Hero folded before Flop (didn't bet)
Seat 6: 9a17558 folded before Flop (didn't bet)


Poker Hand #RC1468475246: Hold'em No Limit  ($0.05/$0.1) - 2023/04/12 19:48:33
Table 'RushAndCash5630506' 6-max Seat #1 is the button
Seat 1: 52e6d214 ($21.56 in chips)
Seat 2: 28012238 ($10.15 in chips)
Seat 3: 214aae63 ($10.35 in chips)
Seat 4: 43cb99df ($9.16 in chips)
Seat 5: Hero ($9.11 in chips)
Seat 6: 190c0832 ($10.42 in chips)
28012238: posts small blind $0.05
214aae63: posts big blind $0.1
*** HOLE CARDS ***
Dealt to 52e6d214 
Dealt to 28012238 
Dealt to 214aae63 
Dealt to 43cb99df 
Dealt to Hero [Kd 4s]
Dealt to 190c0832 
43cb99df: raises $0.1 to $0.2
Hero: folds
190c0832: folds
52e6d214: calls $0.2
28012238: folds
214aae63: folds
*** FLOP *** [Tc Qh 2s]
43cb99df: bets $0.1
52e6d214: calls $0.1
*** TURN *** [Tc Qh 2s] [2c]
43cb99df: bets $0.1
52e6d214: raises $0.65 to $0.75
43cb99df: folds
Uncalled bet ($0.65) returned to 52e6d214
*** SHOWDOWN ***
52e6d214 collected $0.91 from pot
*** SUMMARY ***
Total pot $0.95 | Rake $0.04 | Jackpot $0 | Bingo $0 | Fortune $0
Board [Tc Qh 2s 2c]
Seat 1: 52e6d214 (button) won ($0.91)
Seat 2: 28012238 (small blind) folded before Flop
Seat 3: 214aae63 (big blind) folded before Flop
Seat 4: 43cb99df folded on the Turn
Seat 5: Hero folded before Flop (didn't bet)
Seat 6: 190c0832 folded before Flop (didn't bet)


Poker Hand #RC1468475200: Hold'em No Limit  ($0.05/$0.1) - 2023/04/12 19:48:26
Table 'RushAndCash5630460' 6-max Seat #1 is the button
Seat 1: e0c2d06d ($13.98 in chips)
Seat 2: e100ba5a ($7.9 in chips)
Seat 3: 8e2c0828 ($13.21 in chips)
Seat 4: 27df0055 ($32.76 in chips)
Seat 5: Hero ($9.11 in chips)
Seat 6: 3bc97b07 ($10.5 in chips)
e100ba5a: posts small blind $0.05
8e2c0828: posts big blind $0.1
*** HOLE CARDS ***
Dealt to e0c2d06d 
Dealt to e100ba5a 
Dealt to 8e2c0828 
Dealt to 27df0055 
Dealt to Hero [7d Tc]
Dealt to 3bc97b07 
27df0055: folds
Hero: folds
3bc97b07: folds
e0c2d06d: raises $0.12 to $0.22
e100ba5a: calls $0.17
8e2c0828: folds
*** FLOP *** [Ad 4c 7h]
e100ba5a: checks
e0c2d06d: bets $0.18
e100ba5a: folds
Uncalled bet ($0.18) returned to e0c2d06d
*** SHOWDOWN ***
e0c2d06d collected $0.52 from pot
*** SUMMARY ***
Total pot $0.54 | Rake $0.02 | Jackpot $0 | Bingo $0 | Fortune $0
Board [Ad 4c 7h]
Seat 1: e0c2d06d (button) won ($0.52)
Seat 2: e100ba5a (small blind) folded on the Flop
Seat 3: 8e2c0828 (big blind) folded before Flop
Seat 4: 27df0055 folded before Flop (didn't bet)
Seat 5: Hero folded before Flop (didn't bet)
Seat 6: 3bc97b07 folded before Flop (didn't bet)


Poker Hand #RC1468475159: Hold'em No Limit  ($0.05/$0.1) - 2023/04/12 19:48:20
Table 'RushAndCash5630419' 6-max Seat #1 is the button
Seat 1: b9c3c978 ($10 in chips)
Seat 2: 83c3d170 ($4.24 in chips)
Seat 3: e100ba5a ($8 in chips)
Seat 4: Hero ($9.11 in chips)
Seat 5: de37e859 ($15.04 in chips)
Seat 6: acc311b8 ($15.62 in chips)
83c3d170: posts small blind $0.05
e100ba5a: posts big blind $0.1
*** HOLE CARDS ***
Dealt to b9c3c978 
Dealt to 83c3d170 
Dealt to e100ba5a 
Dealt to Hero [5c Ah]
Dealt to de37e859 
Dealt to acc311b8 
Hero: folds
de37e859: folds
acc311b8: raises $0.12 to $0.22
b9c3c978: folds
83c3d170: folds
e100ba5a: folds
Uncalled bet ($0.12) returned to acc311b8
*** SHOWDOWN ***
acc311b8 collected $0.25 from pot
*** SUMMARY ***
Total pot $0.25 | Rake $0 | Jackpot $0 | Bingo $0 | Fortune $0
Seat 1: b9c3c978 (button) folded before Flop (didn't bet)
Seat 2: 83c3d170 (small blind) folded before Flop
Seat 3: e100ba5a (big blind) folded before Flop
Seat 4: Hero folded before Flop (didn't bet)
Seat 5: de37e859 folded before Flop (didn't bet)
Seat 6: acc311b8 collected ($0.25)


Poker Hand #RC1468474970: Hold'em No Limit  ($0.05/$0.1) - 2023/04/12 19:47:53
Table 'RushAndCash5630230' 6-max Seat #1 is the button
Seat 1: 23102071 ($24.33 in chips)
Seat 2: acc311b8 ($15.92 in chips)
Seat 3: Hero ($8.84 in chips)
Seat 4: b4dec9b2 ($6.74 in chips)
Seat 5: 4cce4b91 ($16 in chips)
Seat 6: a8ee82b3 ($10.22 in chips)
acc311b8: posts small blind $0.05
Hero: posts big blind $0.1
*** HOLE CARDS ***
Dealt to 23102071 
Dealt to acc311b8 
Dealt to Hero [Ks 5d]
Dealt to b4dec9b2 
Dealt to 4cce4b91 
Dealt to a8ee82b3 
b4dec9b2: folds
4cce4b91: folds
a8ee82b3: folds
23102071: folds
acc311b8: raises $0.2 to $0.3
Hero: calls $0.2
*** FLOP *** [Th 9d 2c]
acc311b8: checks
Hero: bets $0.2
acc311b8: folds
Uncalled bet ($0.2) returned to Hero
*** SHOWDOWN ***
Hero collected $0.57 from pot
*** SUMMARY ***
Total pot $0.6 | Rake $0.03 | Jackpot $0 | Bingo $0 | Fortune $0
Board [Th 9d 2c]
Seat 1: 23102071 (button) folded before Flop (didn't bet)
Seat 2: acc311b8 (small blind) folded on the Flop
Seat 3: Hero (big blind) won ($0.57)
Seat 4: b4dec9b2 folded before Flop (didn't bet)
Seat 5: 4cce4b91 folded before Flop (didn't bet)
Seat 6: a8ee82b3 folded before Flop (didn't bet)


Poker Hand #RC1468474925: Hold'em No Limit  ($0.05/$0.1) - 2023/04/12 19:47:46
Table 'RushAndCash5630185' 6-max Seat #1 is the button
Seat 1: eb082207 ($18.07 in chips)
Seat 2: Hero ($8.89 in chips)
Seat 3: cc12baf6 ($13.39 in chips)
Seat 4: 25fdd2c9 ($10.61 in chips)
Seat 5: 5fa5be03 ($18.79 in chips)
Seat 6: 603708bb ($5.08 in chips)
Hero: posts small blind $0.05
cc12baf6: posts big blind $0.1
*** HOLE CARDS ***
Dealt to eb082207 
Dealt to Hero [2c 8h]
Dealt to cc12baf6 
Dealt to 25fdd2c9 
Dealt to 5fa5be03 
Dealt to 603708bb 
25fdd2c9: raises $0.15 to $0.25
5fa5be03: folds
603708bb: folds
eb082207: folds
Hero: folds
cc12baf6: calls $0.15
*** FLOP *** [2d Tc 6h]
cc12baf6: bets $0.19
25fdd2c9: calls $0.19
*** TURN *** [2d Tc 6h] [6c]
cc12baf6: bets $0.31
25fdd2c9: calls $0.31
*** RIVER *** [2d Tc 6h 6c] [7h]
cc12baf6: checks
25fdd2c9: checks
cc12baf6: shows [Th Ah] (Pair of Tens and Pair of Sixes)
25fdd2c9: shows [8c 8s] (Pair of Eights and Pair of Sixes)
*** SHOWDOWN ***
cc12baf6 collected $1.48 from pot
*** SUMMARY ***
Total pot $1.55 | Rake $0.07 | Jackpot $0 | Bingo $0 | Fortune $0
Board [2d Tc 6h 6c 7h]
Seat 1: eb082207 (button) folded before Flop (didn't bet)
Seat 2: Hero (small blind) folded before Flop
Seat 3: cc12baf6 (big blind) showed [Th Ah] and won ($1.48) with Pair of Tens and Pair of Sixes
Seat 4: 25fdd2c9 showed [8c 8s] and lost with Pair of Eights and Pair of Sixes
Seat 5: 5fa5be03 folded before Flop (didn't bet)
Seat 6: 603708bb folded before Flop (didn't bet)


Poker Hand #RC1468474889: Hold'em No Limit  ($0.05/$0.1) - 2023/04/12 19:47:40
Table 'RushAndCash5630149' 6-max Seat #1 is the button
Seat 1: Hero ($8.89 in chips)
Seat 2: 68fafa57 ($11.02 in chips)
Seat 3: 295ae4ba ($10.1 in chips)
Seat 4: 108eb71 ($22.84 in chips)
Seat 5: e8260b30 ($10.5 in chips)
Seat 6: ab766696 ($10 in chips)
68fafa57: posts small blind $0.05
295ae4ba: posts big blind $0.1
*** HOLE CARDS ***
Dealt to Hero [6h 8c]
Dealt to 68fafa57 
Dealt to 295ae4ba 
Dealt to 108eb71 
Dealt to e8260b30 
Dealt to ab766696 
108eb71: folds
e8260b30: folds
ab766696: folds
Hero: folds
68fafa57: folds
Uncalled bet ($0.05) returned to 295ae4ba
*** SHOWDOWN ***
295ae4ba collected $0.1 from pot
*** SUMMARY ***
Total pot $0.1 | Rake $0 | Jackpot $0 | Bingo $0 | Fortune $0
Seat 1: Hero (button) folded before Flop (didn't bet)
Seat 2: 68fafa57 (small blind) folded before Flop
Seat 3: 295ae4ba (big blind) collected ($0.1)
Seat 4: 108eb71 folded before Flop (didn't bet)
Seat 5: e8260b30 folded before Flop (didn't bet)
Seat 6: ab766696 folded before Flop (didn't bet)


Poker Hand #RC1468474846: Hold'em No Limit  ($0.05/$0.1) - 2023/04/12 19:47:34
Table 'RushAndCash5630106' 6-max Seat #1 is the button
Seat 1: e72cc09c ($10.54 in chips)
Seat 2: f6fa0331 ($12.27 in chips)
Seat 3: 878f25bc ($10.53 in chips)
Seat 4: Hero ($8.89 in chips)
Seat 5: fae4e1b2 ($29.59 in chips)
Seat 6: 972258d6 ($9.4 in chips)
f6fa0331: posts small blind $0.05
878f25bc: posts big blind $0.1
*** HOLE CARDS ***
Dealt to e72cc09c 
Dealt to f6fa0331 
Dealt to 878f25bc 
Dealt to Hero [5h Jh]
Dealt to fae4e1b2 
Dealt to 972258d6 
Hero: folds
fae4e1b2: folds
972258d6: folds
e72cc09c: raises $0.17 to $0.27
f6fa0331: folds
878f25bc: folds
Uncalled bet ($0.17) returned to e72cc09c
*** SHOWDOWN ***
e72cc09c collected $0.25 from pot
*** SUMMARY ***
Total pot $0.25 | Rake $0 | Jackpot $0 | Bingo $0 | Fortune $0
Seat 1: e72cc09c (button) collected ($0.25)
Seat 2: f6fa0331 (small blind) folded before Flop
Seat 3: 878f25bc (big blind) folded before Flop
Seat 4: Hero folded before Flop (didn't bet)
Seat 5: fae4e1b2 folded before Flop (didn't bet)
Seat 6: 972258d6 folded before Flop (didn't bet)


Poker Hand #RC1468474812: Hold'em No Limit  ($0.05/$0.1) - 2023/04/12 19:47:28
Table 'RushAndCash5630072' 6-max Seat #1 is the button
Seat 1: f562e714 ($12.35 in chips)
Seat 2: 1633da64 ($22.95 in chips)
Seat 3: 280e3bda ($26.71 in chips)
Seat 4: c8b9f617 ($16 in chips)
Seat 5: 648925e5 ($18.84 in chips)
Seat 6: Hero ($8.89 in chips)
1633da64: posts small blind $0.05
280e3bda: posts big blind $0.1
*** HOLE CARDS ***
Dealt to f562e714 
Dealt to 1633da64 
Dealt to 280e3bda 
Dealt to c8b9f617 
Dealt to 648925e5 
Dealt to Hero [6s 7d]
c8b9f617: folds
648925e5: folds
Hero: folds
f562e714: raises $0.15 to $0.25
1633da64: folds
280e3bda: calls $0.15
*** FLOP *** [5h Ac Ts]
280e3bda: checks
f562e714: checks
*** TURN *** [5h Ac Ts] [Qh]
280e3bda: checks
f562e714: bets $0.1
280e3bda: calls $0.1
*** RIVER *** [5h Ac Ts Qh] [8s]
280e3bda: checks
f562e714: bets $0.57
280e3bda: calls $0.57
f562e714: shows [5d 8d] (Pair of Eights and Pair of Fives)
280e3bda: shows [Qs Jd] (Pair of Queens)
*** SHOWDOWN ***
f562e714 collected $1.8 from pot
*** SUMMARY ***
Total pot $1.89 | Rake $0.09 | Jackpot $0 | Bingo $0 | Fortune $0
Board [5h Ac Ts Qh 8s]
Seat 1: f562e714 (button) showed [5d 8d] and won ($1.8) with Pair of Eights and Pair of Fives
Seat 2: 1633da64 (small blind) folded before Flop
Seat 3: 280e3bda (big blind) showed [Qs Jd] and lost with Pair of Queens
Seat 4: c8b9f617 folded before Flop (didn't bet)
Seat 5: 648925e5 folded before Flop (didn't bet)
Seat 6: Hero folded before Flop (didn't bet)


Poker Hand #RC1468474752: Hold'em No Limit  ($0.05/$0.1) - 2023/04/12 19:47:21
Table 'RushAndCash5630012' 6-max Seat #1 is the button
Seat 1: Hero ($8.89 in chips)
Seat 2: 6e0b38a4 ($11.29 in chips)
Seat 3: a455848b ($5.29 in chips)
Seat 4: 603203b9 ($49 in chips)
Seat 5: 5e0ca113 ($12.09 in chips)
Seat 6: a84e6d0a ($17.7 in chips)
6e0b38a4: posts small blind $0.05
a455848b: posts big blind $0.1
*** HOLE CARDS ***
Dealt to Hero [6s Tc]
Dealt to 6e0b38a4 
Dealt to a455848b 
Dealt to 603203b9 
Dealt to 5e0ca113 
Dealt to a84e6d0a 
603203b9: folds
5e0ca113: folds
a84e6d0a: folds
Hero: folds
6e0b38a4: folds
Uncalled bet ($0.05) returned to a455848b
*** SHOWDOWN ***
a455848b collected $0.1 from pot
*** SUMMARY ***
Total pot $0.1 | Rake $0 | Jackpot $0 | Bingo $0 | Fortune $0
Seat 1: Hero (button) folded before Flop (didn't bet)
Seat 2: 6e0b38a4 (small blind) folded before Flop
Seat 3: a455848b (big blind) collected ($0.1)
Seat 4: 603203b9 folded before Flop (didn't bet)
Seat 5: 5e0ca113 folded before Flop (didn't bet)
Seat 6: a84e6d0a folded before Flop (didn't bet)


Poker Hand #RC1468424249: Hold'em No Limit  ($0.05/$0.1) - 2023/04/12 19:46:08
Table 'RushAndCash5629509' 6-max Seat #1 is the button
Seat 1: 9ad8e031 ($11.4 in chips)
Seat 2: a952432 ($10 in chips)
Seat 3: 5e0ca113 ($12.19 in chips)
Seat 4: 27a75cdb ($10.56 in chips)
Seat 5: Hero ($8.75 in chips)
Seat 6: 7494dd8b ($7.3 in chips)
a952432: posts small blind $0.05
5e0ca113: posts big blind $0.1
*** HOLE CARDS ***
Dealt to 9ad8e031 
Dealt to a952432 
Dealt to 5e0ca113 
Dealt to 27a75cdb 
Dealt to Hero [Ad 5c]
Dealt to 7494dd8b 
27a75cdb: folds
Hero: calls $0.1
7494dd8b: folds
9ad8e031: folds
a952432: folds
5e0ca113: checks
*** FLOP *** [Jc 7c 8s]
5e0ca113: checks
Hero: checks
*** TURN *** [Jc 7c 8s] [Ks]
5e0ca113: checks
Hero: checks
*** RIVER *** [Jc 7c 8s Ks] [8c]
5e0ca113: checks
Hero: checks
5e0ca113: shows [3d 6c] (Pair of Eights)
Hero: shows [Ad 5c] (Pair of Eights)
*** SHOWDOWN ***
Hero collected $0.24 from pot
*** SUMMARY ***
Total pot $0.25 | Rake $0.01 | Jackpot $0 | Bingo $0 | Fortune $0
Board [Jc 7c 8s Ks 8c]
Seat 1: 9ad8e031 (button) folded before Flop (didn't bet)
Seat 2: a952432 (small blind) folded before Flop
Seat 3: 5e0ca113 (big blind) showed [3d 6c] and lost with Pair of Eights
Seat 4: 27a75cdb folded before Flop (didn't bet)
Seat 5: Hero showed [Ad 5c] and won ($0.24) with Pair of Eights
Seat 6: 7494dd8b folded before Flop (didn't bet)


Poker Hand #RC1468424171: Hold'em No Limit  ($0.05/$0.1) - 2023/04/12 19:45:56
Table 'RushAndCash5629431' 6-max Seat #1 is the button
Seat 1: a42dd805 ($13.01 in chips)
Seat 2: eb14124c ($7.65 in chips)
Seat 3: 3528f32d ($9.18 in chips)
Seat 4: 1e2390bd ($10.76 in chips)
Seat 5: f9e2637 ($13.72 in chips)
Seat 6: Hero ($8.75 in chips)
eb14124c: posts small blind $0.05
3528f32d: posts big blind $0.1
*** HOLE CARDS ***
Dealt to a42dd805 
Dealt to eb14124c 
Dealt to 3528f32d 
Dealt to 1e2390bd 
Dealt to f9e2637 
Dealt to Hero [5c 3d]
1e2390bd: folds
f9e2637: folds
Hero: folds
a42dd805: folds
eb14124c: raises $0.2 to $0.3
3528f32d: calls $0.2
*** FLOP *** [Jh 4c 2s]
eb14124c: checks
3528f32d: checks
*** TURN *** [Jh 4c 2s] [6d]
eb14124c: bets $0.2
3528f32d: raises $0.56 to $0.76
eb14124c: calls $0.56
*** RIVER *** [Jh 4c 2s 6d] [Kc]
eb14124c: checks
3528f32d: bets $1.96
eb14124c: raises $4.63 to $6.59 and is all-in
3528f32d: calls $4.63
eb14124c: shows [Ks 2h] (Pair of Kings and Pair of Twos)
3528f32d: shows [4h 4d] (Three Fours)
*** SHOWDOWN ***
3528f32d collected $14.85 from pot
*** SUMMARY ***
Total pot $15.3 | Rake $0.3 | Jackpot $0.15 | Bingo $0 | Fortune $0
Board [Jh 4c 2s 6d Kc]
Seat 1: a42dd805 (button) folded before Flop (didn't bet)
Seat 2: eb14124c (small blind) showed [Ks 2h] and lost with Pair of Kings and Pair of Twos
Seat 3: 3528f32d (big blind) showed [4h 4d] and won ($14.85) with Three Fours
Seat 4: 1e2390bd folded before Flop (didn't bet)
Seat 5: f9e2637 folded before Flop (didn't bet)
Seat 6: Hero folded before Flop (didn't bet)


Poker Hand #RC1468424093: Hold'em No Limit  ($0.05/$0.1) - 2023/04/12 19:45:43
Table 'RushAndCash5629353' 6-max Seat #1 is the button
Seat 1: 82143f9 ($17.93 in chips)
Seat 2: 1b214f81 ($22.73 in chips)
Seat 3: Hero ($8.7 in chips)
Seat 4: 6c6bb6ae ($10 in chips)
Seat 5: 4f56afb4 ($10 in chips)
Seat 6: 4a5be5a7 ($19.01 in chips)
1b214f81: posts small blind $0.05
Hero: posts big blind $0.1
*** HOLE CARDS ***
Dealt to 82143f9 
Dealt to 1b214f81 
Dealt to Hero [4h 9s]
Dealt to 6c6bb6ae 
Dealt to 4f56afb4 
Dealt to 4a5be5a7 
6c6bb6ae: folds
4f56afb4: folds
4a5be5a7: folds
82143f9: folds
1b214f81: folds
Uncalled bet ($0.05) returned to Hero
*** SHOWDOWN ***
Hero collected $0.1 from pot
*** SUMMARY ***
Total pot $0.1 | Rake $0 | Jackpot $0 | Bingo $0 | Fortune $0
Seat 1: 82143f9 (button) folded before Flop (didn't bet)
Seat 2: 1b214f81 (small blind) folded before Flop
Seat 3: Hero (big blind) collected ($0.1)
Seat 4: 6c6bb6ae folded before Flop (didn't bet)
Seat 5: 4f56afb4 folded before Flop (didn't bet)
Seat 6: 4a5be5a7 folded before Flop (didn't bet)


Poker Hand #RC1468423969: Hold'em No Limit  ($0.05/$0.1) - 2023/04/12 19:45:26
Table 'RushAndCash5629229' 6-max Seat #1 is the button
Seat 1: 60b4dc53 ($7.99 in chips)
Seat 2: Hero ($8.75 in chips)
Seat 3: 4760d53e ($20.27 in chips)
Seat 4: ba5b2d5d ($12.49 in chips)
Seat 5: 7eb32471 ($23.13 in chips)
Seat 6: 85c99be5 ($13.21 in chips)
Hero: posts small blind $0.05
4760d53e: posts big blind $0.1
*** HOLE CARDS ***
Dealt to 60b4dc53 
Dealt to Hero [2h Ad]
Dealt to 4760d53e 
Dealt to ba5b2d5d 
Dealt to 7eb32471 
Dealt to 85c99be5 
ba5b2d5d: raises $0.15 to $0.25
7eb32471: folds
85c99be5: folds
60b4dc53: folds
Hero: folds
4760d53e: folds
Uncalled bet ($0.15) returned to ba5b2d5d
*** SHOWDOWN ***
ba5b2d5d collected $0.25 from pot
*** SUMMARY ***
Total pot $0.25 | Rake $0 | Jackpot $0 | Bingo $0 | Fortune $0
Seat 1: 60b4dc53 (button) folded before Flop (didn't bet)
Seat 2: Hero (small blind) folded before Flop
Seat 3: 4760d53e (big blind) folded before Flop
Seat 4: ba5b2d5d collected ($0.25)
Seat 5: 7eb32471 folded before Flop (didn't bet)
Seat 6: 85c99be5 folded before Flop (didn't bet)


Poker Hand #RC1468423939: Hold'em No Limit  ($0.05/$0.1) - 2023/04/12 19:45:21
Table 'RushAndCash5629199' 6-max Seat #1 is the button
Seat 1: af8346aa ($10.8 in chips)
Seat 2: efe13270 ($20.5 in chips)
Seat 3: cb1d5a3c ($10.08 in chips)
Seat 4: 93af2464 ($12.54 in chips)
Seat 5: e961fdf9 ($18.42 in chips)
Seat 6: Hero ($8.75 in chips)
efe13270: posts small blind $0.05
cb1d5a3c: posts big blind $0.1
*** HOLE CARDS ***
Dealt to af8346aa 
Dealt to efe13270 
Dealt to cb1d5a3c 
Dealt to 93af2464 
Dealt to e961fdf9 
Dealt to Hero [As 3c]
93af2464: folds
e961fdf9: folds
Hero: folds
af8346aa: folds
efe13270: folds
Uncalled bet ($0.05) returned to cb1d5a3c
*** SHOWDOWN ***
cb1d5a3c collected $0.1 from pot
*** SUMMARY ***
Total pot $0.1 | Rake $0 | Jackpot $0 | Bingo $0 | Fortune $0
Seat 1: af8346aa (button) folded before Flop (didn't bet)
Seat 2: efe13270 (small blind) folded before Flop
Seat 3: cb1d5a3c (big blind) collected ($0.1)
Seat 4: 93af2464 folded before Flop (didn't bet)
Seat 5: e961fdf9 folded before Flop (didn't bet)
Seat 6: Hero folded before Flop (didn't bet)


Poker Hand #RC1468423899: Hold'em No Limit  ($0.05/$0.1) - 2023/04/12 19:45:14
Table 'RushAndCash5629159' 6-max Seat #1 is the button
Seat 1: e0d7b1d2 ($11.89 in chips)
Seat 2: Hero ($8.8 in chips)
Seat 3: 52140b86 ($9.93 in chips)
Seat 4: effd023b ($10.3 in chips)
Seat 5: 20b2c44c ($17.51 in chips)
Seat 6: bb857721 ($11.42 in chips)
Hero: posts small blind $0.05
52140b86: posts big blind $0.1
*** HOLE CARDS ***
Dealt to e0d7b1d2 
Dealt to Hero [Qh 3h]
Dealt to 52140b86 
Dealt to effd023b 
Dealt to 20b2c44c 
Dealt to bb857721 
effd023b: folds
20b2c44c: folds
bb857721: folds
e0d7b1d2: folds
Hero: folds
Uncalled bet ($0.05) returned to 52140b86
*** SHOWDOWN ***
52140b86 collected $0.1 from pot
*** SUMMARY ***
Total pot $0.1 | Rake $0 | Jackpot $0 | Bingo $0 | Fortune $0
Seat 1: e0d7b1d2 (button) folded before Flop (didn't bet)
Seat 2: Hero (small blind) folded before Flop
Seat 3: 52140b86 (big blind) collected ($0.1)
Seat 4: effd023b folded before Flop (didn't bet)
Seat 5: 20b2c44c folded before Flop (didn't bet)
Seat 6: bb857721 folded before Flop (didn't bet)


Poker Hand #RC1468423874: Hold'em No Limit  ($0.05/$0.1) - 2023/04/12 19:45:10
Table 'RushAndCash5629134' 6-max Seat #1 is the button
Seat 1: Hero ($8.8 in chips)
Seat 2: ed1e58d9 ($12.01 in chips)
Seat 3: e3ffd0f3 ($11.04 in chips)
Seat 4: f9d9e12c ($9.7 in chips)
Seat 5: 2c33c26c ($10.17 in chips)
Seat 6: 38519f22 ($11.84 in chips)
ed1e58d9: posts small blind $0.05
e3ffd0f3: posts big blind $0.1
*** HOLE CARDS ***
Dealt to Hero [2d 4c]
Dealt to ed1e58d9 
Dealt to e3ffd0f3 
Dealt to f9d9e12c 
Dealt to 2c33c26c 
Dealt to 38519f22 
f9d9e12c: folds
2c33c26c: raises $0.15 to $0.25
38519f22: calls $0.25
Hero: folds
ed1e58d9: folds
e3ffd0f3: calls $0.15
*** FLOP *** [6h Ts Tc]
e3ffd0f3: checks
2c33c26c: checks
38519f22: checks
*** TURN *** [6h Ts Tc] [Js]
e3ffd0f3: checks
2c33c26c: bets $0.4
38519f22: calls $0.4
e3ffd0f3: folds
*** RIVER *** [6h Ts Tc Js] [3d]
2c33c26c: checks
38519f22: checks
2c33c26c: shows [Ac Jc] (Pair of Jacks and Pair of Tens)
38519f22: shows [9c 9h] (Pair of Tens and Pair of Nines)
*** SHOWDOWN ***
2c33c26c collected $1.52 from pot
*** SUMMARY ***
Total pot $1.6 | Rake $0.08 | Jackpot $0 | Bingo $0 | Fortune $0
Board [6h Ts Tc Js 3d]
Seat 1: Hero (button) folded before Flop (didn't bet)
Seat 2: ed1e58d9 (small blind) folded before Flop
Seat 3: e3ffd0f3 (big blind) folded on the Turn
Seat 4: f9d9e12c folded before Flop (didn't bet)
Seat 5: 2c33c26c showed [Ac Jc] and won ($1.52) with Pair of Jacks and Pair of Tens
Seat 6: 38519f22 showed [9c 9h] and lost with Pair of Tens and Pair of Nines


Poker Hand #RC1468423814: Hold'em No Limit  ($0.05/$0.1) - 2023/04/12 19:45:01
Table 'RushAndCash5629074' 6-max Seat #1 is the button
Seat 1: a3384092 ($21.8 in chips)
Seat 2: 5fb98e48 ($10 in chips)
Seat 3: Hero ($8.75 in chips)
Seat 4: 7f26736f ($9.43 in chips)
Seat 5: 9ad8e031 ($11.13 in chips)
Seat 6: ff1223c7 ($12.35 in chips)
5fb98e48: posts small blind $0.05
Hero: posts big blind $0.1
*** HOLE CARDS ***
Dealt to a3384092 
Dealt to 5fb98e48 
Dealt to Hero [Ah 5h]
Dealt to 7f26736f 
Dealt to 9ad8e031 
Dealt to ff1223c7 
7f26736f: folds
9ad8e031: folds
ff1223c7: folds
a3384092: folds
5fb98e48: folds
Uncalled bet ($0.05) returned to Hero
*** SHOWDOWN ***
Hero collected $0.1 from pot
*** SUMMARY ***
Total pot $0.1 | Rake $0 | Jackpot $0 | Bingo $0 | Fortune $0
Seat 1: a3384092 (button) folded before Flop (didn't bet)
Seat 2: 5fb98e48 (small blind) folded before Flop
Seat 3: Hero (big blind) collected ($0.1)
Seat 4: 7f26736f folded before Flop (didn't bet)
Seat 5: 9ad8e031 folded before Flop (didn't bet)
Seat 6: ff1223c7 folded before Flop (didn't bet)


Poker Hand #RC1468423764: Hold'em No Limit  ($0.05/$0.1) - 2023/04/12 19:44:52
Table 'RushAndCash5629024' 6-max Seat #1 is the button
Seat 1: 52140b86 ($9.83 in chips)
Seat 2: e3ffd0f3 ($11.09 in chips)
Seat 3: a8ee82b3 ($10.1 in chips)
Seat 4: 6dd18017 ($13.32 in chips)
Seat 5: 2db3f4cd ($12.8 in chips)
Seat 6: Hero ($8.75 in chips)
e3ffd0f3: posts small blind $0.05
a8ee82b3: posts big blind $0.1
*** HOLE CARDS ***
Dealt to 52140b86 
Dealt to e3ffd0f3 
Dealt to a8ee82b3 
Dealt to 6dd18017 
Dealt to 2db3f4cd 
Dealt to Hero [7d Kd]
6dd18017: folds
2db3f4cd: raises $0.15 to $0.25
Hero: folds
52140b86: folds
e3ffd0f3: folds
a8ee82b3: folds
Uncalled bet ($0.15) returned to 2db3f4cd
*** SHOWDOWN ***
2db3f4cd collected $0.25 from pot
*** SUMMARY ***
Total pot $0.25 | Rake $0 | Jackpot $0 | Bingo $0 | Fortune $0
Seat 1: 52140b86 (button) folded before Flop (didn't bet)
Seat 2: e3ffd0f3 (small blind) folded before Flop
Seat 3: a8ee82b3 (big blind) folded before Flop
Seat 4: 6dd18017 folded before Flop (didn't bet)
Seat 5: 2db3f4cd collected ($0.25)
Seat 6: Hero folded before Flop (didn't bet)


Poker Hand #RC1468423734: Hold'em No Limit  ($0.05/$0.1) - 2023/04/12 19:44:46
Table 'RushAndCash5628994' 6-max Seat #1 is the button
Seat 1: b1087382 ($26.15 in chips)
Seat 2: 38519f22 ($11.74 in chips)
Seat 3: 6173bd66 ($22.29 in chips)
Seat 4: Hero ($8.75 in chips)
Seat 5: 57b5f4da ($10.3 in chips)
Seat 6: 6dd18017 ($13.32 in chips)
38519f22: posts small blind $0.05
6173bd66: posts big blind $0.1
*** HOLE CARDS ***
Dealt to b1087382 
Dealt to 38519f22 
Dealt to 6173bd66 
Dealt to Hero [4d 9d]
Dealt to 57b5f4da 
Dealt to 6dd18017 
Hero: folds
57b5f4da: folds
6dd18017: folds
b1087382: raises $0.15 to $0.25
38519f22: folds
6173bd66: folds
Uncalled bet ($0.15) returned to b1087382
*** SHOWDOWN ***
b1087382 collected $0.25 from pot
*** SUMMARY ***
Total pot $0.25 | Rake $0 | Jackpot $0 | Bingo $0 | Fortune $0
Seat 1: b1087382 (button) collected ($0.25)
Seat 2: 38519f22 (small blind) folded before Flop
Seat 3: 6173bd66 (big blind) folded before Flop
Seat 4: Hero folded before Flop (didn't bet)
Seat 5: 57b5f4da folded before Flop (didn't bet)
Seat 6: 6dd18017 folded before Flop (didn't bet)


Poker Hand #RC1468423695: Hold'em No Limit  ($0.05/$0.1) - 2023/04/12 19:44:40
Table 'RushAndCash5628955' 6-max Seat #1 is the button
Seat 1: 55ef7ac8 ($16.84 in chips)
Seat 2: a8ee82b3 ($10 in chips)
Seat 3: faba8d6f ($10 in chips)
Seat 4: 83c3d170 ($5.78 in chips)
Seat 5: Hero ($8.75 in chips)
Seat 6: d290de2a ($17.91 in chips)
a8ee82b3: posts small blind $0.05
faba8d6f: posts big blind $0.1
*** HOLE CARDS ***
Dealt to 55ef7ac8 
Dealt to a8ee82b3 
Dealt to faba8d6f 
Dealt to 83c3d170 
Dealt to Hero [Qd Th]
Dealt to d290de2a 
83c3d170: folds
Hero: folds
d290de2a: folds
55ef7ac8: folds
a8ee82b3: raises $0.13 to $0.23
faba8d6f: folds
Uncalled bet ($0.13) returned to a8ee82b3
*** SHOWDOWN ***
a8ee82b3 collected $0.2 from pot
*** SUMMARY ***
Total pot $0.2 | Rake $0 | Jackpot $0 | Bingo $0 | Fortune $0
Seat 1: 55ef7ac8 (button) folded before Flop (didn't bet)
Seat 2: a8ee82b3 (small blind) collected ($0.2)
Seat 3: faba8d6f (big blind) folded before Flop
Seat 4: 83c3d170 folded before Flop (didn't bet)
Seat 5: Hero folded before Flop (didn't bet)
Seat 6: d290de2a folded before Flop (didn't bet)


Poker Hand #RC1468423661: Hold'em No Limit  ($0.05/$0.1) - 2023/04/12 19:44:34
Table 'RushAndCash5628921' 6-max Seat #1 is the button
Seat 1: dc715600 ($18.07 in chips)
Seat 2: 8265d782 ($10 in chips)
Seat 3: 558b160d ($10.03 in chips)
Seat 4: 1bd3bc3d ($17.62 in chips)
Seat 5: Hero ($8.75 in chips)
Seat 6: 6aba0c18 ($30.61 in chips)
8265d782: posts small blind $0.05
558b160d: posts big blind $0.1
*** HOLE CARDS ***
Dealt to dc715600 
Dealt to 8265d782 
Dealt to 558b160d 
Dealt to 1bd3bc3d 
Dealt to Hero [9d Qd]
Dealt to 6aba0c18 
1bd3bc3d: raises $0.13 to $0.23
Hero: folds
6aba0c18: folds
dc715600: folds
8265d782: calls $0.18
558b160d: folds
*** FLOP *** [2c 3s 6c]
8265d782: checks
1bd3bc3d: bets $0.28
8265d782: calls $0.28
*** TURN *** [2c 3s 6c] [Js]
8265d782: checks
1bd3bc3d: bets $0.25
8265d782: calls $0.25
*** RIVER *** [2c 3s 6c Js] [Ad]
8265d782: checks
1bd3bc3d: checks
8265d782: shows [8d 5d] (Ace-High)
1bd3bc3d: shows [7s 7d] (Pair of Sevens)
*** SHOWDOWN ***
1bd3bc3d collected $1.54 from pot
*** SUMMARY ***
Total pot $1.62 | Rake $0.08 | Jackpot $0 | Bingo $0 | Fortune $0
Board [2c 3s 6c Js Ad]
Seat 1: dc715600 (button) folded before Flop (didn't bet)
Seat 2: 8265d782 (small blind) showed [8d 5d] and lost with Ace-High
Seat 3: 558b160d (big blind) folded before Flop
Seat 4: 1bd3bc3d showed [7s 7d] and won ($1.54) with Pair of Sevens
Seat 5: Hero folded before Flop (didn't bet)
Seat 6: 6aba0c18 folded before Flop (didn't bet)


Poker Hand #RC1468423440: Hold'em No Limit  ($0.05/$0.1) - 2023/04/12 19:43:59
Table 'RushAndCash5628700' 6-max Seat #1 is the button
Seat 1: 74b2edd8 ($9.37 in chips)
Seat 2: f9e2637 ($13.87 in chips)
Seat 3: Hero ($8.48 in chips)
Seat 4: 27c922fe ($38.44 in chips)
Seat 5: c19f477d ($9.85 in chips)
Seat 6: 558b160d ($10.27 in chips)
f9e2637: posts small blind $0.05
Hero: posts big blind $0.1
*** HOLE CARDS ***
Dealt to 74b2edd8 
Dealt to f9e2637 
Dealt to Hero [Ah Jc]
Dealt to 27c922fe 
Dealt to c19f477d 
Dealt to 558b160d 
27c922fe: folds
c19f477d: folds
558b160d: raises $0.14 to $0.24
74b2edd8: folds
f9e2637: folds
Hero: raises $0.8 to $1.04
558b160d: folds
Uncalled bet ($0.8) returned to Hero
*** SHOWDOWN ***
Hero collected $0.51 from pot
*** SUMMARY ***
Total pot $0.53 | Rake $0.02 | Jackpot $0 | Bingo $0 | Fortune $0
Seat 1: 74b2edd8 (button) folded before Flop (didn't bet)
Seat 2: f9e2637 (small blind) folded before Flop
Seat 3: Hero (big blind) collected ($0.51)
Seat 4: 27c922fe folded before Flop (didn't bet)
Seat 5: c19f477d folded before Flop (didn't bet)
Seat 6: 558b160d folded before Flop


Poker Hand #RC1468423380: Hold'em No Limit  ($0.05/$0.1) - 2023/04/12 19:43:50
Table 'RushAndCash5628640' 6-max Seat #1 is the button
Seat 1: 68fafa57 ($12.99 in chips)
Seat 2: Hero ($8.53 in chips)
Seat 3: 93af2464 ($12.23 in chips)
Seat 4: d8e01af9 ($8.88 in chips)
Seat 5: 127f2ea8 ($10.37 in chips)
Seat 6: a8ee82b3 ($10.1 in chips)
Hero: posts small blind $0.05
93af2464: posts big blind $0.1
*** HOLE CARDS ***
Dealt to 68fafa57 
Dealt to Hero [7s 4d]
Dealt to 93af2464 
Dealt to d8e01af9 
Dealt to 127f2ea8 
Dealt to a8ee82b3 
d8e01af9: folds
127f2ea8: raises $0.15 to $0.25
a8ee82b3: folds
68fafa57: raises $0.65 to $0.9
Hero: folds
93af2464: folds
127f2ea8: calls $0.65
*** FLOP *** [8s Kd Qs]
127f2ea8: checks
68fafa57: bets $0.65
127f2ea8: folds
Uncalled bet ($0.65) returned to 68fafa57
*** SHOWDOWN ***
68fafa57 collected $1.86 from pot
*** SUMMARY ***
Total pot $1.95 | Rake $0.09 | Jackpot $0 | Bingo $0 | Fortune $0
Board [8s Kd Qs]
Seat 1: 68fafa57 (button) won ($1.86)
Seat 2: Hero (small blind) folded before Flop
Seat 3: 93af2464 (big blind) folded before Flop
Seat 4: d8e01af9 folded before Flop (didn't bet)
Seat 5: 127f2ea8 folded on the Flop
Seat 6: a8ee82b3 folded before Flop (didn't bet)


Poker Hand #RC1468423352: Hold'em No Limit  ($0.05/$0.1) - 2023/04/12 19:43:46
Table 'RushAndCash5628612' 6-max Seat #1 is the button
Seat 1: e4f65a9 ($7.82 in chips)
Seat 2: 62960ecf ($10 in chips)
Seat 3: 789916a1 ($22.35 in chips)
Seat 4: Hero ($8.53 in chips)
Seat 5: f8e95289 ($11.33 in chips)
Seat 6: 28012238 ($12.73 in chips)
62960ecf: posts small blind $0.05
789916a1: posts big blind $0.1
*** HOLE CARDS ***
Dealt to e4f65a9 
Dealt to 62960ecf 
Dealt to 789916a1 
Dealt to Hero [9h 4h]
Dealt to f8e95289 
Dealt to 28012238 
Hero: folds
f8e95289: folds
28012238: folds
e4f65a9: folds
62960ecf: raises $0.2 to $0.3
789916a1: calls $0.2
*** FLOP *** [Qc Ac 8h]
62960ecf: bets $0.21
789916a1: calls $0.21
*** TURN *** [Qc Ac 8h] [Jh]
62960ecf: checks
789916a1: checks
*** RIVER *** [Qc Ac 8h Jh] [7h]
62960ecf: checks
789916a1: bets $1.02
62960ecf: folds
Uncalled bet ($1.02) returned to 789916a1
*** SHOWDOWN ***
789916a1 collected $0.96 from pot
*** SUMMARY ***
Total pot $1.02 | Rake $0.06 | Jackpot $0 | Bingo $0 | Fortune $0
Board [Qc Ac 8h Jh 7h]
Seat 1: e4f65a9 (button) folded before Flop (didn't bet)
Seat 2: 62960ecf (small blind) folded on the River
Seat 3: 789916a1 (big blind) won ($0.96)
Seat 4: Hero folded before Flop (didn't bet)
Seat 5: f8e95289 folded before Flop (didn't bet)
Seat 6: 28012238 folded before Flop (didn't bet)


Poker Hand #RC1468423039: Hold'em No Limit  ($0.05/$0.1) - 2023/04/12 19:43:00
Table 'RushAndCash5628299' 6-max Seat #1 is the button
Seat 1: a0afbd55 ($11.1 in chips)
Seat 2: 603203b9 ($48.54 in chips)
Seat 3: 7b0eeb66 ($11.18 in chips)
Seat 4: Hero ($8.16 in chips)
Seat 5: e50e1200 ($10.52 in chips)
Seat 6: 28012238 ($12.98 in chips)
603203b9: posts small blind $0.05
7b0eeb66: posts big blind $0.1
*** HOLE CARDS ***
Dealt to a0afbd55 
Dealt to 603203b9 
Dealt to 7b0eeb66 
Dealt to Hero [Js Ad]
Dealt to e50e1200 
Dealt to 28012238 
Hero: raises $0.15 to $0.25
e50e1200: folds
28012238: calls $0.25
a0afbd55: folds
603203b9: folds
7b0eeb66: folds
*** FLOP *** [6h Tc Kh]
Hero: bets $0.33
28012238: folds
Uncalled bet ($0.33) returned to Hero
*** SHOWDOWN ***
Hero collected $0.62 from pot
*** SUMMARY ***
Total pot $0.65 | Rake $0.03 | Jackpot $0 | Bingo $0 | Fortune $0
Board [6h Tc Kh]
Seat 1: a0afbd55 (button) folded before Flop (didn't bet)
Seat 2: 603203b9 (small blind) folded before Flop
Seat 3: 7b0eeb66 (big blind) folded before Flop
Seat 4: Hero won ($0.62)
Seat 5: e50e1200 folded before Flop (didn't bet)
Seat 6: 28012238 folded on the Flop


Poker Hand #RC1468422982: Hold'em No Limit  ($0.05/$0.1) - 2023/04/12 19:42:51
Table 'RushAndCash5628242' 6-max Seat #1 is the button
Seat 1: Hero ($8.16 in chips)
Seat 2: 4416d8c2 ($20.37 in chips)
Seat 3: d58546bd ($10 in chips)
Seat 4: 2db3f4cd ($12.63 in chips)
Seat 5: 58f27a02 ($11.28 in chips)
Seat 6: 49600bcc ($57.56 in chips)
4416d8c2: posts small blind $0.05
d58546bd: posts big blind $0.1
*** HOLE CARDS ***
Dealt to Hero [Jc 6d]
Dealt to 4416d8c2 
Dealt to d58546bd 
Dealt to 2db3f4cd 
Dealt to 58f27a02 
Dealt to 49600bcc 
2db3f4cd: folds
58f27a02: folds
49600bcc: folds
Hero: folds
4416d8c2: folds
Uncalled bet ($0.05) returned to d58546bd
*** SHOWDOWN ***
d58546bd collected $0.1 from pot
*** SUMMARY ***
Total pot $0.1 | Rake $0 | Jackpot $0 | Bingo $0 | Fortune $0
Seat 1: Hero (button) folded before Flop (didn't bet)
Seat 2: 4416d8c2 (small blind) folded before Flop
Seat 3: d58546bd (big blind) collected ($0.1)
Seat 4: 2db3f4cd folded before Flop (didn't bet)
Seat 5: 58f27a02 folded before Flop (didn't bet)
Seat 6: 49600bcc folded before Flop (didn't bet)


Poker Hand #RC1468422825: Hold'em No Limit  ($0.05/$0.1) - 2023/04/12 19:42:29
Table 'RushAndCash5628085' 6-max Seat #1 is the button
Seat 1: 28988e8d ($10.19 in chips)
Seat 2: 297cd4e9 ($9.99 in chips)
Seat 3: Hero ($8.26 in chips)
Seat 4: 15913e59 ($10.42 in chips)
Seat 5: 4e661c11 ($11.21 in chips)
Seat 6: 5aeaa886 ($38.37 in chips)
297cd4e9: posts small blind $0.05
Hero: posts big blind $0.1
*** HOLE CARDS ***
Dealt to 28988e8d 
Dealt to 297cd4e9 
Dealt to Hero [9d Js]
Dealt to 15913e59 
Dealt to 4e661c11 
Dealt to 5aeaa886 
15913e59: folds
4e661c11: raises $0.15 to $0.25
5aeaa886: folds
28988e8d: folds
297cd4e9: calls $0.2
Hero: folds
*** FLOP *** [8d 8s Ad]
297cd4e9: checks
4e661c11: bets $0.2
297cd4e9: calls $0.2
*** TURN *** [8d 8s Ad] [4d]
297cd4e9: checks
4e661c11: checks
*** RIVER *** [8d 8s Ad 4d] [4s]
297cd4e9: checks
4e661c11: checks
297cd4e9: shows [Th Jc] (Pair of Eights and Pair of Fours)
4e661c11: shows [6s 7s] (Pair of Eights and Pair of Fours)
*** SHOWDOWN ***
297cd4e9 collected $0.48 from pot
4e661c11 collected $0.48 from pot
*** SUMMARY ***
Total pot $1 | Rake $0.04 | Jackpot $0 | Bingo $0 | Fortune $0
Board [8d 8s Ad 4d 4s]
Seat 1: 28988e8d (button) folded before Flop (didn't bet)
Seat 2: 297cd4e9 (small blind) showed [Th Jc] and won ($0.48) with Pair of Eights and Pair of Fours
Seat 3: Hero (big blind) folded before Flop
Seat 4: 15913e59 folded before Flop (didn't bet)
Seat 5: 4e661c11 showed [6s 7s] and won ($0.48) with Pair of Eights and Pair of Fours
Seat 6: 5aeaa886 folded before Flop (didn't bet)


Poker Hand #RC1468422779: Hold'em No Limit  ($0.05/$0.1) - 2023/04/12 19:42:22
Table 'RushAndCash5628039' 6-max Seat #1 is the button
Seat 1: 3067e5a8 ($10 in chips)
Seat 2: b66aae79 ($12.1 in chips)
Seat 3: 2e3720a3 ($13.66 in chips)
Seat 4: d48652f ($10 in chips)
Seat 5: Hero ($8.26 in chips)
Seat 6: b4dec9b2 ($8.63 in chips)
b66aae79: posts small blind $0.05
2e3720a3: posts big blind $0.1
*** HOLE CARDS ***
Dealt to 3067e5a8 
Dealt to b66aae79 
Dealt to 2e3720a3 
Dealt to d48652f 
Dealt to Hero [7c Ah]
Dealt to b4dec9b2 
d48652f: folds
Hero: folds
b4dec9b2: folds
3067e5a8: folds
b66aae79: folds
Uncalled bet ($0.05) returned to 2e3720a3
*** SHOWDOWN ***
2e3720a3 collected $0.1 from pot
*** SUMMARY ***
Total pot $0.1 | Rake $0 | Jackpot $0 | Bingo $0 | Fortune $0
Seat 1: 3067e5a8 (button) folded before Flop (didn't bet)
Seat 2: b66aae79 (small blind) folded before Flop
Seat 3: 2e3720a3 (big blind) collected ($0.1)
Seat 4: d48652f folded before Flop (didn't bet)
Seat 5: Hero folded before Flop (didn't bet)
Seat 6: b4dec9b2 folded before Flop (didn't bet)


Poker Hand #RC1468422664: Hold'em No Limit  ($0.05/$0.1) - 2023/04/12 19:42:06
Table 'RushAndCash5627924' 6-max Seat #1 is the button
Seat 1: b6fc1b2e ($10 in chips)
Seat 2: Hero ($8.16 in chips)
Seat 3: 3067e5a8 ($10 in chips)
Seat 4: 5aeaa886 ($38.37 in chips)
Seat 5: 67d9184a ($12.77 in chips)
Seat 6: cb00f00 ($16.4 in chips)
Hero: posts small blind $0.05
3067e5a8: posts big blind $0.1
*** HOLE CARDS ***
Dealt to b6fc1b2e 
Dealt to Hero [9h 9c]
Dealt to 3067e5a8 
Dealt to 5aeaa886 
Dealt to 67d9184a 
Dealt to cb00f00 
5aeaa886: folds
67d9184a: folds
cb00f00: folds
b6fc1b2e: folds
Hero: raises $0.2 to $0.3
3067e5a8: folds
Uncalled bet ($0.2) returned to Hero
*** SHOWDOWN ***
Hero collected $0.2 from pot
*** SUMMARY ***
Total pot $0.2 | Rake $0 | Jackpot $0 | Bingo $0 | Fortune $0
Seat 1: b6fc1b2e (button) folded before Flop (didn't bet)
Seat 2: Hero (small blind) collected ($0.2)
Seat 3: 3067e5a8 (big blind) folded before Flop
Seat 4: 5aeaa886 folded before Flop (didn't bet)
Seat 5: 67d9184a folded before Flop (didn't bet)
Seat 6: cb00f00 folded before Flop (didn't bet)


Poker Hand #RC1468422617: Hold'em No Limit  ($0.05/$0.1) - 2023/04/12 19:41:59
Table 'RushAndCash5627877' 6-max Seat #1 is the button
Seat 1: 9663e609 ($10.15 in chips)
Seat 2: 76f45381 ($10.46 in chips)
Seat 3: c6db735 ($9.48 in chips)
Seat 4: Hero ($8.16 in chips)
Seat 5: f95a35c4 ($10.75 in chips)
Seat 6: 85b7299e ($31.25 in chips)
76f45381: posts small blind $0.05
c6db735: posts big blind $0.1
*** HOLE CARDS ***
Dealt to 9663e609 
Dealt to 76f45381 
Dealt to c6db735 
Dealt to Hero [7d 4c]
Dealt to f95a35c4 
Dealt to 85b7299e 
Hero: folds
f95a35c4: raises $0.15 to $0.25
85b7299e: folds
9663e609: folds
76f45381: folds
c6db735: folds
Uncalled bet ($0.15) returned to f95a35c4
*** SHOWDOWN ***
f95a35c4 collected $0.25 from pot
*** SUMMARY ***
Total pot $0.25 | Rake $0 | Jackpot $0 | Bingo $0 | Fortune $0
Seat 1: 9663e609 (button) folded before Flop (didn't bet)
Seat 2: 76f45381 (small blind) folded before Flop
Seat 3: c6db735 (big blind) folded before Flop
Seat 4: Hero folded before Flop (didn't bet)
Seat 5: f95a35c4 collected ($0.25)
Seat 6: 85b7299e folded before Flop (didn't bet)


Poker Hand #RC1468422579: Hold'em No Limit  ($0.05/$0.1) - 2023/04/12 19:41:53
Table 'RushAndCash5627839' 6-max Seat #1 is the button
Seat 1: 7d9214a4 ($29.66 in chips)
Seat 2: 3c7c0c29 ($36.65 in chips)
Seat 3: 6f8b0e05 ($12.45 in chips)
Seat 4: 3877af71 ($13.1 in chips)
Seat 5: e4f65a9 ($8.79 in chips)
Seat 6: Hero ($8.16 in chips)
3c7c0c29: posts small blind $0.05
6f8b0e05: posts big blind $0.1
*** HOLE CARDS ***
Dealt to 7d9214a4 
Dealt to 3c7c0c29 
Dealt to 6f8b0e05 
Dealt to 3877af71 
Dealt to e4f65a9 
Dealt to Hero [3h 9h]
3877af71: folds
e4f65a9: folds
Hero: folds
7d9214a4: raises $0.2 to $0.3
3c7c0c29: folds
6f8b0e05: folds
Uncalled bet ($0.2) returned to 7d9214a4
*** SHOWDOWN ***
7d9214a4 collected $0.25 from pot
*** SUMMARY ***
Total pot $0.25 | Rake $0 | Jackpot $0 | Bingo $0 | Fortune $0
Seat 1: 7d9214a4 (button) collected ($0.25)
Seat 2: 3c7c0c29 (small blind) folded before Flop
Seat 3: 6f8b0e05 (big blind) folded before Flop
Seat 4: 3877af71 folded before Flop (didn't bet)
Seat 5: e4f65a9 folded before Flop (didn't bet)
Seat 6: Hero folded before Flop (didn't bet)


Poker Hand #RC1468422550: Hold'em No Limit  ($0.05/$0.1) - 2023/04/12 19:41:48
Table 'RushAndCash5627810' 6-max Seat #1 is the button
Seat 1: Hero ($8.16 in chips)
Seat 2: cee63dd ($18.85 in chips)
Seat 3: 7b6a87a3 ($10 in chips)
Seat 4: 6108a2fc ($13.47 in chips)
Seat 5: 859ea6cc ($13.6 in chips)
Seat 6: 8aea79f8 ($8.55 in chips)
cee63dd: posts small blind $0.05
7b6a87a3: posts big blind $0.1
*** HOLE CARDS ***
Dealt to Hero [Ts 7s]
Dealt to cee63dd 
Dealt to 7b6a87a3 
Dealt to 6108a2fc 
Dealt to 859ea6cc 
Dealt to 8aea79f8 
6108a2fc: folds
859ea6cc: folds
8aea79f8: folds
Hero: folds
cee63dd: folds
Uncalled bet ($0.05) returned to 7b6a87a3
*** SHOWDOWN ***
7b6a87a3 collected $0.1 from pot
*** SUMMARY ***
Total pot $0.1 | Rake $0 | Jackpot $0 | Bingo $0 | Fortune $0
Seat 1: Hero (button) folded before Flop (didn't bet)
Seat 2: cee63dd (small blind) folded before Flop
Seat 3: 7b6a87a3 (big blind) collected ($0.1)
Seat 4: 6108a2fc folded before Flop (didn't bet)
Seat 5: 859ea6cc folded before Flop (didn't bet)
Seat 6: 8aea79f8 folded before Flop (didn't bet)


Poker Hand #RC1468422506: Hold'em No Limit  ($0.05/$0.1) - 2023/04/12 19:41:41
Table 'RushAndCash5627766' 6-max Seat #1 is the button
Seat 1: b4baa577 ($10 in chips)
Seat 2: 8c845fa8 ($15.45 in chips)
Seat 3: 67a81530 ($14.22 in chips)
Seat 4: 85c99be5 ($10 in chips)
Seat 5: Hero ($8.16 in chips)
Seat 6: ab766696 ($10.36 in chips)
8c845fa8: posts small blind $0.05
67a81530: posts big blind $0.1
*** HOLE CARDS ***
Dealt to b4baa577 
Dealt to 8c845fa8 
Dealt to 67a81530 
Dealt to 85c99be5 
Dealt to Hero [7s 4h]
Dealt to ab766696 
85c99be5: folds
Hero: folds
ab766696: folds
b4baa577: folds
8c845fa8: raises $0.15 to $0.25
67a81530: folds
Uncalled bet ($0.15) returned to 8c845fa8
*** SHOWDOWN ***
8c845fa8 collected $0.2 from pot
*** SUMMARY ***
Total pot $0.2 | Rake $0 | Jackpot $0 | Bingo $0 | Fortune $0
Seat 1: b4baa577 (button) folded before Flop (didn't bet)
Seat 2: 8c845fa8 (small blind) collected ($0.2)
Seat 3: 67a81530 (big blind) folded before Flop
Seat 4: 85c99be5 folded before Flop (didn't bet)
Seat 5: Hero folded before Flop (didn't bet)
Seat 6: ab766696 folded before Flop (didn't bet)


Poker Hand #RC1468422436: Hold'em No Limit  ($0.05/$0.1) - 2023/04/12 19:41:29
Table 'RushAndCash5627696' 6-max Seat #1 is the button
Seat 1: 3528f32d ($9.87 in chips)
Seat 2: 859ea6cc ($13.28 in chips)
Seat 3: Hero ($8.26 in chips)
Seat 4: b83a7c4 ($10.31 in chips)
Seat 5: 3d9dd182 ($44.9 in chips)
Seat 6: 6108a2fc ($13.72 in chips)
859ea6cc: posts small blind $0.05
Hero: posts big blind $0.1
*** HOLE CARDS ***
Dealt to 3528f32d 
Dealt to 859ea6cc 
Dealt to Hero [7h Jh]
Dealt to b83a7c4 
Dealt to 3d9dd182 
Dealt to 6108a2fc 
b83a7c4: folds
3d9dd182: folds
6108a2fc: raises $0.15 to $0.25
3528f32d: folds
859ea6cc: raises $0.9 to $1.15
Hero: folds
6108a2fc: folds
Uncalled bet ($0.9) returned to 859ea6cc
*** SHOWDOWN ***
859ea6cc collected $0.57 from pot
*** SUMMARY ***
Total pot $0.6 | Rake $0.03 | Jackpot $0 | Bingo $0 | Fortune $0
Seat 1: 3528f32d (button) folded before Flop (didn't bet)
Seat 2: 859ea6cc (small blind) collected ($0.57)
Seat 3: Hero (big blind) folded before Flop
Seat 4: b83a7c4 folded before Flop (didn't bet)
Seat 5: 3d9dd182 folded before Flop (didn't bet)
Seat 6: 6108a2fc folded before Flop


Poker Hand #RC1468422285: Hold'em No Limit  ($0.05/$0.1) - 2023/04/12 19:41:04
Table 'RushAndCash5627545' 6-max Seat #1 is the button
Seat 1: 5dbd6c87 ($9.65 in chips)
Seat 2: a8fd0a2 ($26.39 in chips)
Seat 3: 760fdbe7 ($22.81 in chips)
Seat 4: 3877af71 ($13.4 in chips)
Seat 5: Hero ($8.26 in chips)
Seat 6: 25133b10 ($26.16 in chips)
a8fd0a2: posts small blind $0.05
760fdbe7: posts big blind $0.1
*** HOLE CARDS ***
Dealt to 5dbd6c87 
Dealt to a8fd0a2 
Dealt to 760fdbe7 
Dealt to 3877af71 
Dealt to Hero [9c Kd]
Dealt to 25133b10 
3877af71: folds
Hero: folds
25133b10: folds
5dbd6c87: folds
a8fd0a2: folds
Uncalled bet ($0.05) returned to 760fdbe7
*** SHOWDOWN ***
760fdbe7 collected $0.1 from pot
*** SUMMARY ***
Total pot $0.1 | Rake $0 | Jackpot $0 | Bingo $0 | Fortune $0
Seat 1: 5dbd6c87 (button) folded before Flop (didn't bet)
Seat 2: a8fd0a2 (small blind) folded before Flop
Seat 3: 760fdbe7 (big blind) collected ($0.1)
Seat 4: 3877af71 folded before Flop (didn't bet)
Seat 5: Hero folded before Flop (didn't bet)
Seat 6: 25133b10 folded before Flop (didn't bet)


Poker Hand #RC1468422258: Hold'em No Limit  ($0.05/$0.1) - 2023/04/12 19:40:59
Table 'RushAndCash5627518' 6-max Seat #1 is the button
Seat 1: Hero ($8.26 in chips)
Seat 2: 4d0c21a6 ($18.27 in chips)
Seat 3: e7b56c29 ($27.7 in chips)
Seat 4: 8ebabd7f ($10.89 in chips)
Seat 5: ab6a56dd ($9.85 in chips)
Seat 6: 7d2291a0 ($6.78 in chips)
4d0c21a6: posts small blind $0.05
e7b56c29: posts big blind $0.1
*** HOLE CARDS ***
Dealt to Hero [2s 4d]
Dealt to 4d0c21a6 
Dealt to e7b56c29 
Dealt to 8ebabd7f 
Dealt to ab6a56dd 
Dealt to 7d2291a0 
8ebabd7f: folds
ab6a56dd: folds
7d2291a0: folds
Hero: folds
4d0c21a6: folds
Uncalled bet ($0.05) returned to e7b56c29
*** SHOWDOWN ***
e7b56c29 collected $0.1 from pot
*** SUMMARY ***
Total pot $0.1 | Rake $0 | Jackpot $0 | Bingo $0 | Fortune $0
Seat 1: Hero (button) folded before Flop (didn't bet)
Seat 2: 4d0c21a6 (small blind) folded before Flop
Seat 3: e7b56c29 (big blind) collected ($0.1)
Seat 4: 8ebabd7f folded before Flop (didn't bet)
Seat 5: ab6a56dd folded before Flop (didn't bet)
Seat 6: 7d2291a0 folded before Flop (didn't bet)


Poker Hand #RC1468422164: Hold'em No Limit  ($0.05/$0.1) - 2023/04/12 19:40:46
Table 'RushAndCash5627424' 6-max Seat #1 is the button
Seat 1: 7aa8ed94 ($9.87 in chips)
Seat 2: Hero ($8.16 in chips)
Seat 3: 663d422e ($14.99 in chips)
Seat 4: 98fa32ad ($11.51 in chips)
Seat 5: b51ca385 ($2.9 in chips)
Seat 6: 3877af71 ($13.4 in chips)
Hero: posts small blind $0.05
663d422e: posts big blind $0.1
*** HOLE CARDS ***
Dealt to 7aa8ed94 
Dealt to Hero [Ts Jh]
Dealt to 663d422e 
Dealt to 98fa32ad 
Dealt to b51ca385 
Dealt to 3877af71 
98fa32ad: folds
b51ca385: folds
3877af71: folds
7aa8ed94: folds
Hero: raises $0.2 to $0.3
663d422e: folds
Uncalled bet ($0.2) returned to Hero
*** SHOWDOWN ***
Hero collected $0.2 from pot
*** SUMMARY ***
Total pot $0.2 | Rake $0 | Jackpot $0 | Bingo $0 | Fortune $0
Seat 1: 7aa8ed94 (button) folded before Flop (didn't bet)
Seat 2: Hero (small blind) collected ($0.2)
Seat 3: 663d422e (big blind) folded before Flop
Seat 4: 98fa32ad folded before Flop (didn't bet)
Seat 5: b51ca385 folded before Flop (didn't bet)
Seat 6: 3877af71 folded before Flop (didn't bet)


Poker Hand #RC1468421705: Hold'em No Limit  ($0.05/$0.1) - 2023/04/12 19:39:38
Table 'RushAndCash5626965' 6-max Seat #1 is the button
Seat 1: 57b5f4da ($10.61 in chips)
Seat 2: 15913e59 ($10.7 in chips)
Seat 3: 3877af71 ($13.12 in chips)
Seat 4: 6f8b0e05 ($11.15 in chips)
Seat 5: Hero ($8.41 in chips)
Seat 6: 499d6d5f ($10.21 in chips)
15913e59: posts small blind $0.05
3877af71: posts big blind $0.1
*** HOLE CARDS ***
Dealt to 57b5f4da 
Dealt to 15913e59 
Dealt to 3877af71 
Dealt to 6f8b0e05 
Dealt to Hero [8d 8c]
Dealt to 499d6d5f 
6f8b0e05: folds
Hero: raises $0.15 to $0.25
499d6d5f: folds
57b5f4da: folds
15913e59: folds
3877af71: calls $0.15
*** FLOP *** [Jh Qd 4s]
3877af71: checks
Hero: checks
*** TURN *** [Jh Qd 4s] [9h]
3877af71: bets $0.42
Hero: folds
Uncalled bet ($0.42) returned to 3877af71
*** SHOWDOWN ***
3877af71 collected $0.53 from pot
*** SUMMARY ***
Total pot $0.55 | Rake $0.02 | Jackpot $0 | Bingo $0 | Fortune $0
Board [Jh Qd 4s 9h]
Seat 1: 57b5f4da (button) folded before Flop (didn't bet)
Seat 2: 15913e59 (small blind) folded before Flop
Seat 3: 3877af71 (big blind) won ($0.53)
Seat 4: 6f8b0e05 folded before Flop (didn't bet)
Seat 5: Hero folded on the Turn
Seat 6: 499d6d5f folded before Flop (didn't bet)


Poker Hand #RC1468421672: Hold'em No Limit  ($0.05/$0.1) - 2023/04/12 19:39:33
Table 'RushAndCash5626932' 6-max Seat #1 is the button
Seat 1: 82281e3b ($10.68 in chips)
Seat 2: 5dbd6c87 ($10.25 in chips)
Seat 3: c16d9eef ($12.6 in chips)
Seat 4: Hero ($8.41 in chips)
Seat 5: d56de772 ($11.84 in chips)
Seat 6: dc715600 ($17.61 in chips)
5dbd6c87: posts small blind $0.05
c16d9eef: posts big blind $0.1
*** HOLE CARDS ***
Dealt to 82281e3b 
Dealt to 5dbd6c87 
Dealt to c16d9eef 
Dealt to Hero [9c Jd]
Dealt to d56de772 
Dealt to dc715600 
Hero: folds
d56de772: folds
dc715600: folds
82281e3b: folds
5dbd6c87: raises $0.2 to $0.3
c16d9eef: folds
Uncalled bet ($0.2) returned to 5dbd6c87
*** SHOWDOWN ***
5dbd6c87 collected $0.2 from pot
*** SUMMARY ***
Total pot $0.2 | Rake $0 | Jackpot $0 | Bingo $0 | Fortune $0
Seat 1: 82281e3b (button) folded before Flop (didn't bet)
Seat 2: 5dbd6c87 (small blind) collected ($0.2)
Seat 3: c16d9eef (big blind) folded before Flop
Seat 4: Hero folded before Flop (didn't bet)
Seat 5: d56de772 folded before Flop (didn't bet)
Seat 6: dc715600 folded before Flop (didn't bet)


Poker Hand #RC1468421630: Hold'em No Limit  ($0.05/$0.1) - 2023/04/12 19:39:27
Table 'RushAndCash5626890' 6-max Seat #1 is the button
Seat 1: 28988e8d ($11.36 in chips)
Seat 2: 2e694c7e ($26.5 in chips)
Seat 3: 5e0ca113 ($12.67 in chips)
Seat 4: 7fa9fd71 ($23.47 in chips)
Seat 5: 7f1c7377 ($18.63 in chips)
Seat 6: Hero ($8.41 in chips)
2e694c7e: posts small blind $0.05
5e0ca113: posts big blind $0.1
*** HOLE CARDS ***
Dealt to 28988e8d 
Dealt to 2e694c7e 
Dealt to 5e0ca113 
Dealt to 7fa9fd71 
Dealt to 7f1c7377 
Dealt to Hero [Ah 8s]
7fa9fd71: folds
7f1c7377: raises $0.15 to $0.25
Hero: folds
28988e8d: folds
2e694c7e: folds
5e0ca113: folds
Uncalled bet ($0.15) returned to 7f1c7377
*** SHOWDOWN ***
7f1c7377 collected $0.25 from pot
*** SUMMARY ***
Total pot $0.25 | Rake $0 | Jackpot $0 | Bingo $0 | Fortune $0
Seat 1: 28988e8d (button) folded before Flop (didn't bet)
Seat 2: 2e694c7e (small blind) folded before Flop
Seat 3: 5e0ca113 (big blind) folded before Flop
Seat 4: 7fa9fd71 folded before Flop (didn't bet)
Seat 5: 7f1c7377 collected ($0.25)
Seat 6: Hero folded before Flop (didn't bet)


Poker Hand #RC1468421518: Hold'em No Limit  ($0.05/$0.1) - 2023/04/12 19:39:11
Table 'RushAndCash5626778' 6-max Seat #1 is the button
Seat 1: 195264ef ($10 in chips)
Seat 2: Hero ($8.46 in chips)
Seat 3: 103990f1 ($9.8 in chips)
Seat 4: ec825e33 ($12.11 in chips)
Seat 5: 108eb71 ($23.49 in chips)
Seat 6: e7b56c29 ($27.93 in chips)
Hero: posts small blind $0.05
103990f1: posts big blind $0.1
*** HOLE CARDS ***
Dealt to 195264ef 
Dealt to Hero [5c Jh]
Dealt to 103990f1 
Dealt to ec825e33 
Dealt to 108eb71 
Dealt to e7b56c29 
ec825e33: folds
108eb71: folds
e7b56c29: folds
195264ef: raises $0.15 to $0.25
Hero: folds
103990f1: calls $0.15
*** FLOP *** [Ad 4h As]
103990f1: checks
195264ef: bets $0.2
103990f1: folds
Uncalled bet ($0.2) returned to 195264ef
*** SHOWDOWN ***
195264ef collected $0.53 from pot
*** SUMMARY ***
Total pot $0.55 | Rake $0.02 | Jackpot $0 | Bingo $0 | Fortune $0
Board [Ad 4h As]
Seat 1: 195264ef (button) won ($0.53)
Seat 2: Hero (small blind) folded before Flop
Seat 3: 103990f1 (big blind) folded on the Flop
Seat 4: ec825e33 folded before Flop (didn't bet)
Seat 5: 108eb71 folded before Flop (didn't bet)
Seat 6: e7b56c29 folded before Flop (didn't bet)


Poker Hand #RC1468420990: Hold'em No Limit  ($0.05/$0.1) - 2023/04/12 19:37:52
Table 'RushAndCash5626250' 6-max Seat #1 is the button
Seat 1: 760fdbe7 ($23.26 in chips)
Seat 2: beae0d61 ($9.9 in chips)
Seat 3: Hero ($4.43 in chips)
Seat 4: 782fdbb3 ($11.68 in chips)
Seat 5: 52140b86 ($9.45 in chips)
Seat 6: 7019a139 ($9.94 in chips)
beae0d61: posts small blind $0.05
Hero: posts big blind $0.1
*** HOLE CARDS ***
Dealt to 760fdbe7 
Dealt to beae0d61 
Dealt to Hero [Qd Th]
Dealt to 782fdbb3 
Dealt to 52140b86 
Dealt to 7019a139 
782fdbb3: raises $0.15 to $0.25
52140b86: folds
7019a139: folds
760fdbe7: folds
beae0d61: folds
Hero: calls $0.15
*** FLOP *** [Td Ts 2c]
Hero: checks
782fdbb3: bets $0.42
Hero: calls $0.42
*** TURN *** [Td Ts 2c] [5d]
Hero: checks
782fdbb3: bets $1.05
Hero: calls $1.05
*** RIVER *** [Td Ts 2c 5d] [7c]
Hero: checks
782fdbb3: bets $2.82
Hero: calls $2.71 and is all-in
Uncalled bet ($0.11) returned to 782fdbb3
782fdbb3: shows [Qh Kd] (Pair of Tens)
Hero: shows [Qd Th] (Three Tens)
*** SHOWDOWN ***
Hero collected $8.46 from pot
*** SUMMARY ***
Total pot $8.91 | Rake $0.3 | Jackpot $0.15 | Bingo $0 | Fortune $0
Board [Td Ts 2c 5d 7c]
Seat 1: 760fdbe7 (button) folded before Flop (didn't bet)
Seat 2: beae0d61 (small blind) folded before Flop
Seat 3: Hero (big blind) showed [Qd Th] and won ($8.46) with Three Tens
Seat 4: 782fdbb3 showed [Qh Kd] and lost with Pair of Tens
Seat 5: 52140b86 folded before Flop (didn't bet)
Seat 6: 7019a139 folded before Flop (didn't bet)


Poker Hand #RC1468420956: Hold'em No Limit  ($0.05/$0.1) - 2023/04/12 19:37:47
Table 'RushAndCash5626216' 6-max Seat #1 is the button
Seat 1: Hero ($4.43 in chips)
Seat 2: 2e694c7e ($23.59 in chips)
Seat 3: 1dc32816 ($19.74 in chips)
Seat 4: d094b028 ($20.31 in chips)
Seat 5: 1b6c8638 ($11.7 in chips)
Seat 6: 8f78d748 ($5.18 in chips)
2e694c7e: posts small blind $0.05
1dc32816: posts big blind $0.1
*** HOLE CARDS ***
Dealt to Hero [7d 8c]
Dealt to 2e694c7e 
Dealt to 1dc32816 
Dealt to d094b028 
Dealt to 1b6c8638 
Dealt to 8f78d748 
d094b028: folds
1b6c8638: folds
8f78d748: raises $0.15 to $0.25
Hero: folds
2e694c7e: folds
1dc32816: folds
Uncalled bet ($0.15) returned to 8f78d748
*** SHOWDOWN ***
8f78d748 collected $0.25 from pot
*** SUMMARY ***
Total pot $0.25 | Rake $0 | Jackpot $0 | Bingo $0 | Fortune $0
Seat 1: Hero (button) folded before Flop (didn't bet)
Seat 2: 2e694c7e (small blind) folded before Flop
Seat 3: 1dc32816 (big blind) folded before Flop
Seat 4: d094b028 folded before Flop (didn't bet)
Seat 5: 1b6c8638 folded before Flop (didn't bet)
Seat 6: 8f78d748 collected ($0.25)


Poker Hand #RC1468420902: Hold'em No Limit  ($0.05/$0.1) - 2023/04/12 19:37:40
Table 'RushAndCash5626162' 6-max Seat #1 is the button
Seat 1: 34cca949 ($5.7 in chips)
Seat 2: fb836f3e ($14.87 in chips)
Seat 3: af9f76e1 ($10 in chips)
Seat 4: 8ab41525 ($7.86 in chips)
Seat 5: c576570a ($10.04 in chips)
Seat 6: Hero ($4.43 in chips)
fb836f3e: posts small blind $0.05
af9f76e1: posts big blind $0.1
*** HOLE CARDS ***
Dealt to 34cca949 
Dealt to fb836f3e 
Dealt to af9f76e1 
Dealt to 8ab41525 
Dealt to c576570a 
Dealt to Hero [9c Jh]
8ab41525: calls $0.1
c576570a: folds
Hero: folds
34cca949: folds
fb836f3e: calls $0.05
af9f76e1: checks
*** FLOP *** [8s Ac 4h]
fb836f3e: checks
af9f76e1: checks
8ab41525: checks
*** TURN *** [8s Ac 4h] [5c]
fb836f3e: checks
af9f76e1: checks
8ab41525: bets $0.16
fb836f3e: folds
af9f76e1: calls $0.16
*** RIVER *** [8s Ac 4h 5c] [7d]
af9f76e1: checks
8ab41525: bets $0.33
af9f76e1: folds
Uncalled bet ($0.33) returned to 8ab41525
*** SHOWDOWN ***
8ab41525 collected $0.59 from pot
*** SUMMARY ***
Total pot $0.62 | Rake $0.03 | Jackpot $0 | Bingo $0 | Fortune $0
Board [8s Ac 4h 5c 7d]
Seat 1: 34cca949 (button) folded before Flop (didn't bet)
Seat 2: fb836f3e (small blind) folded on the Turn
Seat 3: af9f76e1 (big blind) folded on the River
Seat 4: 8ab41525 won ($0.59)
Seat 5: c576570a folded before Flop (didn't bet)
Seat 6: Hero folded before Flop (didn't bet)


Poker Hand #RC1468420719: Hold'em No Limit  ($0.05/$0.1) - 2023/04/12 19:37:08
Table 'RushAndCash5625979' 6-max Seat #1 is the button
Seat 1: 138e1573 ($12.19 in chips)
Seat 2: Hero ($4.16 in chips)
Seat 3: fb836f3e ($15.17 in chips)
Seat 4: 30398975 ($19.16 in chips)
Seat 5: 32076ba2 ($10 in chips)
Seat 6: 1e0fb20e ($23.29 in chips)
Hero: posts small blind $0.05
fb836f3e: posts big blind $0.1
*** HOLE CARDS ***
Dealt to 138e1573 
Dealt to Hero [4c As]
Dealt to fb836f3e 
Dealt to 30398975 
Dealt to 32076ba2 
Dealt to 1e0fb20e 
30398975: folds
32076ba2: folds
1e0fb20e: folds
138e1573: folds
Hero: raises $0.2 to $0.3
fb836f3e: calls $0.2
*** FLOP *** [9s 6c Ac]
Hero: bets $0.3
fb836f3e: folds
Uncalled bet ($0.3) returned to Hero
*** SHOWDOWN ***
Hero collected $0.57 from pot
*** SUMMARY ***
Total pot $0.6 | Rake $0.03 | Jackpot $0 | Bingo $0 | Fortune $0
Board [9s 6c Ac]
Seat 1: 138e1573 (button) folded before Flop (didn't bet)
Seat 2: Hero (small blind) won ($0.57)
Seat 3: fb836f3e (big blind) folded on the Flop
Seat 4: 30398975 folded before Flop (didn't bet)
Seat 5: 32076ba2 folded before Flop (didn't bet)
Seat 6: 1e0fb20e folded before Flop (didn't bet)


Poker Hand #RC1468420657: Hold'em No Limit  ($0.05/$0.1) - 2023/04/12 19:36:58
Table 'RushAndCash5625917' 6-max Seat #1 is the button
Seat 1: 192a3861 ($9.51 in chips)
Seat 2: ef855eb5 ($10.27 in chips)
Seat 3: 27c922fe ($38.79 in chips)
Seat 4: 33a16d50 ($10 in chips)
Seat 5: 52140b86 ($9.7 in chips)
Seat 6: Hero ($4.16 in chips)
ef855eb5: posts small blind $0.05
27c922fe: posts big blind $0.1
*** HOLE CARDS ***
Dealt to 192a3861 
Dealt to ef855eb5 
Dealt to 27c922fe 
Dealt to 33a16d50 
Dealt to 52140b86 
Dealt to Hero [5s 2d]
33a16d50: folds
52140b86: folds
Hero: folds
192a3861: raises $0.1 to $0.2
ef855eb5: folds
27c922fe: folds
Uncalled bet ($0.1) returned to 192a3861
*** SHOWDOWN ***
192a3861 collected $0.25 from pot
*** SUMMARY ***
Total pot $0.25 | Rake $0 | Jackpot $0 | Bingo $0 | Fortune $0
Seat 1: 192a3861 (button) collected ($0.25)
Seat 2: ef855eb5 (small blind) folded before Flop
Seat 3: 27c922fe (big blind) folded before Flop
Seat 4: 33a16d50 folded before Flop (didn't bet)
Seat 5: 52140b86 folded before Flop (didn't bet)
Seat 6: Hero folded before Flop (didn't bet)


Poker Hand #RC1468420601: Hold'em No Limit  ($0.05/$0.1) - 2023/04/12 19:36:50
Table 'RushAndCash5625861' 6-max Seat #1 is the button
Seat 1: dff3ca78 ($11.42 in chips)
Seat 2: 52140b86 ($9.75 in chips)
Seat 3: e72cc09c ($10 in chips)
Seat 4: Hero ($4.16 in chips)
Seat 5: 58cc637 ($15.8 in chips)
Seat 6: f031c1da ($23.49 in chips)
52140b86: posts small blind $0.05
e72cc09c: posts big blind $0.1
*** HOLE CARDS ***
Dealt to dff3ca78 
Dealt to 52140b86 
Dealt to e72cc09c 
Dealt to Hero [7h Td]
Dealt to 58cc637 
Dealt to f031c1da 
Hero: folds
58cc637: folds
f031c1da: raises $0.15 to $0.25
dff3ca78: folds
52140b86: folds
e72cc09c: calls $0.15
*** FLOP *** [6c 8d 4s]
e72cc09c: checks
f031c1da: checks
*** TURN *** [6c 8d 4s] [Jc]
e72cc09c: checks
f031c1da: checks
*** RIVER *** [6c 8d 4s Jc] [4h]
e72cc09c: checks
f031c1da: checks
e72cc09c: shows [Th 3h] (Pair of Fours)
f031c1da: shows [Kh Qs] (Pair of Fours)
*** SHOWDOWN ***
f031c1da collected $0.53 from pot
*** SUMMARY ***
Total pot $0.55 | Rake $0.02 | Jackpot $0 | Bingo $0 | Fortune $0
Board [6c 8d 4s Jc 4h]
Seat 1: dff3ca78 (button) folded before Flop (didn't bet)
Seat 2: 52140b86 (small blind) folded before Flop
Seat 3: e72cc09c (big blind) showed [Th 3h] and lost with Pair of Fours
Seat 4: Hero folded before Flop (didn't bet)
Seat 5: 58cc637 folded before Flop (didn't bet)
Seat 6: f031c1da showed [Kh Qs] and won ($0.53) with Pair of Fours


Poker Hand #RC1468420468: Hold'em No Limit  ($0.05/$0.1) - 2023/04/12 19:36:31
Table 'RushAndCash5625728' 6-max Seat #1 is the button
Seat 1: Hero ($4.16 in chips)
Seat 2: 2aba5c11 ($10.27 in chips)
Seat 3: 41e94b43 ($13.18 in chips)
Seat 4: 854615fb ($15.67 in chips)
Seat 5: c6005af6 ($14.97 in chips)
Seat 6: 25133b10 ($27.51 in chips)
2aba5c11: posts small blind $0.05
41e94b43: posts big blind $0.1
*** HOLE CARDS ***
Dealt to Hero [7c 2h]
Dealt to 2aba5c11 
Dealt to 41e94b43 
Dealt to 854615fb 
Dealt to c6005af6 
Dealt to 25133b10 
854615fb: folds
c6005af6: folds
25133b10: folds
Hero: folds
2aba5c11: folds
Uncalled bet ($0.05) returned to 41e94b43
*** SHOWDOWN ***
41e94b43 collected $0.1 from pot
*** SUMMARY ***
Total pot $0.1 | Rake $0 | Jackpot $0 | Bingo $0 | Fortune $0
Seat 1: Hero (button) folded before Flop (didn't bet)
Seat 2: 2aba5c11 (small blind) folded before Flop
Seat 3: 41e94b43 (big blind) collected ($0.1)
Seat 4: 854615fb folded before Flop (didn't bet)
Seat 5: c6005af6 folded before Flop (didn't bet)
Seat 6: 25133b10 folded before Flop (didn't bet)


Poker Hand #RC1468420327: Hold'em No Limit  ($0.05/$0.1) - 2023/04/12 19:36:12
Table 'RushAndCash5625587' 6-max Seat #1 is the button
Seat 1: 5340d4e6 ($10.15 in chips)
Seat 2: 4da094e9 ($11.58 in chips)
Seat 3: Hero ($4.26 in chips)
Seat 4: fc714f84 ($9.36 in chips)
Seat 5: 23102071 ($20.91 in chips)
Seat 6: cac3f4b ($11.44 in chips)
4da094e9: posts small blind $0.05
Hero: posts big blind $0.1
*** HOLE CARDS ***
Dealt to 5340d4e6 
Dealt to 4da094e9 
Dealt to Hero [Td 5h]
Dealt to fc714f84 
Dealt to 23102071 
Dealt to cac3f4b 
fc714f84: folds
23102071: folds
cac3f4b: folds
5340d4e6: folds
4da094e9: raises $0.13 to $0.23
Hero: folds
Uncalled bet ($0.13) returned to 4da094e9
*** SHOWDOWN ***
4da094e9 collected $0.2 from pot
*** SUMMARY ***
Total pot $0.2 | Rake $0 | Jackpot $0 | Bingo $0 | Fortune $0
Seat 1: 5340d4e6 (button) folded before Flop (didn't bet)
Seat 2: 4da094e9 (small blind) collected ($0.2)
Seat 3: Hero (big blind) folded before Flop
Seat 4: fc714f84 folded before Flop (didn't bet)
Seat 5: 23102071 folded before Flop (didn't bet)
Seat 6: cac3f4b folded before Flop (didn't bet)


Poker Hand #RC1468420238: Hold'em No Limit  ($0.05/$0.1) - 2023/04/12 19:35:58
Table 'RushAndCash5625498' 6-max Seat #1 is the button
Seat 1: 6b999614 ($8.84 in chips)
Seat 2: e7b56c29 ($25.46 in chips)
Seat 3: 98fa32ad ($10.55 in chips)
Seat 4: e3460403 ($10.55 in chips)
Seat 5: 1c014221 ($8.88 in chips)
Seat 6: Hero ($4.11 in chips)
e7b56c29: posts small blind $0.05
98fa32ad: posts big blind $0.1
*** HOLE CARDS ***
Dealt to 6b999614 
Dealt to e7b56c29 
Dealt to 98fa32ad 
Dealt to e3460403 
Dealt to 1c014221 
Dealt to Hero [Ad Jc]
e3460403: folds
1c014221: folds
Hero: raises $0.15 to $0.25
6b999614: folds
e7b56c29: folds
98fa32ad: folds
Uncalled bet ($0.15) returned to Hero
*** SHOWDOWN ***
Hero collected $0.25 from pot
*** SUMMARY ***
Total pot $0.25 | Rake $0 | Jackpot $0 | Bingo $0 | Fortune $0
Seat 1: 6b999614 (button) folded before Flop (didn't bet)
Seat 2: e7b56c29 (small blind) folded before Flop
Seat 3: 98fa32ad (big blind) folded before Flop
Seat 4: e3460403 folded before Flop (didn't bet)
Seat 5: 1c014221 folded before Flop (didn't bet)
Seat 6: Hero collected ($0.25)


Poker Hand #RC1468420159: Hold'em No Limit  ($0.05/$0.1) - 2023/04/12 19:35:45
Table 'RushAndCash5625419' 6-max Seat #1 is the button
Seat 1: cc04985d ($22.48 in chips)
Seat 2: Hero ($4.16 in chips)
Seat 3: 6108a2fc ($13.52 in chips)
Seat 4: 1e0fb20e ($23.29 in chips)
Seat 5: cdb2f412 ($11.16 in chips)
Seat 6: 4bc7e34d ($10 in chips)
Hero: posts small blind $0.05
6108a2fc: posts big blind $0.1
*** HOLE CARDS ***
Dealt to cc04985d 
Dealt to Hero [4h 5s]
Dealt to 6108a2fc 
Dealt to 1e0fb20e 
Dealt to cdb2f412 
Dealt to 4bc7e34d 
1e0fb20e: folds
cdb2f412: raises $0.2 to $0.3
4bc7e34d: folds
cc04985d: folds
Hero: folds
6108a2fc: folds
Uncalled bet ($0.2) returned to cdb2f412
*** SHOWDOWN ***
cdb2f412 collected $0.25 from pot
*** SUMMARY ***
Total pot $0.25 | Rake $0 | Jackpot $0 | Bingo $0 | Fortune $0
Seat 1: cc04985d (button) folded before Flop (didn't bet)
Seat 2: Hero (small blind) folded before Flop
Seat 3: 6108a2fc (big blind) folded before Flop
Seat 4: 1e0fb20e folded before Flop (didn't bet)
Seat 5: cdb2f412 collected ($0.25)
Seat 6: 4bc7e34d folded before Flop (didn't bet)


Poker Hand #RC1468420064: Hold'em No Limit  ($0.05/$0.1) - 2023/04/12 19:35:32
Table 'RushAndCash5625324' 6-max Seat #1 is the button
Seat 1: 76b30415 ($12.25 in chips)
Seat 2: 52140b86 ($8.61 in chips)
Seat 3: Hero ($4.26 in chips)
Seat 4: 103990f1 ($8.73 in chips)
Seat 5: 5ad0a89e ($10 in chips)
Seat 6: e8260b30 ($10 in chips)
52140b86: posts small blind $0.05
Hero: posts big blind $0.1
*** HOLE CARDS ***
Dealt to 76b30415 
Dealt to 52140b86 
Dealt to Hero [5c 3s]
Dealt to 103990f1 
Dealt to 5ad0a89e 
Dealt to e8260b30 
103990f1: folds
5ad0a89e: raises $0.1 to $0.2
e8260b30: folds
76b30415: folds
52140b86: folds
Hero: folds
Uncalled bet ($0.1) returned to 5ad0a89e
*** SHOWDOWN ***
5ad0a89e collected $0.25 from pot
*** SUMMARY ***
Total pot $0.25 | Rake $0 | Jackpot $0 | Bingo $0 | Fortune $0
Seat 1: 76b30415 (button) folded before Flop (didn't bet)
Seat 2: 52140b86 (small blind) folded before Flop
Seat 3: Hero (big blind) folded before Flop
Seat 4: 103990f1 folded before Flop (didn't bet)
Seat 5: 5ad0a89e collected ($0.25)
Seat 6: e8260b30 folded before Flop (didn't bet)


Poker Hand #RC1468420010: Hold'em No Limit  ($0.05/$0.1) - 2023/04/12 19:35:24
Table 'RushAndCash5625270' 6-max Seat #1 is the button
Seat 1: fed049f0 ($14.46 in chips)
Seat 2: 4a5be5a7 ($11.83 in chips)
Seat 3: d58546bd ($10 in chips)
Seat 4: Hero ($4.26 in chips)
Seat 5: 108eb71 ($23.61 in chips)
Seat 6: e0a6bca8 ($11.2 in chips)
4a5be5a7: posts small blind $0.05
d58546bd: posts big blind $0.1
*** HOLE CARDS ***
Dealt to fed049f0 
Dealt to 4a5be5a7 
Dealt to d58546bd 
Dealt to Hero [6h Kh]
Dealt to 108eb71 
Dealt to e0a6bca8 
Hero: folds
108eb71: folds
e0a6bca8: folds
fed049f0: folds
4a5be5a7: folds
Uncalled bet ($0.05) returned to d58546bd
*** SHOWDOWN ***
d58546bd collected $0.1 from pot
*** SUMMARY ***
Total pot $0.1 | Rake $0 | Jackpot $0 | Bingo $0 | Fortune $0
Seat 1: fed049f0 (button) folded before Flop (didn't bet)
Seat 2: 4a5be5a7 (small blind) folded before Flop
Seat 3: d58546bd (big blind) collected ($0.1)
Seat 4: Hero folded before Flop (didn't bet)
Seat 5: 108eb71 folded before Flop (didn't bet)
Seat 6: e0a6bca8 folded before Flop (didn't bet)


Poker Hand #RC1468419964: Hold'em No Limit  ($0.05/$0.1) - 2023/04/12 19:35:18
Table 'RushAndCash5625224' 6-max Seat #1 is the button
Seat 1: 4bc7e34d ($10 in chips)
Seat 2: db00a252 ($7.99 in chips)
Seat 3: 74b2edd8 ($13.76 in chips)
Seat 4: Hero ($4.26 in chips)
Seat 5: d7bba46a ($10.85 in chips)
Seat 6: f8d0f9e ($10.13 in chips)
db00a252: posts small blind $0.05
74b2edd8: posts big blind $0.1
*** HOLE CARDS ***
Dealt to 4bc7e34d 
Dealt to db00a252 
Dealt to 74b2edd8 
Dealt to Hero [Js 5d]
Dealt to d7bba46a 
Dealt to f8d0f9e 
Hero: folds
d7bba46a: folds
f8d0f9e: folds
4bc7e34d: folds
db00a252: raises $0.2 to $0.3
74b2edd8: calls $0.2
*** FLOP *** [9d Jd 6s]
db00a252: checks
74b2edd8: bets $0.3
db00a252: folds
Uncalled bet ($0.3) returned to 74b2edd8
*** SHOWDOWN ***
74b2edd8 collected $0.57 from pot
*** SUMMARY ***
Total pot $0.6 | Rake $0.03 | Jackpot $0 | Bingo $0 | Fortune $0
Board [9d Jd 6s]
Seat 1: 4bc7e34d (button) folded before Flop (didn't bet)
Seat 2: db00a252 (small blind) folded on the Flop
Seat 3: 74b2edd8 (big blind) won ($0.57)
Seat 4: Hero folded before Flop (didn't bet)
Seat 5: d7bba46a folded before Flop (didn't bet)
Seat 6: f8d0f9e folded before Flop (didn't bet)


Poker Hand #RC1468419891: Hold'em No Limit  ($0.05/$0.1) - 2023/04/12 19:35:05
Table 'RushAndCash5625151' 6-max Seat #1 is the button
Seat 1: Hero ($4.26 in chips)
Seat 2: d2066b7d ($15.25 in chips)
Seat 3: 55c94a9b ($1.42 in chips)
Seat 4: 16748df0 ($9.9 in chips)
Seat 5: 9330c0c7 ($35.42 in chips)
Seat 6: e164d69f ($12.56 in chips)
d2066b7d: posts small blind $0.05
55c94a9b: posts big blind $0.1
*** HOLE CARDS ***
Dealt to Hero [7s 6d]
Dealt to d2066b7d 
Dealt to 55c94a9b 
Dealt to 16748df0 
Dealt to 9330c0c7 
Dealt to e164d69f 
16748df0: folds
9330c0c7: folds
e164d69f: folds
Hero: folds
d2066b7d: folds
Uncalled bet ($0.05) returned to 55c94a9b
*** SHOWDOWN ***
55c94a9b collected $0.1 from pot
*** SUMMARY ***
Total pot $0.1 | Rake $0 | Jackpot $0 | Bingo $0 | Fortune $0
Seat 1: Hero (button) folded before Flop (didn't bet)
Seat 2: d2066b7d (small blind) folded before Flop
Seat 3: 55c94a9b (big blind) collected ($0.1)
Seat 4: 16748df0 folded before Flop (didn't bet)
Seat 5: 9330c0c7 folded before Flop (didn't bet)
Seat 6: e164d69f folded before Flop (didn't bet)


Poker Hand #RC1468419832: Hold'em No Limit  ($0.05/$0.1) - 2023/04/12 19:34:56
Table 'RushAndCash5625092' 6-max Seat #1 is the button
Seat 1: ec79d655 ($10 in chips)
Seat 2: ee5b04c9 ($11.24 in chips)
Seat 3: Hero ($4.21 in chips)
Seat 4: 1d817480 ($13.23 in chips)
Seat 5: b4baa577 ($12.46 in chips)
Seat 6: 138e1573 ($12.99 in chips)
ee5b04c9: posts small blind $0.05
Hero: posts big blind $0.1
*** HOLE CARDS ***
Dealt to ec79d655 
Dealt to ee5b04c9 
Dealt to Hero [Kc 6d]
Dealt to 1d817480 
Dealt to b4baa577 
Dealt to 138e1573 
1d817480: folds
b4baa577: folds
138e1573: folds
ec79d655: folds
ee5b04c9: folds
Uncalled bet ($0.05) returned to Hero
*** SHOWDOWN ***
Hero collected $0.1 from pot
*** SUMMARY ***
Total pot $0.1 | Rake $0 | Jackpot $0 | Bingo $0 | Fortune $0
Seat 1: ec79d655 (button) folded before Flop (didn't bet)
Seat 2: ee5b04c9 (small blind) folded before Flop
Seat 3: Hero (big blind) collected ($0.1)
Seat 4: 1d817480 folded before Flop (didn't bet)
Seat 5: b4baa577 folded before Flop (didn't bet)
Seat 6: 138e1573 folded before Flop (didn't bet)


Poker Hand #RC1468419746: Hold'em No Limit  ($0.05/$0.1) - 2023/04/12 19:34:45
Table 'RushAndCash5625006' 6-max Seat #1 is the button
Seat 1: 55c94a9b ($1.42 in chips)
Seat 2: 8aea79f8 ($13.28 in chips)
Seat 3: 79afed12 ($14.54 in chips)
Seat 4: c9cd5132 ($8.79 in chips)
Seat 5: Hero ($4.21 in chips)
Seat 6: bed651ef ($10 in chips)
8aea79f8: posts small blind $0.05
79afed12: posts big blind $0.1
*** HOLE CARDS ***
Dealt to 55c94a9b 
Dealt to 8aea79f8 
Dealt to 79afed12 
Dealt to c9cd5132 
Dealt to Hero [6d 5s]
Dealt to bed651ef 
c9cd5132: folds
Hero: folds
bed651ef: folds
55c94a9b: folds
8aea79f8: folds
Uncalled bet ($0.05) returned to 79afed12
*** SHOWDOWN ***
79afed12 collected $0.1 from pot
*** SUMMARY ***
Total pot $0.1 | Rake $0 | Jackpot $0 | Bingo $0 | Fortune $0
Seat 1: 55c94a9b (button) folded before Flop (didn't bet)
Seat 2: 8aea79f8 (small blind) folded before Flop
Seat 3: 79afed12 (big blind) collected ($0.1)
Seat 4: c9cd5132 folded before Flop (didn't bet)
Seat 5: Hero folded before Flop (didn't bet)
Seat 6: bed651ef folded before Flop (didn't bet)


Poker Hand #RC1468419618: Hold'em No Limit  ($0.05/$0.1) - 2023/04/12 19:34:25
Table 'RushAndCash5624878' 6-max Seat #1 is the button
Seat 1: Hero ($4.06 in chips)
Seat 2: 5f9fbe1b ($1.51 in chips)
Seat 3: 8a37c1cd ($10 in chips)
Seat 4: a1f82121 ($29.83 in chips)
Seat 5: 96c309b0 ($30.22 in chips)
Seat 6: e7cb78b1 ($12.84 in chips)
5f9fbe1b: posts small blind $0.05
8a37c1cd: posts big blind $0.1
*** HOLE CARDS ***
Dealt to Hero [9c Jh]
Dealt to 5f9fbe1b 
Dealt to 8a37c1cd 
Dealt to a1f82121 
Dealt to 96c309b0 
Dealt to e7cb78b1 
a1f82121: folds
96c309b0: folds
e7cb78b1: folds
Hero: raises $0.15 to $0.25
5f9fbe1b: folds
8a37c1cd: folds
Uncalled bet ($0.15) returned to Hero
*** SHOWDOWN ***
Hero collected $0.25 from pot
*** SUMMARY ***
Total pot $0.25 | Rake $0 | Jackpot $0 | Bingo $0 | Fortune $0
Seat 1: Hero (button) collected ($0.25)
Seat 2: 5f9fbe1b (small blind) folded before Flop
Seat 3: 8a37c1cd (big blind) folded before Flop
Seat 4: a1f82121 folded before Flop (didn't bet)
Seat 5: 96c309b0 folded before Flop (didn't bet)
Seat 6: e7cb78b1 folded before Flop (didn't bet)


Poker Hand #RC1468419563: Hold'em No Limit  ($0.05/$0.1) - 2023/04/12 19:34:16
Table 'RushAndCash5624823' 6-max Seat #1 is the button
Seat 1: d4483568 ($10.3 in chips)
Seat 2: Hero ($4.11 in chips)
Seat 3: 2e694c7e ($22.72 in chips)
Seat 4: bb03a8cb ($10.72 in chips)
Seat 5: 721d43f6 ($11.18 in chips)
Seat 6: e7b56c29 ($25.66 in chips)
Hero: posts small blind $0.05
2e694c7e: posts big blind $0.1
*** HOLE CARDS ***
Dealt to d4483568 
Dealt to Hero [4s Ac]
Dealt to 2e694c7e 
Dealt to bb03a8cb 
Dealt to 721d43f6 
Dealt to e7b56c29 
bb03a8cb: raises $0.1 to $0.2
721d43f6: folds
e7b56c29: folds
d4483568: folds
Hero: folds
2e694c7e: folds
Uncalled bet ($0.1) returned to bb03a8cb
*** SHOWDOWN ***
bb03a8cb collected $0.25 from pot
*** SUMMARY ***
Total pot $0.25 | Rake $0 | Jackpot $0 | Bingo $0 | Fortune $0
Seat 1: d4483568 (button) folded before Flop (didn't bet)
Seat 2: Hero (small blind) folded before Flop
Seat 3: 2e694c7e (big blind) folded before Flop
Seat 4: bb03a8cb collected ($0.25)
Seat 5: 721d43f6 folded before Flop (didn't bet)
Seat 6: e7b56c29 folded before Flop (didn't bet)


Poker Hand #RC1468419526: Hold'em No Limit  ($0.05/$0.1) - 2023/04/12 19:34:10
Table 'RushAndCash5624786' 6-max Seat #1 is the button
Seat 1: 51443629 ($10 in chips)
Seat 2: 5e0ca113 ($12.92 in chips)
Seat 3: 94a68cb8 ($6.13 in chips)
Seat 4: Hero ($4.11 in chips)
Seat 5: 6aba0c18 ($29.55 in chips)
Seat 6: 1f58de2 ($49.66 in chips)
5e0ca113: posts small blind $0.05
94a68cb8: posts big blind $0.1
*** HOLE CARDS ***
Dealt to 51443629 
Dealt to 5e0ca113 
Dealt to 94a68cb8 
Dealt to Hero [5s 9c]
Dealt to 6aba0c18 
Dealt to 1f58de2 
Hero: folds
6aba0c18: raises $0.15 to $0.25
1f58de2: calls $0.25
51443629: folds
5e0ca113: folds
94a68cb8: folds
*** FLOP *** [5d Kd Qh]
6aba0c18: bets $0.22
1f58de2: calls $0.22
*** TURN *** [5d Kd Qh] [Ks]
6aba0c18: checks
1f58de2: bets $0.36
6aba0c18: calls $0.36
*** RIVER *** [5d Kd Qh Ks] [2h]
6aba0c18: checks
1f58de2: checks
6aba0c18: shows [Ah Qd] (Pair of Kings and Pair of Queens)
1f58de2: shows [Qc Ts] (Pair of Kings and Pair of Queens)
*** SHOWDOWN ***
6aba0c18 collected $1.72 from pot
*** SUMMARY ***
Total pot $1.81 | Rake $0.09 | Jackpot $0 | Bingo $0 | Fortune $0
Board [5d Kd Qh Ks 2h]
Seat 1: 51443629 (button) folded before Flop (didn't bet)
Seat 2: 5e0ca113 (small blind) folded before Flop
Seat 3: 94a68cb8 (big blind) folded before Flop
Seat 4: Hero folded before Flop (didn't bet)
Seat 5: 6aba0c18 showed [Ah Qd] and won ($1.72) with Pair of Kings and Pair of Queens
Seat 6: 1f58de2 showed [Qc Ts] and lost with Pair of Kings and Pair of Queens


Poker Hand #RC1468419490: Hold'em No Limit  ($0.05/$0.1) - 2023/04/12 19:34:05
Table 'RushAndCash5624750' 6-max Seat #1 is the button
Seat 1: 3a2d2163 ($16.74 in chips)
Seat 2: 7dc5298d ($10 in chips)
Seat 3: cc04985d ($22.53 in chips)
Seat 4: 3a311128 ($10.15 in chips)
Seat 5: Hero ($4.11 in chips)
Seat 6: 1453546e ($10 in chips)
7dc5298d: posts small blind $0.05
cc04985d: posts big blind $0.1
*** HOLE CARDS ***
Dealt to 3a2d2163 
Dealt to 7dc5298d 
Dealt to cc04985d 
Dealt to 3a311128 
Dealt to Hero [9c 7h]
Dealt to 1453546e 
3a311128: folds
Hero: folds
1453546e: folds
3a2d2163: folds
7dc5298d: raises $0.1 to $0.2
cc04985d: calls $0.1
*** FLOP *** [7c 8d Ac]
7dc5298d: bets $0.14
cc04985d: folds
Uncalled bet ($0.14) returned to 7dc5298d
*** SHOWDOWN ***
7dc5298d collected $0.38 from pot
*** SUMMARY ***
Total pot $0.4 | Rake $0.02 | Jackpot $0 | Bingo $0 | Fortune $0
Board [7c 8d Ac]
Seat 1: 3a2d2163 (button) folded before Flop (didn't bet)
Seat 2: 7dc5298d (small blind) won ($0.38)
Seat 3: cc04985d (big blind) folded on the Flop
Seat 4: 3a311128 folded before Flop (didn't bet)
Seat 5: Hero folded before Flop (didn't bet)
Seat 6: 1453546e folded before Flop (didn't bet)


Poker Hand #RC1468419419: Hold'em No Limit  ($0.05/$0.1) - 2023/04/12 19:33:55
Table 'RushAndCash5624679' 6-max Seat #1 is the button
Seat 1: a6775617 ($10.33 in chips)
Seat 2: 1b6c8638 ($12.7 in chips)
Seat 3: 82281e3b ($9.45 in chips)
Seat 4: 1e2390bd ($10.79 in chips)
Seat 5: Hero ($4.11 in chips)
Seat 6: 4a2ca0cb ($13.35 in chips)
1b6c8638: posts small blind $0.05
82281e3b: posts big blind $0.1
*** HOLE CARDS ***
Dealt to a6775617 
Dealt to 1b6c8638 
Dealt to 82281e3b 
Dealt to 1e2390bd 
Dealt to Hero [Kd 7c]
Dealt to 4a2ca0cb 
1e2390bd: folds
Hero: folds
4a2ca0cb: folds
a6775617: folds
1b6c8638: folds
Uncalled bet ($0.05) returned to 82281e3b
*** SHOWDOWN ***
82281e3b collected $0.1 from pot
*** SUMMARY ***
Total pot $0.1 | Rake $0 | Jackpot $0 | Bingo $0 | Fortune $0
Seat 1: a6775617 (button) folded before Flop (didn't bet)
Seat 2: 1b6c8638 (small blind) folded before Flop
Seat 3: 82281e3b (big blind) collected ($0.1)
Seat 4: 1e2390bd folded before Flop (didn't bet)
Seat 5: Hero folded before Flop (didn't bet)
Seat 6: 4a2ca0cb folded before Flop (didn't bet)


Poker Hand #RC1468419353: Hold'em No Limit  ($0.05/$0.1) - 2023/04/12 19:33:46
Table 'RushAndCash5624613' 6-max Seat #1 is the button
Seat 1: 59724ca3 ($4.42 in chips)
Seat 2: 107f293 ($13.94 in chips)
Seat 3: e6b0c676 ($12.55 in chips)
Seat 4: 2718c03d ($25.43 in chips)
Seat 5: 97463413 ($9.36 in chips)
Seat 6: Hero ($4.11 in chips)
107f293: posts small blind $0.05
e6b0c676: posts big blind $0.1
*** HOLE CARDS ***
Dealt to 59724ca3 
Dealt to 107f293 
Dealt to e6b0c676 
Dealt to 2718c03d 
Dealt to 97463413 
Dealt to Hero [8c Jd]
2718c03d: folds
97463413: raises $0.1 to $0.2
Hero: folds
59724ca3: folds
107f293: folds
e6b0c676: folds
Uncalled bet ($0.1) returned to 97463413
*** SHOWDOWN ***
97463413 collected $0.25 from pot
*** SUMMARY ***
Total pot $0.25 | Rake $0 | Jackpot $0 | Bingo $0 | Fortune $0
Seat 1: 59724ca3 (button) folded before Flop (didn't bet)
Seat 2: 107f293 (small blind) folded before Flop
Seat 3: e6b0c676 (big blind) folded before Flop
Seat 4: 2718c03d folded before Flop (didn't bet)
Seat 5: 97463413 collected ($0.25)
Seat 6: Hero folded before Flop (didn't bet)


Poker Hand #RC1468419302: Hold'em No Limit  ($0.05/$0.1) - 2023/04/12 19:33:39
Table 'RushAndCash5624562' 6-max Seat #1 is the button
Seat 1: bfbec681 ($17.97 in chips)
Seat 2: c9c743d2 ($22.62 in chips)
Seat 3: 7948553f ($11.84 in chips)
Seat 4: Hero ($4.11 in chips)
Seat 5: 94c2e07d ($16.55 in chips)
Seat 6: 891c6fd ($26.96 in chips)
c9c743d2: posts small blind $0.05
7948553f: posts big blind $0.1
*** HOLE CARDS ***
Dealt to bfbec681 
Dealt to c9c743d2 
Dealt to 7948553f 
Dealt to Hero [2c Tc]
Dealt to 94c2e07d 
Dealt to 891c6fd 
Hero: folds
94c2e07d: folds
891c6fd: folds
bfbec681: raises $0.12 to $0.22
c9c743d2: folds
7948553f: calls $0.12
*** FLOP *** [4h Ah 7s]
7948553f: checks
bfbec681: checks
*** TURN *** [4h Ah 7s] [3c]
7948553f: checks
bfbec681: checks
*** RIVER *** [4h Ah 7s 3c] [Kh]
7948553f: checks
bfbec681: bets $0.4
7948553f: folds
Uncalled bet ($0.4) returned to bfbec681
7948553f: shows [Kd] (Pair of Kings)
*** SHOWDOWN ***
bfbec681 collected $0.47 from pot
*** SUMMARY ***
Total pot $0.49 | Rake $0.02 | Jackpot $0 | Bingo $0 | Fortune $0
Board [4h Ah 7s 3c Kh]
Seat 1: bfbec681 (button) won ($0.47)
Seat 2: c9c743d2 (small blind) folded before Flop
Seat 3: 7948553f (big blind) folded on the River
Seat 4: Hero folded before Flop (didn't bet)
Seat 5: 94c2e07d folded before Flop (didn't bet)
Seat 6: 891c6fd folded before Flop (didn't bet)


Poker Hand #RC1468419235: Hold'em No Limit  ($0.05/$0.1) - 2023/04/12 19:33:30
Table 'RushAndCash5624495' 6-max Seat #1 is the button
Seat 1: 7a5365f2 ($15.47 in chips)
Seat 2: Hero ($4.16 in chips)
Seat 3: 3b65ce48 ($27.02 in chips)
Seat 4: 94413495 ($10 in chips)
Seat 5: 89dd6b86 ($16.31 in chips)
Seat 6: a8fd0a2 ($31.37 in chips)
Hero: posts small blind $0.05
3b65ce48: posts big blind $0.1
*** HOLE CARDS ***
Dealt to 7a5365f2 
Dealt to Hero [Td 6c]
Dealt to 3b65ce48 
Dealt to 94413495 
Dealt to 89dd6b86 
Dealt to a8fd0a2 
94413495: raises $0.15 to $0.25
89dd6b86: folds
a8fd0a2: folds
7a5365f2: folds
Hero: folds
3b65ce48: folds
Uncalled bet ($0.15) returned to 94413495
*** SHOWDOWN ***
94413495 collected $0.25 from pot
*** SUMMARY ***
Total pot $0.25 | Rake $0 | Jackpot $0 | Bingo $0 | Fortune $0
Seat 1: 7a5365f2 (button) folded before Flop (didn't bet)
Seat 2: Hero (small blind) folded before Flop
Seat 3: 3b65ce48 (big blind) folded before Flop
Seat 4: 94413495 collected ($0.25)
Seat 5: 89dd6b86 folded before Flop (didn't bet)
Seat 6: a8fd0a2 folded before Flop (didn't bet)


Poker Hand #RC1468419151: Hold'em No Limit  ($0.05/$0.1) - 2023/04/12 19:33:18
Table 'RushAndCash5624411' 6-max Seat #1 is the button
Seat 1: 1512eab1 ($8.02 in chips)
Seat 2: Hero ($4.06 in chips)
Seat 3: bd4eb5ca ($11.31 in chips)
Seat 4: 3a311128 ($10.15 in chips)
Seat 5: e4f65a9 ($8.54 in chips)
Seat 6: c6005af6 ($13.76 in chips)
Hero: posts small blind $0.05
bd4eb5ca: posts big blind $0.1
*** HOLE CARDS ***
Dealt to 1512eab1 
Dealt to Hero [5s As]
Dealt to bd4eb5ca 
Dealt to 3a311128 
Dealt to e4f65a9 
Dealt to c6005af6 
3a311128: folds
e4f65a9: folds
c6005af6: folds
1512eab1: folds
Hero: raises $0.2 to $0.3
bd4eb5ca: folds
Uncalled bet ($0.2) returned to Hero
*** SHOWDOWN ***
Hero collected $0.2 from pot
*** SUMMARY ***
Total pot $0.2 | Rake $0 | Jackpot $0 | Bingo $0 | Fortune $0
Seat 1: 1512eab1 (button) folded before Flop (didn't bet)
Seat 2: Hero (small blind) collected ($0.2)
Seat 3: bd4eb5ca (big blind) folded before Flop
Seat 4: 3a311128 folded before Flop (didn't bet)
Seat 5: e4f65a9 folded before Flop (didn't bet)
Seat 6: c6005af6 folded before Flop (didn't bet)


Poker Hand #RC1468418824: Hold'em No Limit  ($0.05/$0.1) - 2023/04/12 19:32:28
Table 'RushAndCash5624084' 6-max Seat #1 is the button
Seat 1: Hero ($2.97 in chips)
Seat 2: 1512eab1 ($8.07 in chips)
Seat 3: 22ce7a0d ($4 in chips)
Seat 4: f43f6980 ($11.54 in chips)
Seat 5: ac0792c4 ($10.92 in chips)
Seat 6: 1c014221 ($9.95 in chips)
Cash Drop to Pot : total $1 
1512eab1: posts small blind $0.05
22ce7a0d: posts big blind $0.1
*** HOLE CARDS ***
Dealt to Hero [Tc 7h]
Dealt to 1512eab1 
Dealt to 22ce7a0d 
Dealt to f43f6980 
Dealt to ac0792c4 
Dealt to 1c014221 
f43f6980: folds
ac0792c4: folds
1c014221: folds
Hero: raises $0.7 to $0.8
1512eab1: folds
22ce7a0d: folds
Uncalled bet ($0.7) returned to Hero
*** SHOWDOWN ***
Hero collected $1.19 from pot
*** SUMMARY ***
Total pot $1.25 | Rake $0.06 | Jackpot $0 | Bingo $0 | Fortune $0
Seat 1: Hero (button) collected ($1.19)
Seat 2: 1512eab1 (small blind) folded before Flop
Seat 3: 22ce7a0d (big blind) folded before Flop
Seat 4: f43f6980 folded before Flop (didn't bet)
Seat 5: ac0792c4 folded before Flop (didn't bet)
Seat 6: 1c014221 folded before Flop (didn't bet)


Poker Hand #RC1468418405: Hold'em No Limit  ($0.05/$0.1) - 2023/04/12 19:31:25
Table 'RushAndCash5623665' 6-max Seat #1 is the button
Seat 1: 70a075c9 ($20.85 in chips)
Seat 2: ec79d655 ($10.43 in chips)
Seat 3: 1512eab1 ($7.21 in chips)
Seat 4: 3a311128 ($10.03 in chips)
Seat 5: c80f3b05 ($11.14 in chips)
Seat 6: Hero ($3.87 in chips)
ec79d655: posts small blind $0.05
1512eab1: posts big blind $0.1
*** HOLE CARDS ***
Dealt to 70a075c9 
Dealt to ec79d655 
Dealt to 1512eab1 
Dealt to 3a311128 
Dealt to c80f3b05 
Dealt to Hero [Js Tc]
3a311128: folds
c80f3b05: folds
Hero: raises $0.15 to $0.25
70a075c9: folds
ec79d655: folds
1512eab1: calls $0.15
*** FLOP *** [Jc 4h 5c]
1512eab1: checks
Hero: bets $0.28
1512eab1: calls $0.28
*** TURN *** [Jc 4h 5c] [9c]
1512eab1: checks
Hero: checks
*** RIVER *** [Jc 4h 5c 9c] [Qc]
1512eab1: bets $0.37
Hero: calls $0.37
1512eab1: shows [Kc Th] (King High Flush)
Hero: shows [Js Tc] (Queen High Flush)
*** SHOWDOWN ***
1512eab1 collected $1.76 from pot
*** SUMMARY ***
Total pot $1.85 | Rake $0.09 | Jackpot $0 | Bingo $0 | Fortune $0
Board [Jc 4h 5c 9c Qc]
Seat 1: 70a075c9 (button) folded before Flop (didn't bet)
Seat 2: ec79d655 (small blind) folded before Flop
Seat 3: 1512eab1 (big blind) showed [Kc Th] and won ($1.76) with King High Flush
Seat 4: 3a311128 folded before Flop (didn't bet)
Seat 5: c80f3b05 folded before Flop (didn't bet)
Seat 6: Hero showed [Js Tc] and lost with Queen High Flush


Poker Hand #RC1468418349: Hold'em No Limit  ($0.05/$0.1) - 2023/04/12 19:31:17
Table 'RushAndCash5623609' 6-max Seat #1 is the button
Seat 1: a9de3116 ($12.87 in chips)
Seat 2: 32630767 ($10.05 in chips)
Seat 3: Hero ($3.97 in chips)
Seat 4: f95a35c4 ($10 in chips)
Seat 5: 175454e8 ($9 in chips)
Seat 6: 9f97f6b4 ($11.11 in chips)
32630767: posts small blind $0.05
Hero: posts big blind $0.1
*** HOLE CARDS ***
Dealt to a9de3116 
Dealt to 32630767 
Dealt to Hero [5c Qs]
Dealt to f95a35c4 
Dealt to 175454e8 
Dealt to 9f97f6b4 
f95a35c4: folds
175454e8: folds
9f97f6b4: folds
a9de3116: raises $0.1 to $0.2
32630767: folds
Hero: folds
Uncalled bet ($0.1) returned to a9de3116
*** SHOWDOWN ***
a9de3116 collected $0.25 from pot
*** SUMMARY ***
Total pot $0.25 | Rake $0 | Jackpot $0 | Bingo $0 | Fortune $0
Seat 1: a9de3116 (button) collected ($0.25)
Seat 2: 32630767 (small blind) folded before Flop
Seat 3: Hero (big blind) folded before Flop
Seat 4: f95a35c4 folded before Flop (didn't bet)
Seat 5: 175454e8 folded before Flop (didn't bet)
Seat 6: 9f97f6b4 folded before Flop (didn't bet)


Poker Hand #RC1468418225: Hold'em No Limit  ($0.05/$0.1) - 2023/04/12 19:30:57
Table 'RushAndCash5623485' 6-max Seat #1 is the button
Seat 1: 50ce1268 ($10.28 in chips)
Seat 2: e4c97335 ($30.38 in chips)
Seat 3: Hero ($4.07 in chips)
Seat 4: 295ae4ba ($10.97 in chips)
Seat 5: ba4d0ff6 ($16.38 in chips)
Seat 6: 6882a6d9 ($10.22 in chips)
e4c97335: posts small blind $0.05
Hero: posts big blind $0.1
*** HOLE CARDS ***
Dealt to 50ce1268 
Dealt to e4c97335 
Dealt to Hero [5c 4s]
Dealt to 295ae4ba 
Dealt to ba4d0ff6 
Dealt to 6882a6d9 
295ae4ba: folds
ba4d0ff6: raises $0.15 to $0.25
6882a6d9: folds
50ce1268: raises $0.55 to $0.8
e4c97335: folds
Hero: folds
ba4d0ff6: calls $0.55
*** FLOP *** [Ks Th 7c]
ba4d0ff6: checks
50ce1268: bets $0.58
ba4d0ff6: calls $0.58
*** TURN *** [Ks Th 7c] [Ah]
ba4d0ff6: checks
50ce1268: bets $1.46
ba4d0ff6: folds
Uncalled bet ($1.46) returned to 50ce1268
*** SHOWDOWN ***
50ce1268 collected $2.77 from pot
*** SUMMARY ***
Total pot $2.91 | Rake $0.14 | Jackpot $0 | Bingo $0 | Fortune $0
Board [Ks Th 7c Ah]
Seat 1: 50ce1268 (button) won ($2.77)
Seat 2: e4c97335 (small blind) folded before Flop
Seat 3: Hero (big blind) folded before Flop
Seat 4: 295ae4ba folded before Flop (didn't bet)
Seat 5: ba4d0ff6 folded on the Turn
Seat 6: 6882a6d9 folded before Flop (didn't bet)


Poker Hand #RC1468418189: Hold'em No Limit  ($0.05/$0.1) - 2023/04/12 19:30:53
Table 'RushAndCash5623449' 6-max Seat #1 is the button
Seat 1: 596e7ce8 ($18.48 in chips)
Seat 2: 648925e5 ($17.86 in chips)
Seat 3: f9bd8de9 ($19.8 in chips)
Seat 4: Hero ($4.07 in chips)
Seat 5: e44facdf ($8.46 in chips)
Seat 6: 7e549c5c ($15.02 in chips)
648925e5: posts small blind $0.05
f9bd8de9: posts big blind $0.1
*** HOLE CARDS ***
Dealt to 596e7ce8 
Dealt to 648925e5 
Dealt to f9bd8de9 
Dealt to Hero [5h Ac]
Dealt to e44facdf 
Dealt to 7e549c5c 
Hero: folds
e44facdf: folds
7e549c5c: folds
596e7ce8: folds
648925e5: folds
Uncalled bet ($0.05) returned to f9bd8de9
*** SHOWDOWN ***
f9bd8de9 collected $0.1 from pot
*** SUMMARY ***
Total pot $0.1 | Rake $0 | Jackpot $0 | Bingo $0 | Fortune $0
Seat 1: 596e7ce8 (button) folded before Flop (didn't bet)
Seat 2: 648925e5 (small blind) folded before Flop
Seat 3: f9bd8de9 (big blind) collected ($0.1)
Seat 4: Hero folded before Flop (didn't bet)
Seat 5: e44facdf folded before Flop (didn't bet)
Seat 6: 7e549c5c folded before Flop (didn't bet)


Poker Hand #RC1468418142: Hold'em No Limit  ($0.05/$0.1) - 2023/04/12 19:30:46
Table 'RushAndCash5623402' 6-max Seat #1 is the button
Seat 1: Hero ($4.07 in chips)
Seat 2: a7d150e5 ($18.8 in chips)
Seat 3: 69ea70e ($10.85 in chips)
Seat 4: 3d5cd531 ($10.52 in chips)
Seat 5: 98e602e6 ($37.18 in chips)
Seat 6: dc715600 ($22.53 in chips)
a7d150e5: posts small blind $0.05
69ea70e: posts big blind $0.1
*** HOLE CARDS ***
Dealt to Hero [6d Ks]
Dealt to a7d150e5 
Dealt to 69ea70e 
Dealt to 3d5cd531 
Dealt to 98e602e6 
Dealt to dc715600 
3d5cd531: raises $0.12 to $0.22
98e602e6: folds
dc715600: calls $0.22
Hero: folds
a7d150e5: raises $0.57 to $0.79
69ea70e: folds
3d5cd531: folds
dc715600: calls $0.57
*** FLOP *** [8h Jh 8c]
a7d150e5: bets $0.95
dc715600: folds
Uncalled bet ($0.95) returned to a7d150e5
*** SHOWDOWN ***
a7d150e5 collected $1.81 from pot
*** SUMMARY ***
Total pot $1.9 | Rake $0.09 | Jackpot $0 | Bingo $0 | Fortune $0
Board [8h Jh 8c]
Seat 1: Hero (button) folded before Flop (didn't bet)
Seat 2: a7d150e5 (small blind) won ($1.81)
Seat 3: 69ea70e (big blind) folded before Flop
Seat 4: 3d5cd531 folded before Flop
Seat 5: 98e602e6 folded before Flop (didn't bet)
Seat 6: dc715600 folded on the Flop


Poker Hand #RC1468417901: Hold'em No Limit  ($0.05/$0.1) - 2023/04/12 19:30:09
Table 'RushAndCash5623161' 6-max Seat #1 is the button
Seat 1: 17b3ecc5 ($11.04 in chips)
Seat 2: 38e75230 ($9.34 in chips)
Seat 3: dc715600 ($22.68 in chips)
Seat 4: Hero ($4.32 in chips)
Seat 5: 3d5cd531 ($10.15 in chips)
Seat 6: ca49855c ($11.13 in chips)
38e75230: posts small blind $0.05
dc715600: posts big blind $0.1
*** HOLE CARDS ***
Dealt to 17b3ecc5 
Dealt to 38e75230 
Dealt to dc715600 
Dealt to Hero [Kd Td]
Dealt to 3d5cd531 
Dealt to ca49855c 
Hero: raises $0.15 to $0.25
3d5cd531: calls $0.25
ca49855c: folds
17b3ecc5: folds
38e75230: folds
dc715600: folds
*** FLOP *** [Jc 8h 5h]
Hero: checks
3d5cd531: bets $0.25
Hero: folds
Uncalled bet ($0.25) returned to 3d5cd531
*** SHOWDOWN ***
3d5cd531 collected $0.62 from pot
*** SUMMARY ***
Total pot $0.65 | Rake $0.03 | Jackpot $0 | Bingo $0 | Fortune $0
Board [Jc 8h 5h]
Seat 1: 17b3ecc5 (button) folded before Flop (didn't bet)
Seat 2: 38e75230 (small blind) folded before Flop
Seat 3: dc715600 (big blind) folded before Flop
Seat 4: Hero folded on the Flop
Seat 5: 3d5cd531 won ($0.62)
Seat 6: ca49855c folded before Flop (didn't bet)


Poker Hand #RC1468417840: Hold'em No Limit  ($0.05/$0.1) - 2023/04/12 19:30:00
Table 'RushAndCash5623100' 6-max Seat #1 is the button
Seat 1: eb14124c ($6.1 in chips)
Seat 2: a282762b ($10.85 in chips)
Seat 3: 67d9184a ($10.77 in chips)
Seat 4: Hero ($4.32 in chips)
Seat 5: 8de3d124 ($12.23 in chips)
Seat 6: b641fe9 ($15.05 in chips)
a282762b: posts small blind $0.05
67d9184a: posts big blind $0.1
*** HOLE CARDS ***
Dealt to eb14124c 
Dealt to a282762b 
Dealt to 67d9184a 
Dealt to Hero [7h Qh]
Dealt to 8de3d124 
Dealt to b641fe9 
Hero: folds
8de3d124: folds
b641fe9: folds
eb14124c: raises $0.12 to $0.22
a282762b: folds
67d9184a: folds
Uncalled bet ($0.12) returned to eb14124c
*** SHOWDOWN ***
eb14124c collected $0.25 from pot
*** SUMMARY ***
Total pot $0.25 | Rake $0 | Jackpot $0 | Bingo $0 | Fortune $0
Seat 1: eb14124c (button) collected ($0.25)
Seat 2: a282762b (small blind) folded before Flop
Seat 3: 67d9184a (big blind) folded before Flop
Seat 4: Hero folded before Flop (didn't bet)
Seat 5: 8de3d124 folded before Flop (didn't bet)
Seat 6: b641fe9 folded before Flop (didn't bet)


Poker Hand #RC1468417731: Hold'em No Limit  ($0.05/$0.1) - 2023/04/12 19:29:45
Table 'RushAndCash5622991' 6-max Seat #1 is the button
Seat 1: f1b8a68f ($13.43 in chips)
Seat 2: ea8dd84 ($13.55 in chips)
Seat 3: Hero ($4.42 in chips)
Seat 4: e4f65a9 ($4.25 in chips)
Seat 5: 23102071 ($16.56 in chips)
Seat 6: 82281e3b ($9.85 in chips)
ea8dd84: posts small blind $0.05
Hero: posts big blind $0.1
*** HOLE CARDS ***
Dealt to f1b8a68f 
Dealt to ea8dd84 
Dealt to Hero [6d 4s]
Dealt to e4f65a9 
Dealt to 23102071 
Dealt to 82281e3b 
e4f65a9: raises $0.1 to $0.2
23102071: folds
82281e3b: raises $0.5 to $0.7
f1b8a68f: folds
ea8dd84: folds
Hero: folds
e4f65a9: raises $3.55 to $4.25 and is all-in
82281e3b: calls $3.55
e4f65a9: shows [Ac Qh]
82281e3b: shows [Kh Ah]
*** FLOP *** [Jc 5d 9d]
*** TURN *** [Jc 5d 9d] [7c]
*** RIVER *** [Jc 5d 9d 7c] [Qs]
*** SHOWDOWN ***
e4f65a9 collected $8.2 from pot
*** SUMMARY ***
Total pot $8.65 | Rake $0.3 | Jackpot $0.15 | Bingo $0 | Fortune $0
Board [Jc 5d 9d 7c Qs]
Seat 1: f1b8a68f (button) folded before Flop (didn't bet)
Seat 2: ea8dd84 (small blind) folded before Flop
Seat 3: Hero (big blind) folded before Flop
Seat 4: e4f65a9 showed [Ac Qh] and won ($8.2) with Pair of Queens
Seat 5: 23102071 folded before Flop (didn't bet)
Seat 6: 82281e3b showed [Kh Ah] and lost with Ace-High


Poker Hand #RC1468417553: Hold'em No Limit  ($0.05/$0.1) - 2023/04/12 19:29:20
Table 'RushAndCash5622813' 6-max Seat #1 is the button
Seat 1: 112642f3 ($29.68 in chips)
Seat 2: Hero ($4.32 in chips)
Seat 3: 51443629 ($10.24 in chips)
Seat 4: 50b345e4 ($13.97 in chips)
Seat 5: 85b7299e ($31.23 in chips)
Seat 6: 1c97f776 ($9.85 in chips)
Hero: posts small blind $0.05
51443629: posts big blind $0.1
*** HOLE CARDS ***
Dealt to 112642f3 
Dealt to Hero [Ts Kc]
Dealt to 51443629 
Dealt to 50b345e4 
Dealt to 85b7299e 
Dealt to 1c97f776 
50b345e4: folds
85b7299e: folds
1c97f776: folds
112642f3: folds
Hero: raises $0.2 to $0.3
51443629: folds
Uncalled bet ($0.2) returned to Hero
*** SHOWDOWN ***
Hero collected $0.2 from pot
*** SUMMARY ***
Total pot $0.2 | Rake $0 | Jackpot $0 | Bingo $0 | Fortune $0
Seat 1: 112642f3 (button) folded before Flop (didn't bet)
Seat 2: Hero (small blind) collected ($0.2)
Seat 3: 51443629 (big blind) folded before Flop
Seat 4: 50b345e4 folded before Flop (didn't bet)
Seat 5: 85b7299e folded before Flop (didn't bet)
Seat 6: 1c97f776 folded before Flop (didn't bet)


Poker Hand #RC1468417520: Hold'em No Limit  ($0.05/$0.1) - 2023/04/12 19:29:13
Table 'RushAndCash5622780' 6-max Seat #1 is the button
Seat 1: 8d22595a ($17.46 in chips)
Seat 2: 859ea6cc ($10.83 in chips)
Seat 3: 138e1573 ($9.76 in chips)
Seat 4: 58cc637 ($16.1 in chips)
Seat 5: 6e555479 ($12.17 in chips)
Seat 6: Hero ($4.32 in chips)
859ea6cc: posts small blind $0.05
138e1573: posts big blind $0.1
*** HOLE CARDS ***
Dealt to 8d22595a 
Dealt to 859ea6cc 
Dealt to 138e1573 
Dealt to 58cc637 
Dealt to 6e555479 
Dealt to Hero [5c 8h]
58cc637: folds
6e555479: folds
Hero: folds
8d22595a: raises $0.15 to $0.25
859ea6cc: folds
138e1573: folds
Uncalled bet ($0.15) returned to 8d22595a
*** SHOWDOWN ***
8d22595a collected $0.25 from pot
*** SUMMARY ***
Total pot $0.25 | Rake $0 | Jackpot $0 | Bingo $0 | Fortune $0
Seat 1: 8d22595a (button) collected ($0.25)
Seat 2: 859ea6cc (small blind) folded before Flop
Seat 3: 138e1573 (big blind) folded before Flop
Seat 4: 58cc637 folded before Flop (didn't bet)
Seat 5: 6e555479 folded before Flop (didn't bet)
Seat 6: Hero folded before Flop (didn't bet)


Poker Hand #RC1468417412: Hold'em No Limit  ($0.05/$0.1) - 2023/04/12 19:28:57
Table 'RushAndCash5622672' 6-max Seat #1 is the button
Seat 1: 25fdd2c9 ($10.15 in chips)
Seat 2: ac63fe01 ($18.51 in chips)
Seat 3: c963f53 ($25.82 in chips)
Seat 4: 542d10ff ($10 in chips)
Seat 5: Hero ($4.32 in chips)
Seat 6: 52c0e247 ($10.42 in chips)
ac63fe01: posts small blind $0.05
c963f53: posts big blind $0.1
*** HOLE CARDS ***
Dealt to 25fdd2c9 
Dealt to ac63fe01 
Dealt to c963f53 
Dealt to 542d10ff 
Dealt to Hero [5s 9c]
Dealt to 52c0e247 
542d10ff: folds
Hero: folds
52c0e247: folds
25fdd2c9: folds
ac63fe01: folds
Uncalled bet ($0.05) returned to c963f53
*** SHOWDOWN ***
c963f53 collected $0.1 from pot
*** SUMMARY ***
Total pot $0.1 | Rake $0 | Jackpot $0 | Bingo $0 | Fortune $0
Seat 1: 25fdd2c9 (button) folded before Flop (didn't bet)
Seat 2: ac63fe01 (small blind) folded before Flop
Seat 3: c963f53 (big blind) collected ($0.1)
Seat 4: 542d10ff folded before Flop (didn't bet)
Seat 5: Hero folded before Flop (didn't bet)
Seat 6: 52c0e247 folded before Flop (didn't bet)


Poker Hand #RC1468417384: Hold'em No Limit  ($0.05/$0.1) - 2023/04/12 19:28:52
Table 'RushAndCash5622644' 6-max Seat #1 is the button
Seat 1: 50865c1e ($6.52 in chips)
Seat 2: 49600bcc ($58.77 in chips)
Seat 3: 8c845fa8 ($15.74 in chips)
Seat 4: 5fa5be03 ($20.25 in chips)
Seat 5: Hero ($4.32 in chips)
Seat 6: 12989685 ($10.43 in chips)
49600bcc: posts small blind $0.05
8c845fa8: posts big blind $0.1
*** HOLE CARDS ***
Dealt to 50865c1e 
Dealt to 49600bcc 
Dealt to 8c845fa8 
Dealt to 5fa5be03 
Dealt to Hero [4d 7s]
Dealt to 12989685 
5fa5be03: folds
Hero: folds
12989685: raises $0.1 to $0.2
50865c1e: raises $0.42 to $0.62
49600bcc: folds
8c845fa8: folds
12989685: calls $0.42
*** FLOP *** [Qs 7c Ad]
12989685: checks
50865c1e: bets $0.7
12989685: raises $9.11 to $9.81 and is all-in
50865c1e: calls $5.2 and is all-in
Uncalled bet ($3.91) returned to 12989685
12989685: shows [Ah Kh] (Pair of Aces)
50865c1e: shows [As Qh] (Pair of Aces and Pair of Queens)
50865c1e: Chooses to EV Cashout 
*** TURN *** [Qs 7c Ad] [5h]
*** RIVER *** [Qs 7c Ad 5h] [2s]
50865c1e: Pays Cashout Risk ($1.94)
*** SHOWDOWN ***
50865c1e collected $12.74 from pot
*** SUMMARY ***
Total pot $13.19 | Rake $0.3 | Jackpot $0.15 | Bingo $0 | Fortune $0
Board [Qs 7c Ad 5h 2s]
Seat 1: 50865c1e (button) showed [As Qh] and won ($12.74) with Pair of Aces and Pair of Queens, Cashout Risk ($1.94)
Seat 2: 49600bcc (small blind) folded before Flop
Seat 3: 8c845fa8 (big blind) folded before Flop
Seat 4: 5fa5be03 folded before Flop (didn't bet)
Seat 5: Hero folded before Flop (didn't bet)
Seat 6: 12989685 showed [Ah Kh] and lost with Pair of Aces


Poker Hand #RC1468417334: Hold'em No Limit  ($0.05/$0.1) - 2023/04/12 19:28:45
Table 'RushAndCash5622594' 6-max Seat #1 is the button
Seat 1: 5aeaa886 ($21.7 in chips)
Seat 2: 95e8a748 ($11.3 in chips)
Seat 3: b865cf8a ($10.18 in chips)
Seat 4: 757087ef ($10.81 in chips)
Seat 5: Hero ($4.32 in chips)
Seat 6: ce2392b ($46.08 in chips)
95e8a748: posts small blind $0.05
b865cf8a: posts big blind $0.1
*** HOLE CARDS ***
Dealt to 5aeaa886 
Dealt to 95e8a748 
Dealt to b865cf8a 
Dealt to 757087ef 
Dealt to Hero [4h 2s]
Dealt to ce2392b 
757087ef: folds
Hero: folds
ce2392b: raises $0.11 to $0.21
5aeaa886: folds
95e8a748: folds
b865cf8a: calls $0.11
*** FLOP *** [8d 9h 6s]
b865cf8a: checks
ce2392b: checks
*** TURN *** [8d 9h 6s] [Kd]
b865cf8a: checks
ce2392b: checks
*** RIVER *** [8d 9h 6s Kd] [5c]
b865cf8a: checks
ce2392b: checks
b865cf8a: shows [4s Qs] (King-High)
ce2392b: shows [Jd As] (Ace-High)
*** SHOWDOWN ***
ce2392b collected $0.45 from pot
*** SUMMARY ***
Total pot $0.47 | Rake $0.02 | Jackpot $0 | Bingo $0 | Fortune $0
Board [8d 9h 6s Kd 5c]
Seat 1: 5aeaa886 (button) folded before Flop (didn't bet)
Seat 2: 95e8a748 (small blind) folded before Flop
Seat 3: b865cf8a (big blind) showed [4s Qs] and lost with King-High
Seat 4: 757087ef folded before Flop (didn't bet)
Seat 5: Hero folded before Flop (didn't bet)
Seat 6: ce2392b showed [Jd As] and won ($0.45) with Ace-High


Poker Hand #RC1468416955: Hold'em No Limit  ($0.05/$0.1) - 2023/04/12 19:27:49
Table 'RushAndCash5622215' 6-max Seat #1 is the button
Seat 1: 21ea41da ($54.84 in chips)
Seat 2: 5aeaa886 ($22.15 in chips)
Seat 3: 2447e470 ($10 in chips)
Seat 4: 3bf969ff ($11.62 in chips)
Seat 5: Hero ($3.82 in chips)
Seat 6: f3cd493a ($12.77 in chips)
5aeaa886: posts small blind $0.05
2447e470: posts big blind $0.1
*** HOLE CARDS ***
Dealt to 21ea41da 
Dealt to 5aeaa886 
Dealt to 2447e470 
Dealt to 3bf969ff 
Dealt to Hero [Qs Jh]
Dealt to f3cd493a 
3bf969ff: folds
Hero: raises $0.15 to $0.25
f3cd493a: folds
21ea41da: folds
5aeaa886: calls $0.2
2447e470: folds
*** FLOP *** [3h As Js]
5aeaa886: checks
Hero: checks
*** TURN *** [3h As Js] [7d]
5aeaa886: bets $0.2
Hero: calls $0.2
*** RIVER *** [3h As Js 7d] [7c]
5aeaa886: checks
Hero: checks
5aeaa886: shows [2s 2h] (Pair of Sevens and Pair of Twos)
Hero: shows [Qs Jh] (Pair of Jacks and Pair of Sevens)
*** SHOWDOWN ***
Hero collected $0.95 from pot
*** SUMMARY ***
Total pot $1 | Rake $0.05 | Jackpot $0 | Bingo $0 | Fortune $0
Board [3h As Js 7d 7c]
Seat 1: 21ea41da (button) folded before Flop (didn't bet)
Seat 2: 5aeaa886 (small blind) showed [2s 2h] and lost with Pair of Sevens and Pair of Twos
Seat 3: 2447e470 (big blind) folded before Flop
Seat 4: 3bf969ff folded before Flop (didn't bet)
Seat 5: Hero showed [Qs Jh] and won ($0.95) with Pair of Jacks and Pair of Sevens
Seat 6: f3cd493a folded before Flop (didn't bet)


Poker Hand #RC1468416852: Hold'em No Limit  ($0.05/$0.1) - 2023/04/12 19:27:35
Table 'RushAndCash5622112' 6-max Seat #1 is the button
Seat 1: Hero ($3.82 in chips)
Seat 2: a26c9ff2 ($12.43 in chips)
Seat 3: 59724ca3 ($4.28 in chips)
Seat 4: 1aaeec0f ($10.63 in chips)
Seat 5: a952432 ($10.15 in chips)
Seat 6: 295ae4ba ($10.09 in chips)
a26c9ff2: posts small blind $0.05
59724ca3: posts big blind $0.1
*** HOLE CARDS ***
Dealt to Hero [6s 8h]
Dealt to a26c9ff2 
Dealt to 59724ca3 
Dealt to 1aaeec0f 
Dealt to a952432 
Dealt to 295ae4ba 
1aaeec0f: folds
a952432: folds
295ae4ba: folds
Hero: folds
a26c9ff2: folds
Uncalled bet ($0.05) returned to 59724ca3
*** SHOWDOWN ***
59724ca3 collected $0.1 from pot
*** SUMMARY ***
Total pot $0.1 | Rake $0 | Jackpot $0 | Bingo $0 | Fortune $0
Seat 1: Hero (button) folded before Flop (didn't bet)
Seat 2: a26c9ff2 (small blind) folded before Flop
Seat 3: 59724ca3 (big blind) collected ($0.1)
Seat 4: 1aaeec0f folded before Flop (didn't bet)
Seat 5: a952432 folded before Flop (didn't bet)
Seat 6: 295ae4ba folded before Flop (didn't bet)


Poker Hand #RC1468416402: Hold'em No Limit  ($0.05/$0.1) - 2023/04/12 19:26:31
Table 'RushAndCash5621662' 6-max Seat #1 is the button
Seat 1: 1aaeec0f ($10.31 in chips)
Seat 2: 4afd4208 ($10 in chips)
Seat 3: Hero ($4.12 in chips)
Seat 4: 21ea41da ($54.99 in chips)
Seat 5: 1b43483 ($26.81 in chips)
Seat 6: 1bd3bc3d ($10.1 in chips)
4afd4208: posts small blind $0.05
Hero: posts big blind $0.1
*** HOLE CARDS ***
Dealt to 1aaeec0f 
Dealt to 4afd4208 
Dealt to Hero [Ah 5c]
Dealt to 21ea41da 
Dealt to 1b43483 
Dealt to 1bd3bc3d 
21ea41da: folds
1b43483: folds
1bd3bc3d: folds
1aaeec0f: raises $0.2 to $0.3
4afd4208: folds
Hero: calls $0.2
*** FLOP *** [6s Kh 7s]
Hero: checks
1aaeec0f: bets $0.44
Hero: folds
Uncalled bet ($0.44) returned to 1aaeec0f
*** SHOWDOWN ***
1aaeec0f collected $0.62 from pot
*** SUMMARY ***
Total pot $0.65 | Rake $0.03 | Jackpot $0 | Bingo $0 | Fortune $0
Board [6s Kh 7s]
Seat 1: 1aaeec0f (button) won ($0.62)
Seat 2: 4afd4208 (small blind) folded before Flop
Seat 3: Hero (big blind) folded on the Flop
Seat 4: 21ea41da folded before Flop (didn't bet)
Seat 5: 1b43483 folded before Flop (didn't bet)
Seat 6: 1bd3bc3d folded before Flop (didn't bet)


Poker Hand #RC1468416329: Hold'em No Limit  ($0.05/$0.1) - 2023/04/12 19:26:20
Table 'RushAndCash5621589' 6-max Seat #1 is the button
Seat 1: 7023a121 ($7.49 in chips)
Seat 2: 9330c0c7 ($30.74 in chips)
Seat 3: f0499d54 ($10 in chips)
Seat 4: d0d66073 ($8.22 in chips)
Seat 5: 7815dbab ($8.21 in chips)
Seat 6: Hero ($4.12 in chips)
9330c0c7: posts small blind $0.05
f0499d54: posts big blind $0.1
*** HOLE CARDS ***
Dealt to 7023a121 
Dealt to 9330c0c7 
Dealt to f0499d54 
Dealt to d0d66073 
Dealt to 7815dbab 
Dealt to Hero [Ks 9c]
d0d66073: raises $0.14 to $0.24
7815dbab: folds
Hero: folds
7023a121: calls $0.24
9330c0c7: folds
f0499d54: folds
*** FLOP *** [Qd Tc 9d]
d0d66073: bets $0.21
7023a121: raises $0.21 to $0.42
d0d66073: calls $0.21
*** TURN *** [Qd Tc 9d] [2c]
d0d66073: checks
7023a121: bets $0.52
d0d66073: calls $0.52
*** RIVER *** [Qd Tc 9d 2c] [8d]
d0d66073: checks
7023a121: bets $1.31
d0d66073: folds
Uncalled bet ($1.31) returned to 7023a121
*** SHOWDOWN ***
7023a121 collected $2.39 from pot
*** SUMMARY ***
Total pot $2.51 | Rake $0.12 | Jackpot $0 | Bingo $0 | Fortune $0
Board [Qd Tc 9d 2c 8d]
Seat 1: 7023a121 (button) won ($2.39)
Seat 2: 9330c0c7 (small blind) folded before Flop
Seat 3: f0499d54 (big blind) folded before Flop
Seat 4: d0d66073 folded on the River
Seat 5: 7815dbab folded before Flop (didn't bet)
Seat 6: Hero folded before Flop (didn't bet)


Poker Hand #RC1468415764: Hold'em No Limit  ($0.05/$0.1) - 2023/04/12 19:24:55
Table 'RushAndCash5621024' 6-max Seat #1 is the button
Seat 1: 2c33c26c ($10 in chips)
Seat 2: Hero ($4.67 in chips)
Seat 3: ba4d0ff6 ($11.14 in chips)
Seat 4: ac63fe01 ($18.47 in chips)
Seat 5: 67d9184a ($10 in chips)
Seat 6: 53028870 ($4.25 in chips)
Hero: posts small blind $0.05
ba4d0ff6: posts big blind $0.1
*** HOLE CARDS ***
Dealt to 2c33c26c 
Dealt to Hero [3d 3h]
Dealt to ba4d0ff6 
Dealt to ac63fe01 
Dealt to 67d9184a 
Dealt to 53028870 
ac63fe01: folds
67d9184a: raises $0.15 to $0.25
53028870: folds
2c33c26c: folds
Hero: calls $0.2
ba4d0ff6: folds
*** FLOP *** [7c 4h 2c]
Hero: checks
67d9184a: checks
*** TURN *** [7c 4h 2c] [Ah]
Hero: checks
67d9184a: bets $0.3
Hero: calls $0.3
*** RIVER *** [7c 4h 2c Ah] [Tc]
Hero: checks
67d9184a: bets $0.41
Hero: folds
Uncalled bet ($0.41) returned to 67d9184a
*** SHOWDOWN ***
67d9184a collected $1.14 from pot
*** SUMMARY ***
Total pot $1.2 | Rake $0.06 | Jackpot $0 | Bingo $0 | Fortune $0
Board [7c 4h 2c Ah Tc]
Seat 1: 2c33c26c (button) folded before Flop (didn't bet)
Seat 2: Hero (small blind) folded on the River
Seat 3: ba4d0ff6 (big blind) folded before Flop
Seat 4: ac63fe01 folded before Flop (didn't bet)
Seat 5: 67d9184a won ($1.14)
Seat 6: 53028870 folded before Flop (didn't bet)


Poker Hand #RC1468415698: Hold'em No Limit  ($0.05/$0.1) - 2023/04/12 19:24:45
Table 'RushAndCash5620958' 6-max Seat #1 is the button
Seat 1: f3cd493a ($13.04 in chips)
Seat 2: cd5c1dcb ($22.39 in chips)
Seat 3: 3a2d2163 ($14.74 in chips)
Seat 4: Hero ($4.67 in chips)
Seat 5: 65781e3e ($9.44 in chips)
Seat 6: 8796732 ($8.53 in chips)
cd5c1dcb: posts small blind $0.05
3a2d2163: posts big blind $0.1
*** HOLE CARDS ***
Dealt to f3cd493a 
Dealt to cd5c1dcb 
Dealt to 3a2d2163 
Dealt to Hero [Tc 6s]
Dealt to 65781e3e 
Dealt to 8796732 
Hero: folds
65781e3e: folds
8796732: folds
f3cd493a: raises $0.1 to $0.2
cd5c1dcb: raises $0.65 to $0.85
3a2d2163: raises $1.55 to $2.4
f3cd493a: folds
cd5c1dcb: folds
Uncalled bet ($1.55) returned to 3a2d2163
*** SHOWDOWN ***
3a2d2163 collected $1.81 from pot
*** SUMMARY ***
Total pot $1.9 | Rake $0.09 | Jackpot $0 | Bingo $0 | Fortune $0
Seat 1: f3cd493a (button) folded before Flop
Seat 2: cd5c1dcb (small blind) folded before Flop
Seat 3: 3a2d2163 (big blind) collected ($1.81)
Seat 4: Hero folded before Flop (didn't bet)
Seat 5: 65781e3e folded before Flop (didn't bet)
Seat 6: 8796732 folded before Flop (didn't bet)


Poker Hand #RC1468415172: Hold'em No Limit  ($0.05/$0.1) - 2023/04/12 19:23:22
Table 'RushAndCash5620432' 6-max Seat #1 is the button
Seat 1: Hero ($8.01 in chips)
Seat 2: b8b76e5d ($11.91 in chips)
Seat 3: 50ce1268 ($12.3 in chips)
Seat 4: bdd8009d ($5.02 in chips)
Seat 5: 41975fdb ($14.73 in chips)
Seat 6: f3cd493a ($10 in chips)
b8b76e5d: posts small blind $0.05
50ce1268: posts big blind $0.1
*** HOLE CARDS ***
Dealt to Hero [Qs Kd]
Dealt to b8b76e5d 
Dealt to 50ce1268 
Dealt to bdd8009d 
Dealt to 41975fdb 
Dealt to f3cd493a 
bdd8009d: folds
41975fdb: folds
f3cd493a: raises $0.2 to $0.3
Hero: raises $0.62 to $0.92
b8b76e5d: folds
50ce1268: folds
f3cd493a: calls $0.62
*** FLOP *** [9s 5h Ah]
f3cd493a: checks
Hero: bets $0.71
f3cd493a: calls $0.71
*** TURN *** [9s 5h Ah] [2c]
f3cd493a: checks
Hero: bets $1.71
f3cd493a: calls $1.71
*** RIVER *** [9s 5h Ah 2c] [6d]
f3cd493a: checks
Hero: checks
f3cd493a: shows [Js Ac] (Pair of Aces)
Hero: shows [Qs Kd] (Ace-High)
*** SHOWDOWN ***
f3cd493a collected $6.38 from pot
*** SUMMARY ***
Total pot $6.83 | Rake $0.3 | Jackpot $0.15 | Bingo $0 | Fortune $0
Board [9s 5h Ah 2c 6d]
Seat 1: Hero (button) showed [Qs Kd] and lost with Ace-High
Seat 2: b8b76e5d (small blind) folded before Flop
Seat 3: 50ce1268 (big blind) folded before Flop
Seat 4: bdd8009d folded before Flop (didn't bet)
Seat 5: 41975fdb folded before Flop (didn't bet)
Seat 6: f3cd493a showed [Js Ac] and won ($6.38) with Pair of Aces


Poker Hand #RC1468415033: Hold'em No Limit  ($0.05/$0.1) - 2023/04/12 19:23:00
Table 'RushAndCash5620293' 6-max Seat #1 is the button
Seat 1: Hero ($7.86 in chips)
Seat 2: 1936082a ($12.18 in chips)
Seat 3: 5ab4c45b ($15.85 in chips)
Seat 4: aeed83 ($11.69 in chips)
Seat 5: 14695476 ($20.21 in chips)
Seat 6: c9cd5132 ($4 in chips)
1936082a: posts small blind $0.05
5ab4c45b: posts big blind $0.1
*** HOLE CARDS ***
Dealt to Hero [Ad Th]
Dealt to 1936082a 
Dealt to 5ab4c45b 
Dealt to aeed83 
Dealt to 14695476 
Dealt to c9cd5132 
aeed83: folds
14695476: folds
c9cd5132: folds
Hero: raises $0.15 to $0.25
1936082a: folds
5ab4c45b: folds
Uncalled bet ($0.15) returned to Hero
*** SHOWDOWN ***
Hero collected $0.25 from pot
*** SUMMARY ***
Total pot $0.25 | Rake $0 | Jackpot $0 | Bingo $0 | Fortune $0
Seat 1: Hero (button) collected ($0.25)
Seat 2: 1936082a (small blind) folded before Flop
Seat 3: 5ab4c45b (big blind) folded before Flop
Seat 4: aeed83 folded before Flop (didn't bet)
Seat 5: 14695476 folded before Flop (didn't bet)
Seat 6: c9cd5132 folded before Flop (didn't bet)


Poker Hand #RC1468414879: Hold'em No Limit  ($0.05/$0.1) - 2023/04/12 19:22:38
Table 'RushAndCash5620139' 6-max Seat #1 is the button
Seat 1: 70a075c9 ($23.31 in chips)
Seat 2: 9d4eac4e ($12.7 in chips)
Seat 3: Hero ($7.96 in chips)
Seat 4: aacc502f ($10 in chips)
Seat 5: 50ce1268 ($12.35 in chips)
Seat 6: 3877af71 ($12.5 in chips)
9d4eac4e: posts small blind $0.05
Hero: posts big blind $0.1
*** HOLE CARDS ***
Dealt to 70a075c9 
Dealt to 9d4eac4e 
Dealt to Hero [2h Qs]
Dealt to aacc502f 
Dealt to 50ce1268 
Dealt to 3877af71 
aacc502f: folds
50ce1268: folds
3877af71: raises $0.13 to $0.23
70a075c9: raises $0.21 to $0.44
9d4eac4e: folds
Hero: folds
3877af71: calls $0.21
*** FLOP *** [7s 3c 7c]
3877af71: checks
70a075c9: checks
*** TURN *** [7s 3c 7c] [7d]
3877af71: checks
70a075c9: bets $1.03
3877af71: folds
Uncalled bet ($1.03) returned to 70a075c9
*** SHOWDOWN ***
70a075c9 collected $0.98 from pot
*** SUMMARY ***
Total pot $1.03 | Rake $0.05 | Jackpot $0 | Bingo $0 | Fortune $0
Board [7s 3c 7c 7d]
Seat 1: 70a075c9 (button) won ($0.98)
Seat 2: 9d4eac4e (small blind) folded before Flop
Seat 3: Hero (big blind) folded before Flop
Seat 4: aacc502f folded before Flop (didn't bet)
Seat 5: 50ce1268 folded before Flop (didn't bet)
Seat 6: 3877af71 folded on the Turn


Poker Hand #RC1468414798: Hold'em No Limit  ($0.05/$0.1) - 2023/04/12 19:22:25
Table 'RushAndCash5620058' 6-max Seat #1 is the button
Seat 1: 7eb32471 ($11.29 in chips)
Seat 2: Hero ($8.01 in chips)
Seat 3: effd023b ($11.34 in chips)
Seat 4: f89d54f1 ($51.82 in chips)
Seat 5: 60f680c5 ($10.92 in chips)
Seat 6: fc29cdac ($15.8 in chips)
Hero: posts small blind $0.05
effd023b: posts big blind $0.1
*** HOLE CARDS ***
Dealt to 7eb32471 
Dealt to Hero [Js 6h]
Dealt to effd023b 
Dealt to f89d54f1 
Dealt to 60f680c5 
Dealt to fc29cdac 
f89d54f1: folds
60f680c5: folds
fc29cdac: folds
7eb32471: folds
Hero: folds
Uncalled bet ($0.05) returned to effd023b
*** SHOWDOWN ***
effd023b collected $0.1 from pot
*** SUMMARY ***
Total pot $0.1 | Rake $0 | Jackpot $0 | Bingo $0 | Fortune $0
Seat 1: 7eb32471 (button) folded before Flop (didn't bet)
Seat 2: Hero (small blind) folded before Flop
Seat 3: effd023b (big blind) collected ($0.1)
Seat 4: f89d54f1 folded before Flop (didn't bet)
Seat 5: 60f680c5 folded before Flop (didn't bet)
Seat 6: fc29cdac folded before Flop (didn't bet)


Poker Hand #RC1468394736: Hold'em No Limit  ($0.05/$0.1) - 2023/04/12 19:22:16
Table 'RushAndCash5619996' 6-max Seat #1 is the button
Seat 1: 27df0055 ($13.18 in chips)
Seat 2: Hero ($8.06 in chips)
Seat 3: dc715600 ($11.66 in chips)
Seat 4: 50ce1268 ($12.4 in chips)
Seat 5: 4c62fede ($10 in chips)
Seat 6: a84e6d0a ($12.99 in chips)
Hero: posts small blind $0.05
dc715600: posts big blind $0.1
*** HOLE CARDS ***
Dealt to 27df0055 
Dealt to Hero [5h 2c]
Dealt to dc715600 
Dealt to 50ce1268 
Dealt to 4c62fede 
Dealt to a84e6d0a 
50ce1268: folds
4c62fede: folds
a84e6d0a: folds
27df0055: folds
Hero: folds
Uncalled bet ($0.05) returned to dc715600
*** SHOWDOWN ***
dc715600 collected $0.1 from pot
*** SUMMARY ***
Total pot $0.1 | Rake $0 | Jackpot $0 | Bingo $0 | Fortune $0
Seat 1: 27df0055 (button) folded before Flop (didn't bet)
Seat 2: Hero (small blind) folded before Flop
Seat 3: dc715600 (big blind) collected ($0.1)
Seat 4: 50ce1268 folded before Flop (didn't bet)
Seat 5: 4c62fede folded before Flop (didn't bet)
Seat 6: a84e6d0a folded before Flop (didn't bet)


Poker Hand #RC1468394692: Hold'em No Limit  ($0.05/$0.1) - 2023/04/12 19:22:08
Table 'RushAndCash5619952' 6-max Seat #1 is the button
Seat 1: 6173bd66 ($19.04 in chips)
Seat 2: 7c507e93 ($24.56 in chips)
Seat 3: 434b0e23 ($19.02 in chips)
Seat 4: 8aea79f8 ($9.09 in chips)
Seat 5: a84e6d0a ($12.99 in chips)
Seat 6: Hero ($8.06 in chips)
7c507e93: posts small blind $0.05
434b0e23: posts big blind $0.1
*** HOLE CARDS ***
Dealt to 6173bd66 
Dealt to 7c507e93 
Dealt to 434b0e23 
Dealt to 8aea79f8 
Dealt to a84e6d0a 
Dealt to Hero [Th 5h]
8aea79f8: folds
a84e6d0a: folds
Hero: folds
6173bd66: folds
7c507e93: folds
Uncalled bet ($0.05) returned to 434b0e23
*** SHOWDOWN ***
434b0e23 collected $0.1 from pot
*** SUMMARY ***
Total pot $0.1 | Rake $0 | Jackpot $0 | Bingo $0 | Fortune $0
Seat 1: 6173bd66 (button) folded before Flop (didn't bet)
Seat 2: 7c507e93 (small blind) folded before Flop
Seat 3: 434b0e23 (big blind) collected ($0.1)
Seat 4: 8aea79f8 folded before Flop (didn't bet)
Seat 5: a84e6d0a folded before Flop (didn't bet)
Seat 6: Hero folded before Flop (didn't bet)


Poker Hand #RC1468394626: Hold'em No Limit  ($0.05/$0.1) - 2023/04/12 19:21:59
Table 'RushAndCash5619886' 6-max Seat #1 is the button
Seat 1: bb03a8cb ($16.44 in chips)
Seat 2: d0d66073 ($10.2 in chips)
Seat 3: c16d9eef ($8.1 in chips)
Seat 4: 9f97f6b4 ($10 in chips)
Seat 5: Hero ($8.06 in chips)
Seat 6: 45d4b2f5 ($10.15 in chips)
d0d66073: posts small blind $0.05
c16d9eef: posts big blind $0.1
*** HOLE CARDS ***
Dealt to bb03a8cb 
Dealt to d0d66073 
Dealt to c16d9eef 
Dealt to 9f97f6b4 
Dealt to Hero [8c Jh]
Dealt to 45d4b2f5 
9f97f6b4: raises $0.1 to $0.2
Hero: folds
45d4b2f5: folds
bb03a8cb: folds
d0d66073: calls $0.15
c16d9eef: folds
*** FLOP *** [8d Td Kh]
d0d66073: checks
9f97f6b4: checks
*** TURN *** [8d Td Kh] [Ah]
d0d66073: checks
9f97f6b4: checks
*** RIVER *** [8d Td Kh Ah] [5c]
d0d66073: checks
9f97f6b4: checks
d0d66073: shows [9c Ac] (Pair of Aces)
9f97f6b4: shows [7s 5s] (Pair of Fives)
*** SHOWDOWN ***
d0d66073 collected $0.48 from pot
*** SUMMARY ***
Total pot $0.5 | Rake $0.02 | Jackpot $0 | Bingo $0 | Fortune $0
Board [8d Td Kh Ah 5c]
Seat 1: bb03a8cb (button) folded before Flop (didn't bet)
Seat 2: d0d66073 (small blind) showed [9c Ac] and won ($0.48) with Pair of Aces
Seat 3: c16d9eef (big blind) folded before Flop
Seat 4: 9f97f6b4 showed [7s 5s] and lost with Pair of Fives
Seat 5: Hero folded before Flop (didn't bet)
Seat 6: 45d4b2f5 folded before Flop (didn't bet)


Poker Hand #RC1468394578: Hold'em No Limit  ($0.05/$0.1) - 2023/04/12 19:21:52
Table 'RushAndCash5619838' 6-max Seat #1 is the button
Seat 1: 93af2464 ($6.49 in chips)
Seat 2: e2e002f1 ($10.13 in chips)
Seat 3: 5806eb86 ($10.05 in chips)
Seat 4: Hero ($8.06 in chips)
Seat 5: b641fe9 ($10.17 in chips)
Seat 6: 195264ef ($10.22 in chips)
e2e002f1: posts small blind $0.05
5806eb86: posts big blind $0.1
*** HOLE CARDS ***
Dealt to 93af2464 
Dealt to e2e002f1 
Dealt to 5806eb86 
Dealt to Hero [4c Ks]
Dealt to b641fe9 
Dealt to 195264ef 
Hero: folds
b641fe9: folds
195264ef: folds
93af2464: raises $0.15 to $0.25
e2e002f1: calls $0.2
5806eb86: calls $0.15
*** FLOP *** [Jd 3s Ac]
e2e002f1: checks
5806eb86: checks
93af2464: bets $0.27
e2e002f1: calls $0.27
5806eb86: calls $0.27
*** TURN *** [Jd 3s Ac] [2h]
e2e002f1: checks
5806eb86: checks
93af2464: checks
*** RIVER *** [Jd 3s Ac 2h] [4d]
e2e002f1: checks
5806eb86: checks
93af2464: checks
e2e002f1: shows [Jc Qc] (Pair of Jacks)
5806eb86: shows [Qs Kh] (Ace-High)
93af2464: shows [Ad Ts] (Pair of Aces)
*** SHOWDOWN ***
93af2464 collected $1.49 from pot
*** SUMMARY ***
Total pot $1.56 | Rake $0.07 | Jackpot $0 | Bingo $0 | Fortune $0
Board [Jd 3s Ac 2h 4d]
Seat 1: 93af2464 (button) showed [Ad Ts] and won ($1.49) with Pair of Aces
Seat 2: e2e002f1 (small blind) showed [Jc Qc] and lost with Pair of Jacks
Seat 3: 5806eb86 (big blind) showed [Qs Kh] and lost with Ace-High
Seat 4: Hero folded before Flop (didn't bet)
Seat 5: b641fe9 folded before Flop (didn't bet)
Seat 6: 195264ef folded before Flop (didn't bet)


Poker Hand #RC1468394463: Hold'em No Limit  ($0.05/$0.1) - 2023/04/12 19:21:35
Table 'RushAndCash5619723' 6-max Seat #1 is the button
Seat 1: f1b8a68f ($20.48 in chips)
Seat 2: ab766696 ($11.29 in chips)
Seat 3: Hero ($8.16 in chips)
Seat 4: 1f85964f ($6.65 in chips)
Seat 5: c56a6741 ($16.38 in chips)
Seat 6: 3bc97b07 ($10 in chips)
ab766696: posts small blind $0.05
Hero: posts big blind $0.1
*** HOLE CARDS ***
Dealt to f1b8a68f 
Dealt to ab766696 
Dealt to Hero [3d 9s]
Dealt to 1f85964f 
Dealt to c56a6741 
Dealt to 3bc97b07 
1f85964f: raises $0.15 to $0.25
c56a6741: folds
3bc97b07: folds
f1b8a68f: calls $0.25
ab766696: folds
Hero: folds
*** FLOP *** [Qc 6h Kh]
1f85964f: checks
f1b8a68f: checks
*** TURN *** [Qc 6h Kh] [Tc]
1f85964f: bets $0.43
f1b8a68f: calls $0.43
*** RIVER *** [Qc 6h Kh Tc] [Td]
1f85964f: bets $1
f1b8a68f: raises $2.64 to $3.64
1f85964f: calls $2.64
f1b8a68f: shows [Js Ac] (Aces-High Straight)
1f85964f: shows [6c 6s] (Sixes Full over Tens)
*** SHOWDOWN ***
1f85964f collected $8.34 from pot
*** SUMMARY ***
Total pot $8.79 | Rake $0.3 | Jackpot $0.15 | Bingo $0 | Fortune $0
Board [Qc 6h Kh Tc Td]
Seat 1: f1b8a68f (button) showed [Js Ac] and lost with Aces-High Straight
Seat 2: ab766696 (small blind) folded before Flop
Seat 3: Hero (big blind) folded before Flop
Seat 4: 1f85964f showed [6c 6s] and won ($8.34) with Sixes Full over Tens
Seat 5: c56a6741 folded before Flop (didn't bet)
Seat 6: 3bc97b07 folded before Flop (didn't bet)


Poker Hand #RC1468394423: Hold'em No Limit  ($0.05/$0.1) - 2023/04/12 19:21:29
Table 'RushAndCash5619683' 6-max Seat #1 is the button
Seat 1: 77b0e65c ($45.15 in chips)
Seat 2: 2f01db10 ($28.19 in chips)
Seat 3: 7f96f66b ($10.15 in chips)
Seat 4: 74f5ba4c ($11.67 in chips)
Seat 5: Hero ($8.16 in chips)
Seat 6: 16e733a5 ($12.62 in chips)
2f01db10: posts small blind $0.05
7f96f66b: posts big blind $0.1
*** HOLE CARDS ***
Dealt to 77b0e65c 
Dealt to 2f01db10 
Dealt to 7f96f66b 
Dealt to 74f5ba4c 
Dealt to Hero [6c 7d]
Dealt to 16e733a5 
74f5ba4c: raises $0.15 to $0.25
Hero: folds
16e733a5: folds
77b0e65c: folds
2f01db10: folds
7f96f66b: folds
Uncalled bet ($0.15) returned to 74f5ba4c
*** SHOWDOWN ***
74f5ba4c collected $0.25 from pot
*** SUMMARY ***
Total pot $0.25 | Rake $0 | Jackpot $0 | Bingo $0 | Fortune $0
Seat 1: 77b0e65c (button) folded before Flop (didn't bet)
Seat 2: 2f01db10 (small blind) folded before Flop
Seat 3: 7f96f66b (big blind) folded before Flop
Seat 4: 74f5ba4c collected ($0.25)
Seat 5: Hero folded before Flop (didn't bet)
Seat 6: 16e733a5 folded before Flop (didn't bet)


Poker Hand #RC1468394358: Hold'em No Limit  ($0.05/$0.1) - 2023/04/12 19:21:19
Table 'RushAndCash5619618' 6-max Seat #1 is the button
Seat 1: Hero ($8.16 in chips)
Seat 2: 42c88d3 ($11.41 in chips)
Seat 3: ac7fce4a ($41.04 in chips)
Seat 4: 7b0eeb66 ($6.11 in chips)
Seat 5: ad456f0f ($14.51 in chips)
Seat 6: 98fa32ad ($11.94 in chips)
42c88d3: posts small blind $0.05
ac7fce4a: posts big blind $0.1
*** HOLE CARDS ***
Dealt to Hero [6d 5c]
Dealt to 42c88d3 
Dealt to ac7fce4a 
Dealt to 7b0eeb66 
Dealt to ad456f0f 
Dealt to 98fa32ad 
7b0eeb66: raises $0.13 to $0.23
ad456f0f: folds
98fa32ad: folds
Hero: folds
42c88d3: folds
ac7fce4a: calls $0.13
*** FLOP *** [Qs 7s 3s]
ac7fce4a: checks
7b0eeb66: bets $0.17
ac7fce4a: raises $0.17 to $0.34
7b0eeb66: raises $5.54 to $5.88 and is all-in
ac7fce4a: folds
Uncalled bet ($5.54) returned to 7b0eeb66
*** SHOWDOWN ***
7b0eeb66 collected $1.13 from pot
*** SUMMARY ***
Total pot $1.19 | Rake $0.06 | Jackpot $0 | Bingo $0 | Fortune $0
Board [Qs 7s 3s]
Seat 1: Hero (button) folded before Flop (didn't bet)
Seat 2: 42c88d3 (small blind) folded before Flop
Seat 3: ac7fce4a (big blind) folded on the Flop
Seat 4: 7b0eeb66 won ($1.13)
Seat 5: ad456f0f folded before Flop (didn't bet)
Seat 6: 98fa32ad folded before Flop (didn't bet)


Poker Hand #RC1468394266: Hold'em No Limit  ($0.05/$0.1) - 2023/04/12 19:21:04
Table 'RushAndCash5619526' 6-max Seat #1 is the button
Seat 1: bfbec681 ($15.38 in chips)
Seat 2: b191df37 ($10 in chips)
Seat 3: 75ccd39 ($10.67 in chips)
Seat 4: e2ec5807 ($10.31 in chips)
Seat 5: 2c719efa ($10.34 in chips)
Seat 6: Hero ($8.16 in chips)
b191df37: posts small blind $0.05
75ccd39: posts big blind $0.1
*** HOLE CARDS ***
Dealt to bfbec681 
Dealt to b191df37 
Dealt to 75ccd39 
Dealt to e2ec5807 
Dealt to 2c719efa 
Dealt to Hero [4h 6d]
e2ec5807: folds
2c719efa: raises $0.15 to $0.25
Hero: folds
bfbec681: raises $0.5 to $0.75
b191df37: folds
75ccd39: folds
2c719efa: calls $0.5
*** FLOP *** [Ac 8c 8d]
2c719efa: checks
bfbec681: checks
*** TURN *** [Ac 8c 8d] [7h]
2c719efa: checks
bfbec681: bets $0.8
2c719efa: calls $0.8
*** RIVER *** [Ac 8c 8d 7h] [Kh]
2c719efa: checks
bfbec681: bets $0.85
2c719efa: folds
Uncalled bet ($0.85) returned to bfbec681
*** SHOWDOWN ***
bfbec681 collected $2.95 from pot
*** SUMMARY ***
Total pot $3.25 | Rake $0.15 | Jackpot $0.15 | Bingo $0 | Fortune $0
Board [Ac 8c 8d 7h Kh]
Seat 1: bfbec681 (button) won ($2.95)
Seat 2: b191df37 (small blind) folded before Flop
Seat 3: 75ccd39 (big blind) folded before Flop
Seat 4: e2ec5807 folded before Flop (didn't bet)
Seat 5: 2c719efa folded on the River
Seat 6: Hero folded before Flop (didn't bet)


Poker Hand #RC1468394200: Hold'em No Limit  ($0.05/$0.1) - 2023/04/12 19:20:52
Table 'RushAndCash5619460' 6-max Seat #1 is the button
Seat 1: 5dd90042 ($11.37 in chips)
Seat 2: a6133ad2 ($11.59 in chips)
Seat 3: aa28ab16 ($48.09 in chips)
Seat 4: Hero ($8.01 in chips)
Seat 5: 1633da64 ($10 in chips)
Seat 6: 8941cc31 ($13.09 in chips)
a6133ad2: posts small blind $0.05
aa28ab16: posts big blind $0.1
*** HOLE CARDS ***
Dealt to 5dd90042 
Dealt to a6133ad2 
Dealt to aa28ab16 
Dealt to Hero [Ks Jh]
Dealt to 1633da64 
Dealt to 8941cc31 
Hero: raises $0.15 to $0.25
1633da64: folds
8941cc31: folds
5dd90042: folds
a6133ad2: folds
aa28ab16: folds
Uncalled bet ($0.15) returned to Hero
*** SHOWDOWN ***
Hero collected $0.25 from pot
*** SUMMARY ***
Total pot $0.25 | Rake $0 | Jackpot $0 | Bingo $0 | Fortune $0
Seat 1: 5dd90042 (button) folded before Flop (didn't bet)
Seat 2: a6133ad2 (small blind) folded before Flop
Seat 3: aa28ab16 (big blind) folded before Flop
Seat 4: Hero collected ($0.25)
Seat 5: 1633da64 folded before Flop (didn't bet)
Seat 6: 8941cc31 folded before Flop (didn't bet)


Poker Hand #RC1468394146: Hold'em No Limit  ($0.05/$0.1) - 2023/04/12 19:20:44
Table 'RushAndCash5619406' 6-max Seat #1 is the button
Seat 1: Hero ($8.01 in chips)
Seat 2: 7a7555a1 ($14.48 in chips)
Seat 3: effd023b ($10 in chips)
Seat 4: 4b0f3ac7 ($15.61 in chips)
Seat 5: 59724ca3 ($5.39 in chips)
Seat 6: ffe6b243 ($12.23 in chips)
7a7555a1: posts small blind $0.05
effd023b: posts big blind $0.1
*** HOLE CARDS ***
Dealt to Hero [7c 9h]
Dealt to 7a7555a1 
Dealt to effd023b 
Dealt to 4b0f3ac7 
Dealt to 59724ca3 
Dealt to ffe6b243 
4b0f3ac7: folds
59724ca3: folds
ffe6b243: folds
Hero: folds
7a7555a1: raises $0.15 to $0.25
effd023b: folds
Uncalled bet ($0.15) returned to 7a7555a1
*** SHOWDOWN ***
7a7555a1 collected $0.2 from pot
*** SUMMARY ***
Total pot $0.2 | Rake $0 | Jackpot $0 | Bingo $0 | Fortune $0
Seat 1: Hero (button) folded before Flop (didn't bet)
Seat 2: 7a7555a1 (small blind) collected ($0.2)
Seat 3: effd023b (big blind) folded before Flop
Seat 4: 4b0f3ac7 folded before Flop (didn't bet)
Seat 5: 59724ca3 folded before Flop (didn't bet)
Seat 6: ffe6b243 folded before Flop (didn't bet)


Poker Hand #RC1468394046: Hold'em No Limit  ($0.05/$0.1) - 2023/04/12 19:20:29
Table 'RushAndCash5619306' 6-max Seat #1 is the button
Seat 1: 4a19b931 ($7.09 in chips)
Seat 2: 3cbc9d6 ($13.39 in chips)
Seat 3: 9aa0bcbf ($12.34 in chips)
Seat 4: c27fffd6 ($3.66 in chips)
Seat 5: Hero ($8.01 in chips)
Seat 6: 1ddf185d ($10.45 in chips)
3cbc9d6: posts small blind $0.05
9aa0bcbf: posts big blind $0.1
*** HOLE CARDS ***
Dealt to 4a19b931 
Dealt to 3cbc9d6 
Dealt to 9aa0bcbf 
Dealt to c27fffd6 
Dealt to Hero [4d Td]
Dealt to 1ddf185d 
c27fffd6: raises $0.1 to $0.2
Hero: folds
1ddf185d: folds
4a19b931: raises $0.42 to $0.62
3cbc9d6: folds
9aa0bcbf: folds
c27fffd6: folds
Uncalled bet ($0.42) returned to 4a19b931
*** SHOWDOWN ***
4a19b931 collected $0.53 from pot
*** SUMMARY ***
Total pot $0.55 | Rake $0.02 | Jackpot $0 | Bingo $0 | Fortune $0
Seat 1: 4a19b931 (button) collected ($0.53)
Seat 2: 3cbc9d6 (small blind) folded before Flop
Seat 3: 9aa0bcbf (big blind) folded before Flop
Seat 4: c27fffd6 folded before Flop
Seat 5: Hero folded before Flop (didn't bet)
Seat 6: 1ddf185d folded before Flop (didn't bet)


Poker Hand #RC1468393999: Hold'em No Limit  ($0.05/$0.1) - 2023/04/12 19:20:23
Table 'RushAndCash5619259' 6-max Seat #1 is the button
Seat 1: 891c6fd ($17.42 in chips)
Seat 2: ea50a791 ($15.01 in chips)
Seat 3: Hero ($7.96 in chips)
Seat 4: f8a25feb ($12.18 in chips)
Seat 5: 15f5529c ($10 in chips)
Seat 6: 5622fee ($8.3 in chips)
ea50a791: posts small blind $0.05
Hero: posts big blind $0.1
*** HOLE CARDS ***
Dealt to 891c6fd 
Dealt to ea50a791 
Dealt to Hero [2d 8c]
Dealt to f8a25feb 
Dealt to 15f5529c 
Dealt to 5622fee 
f8a25feb: folds
15f5529c: folds
5622fee: folds
891c6fd: folds
ea50a791: folds
Uncalled bet ($0.05) returned to Hero
*** SHOWDOWN ***
Hero collected $0.1 from pot
*** SUMMARY ***
Total pot $0.1 | Rake $0 | Jackpot $0 | Bingo $0 | Fortune $0
Seat 1: 891c6fd (button) folded before Flop (didn't bet)
Seat 2: ea50a791 (small blind) folded before Flop
Seat 3: Hero (big blind) collected ($0.1)
Seat 4: f8a25feb folded before Flop (didn't bet)
Seat 5: 15f5529c folded before Flop (didn't bet)
Seat 6: 5622fee folded before Flop (didn't bet)


Poker Hand #RC1468393831: Hold'em No Limit  ($0.05/$0.1) - 2023/04/12 19:19:57
Table 'RushAndCash5619091' 6-max Seat #1 is the button
Seat 1: 891c6fd ($17.52 in chips)
Seat 2: Hero ($8.01 in chips)
Seat 3: f2b01908 ($27.83 in chips)
Seat 4: acc311b8 ($18.6 in chips)
Seat 5: 9938589a ($11.66 in chips)
Seat 6: f352ad99 ($10.34 in chips)
Hero: posts small blind $0.05
f2b01908: posts big blind $0.1
*** HOLE CARDS ***
Dealt to 891c6fd 
Dealt to Hero [4s Qs]
Dealt to f2b01908 
Dealt to acc311b8 
Dealt to 9938589a 
Dealt to f352ad99 
acc311b8: folds
9938589a: calls $0.1
f352ad99: raises $0.18 to $0.28
891c6fd: folds
Hero: folds
f2b01908: folds
9938589a: calls $0.18
*** FLOP *** [5d 3c Kd]
9938589a: checks
f352ad99: bets $0.36
9938589a: folds
Uncalled bet ($0.36) returned to f352ad99
*** SHOWDOWN ***
f352ad99 collected $0.68 from pot
*** SUMMARY ***
Total pot $0.71 | Rake $0.03 | Jackpot $0 | Bingo $0 | Fortune $0
Board [5d 3c Kd]
Seat 1: 891c6fd (button) folded before Flop (didn't bet)
Seat 2: Hero (small blind) folded before Flop
Seat 3: f2b01908 (big blind) folded before Flop
Seat 4: acc311b8 folded before Flop (didn't bet)
Seat 5: 9938589a folded on the Flop
Seat 6: f352ad99 won ($0.68)


Poker Hand #RC1468393759: Hold'em No Limit  ($0.05/$0.1) - 2023/04/12 19:19:46
Table 'RushAndCash5619019' 6-max Seat #1 is the button
Seat 1: d679ce5d ($9.23 in chips)
Seat 2: 6c7786e5 ($16.09 in chips)
Seat 3: 77b0e65c ($45.3 in chips)
Seat 4: b83a7c4 ($10.83 in chips)
Seat 5: a6133ad2 ($11.22 in chips)
Seat 6: Hero ($7.86 in chips)
6c7786e5: posts small blind $0.05
77b0e65c: posts big blind $0.1
*** HOLE CARDS ***
Dealt to d679ce5d 
Dealt to 6c7786e5 
Dealt to 77b0e65c 
Dealt to b83a7c4 
Dealt to a6133ad2 
Dealt to Hero [Ac 9d]
b83a7c4: folds
a6133ad2: folds
Hero: raises $0.15 to $0.25
d679ce5d: folds
6c7786e5: folds
77b0e65c: folds
Uncalled bet ($0.15) returned to Hero
*** SHOWDOWN ***
Hero collected $0.25 from pot
*** SUMMARY ***
Total pot $0.25 | Rake $0 | Jackpot $0 | Bingo $0 | Fortune $0
Seat 1: d679ce5d (button) folded before Flop (didn't bet)
Seat 2: 6c7786e5 (small blind) folded before Flop
Seat 3: 77b0e65c (big blind) folded before Flop
Seat 4: b83a7c4 folded before Flop (didn't bet)
Seat 5: a6133ad2 folded before Flop (didn't bet)
Seat 6: Hero collected ($0.25)


Poker Hand #RC1468393674: Hold'em No Limit  ($0.05/$0.1) - 2023/04/12 19:19:32
Table 'RushAndCash5618934' 6-max Seat #1 is the button
Seat 1: Hero ($7.86 in chips)
Seat 2: 603203b9 ($46.24 in chips)
Seat 3: 53028870 ($6.21 in chips)
Seat 4: e70ffbcd ($18.12 in chips)
Seat 5: f52f2ead ($36.65 in chips)
Seat 6: e44facdf ($8.89 in chips)
603203b9: posts small blind $0.05
53028870: posts big blind $0.1
*** HOLE CARDS ***
Dealt to Hero [Kh 7d]
Dealt to 603203b9 
Dealt to 53028870 
Dealt to e70ffbcd 
Dealt to f52f2ead 
Dealt to e44facdf 
e70ffbcd: folds
f52f2ead: folds
e44facdf: folds
Hero: folds
603203b9: raises $0.2 to $0.3
53028870: folds
Uncalled bet ($0.2) returned to 603203b9
*** SHOWDOWN ***
603203b9 collected $0.2 from pot
*** SUMMARY ***
Total pot $0.2 | Rake $0 | Jackpot $0 | Bingo $0 | Fortune $0
Seat 1: Hero (button) folded before Flop (didn't bet)
Seat 2: 603203b9 (small blind) collected ($0.2)
Seat 3: 53028870 (big blind) folded before Flop
Seat 4: e70ffbcd folded before Flop (didn't bet)
Seat 5: f52f2ead folded before Flop (didn't bet)
Seat 6: e44facdf folded before Flop (didn't bet)


Poker Hand #RC1468393429: Hold'em No Limit  ($0.05/$0.1) - 2023/04/12 19:18:55
Table 'RushAndCash5618689' 6-max Seat #1 is the button
Seat 1: ff849690 ($12.82 in chips)
Seat 2: 49df31c9 ($10 in chips)
Seat 3: 603203b9 ($46.49 in chips)
Seat 4: 75e632b8 ($3.3 in chips)
Seat 5: d56de772 ($18.6 in chips)
Seat 6: Hero ($7.58 in chips)
49df31c9: posts small blind $0.05
603203b9: posts big blind $0.1
*** HOLE CARDS ***
Dealt to ff849690 
Dealt to 49df31c9 
Dealt to 603203b9 
Dealt to 75e632b8 
Dealt to d56de772 
Dealt to Hero [Qh Ks]
75e632b8: folds
d56de772: folds
Hero: raises $0.15 to $0.25
ff849690: folds
49df31c9: folds
603203b9: calls $0.15
*** FLOP *** [8c Ad Qs]
603203b9: checks
Hero: checks
*** TURN *** [8c Ad Qs] [3s]
603203b9: checks
Hero: bets $0.19
603203b9: folds
Uncalled bet ($0.19) returned to Hero
*** SHOWDOWN ***
Hero collected $0.53 from pot
*** SUMMARY ***
Total pot $0.55 | Rake $0.02 | Jackpot $0 | Bingo $0 | Fortune $0
Board [8c Ad Qs 3s]
Seat 1: ff849690 (button) folded before Flop (didn't bet)
Seat 2: 49df31c9 (small blind) folded before Flop
Seat 3: 603203b9 (big blind) folded on the Turn
Seat 4: 75e632b8 folded before Flop (didn't bet)
Seat 5: d56de772 folded before Flop (didn't bet)
Seat 6: Hero won ($0.53)


Poker Hand #RC1468393364: Hold'em No Limit  ($0.05/$0.1) - 2023/04/12 19:18:46
Table 'RushAndCash5618624' 6-max Seat #1 is the button
Seat 1: ba4d0ff6 ($11.06 in chips)
Seat 2: f3d17971 ($13.12 in chips)
Seat 3: Hero ($7.68 in chips)
Seat 4: f1b8a68f ($20.09 in chips)
Seat 5: 34a8c58c ($14.19 in chips)
Seat 6: 27c3301e ($10.1 in chips)
f3d17971: posts small blind $0.05
Hero: posts big blind $0.1
*** HOLE CARDS ***
Dealt to ba4d0ff6 
Dealt to f3d17971 
Dealt to Hero [6c 7h]
Dealt to f1b8a68f 
Dealt to 34a8c58c 
Dealt to 27c3301e 
f1b8a68f: folds
34a8c58c: folds
27c3301e: folds
ba4d0ff6: raises $0.15 to $0.25
f3d17971: folds
Hero: folds
Uncalled bet ($0.15) returned to ba4d0ff6
*** SHOWDOWN ***
ba4d0ff6 collected $0.25 from pot
*** SUMMARY ***
Total pot $0.25 | Rake $0 | Jackpot $0 | Bingo $0 | Fortune $0
Seat 1: ba4d0ff6 (button) collected ($0.25)
Seat 2: f3d17971 (small blind) folded before Flop
Seat 3: Hero (big blind) folded before Flop
Seat 4: f1b8a68f folded before Flop (didn't bet)
Seat 5: 34a8c58c folded before Flop (didn't bet)
Seat 6: 27c3301e folded before Flop (didn't bet)


Poker Hand #RC1468393303: Hold'em No Limit  ($0.05/$0.1) - 2023/04/12 19:18:37
Table 'RushAndCash5618563' 6-max Seat #1 is the button
Seat 1: e7ba75cb ($10.04 in chips)
Seat 2: Hero ($7.73 in chips)
Seat 3: 1609da7c ($10.34 in chips)
Seat 4: a5015beb ($15.12 in chips)
Seat 5: 5aeaa886 ($21.5 in chips)
Seat 6: ec825e33 ($14.61 in chips)
Hero: posts small blind $0.05
1609da7c: posts big blind $0.1
*** HOLE CARDS ***
Dealt to e7ba75cb 
Dealt to Hero [9d 7s]
Dealt to 1609da7c 
Dealt to a5015beb 
Dealt to 5aeaa886 
Dealt to ec825e33 
a5015beb: folds
5aeaa886: folds
ec825e33: raises $0.12 to $0.22
e7ba75cb: folds
Hero: folds
1609da7c: folds
Uncalled bet ($0.12) returned to ec825e33
*** SHOWDOWN ***
ec825e33 collected $0.25 from pot
*** SUMMARY ***
Total pot $0.25 | Rake $0 | Jackpot $0 | Bingo $0 | Fortune $0
Seat 1: e7ba75cb (button) folded before Flop (didn't bet)
Seat 2: Hero (small blind) folded before Flop
Seat 3: 1609da7c (big blind) folded before Flop
Seat 4: a5015beb folded before Flop (didn't bet)
Seat 5: 5aeaa886 folded before Flop (didn't bet)
Seat 6: ec825e33 collected ($0.25)


Poker Hand #RC1468393140: Hold'em No Limit  ($0.05/$0.1) - 2023/04/12 19:18:12
Table 'RushAndCash5618400' 6-max Seat #1 is the button
Seat 1: 5aeaa886 ($21.13 in chips)
Seat 2: cc12baf6 ($10.27 in chips)
Seat 3: 9a2a39a3 ($7.92 in chips)
Seat 4: de37e859 ($12.91 in chips)
Seat 5: 18e85256 ($8.96 in chips)
Seat 6: Hero ($7.98 in chips)
cc12baf6: posts small blind $0.05
9a2a39a3: posts big blind $0.1
*** HOLE CARDS ***
Dealt to 5aeaa886 
Dealt to cc12baf6 
Dealt to 9a2a39a3 
Dealt to de37e859 
Dealt to 18e85256 
Dealt to Hero [Ah 8d]
de37e859: folds
18e85256: folds
Hero: raises $0.15 to $0.25
5aeaa886: raises $0.65 to $0.9
cc12baf6: folds
9a2a39a3: folds
Hero: folds
Uncalled bet ($0.65) returned to 5aeaa886
*** SHOWDOWN ***
5aeaa886 collected $0.62 from pot
*** SUMMARY ***
Total pot $0.65 | Rake $0.03 | Jackpot $0 | Bingo $0 | Fortune $0
Seat 1: 5aeaa886 (button) collected ($0.62)
Seat 2: cc12baf6 (small blind) folded before Flop
Seat 3: 9a2a39a3 (big blind) folded before Flop
Seat 4: de37e859 folded before Flop (didn't bet)
Seat 5: 18e85256 folded before Flop (didn't bet)
Seat 6: Hero folded before Flop


Poker Hand #RC1468393112: Hold'em No Limit  ($0.05/$0.1) - 2023/04/12 19:18:08
Table 'RushAndCash5618372' 6-max Seat #1 is the button
Seat 1: 4b0f3ac7 ($14.91 in chips)
Seat 2: c6005af6 ($15.18 in chips)
Seat 3: 52fcaa49 ($10.55 in chips)
Seat 4: Hero ($7.98 in chips)
Seat 5: f07accb8 ($5.92 in chips)
Seat 6: 6c903ec8 ($18.47 in chips)
c6005af6: posts small blind $0.05
52fcaa49: posts big blind $0.1
*** HOLE CARDS ***
Dealt to 4b0f3ac7 
Dealt to c6005af6 
Dealt to 52fcaa49 
Dealt to Hero [9c Ks]
Dealt to f07accb8 
Dealt to 6c903ec8 
Hero: folds
f07accb8: folds
6c903ec8: folds
4b0f3ac7: raises $0.1 to $0.2
c6005af6: folds
52fcaa49: calls $0.1
*** FLOP *** [Ah 7s Td]
52fcaa49: checks
4b0f3ac7: checks
*** TURN *** [Ah 7s Td] [7c]
52fcaa49: checks
4b0f3ac7: bets $0.23
52fcaa49: raises $0.48 to $0.71
4b0f3ac7: calls $0.48
*** RIVER *** [Ah 7s Td 7c] [4c]
52fcaa49: bets $1.43
4b0f3ac7: calls $1.43
52fcaa49: shows [Jd Ac] (Pair of Aces and Pair of Sevens)
4b0f3ac7: shows [6s Ad] (Pair of Aces and Pair of Sevens)
*** SHOWDOWN ***
52fcaa49 collected $4.36 from pot
*** SUMMARY ***
Total pot $4.73 | Rake $0.22 | Jackpot $0.15 | Bingo $0 | Fortune $0
Board [Ah 7s Td 7c 4c]
Seat 1: 4b0f3ac7 (button) showed [6s Ad] and lost with Pair of Aces and Pair of Sevens
Seat 2: c6005af6 (small blind) folded before Flop
Seat 3: 52fcaa49 (big blind) showed [Jd Ac] and won ($4.36) with Pair of Aces and Pair of Sevens
Seat 4: Hero folded before Flop (didn't bet)
Seat 5: f07accb8 folded before Flop (didn't bet)
Seat 6: 6c903ec8 folded before Flop (didn't bet)


Poker Hand #RC1468392916: Hold'em No Limit  ($0.05/$0.1) - 2023/04/12 19:17:36
Table 'RushAndCash5618176' 6-max Seat #1 is the button
Seat 1: 52140b86 ($8.06 in chips)
Seat 2: Hero ($8.28 in chips)
Seat 3: c6005af6 ($14.91 in chips)
Seat 4: af9f76e1 ($12.71 in chips)
Seat 5: 945d04de ($10.15 in chips)
Seat 6: db1c9219 ($11.26 in chips)
Hero: posts small blind $0.05
c6005af6: posts big blind $0.1
*** HOLE CARDS ***
Dealt to 52140b86 
Dealt to Hero [9c Kd]
Dealt to c6005af6 
Dealt to af9f76e1 
Dealt to 945d04de 
Dealt to db1c9219 
af9f76e1: folds
945d04de: folds
db1c9219: folds
52140b86: folds
Hero: raises $0.2 to $0.3
c6005af6: calls $0.2
*** FLOP *** [2d 8h Jd]
Hero: checks
c6005af6: bets $0.45
Hero: folds
Uncalled bet ($0.45) returned to c6005af6
*** SHOWDOWN ***
c6005af6 collected $0.57 from pot
*** SUMMARY ***
Total pot $0.6 | Rake $0.03 | Jackpot $0 | Bingo $0 | Fortune $0
Board [2d 8h Jd]
Seat 1: 52140b86 (button) folded before Flop (didn't bet)
Seat 2: Hero (small blind) folded on the Flop
Seat 3: c6005af6 (big blind) won ($0.57)
Seat 4: af9f76e1 folded before Flop (didn't bet)
Seat 5: 945d04de folded before Flop (didn't bet)
Seat 6: db1c9219 folded before Flop (didn't bet)


Poker Hand #RC1468392397: Hold'em No Limit  ($0.05/$0.1) - 2023/04/12 19:16:12
Table 'RushAndCash5617657' 6-max Seat #1 is the button
Seat 1: c1e71bf3 ($13.07 in chips)
Seat 2: 52140b86 ($8.26 in chips)
Seat 3: Hero ($8.48 in chips)
Seat 4: 63d7b010 ($10 in chips)
Seat 5: c6005af6 ($13.21 in chips)
Seat 6: db1c9219 ($11.46 in chips)
Cash Drop to Pot : total $1 
52140b86: posts small blind $0.05
Hero: posts big blind $0.1
*** HOLE CARDS ***
Dealt to c1e71bf3 
Dealt to 52140b86 
Dealt to Hero [2h 6h]
Dealt to 63d7b010 
Dealt to c6005af6 
Dealt to db1c9219 
63d7b010: raises $0.1 to $0.2
c6005af6: calls $0.2
db1c9219: calls $0.2
c1e71bf3: folds
52140b86: calls $0.15
Hero: calls $0.1
*** FLOP *** [Ts Tc 3s]
52140b86: checks
Hero: checks
63d7b010: checks
c6005af6: checks
db1c9219: checks
*** TURN *** [Ts Tc 3s] [Qs]
52140b86: checks
Hero: checks
63d7b010: checks
c6005af6: checks
db1c9219: checks
*** RIVER *** [Ts Tc 3s Qs] [5d]
52140b86: checks
Hero: checks
63d7b010: checks
c6005af6: checks
db1c9219: checks
52140b86: shows [9s Jh] (Pair of Tens)
Hero: shows [2h 6h] (Pair of Tens)
63d7b010: shows [Ks 8d] (Pair of Tens)
c6005af6: shows [Jc Kh] (Pair of Tens)
db1c9219: shows [4s 2d] (Pair of Tens)
*** SHOWDOWN ***
c6005af6 collected $1.9 from pot
*** SUMMARY ***
Total pot $2 | Rake $0.1 | Jackpot $0 | Bingo $0 | Fortune $0
Board [Ts Tc 3s Qs 5d]
Seat 1: c1e71bf3 (button) folded before Flop (didn't bet)
Seat 2: 52140b86 (small blind) showed [9s Jh] and lost with Pair of Tens
Seat 3: Hero (big blind) showed [2h 6h] and lost with Pair of Tens
Seat 4: 63d7b010 showed [Ks 8d] and lost with Pair of Tens
Seat 5: c6005af6 showed [Jc Kh] and won ($1.9) with Pair of Tens
Seat 6: db1c9219 showed [4s 2d] and lost with Pair of Tens


Poker Hand #RC1468392322: Hold'em No Limit  ($0.05/$0.1) - 2023/04/12 19:15:58
Table 'RushAndCash5617582' 6-max Seat #1 is the button
Seat 1: fb268b85 ($7.76 in chips)
Seat 2: e92af09b ($16.01 in chips)
Seat 3: 2e1022e ($12.59 in chips)
Seat 4: 74cab156 ($11.16 in chips)
Seat 5: 14d08086 ($10.03 in chips)
Seat 6: Hero ($8.48 in chips)
e92af09b: posts small blind $0.05
2e1022e: posts big blind $0.1
*** HOLE CARDS ***
Dealt to fb268b85 
Dealt to e92af09b 
Dealt to 2e1022e 
Dealt to 74cab156 
Dealt to 14d08086 
Dealt to Hero [4s Jh]
74cab156: folds
14d08086: folds
Hero: folds
fb268b85: folds
e92af09b: folds
Uncalled bet ($0.05) returned to 2e1022e
*** SHOWDOWN ***
2e1022e collected $0.1 from pot
*** SUMMARY ***
Total pot $0.1 | Rake $0 | Jackpot $0 | Bingo $0 | Fortune $0
Seat 1: fb268b85 (button) folded before Flop (didn't bet)
Seat 2: e92af09b (small blind) folded before Flop
Seat 3: 2e1022e (big blind) collected ($0.1)
Seat 4: 74cab156 folded before Flop (didn't bet)
Seat 5: 14d08086 folded before Flop (didn't bet)
Seat 6: Hero folded before Flop (didn't bet)


Poker Hand #RC1468392273: Hold'em No Limit  ($0.05/$0.1) - 2023/04/12 19:15:50
Table 'RushAndCash5617533' 6-max Seat #1 is the button
Seat 1: Hero ($8.48 in chips)
Seat 2: fb836f3e ($9.69 in chips)
Seat 3: ec825e33 ($14.68 in chips)
Seat 4: 9a2a39a3 ($9.69 in chips)
Seat 5: 3bf969ff ($12.16 in chips)
Seat 6: 265f36f4 ($15.67 in chips)
fb836f3e: posts small blind $0.05
ec825e33: posts big blind $0.1
*** HOLE CARDS ***
Dealt to Hero [5d 6c]
Dealt to fb836f3e 
Dealt to ec825e33 
Dealt to 9a2a39a3 
Dealt to 3bf969ff 
Dealt to 265f36f4 
9a2a39a3: raises $0.2 to $0.3
3bf969ff: folds
265f36f4: folds
Hero: folds
fb836f3e: raises $0.9 to $1.2
ec825e33: folds
9a2a39a3: calls $0.9
*** FLOP *** [6s Kc 8s]
fb836f3e: bets $0.8
9a2a39a3: calls $0.8
*** TURN *** [6s Kc 8s] [3d]
fb836f3e: bets $2.71
9a2a39a3: folds
Uncalled bet ($2.71) returned to fb836f3e
*** SHOWDOWN ***
fb836f3e collected $3.76 from pot
*** SUMMARY ***
Total pot $4.1 | Rake $0.19 | Jackpot $0.15 | Bingo $0 | Fortune $0
Board [6s Kc 8s 3d]
Seat 1: Hero (button) folded before Flop (didn't bet)
Seat 2: fb836f3e (small blind) won ($3.76)
Seat 3: ec825e33 (big blind) folded before Flop
Seat 4: 9a2a39a3 folded on the Turn
Seat 5: 3bf969ff folded before Flop (didn't bet)
Seat 6: 265f36f4 folded before Flop (didn't bet)


Poker Hand #RC1468392194: Hold'em No Limit  ($0.05/$0.1) - 2023/04/12 19:15:38
Table 'RushAndCash5617454' 6-max Seat #1 is the button
Seat 1: e0d7b1d2 ($10 in chips)
Seat 2: 3236819 ($10 in chips)
Seat 3: a31d9536 ($19.97 in chips)
Seat 4: 6b999614 ($15.28 in chips)
Seat 5: 6bb948b2 ($38.94 in chips)
Seat 6: Hero ($8.48 in chips)
3236819: posts small blind $0.05
a31d9536: posts big blind $0.1
*** HOLE CARDS ***
Dealt to e0d7b1d2 
Dealt to 3236819 
Dealt to a31d9536 
Dealt to 6b999614 
Dealt to 6bb948b2 
Dealt to Hero [Qs 9c]
6b999614: raises $0.14 to $0.24
6bb948b2: folds
Hero: folds
e0d7b1d2: folds
3236819: folds
a31d9536: folds
Uncalled bet ($0.14) returned to 6b999614
*** SHOWDOWN ***
6b999614 collected $0.25 from pot
*** SUMMARY ***
Total pot $0.25 | Rake $0 | Jackpot $0 | Bingo $0 | Fortune $0
Seat 1: e0d7b1d2 (button) folded before Flop (didn't bet)
Seat 2: 3236819 (small blind) folded before Flop
Seat 3: a31d9536 (big blind) folded before Flop
Seat 4: 6b999614 collected ($0.25)
Seat 5: 6bb948b2 folded before Flop (didn't bet)
Seat 6: Hero folded before Flop (didn't bet)


Poker Hand #RC1468392109: Hold'em No Limit  ($0.05/$0.1) - 2023/04/12 19:15:26
Table 'RushAndCash5617369' 6-max Seat #1 is the button
Seat 1: b574e05 ($10.58 in chips)
Seat 2: a81c5b21 ($3.72 in chips)
Seat 3: 49600bcc ($61.1 in chips)
Seat 4: 57b5f4da ($13.47 in chips)
Seat 5: 94c2e07d ($9.85 in chips)
Seat 6: Hero ($8.33 in chips)
a81c5b21: posts small blind $0.05
49600bcc: posts big blind $0.1
*** HOLE CARDS ***
Dealt to b574e05 
Dealt to a81c5b21 
Dealt to 49600bcc 
Dealt to 57b5f4da 
Dealt to 94c2e07d 
Dealt to Hero [As Qc]
57b5f4da: folds
94c2e07d: folds
Hero: raises $0.15 to $0.25
b574e05: folds
a81c5b21: folds
49600bcc: folds
Uncalled bet ($0.15) returned to Hero
*** SHOWDOWN ***
Hero collected $0.25 from pot
*** SUMMARY ***
Total pot $0.25 | Rake $0 | Jackpot $0 | Bingo $0 | Fortune $0
Seat 1: b574e05 (button) folded before Flop (didn't bet)
Seat 2: a81c5b21 (small blind) folded before Flop
Seat 3: 49600bcc (big blind) folded before Flop
Seat 4: 57b5f4da folded before Flop (didn't bet)
Seat 5: 94c2e07d folded before Flop (didn't bet)
Seat 6: Hero collected ($0.25)


Poker Hand #RC1468392045: Hold'em No Limit  ($0.05/$0.1) - 2023/04/12 19:15:15
Table 'RushAndCash5617305' 6-max Seat #1 is the button
Seat 1: 77b0e65c ($45.48 in chips)
Seat 2: Hero ($8.38 in chips)
Seat 3: 98826e23 ($7.94 in chips)
Seat 4: 67a81530 ($10.23 in chips)
Seat 5: 94f8e065 ($6.18 in chips)
Seat 6: e6781ffc ($7.58 in chips)
Hero: posts small blind $0.05
98826e23: posts big blind $0.1
*** HOLE CARDS ***
Dealt to 77b0e65c 
Dealt to Hero [5s 4d]
Dealt to 98826e23 
Dealt to 67a81530 
Dealt to 94f8e065 
Dealt to e6781ffc 
67a81530: folds
94f8e065: folds
e6781ffc: raises $0.15 to $0.25
77b0e65c: folds
Hero: folds
98826e23: calls $0.15
*** FLOP *** [Qd 9c 8c]
98826e23: checks
e6781ffc: bets $0.19
98826e23: calls $0.19
*** TURN *** [Qd 9c 8c] [7d]
98826e23: checks
e6781ffc: bets $0.31
98826e23: calls $0.31
*** RIVER *** [Qd 9c 8c 7d] [5h]
98826e23: checks
e6781ffc: checks
98826e23: shows [8h Ad] (Pair of Eights)
e6781ffc: shows [Ts Tc] (Pair of Tens)
*** SHOWDOWN ***
e6781ffc collected $1.48 from pot
*** SUMMARY ***
Total pot $1.55 | Rake $0.07 | Jackpot $0 | Bingo $0 | Fortune $0
Board [Qd 9c 8c 7d 5h]
Seat 1: 77b0e65c (button) folded before Flop (didn't bet)
Seat 2: Hero (small blind) folded before Flop
Seat 3: 98826e23 (big blind) showed [8h Ad] and lost with Pair of Eights
Seat 4: 67a81530 folded before Flop (didn't bet)
Seat 5: 94f8e065 folded before Flop (didn't bet)
Seat 6: e6781ffc showed [Ts Tc] and won ($1.48) with Pair of Tens


Poker Hand #RC1468392020: Hold'em No Limit  ($0.05/$0.1) - 2023/04/12 19:15:11
Table 'RushAndCash5617280' 6-max Seat #1 is the button
Seat 1: 2f8b5e0c ($4.4 in chips)
Seat 2: fadee1aa ($9.9 in chips)
Seat 3: 74ccf940 ($16.47 in chips)
Seat 4: 3d149b47 ($14.9 in chips)
Seat 5: Hero ($8.38 in chips)
Seat 6: 6441fc6f ($12.95 in chips)
fadee1aa: posts small blind $0.05
74ccf940: posts big blind $0.1
*** HOLE CARDS ***
Dealt to 2f8b5e0c 
Dealt to fadee1aa 
Dealt to 74ccf940 
Dealt to 3d149b47 
Dealt to Hero [8d Ts]
Dealt to 6441fc6f 
3d149b47: folds
Hero: folds
6441fc6f: raises $0.15 to $0.25
2f8b5e0c: folds
fadee1aa: folds
74ccf940: calls $0.15
*** FLOP *** [Jd 9s 4c]
74ccf940: checks
6441fc6f: bets $0.2
74ccf940: calls $0.2
*** TURN *** [Jd 9s 4c] [8h]
74ccf940: checks
6441fc6f: bets $0.5
74ccf940: calls $0.5
*** RIVER *** [Jd 9s 4c 8h] [6d]
74ccf940: checks
6441fc6f: checks
74ccf940: shows [9d 7d] (Pair of Nines)
6441fc6f: shows [Kc Ah] (Ace-High)
*** SHOWDOWN ***
74ccf940 collected $1.86 from pot
*** SUMMARY ***
Total pot $1.95 | Rake $0.09 | Jackpot $0 | Bingo $0 | Fortune $0
Board [Jd 9s 4c 8h 6d]
Seat 1: 2f8b5e0c (button) folded before Flop (didn't bet)
Seat 2: fadee1aa (small blind) folded before Flop
Seat 3: 74ccf940 (big blind) showed [9d 7d] and won ($1.86) with Pair of Nines
Seat 4: 3d149b47 folded before Flop (didn't bet)
Seat 5: Hero folded before Flop (didn't bet)
Seat 6: 6441fc6f showed [Kc Ah] and lost with Ace-High


Poker Hand #RC1468391983: Hold'em No Limit  ($0.05/$0.1) - 2023/04/12 19:15:05
Table 'RushAndCash5617243' 6-max Seat #1 is the button
Seat 1: 6b999614 ($15.28 in chips)
Seat 2: 9d47fdba ($11.44 in chips)
Seat 3: 8941cc31 ($13.69 in chips)
Seat 4: 1d817480 ($9.45 in chips)
Seat 5: 2f01db10 ($30.14 in chips)
Seat 6: Hero ($8.38 in chips)
9d47fdba: posts small blind $0.05
8941cc31: posts big blind $0.1
*** HOLE CARDS ***
Dealt to 6b999614 
Dealt to 9d47fdba 
Dealt to 8941cc31 
Dealt to 1d817480 
Dealt to 2f01db10 
Dealt to Hero [Jd 7d]
1d817480: folds
2f01db10: folds
Hero: folds
6b999614: folds
9d47fdba: raises $0.2 to $0.3
8941cc31: folds
Uncalled bet ($0.2) returned to 9d47fdba
*** SHOWDOWN ***
9d47fdba collected $0.2 from pot
*** SUMMARY ***
Total pot $0.2 | Rake $0 | Jackpot $0 | Bingo $0 | Fortune $0
Seat 1: 6b999614 (button) folded before Flop (didn't bet)
Seat 2: 9d47fdba (small blind) collected ($0.2)
Seat 3: 8941cc31 (big blind) folded before Flop
Seat 4: 1d817480 folded before Flop (didn't bet)
Seat 5: 2f01db10 folded before Flop (didn't bet)
Seat 6: Hero folded before Flop (didn't bet)


Poker Hand #RC1468391641: Hold'em No Limit  ($0.05/$0.1) - 2023/04/12 19:14:08
Table 'RushAndCash5616901' 6-max Seat #1 is the button
Seat 1: 4f709fe7 ($6.98 in chips)
Seat 2: a31d9536 ($20.32 in chips)
Seat 3: Hero ($4.39 in chips)
Seat 4: 6b999614 ($19.67 in chips)
Seat 5: acc311b8 ($21.04 in chips)
Seat 6: a6133ad2 ($11.61 in chips)
a31d9536: posts small blind $0.05
Hero: posts big blind $0.1
*** HOLE CARDS ***
Dealt to 4f709fe7 
Dealt to a31d9536 
Dealt to Hero [Ad As]
Dealt to 6b999614 
Dealt to acc311b8 
Dealt to a6133ad2 
6b999614: raises $0.14 to $0.24
acc311b8: folds
a6133ad2: folds
4f709fe7: folds
a31d9536: folds
Hero: raises $0.56 to $0.8
6b999614: calls $0.56
*** FLOP *** [3d 4c Tc]
Hero: bets $0.83
6b999614: calls $0.83
*** TURN *** [3d 4c Tc] [6h]
Hero: bets $2.76 and is all-in
6b999614: calls $2.76
Hero: shows [Ad As] (Pair of Aces)
6b999614: shows [Qd Td] (Pair of Tens)
*** RIVER *** [3d 4c Tc 6h] [4d]
*** SHOWDOWN ***
Hero collected $8.38 from pot
*** SUMMARY ***
Total pot $8.83 | Rake $0.3 | Jackpot $0.15 | Bingo $0 | Fortune $0
Board [3d 4c Tc 6h 4d]
Seat 1: 4f709fe7 (button) folded before Flop (didn't bet)
Seat 2: a31d9536 (small blind) folded before Flop
Seat 3: Hero (big blind) showed [Ad As] and won ($8.38) with Pair of Aces and Pair of Fours
Seat 4: 6b999614 showed [Qd Td] and lost with Pair of Tens and Pair of Fours
Seat 5: acc311b8 folded before Flop (didn't bet)
Seat 6: a6133ad2 folded before Flop (didn't bet)


Poker Hand #RC1468391598: Hold'em No Limit  ($0.05/$0.1) - 2023/04/12 19:14:02
Table 'RushAndCash5616858' 6-max Seat #1 is the button
Seat 1: 87f2f24 ($12.22 in chips)
Seat 2: 97373969 ($10.72 in chips)
Seat 3: 3d9dd182 ($42 in chips)
Seat 4: 95e8a748 ($17.12 in chips)
Seat 5: 9e66cd6f ($9.25 in chips)
Seat 6: Hero ($4.39 in chips)
97373969: posts small blind $0.05
3d9dd182: posts big blind $0.1
*** HOLE CARDS ***
Dealt to 87f2f24 
Dealt to 97373969 
Dealt to 3d9dd182 
Dealt to 95e8a748 
Dealt to 9e66cd6f 
Dealt to Hero [6c 3c]
95e8a748: folds
9e66cd6f: folds
Hero: folds
87f2f24: folds
97373969: folds
Uncalled bet ($0.05) returned to 3d9dd182
*** SHOWDOWN ***
3d9dd182 collected $0.1 from pot
*** SUMMARY ***
Total pot $0.1 | Rake $0 | Jackpot $0 | Bingo $0 | Fortune $0
Seat 1: 87f2f24 (button) folded before Flop (didn't bet)
Seat 2: 97373969 (small blind) folded before Flop
Seat 3: 3d9dd182 (big blind) collected ($0.1)
Seat 4: 95e8a748 folded before Flop (didn't bet)
Seat 5: 9e66cd6f folded before Flop (didn't bet)
Seat 6: Hero folded before Flop (didn't bet)


Poker Hand #RC1468391377: Hold'em No Limit  ($0.05/$0.1) - 2023/04/12 19:13:25
Table 'RushAndCash5616637' 6-max Seat #1 is the button
Seat 1: Hero ($4.64 in chips)
Seat 2: 87f2f24 ($11.66 in chips)
Seat 3: 977c340b ($9.88 in chips)
Seat 4: 5c6336fb ($14.17 in chips)
Seat 5: 3d9dd182 ($42.25 in chips)
Seat 6: 750e9377 ($38.02 in chips)
87f2f24: posts small blind $0.05
977c340b: posts big blind $0.1
*** HOLE CARDS ***
Dealt to Hero [9d 8d]
Dealt to 87f2f24 
Dealt to 977c340b 
Dealt to 5c6336fb 
Dealt to 3d9dd182 
Dealt to 750e9377 
5c6336fb: folds
3d9dd182: raises $0.15 to $0.25
750e9377: folds
Hero: calls $0.25
87f2f24: calls $0.2
977c340b: folds
*** FLOP *** [2s Jc 5c]
87f2f24: checks
3d9dd182: checks
Hero: checks
*** TURN *** [2s Jc 5c] [6c]
87f2f24: bets $0.43
3d9dd182: folds
Hero: folds
Uncalled bet ($0.43) returned to 87f2f24
*** SHOWDOWN ***
87f2f24 collected $0.81 from pot
*** SUMMARY ***
Total pot $0.85 | Rake $0.04 | Jackpot $0 | Bingo $0 | Fortune $0
Board [2s Jc 5c 6c]
Seat 1: Hero (button) folded on the Turn
Seat 2: 87f2f24 (small blind) won ($0.81)
Seat 3: 977c340b (big blind) folded before Flop
Seat 4: 5c6336fb folded before Flop (didn't bet)
Seat 5: 3d9dd182 folded on the Turn
Seat 6: 750e9377 folded before Flop (didn't bet)


Poker Hand #RC1468391309: Hold'em No Limit  ($0.05/$0.1) - 2023/04/12 19:13:13
Table 'RushAndCash5616569' 6-max Seat #1 is the button
Seat 1: 434b0e23 ($21.17 in chips)
Seat 2: 51066abf ($10.05 in chips)
Seat 3: f6fa0331 ($11.87 in chips)
Seat 4: 9a236857 ($10.15 in chips)
Seat 5: 66632ef3 ($10.1 in chips)
Seat 6: Hero ($4.64 in chips)
51066abf: posts small blind $0.05
f6fa0331: posts big blind $0.1
*** HOLE CARDS ***
Dealt to 434b0e23 
Dealt to 51066abf 
Dealt to f6fa0331 
Dealt to 9a236857 
Dealt to 66632ef3 
Dealt to Hero [5c 9d]
9a236857: folds
66632ef3: folds
Hero: folds
434b0e23: folds
51066abf: raises $0.2 to $0.3
f6fa0331: folds
Uncalled bet ($0.2) returned to 51066abf
*** SHOWDOWN ***
51066abf collected $0.2 from pot
*** SUMMARY ***
Total pot $0.2 | Rake $0 | Jackpot $0 | Bingo $0 | Fortune $0
Seat 1: 434b0e23 (button) folded before Flop (didn't bet)
Seat 2: 51066abf (small blind) collected ($0.2)
Seat 3: f6fa0331 (big blind) folded before Flop
Seat 4: 9a236857 folded before Flop (didn't bet)
Seat 5: 66632ef3 folded before Flop (didn't bet)
Seat 6: Hero folded before Flop (didn't bet)


Poker Hand #RC1468391250: Hold'em No Limit  ($0.05/$0.1) - 2023/04/12 19:13:03
Table 'RushAndCash5616510' 6-max Seat #1 is the button
Seat 1: Hero ($4.64 in chips)
Seat 2: 2fe97adf ($6.26 in chips)
Seat 3: ab0e3a18 ($10.32 in chips)
Seat 4: 4c5e3a1d ($4.74 in chips)
Seat 5: 2e1022e ($12.64 in chips)
Seat 6: 8f9a6467 ($39.9 in chips)
2fe97adf: posts small blind $0.05
ab0e3a18: posts big blind $0.1
*** HOLE CARDS ***
Dealt to Hero [9c 6d]
Dealt to 2fe97adf 
Dealt to ab0e3a18 
Dealt to 4c5e3a1d 
Dealt to 2e1022e 
Dealt to 8f9a6467 
4c5e3a1d: raises $0.1 to $0.2
2e1022e: folds
8f9a6467: folds
Hero: folds
2fe97adf: raises $0.33 to $0.53
ab0e3a18: folds
4c5e3a1d: raises $4.21 to $4.74 and is all-in
2fe97adf: calls $4.21
4c5e3a1d: shows [Ac Kc]
2fe97adf: shows [Ad As]
*** FLOP *** [4s 6c 3d]
*** TURN *** [4s 6c 3d] [Ah]
*** RIVER *** [4s 6c 3d Ah] [5s]
*** SHOWDOWN ***
2fe97adf collected $9.13 from pot
*** SUMMARY ***
Total pot $9.58 | Rake $0.3 | Jackpot $0.15 | Bingo $0 | Fortune $0
Board [4s 6c 3d Ah 5s]
Seat 1: Hero (button) folded before Flop (didn't bet)
Seat 2: 2fe97adf (small blind) showed [Ad As] and won ($9.13) with Three Aces
Seat 3: ab0e3a18 (big blind) folded before Flop
Seat 4: 4c5e3a1d showed [Ac Kc] and lost with Pair of Aces
Seat 5: 2e1022e folded before Flop (didn't bet)
Seat 6: 8f9a6467 folded before Flop (didn't bet)


Poker Hand #RC1468391187: Hold'em No Limit  ($0.05/$0.1) - 2023/04/12 19:12:53
Table 'RushAndCash5616447' 6-max Seat #1 is the button
Seat 1: adbda47d ($47.61 in chips)
Seat 2: Hero ($4.69 in chips)
Seat 3: 68a19d88 ($14.01 in chips)
Seat 4: bfbec681 ($10.82 in chips)
Seat 5: 90b414a9 ($21.33 in chips)
Seat 6: 8aea79f8 ($10.2 in chips)
Hero: posts small blind $0.05
68a19d88: posts big blind $0.1
*** HOLE CARDS ***
Dealt to adbda47d 
Dealt to Hero [4c 8s]
Dealt to 68a19d88 
Dealt to bfbec681 
Dealt to 90b414a9 
Dealt to 8aea79f8 
bfbec681: folds
90b414a9: raises $0.15 to $0.25
8aea79f8: folds
adbda47d: folds
Hero: folds
68a19d88: folds
Uncalled bet ($0.15) returned to 90b414a9
*** SHOWDOWN ***
90b414a9 collected $0.25 from pot
*** SUMMARY ***
Total pot $0.25 | Rake $0 | Jackpot $0 | Bingo $0 | Fortune $0
Seat 1: adbda47d (button) folded before Flop (didn't bet)
Seat 2: Hero (small blind) folded before Flop
Seat 3: 68a19d88 (big blind) folded before Flop
Seat 4: bfbec681 folded before Flop (didn't bet)
Seat 5: 90b414a9 collected ($0.25)
Seat 6: 8aea79f8 folded before Flop (didn't bet)


Poker Hand #RC1468391105: Hold'em No Limit  ($0.05/$0.1) - 2023/04/12 19:12:39
Table 'RushAndCash5616365' 6-max Seat #1 is the button
Seat 1: 4bdbd306 ($10.15 in chips)
Seat 2: 4afd4208 ($10.54 in chips)
Seat 3: Hero ($4.64 in chips)
Seat 4: 6c7786e5 ($11.76 in chips)
Seat 5: 52c0e247 ($10 in chips)
Seat 6: ba4d0ff6 ($14.62 in chips)
4afd4208: posts small blind $0.05
Hero: posts big blind $0.1
*** HOLE CARDS ***
Dealt to 4bdbd306 
Dealt to 4afd4208 
Dealt to Hero [7d 6s]
Dealt to 6c7786e5 
Dealt to 52c0e247 
Dealt to ba4d0ff6 
6c7786e5: folds
52c0e247: folds
ba4d0ff6: folds
4bdbd306: folds
4afd4208: folds
Uncalled bet ($0.05) returned to Hero
*** SHOWDOWN ***
Hero collected $0.1 from pot
*** SUMMARY ***
Total pot $0.1 | Rake $0 | Jackpot $0 | Bingo $0 | Fortune $0
Seat 1: 4bdbd306 (button) folded before Flop (didn't bet)
Seat 2: 4afd4208 (small blind) folded before Flop
Seat 3: Hero (big blind) collected ($0.1)
Seat 4: 6c7786e5 folded before Flop (didn't bet)
Seat 5: 52c0e247 folded before Flop (didn't bet)
Seat 6: ba4d0ff6 folded before Flop (didn't bet)


Poker Hand #RC1468391077: Hold'em No Limit  ($0.05/$0.1) - 2023/04/12 19:12:35
Table 'RushAndCash5616337' 6-max Seat #1 is the button
Seat 1: dff3ca78 ($11.46 in chips)
Seat 2: 7e549c5c ($12 in chips)
Seat 3: 51580662 ($5.18 in chips)
Seat 4: Hero ($4.64 in chips)
Seat 5: 4b33fe04 ($6.16 in chips)
Seat 6: ec8d47d1 ($9.11 in chips)
7e549c5c: posts small blind $0.05
51580662: posts big blind $0.1
*** HOLE CARDS ***
Dealt to dff3ca78 
Dealt to 7e549c5c 
Dealt to 51580662 
Dealt to Hero [8h Ac]
Dealt to 4b33fe04 
Dealt to ec8d47d1 
Hero: folds
4b33fe04: folds
ec8d47d1: folds
dff3ca78: raises $0.1 to $0.2
7e549c5c: raises $0.5 to $0.7
51580662: folds
dff3ca78: folds
Uncalled bet ($0.5) returned to 7e549c5c
*** SHOWDOWN ***
7e549c5c collected $0.48 from pot
*** SUMMARY ***
Total pot $0.5 | Rake $0.02 | Jackpot $0 | Bingo $0 | Fortune $0
Seat 1: dff3ca78 (button) folded before Flop
Seat 2: 7e549c5c (small blind) collected ($0.48)
Seat 3: 51580662 (big blind) folded before Flop
Seat 4: Hero folded before Flop (didn't bet)
Seat 5: 4b33fe04 folded before Flop (didn't bet)
Seat 6: ec8d47d1 folded before Flop (didn't bet)


Poker Hand #RC1468390589: Hold'em No Limit  ($0.05/$0.1) - 2023/04/12 19:11:24
Table 'RushAndCash5615849' 6-max Seat #1 is the button
Seat 1: Hero ($5.66 in chips)
Seat 2: 46fcd3d4 ($8.62 in chips)
Seat 3: 7e549c5c ($11.03 in chips)
Seat 4: bed651ef ($18.87 in chips)
Seat 5: cb1d5a3c ($9.01 in chips)
Seat 6: 9bd4513 ($22.34 in chips)
46fcd3d4: posts small blind $0.05
7e549c5c: posts big blind $0.1
*** HOLE CARDS ***
Dealt to Hero [9h Ah]
Dealt to 46fcd3d4 
Dealt to 7e549c5c 
Dealt to bed651ef 
Dealt to cb1d5a3c 
Dealt to 9bd4513 
bed651ef: folds
cb1d5a3c: folds
9bd4513: folds
Hero: raises $0.15 to $0.25
46fcd3d4: folds
7e549c5c: calls $0.15
*** FLOP *** [Jh 4s Jd]
7e549c5c: checks
Hero: checks
*** TURN *** [Jh 4s Jd] [3h]
7e549c5c: bets $0.77
Hero: calls $0.77
*** RIVER *** [Jh 4s Jd 3h] [As]
7e549c5c: bets $10.01 and is all-in
Hero: folds
Uncalled bet ($10.01) returned to 7e549c5c
Hero: shows [9h Ah] (Pair of Aces and Pair of Jacks)
*** SHOWDOWN ***
7e549c5c collected $1.99 from pot
*** SUMMARY ***
Total pot $2.09 | Rake $0.1 | Jackpot $0 | Bingo $0 | Fortune $0
Board [Jh 4s Jd 3h As]
Seat 1: Hero (button) folded on the River
Seat 2: 46fcd3d4 (small blind) folded before Flop
Seat 3: 7e549c5c (big blind) won ($1.99)
Seat 4: bed651ef folded before Flop (didn't bet)
Seat 5: cb1d5a3c folded before Flop (didn't bet)
Seat 6: 9bd4513 folded before Flop (didn't bet)


Poker Hand #RC1468389880: Hold'em No Limit  ($0.05/$0.1) - 2023/04/12 19:09:39
Table 'RushAndCash5615140' 6-max Seat #1 is the button
Seat 1: 82fa3321 ($18.23 in chips)
Seat 2: 58cc637 ($10.61 in chips)
Seat 3: 1278ad6 ($9.77 in chips)
Seat 4: Hero ($8.9 in chips)
Seat 5: 2bc8b322 ($10.05 in chips)
Seat 6: 9bd4513 ($19 in chips)
58cc637: posts small blind $0.05
1278ad6: posts big blind $0.1
*** HOLE CARDS ***
Dealt to 82fa3321 
Dealt to 58cc637 
Dealt to 1278ad6 
Dealt to Hero [Kd Ah]
Dealt to 2bc8b322 
Dealt to 9bd4513 
Hero: raises $0.15 to $0.25
2bc8b322: folds
9bd4513: calls $0.25
82fa3321: calls $0.25
58cc637: folds
1278ad6: calls $0.15
*** FLOP *** [Ac Qh 5c]
1278ad6: checks
Hero: bets $0.53
9bd4513: calls $0.53
82fa3321: folds
1278ad6: folds
*** TURN *** [Ac Qh 5c] [2c]
Hero: bets $1.06
9bd4513: calls $1.06
*** RIVER *** [Ac Qh 5c 2c] [5d]
Hero: bets $1.4
9bd4513: raises $5.28 to $6.68
Hero: folds
Uncalled bet ($5.28) returned to 9bd4513
9bd4513: shows [6c Kc] (Ace High Flush)
*** SHOWDOWN ***
9bd4513 collected $6.58 from pot
*** SUMMARY ***
Total pot $7.03 | Rake $0.3 | Jackpot $0.15 | Bingo $0 | Fortune $0
Board [Ac Qh 5c 2c 5d]
Seat 1: 82fa3321 (button) folded on the Flop
Seat 2: 58cc637 (small blind) folded before Flop
Seat 3: 1278ad6 (big blind) folded on the Flop
Seat 4: Hero folded on the River
Seat 5: 2bc8b322 folded before Flop (didn't bet)
Seat 6: 9bd4513 showed [6c Kc] and won ($6.58) with Ace High Flush


Poker Hand #RC1468389611: Hold'em No Limit  ($0.05/$0.1) - 2023/04/12 19:09:02
Table 'RushAndCash5614871' 6-max Seat #1 is the button
Seat 1: 83dfe13b ($10.49 in chips)
Seat 2: d3c4014a ($10.25 in chips)
Seat 3: 5e0ca113 ($12.57 in chips)
Seat 4: 921a0b3f ($11.73 in chips)
Seat 5: 31fdab54 ($10 in chips)
Seat 6: Hero ($8.62 in chips)
d3c4014a: posts small blind $0.05
5e0ca113: posts big blind $0.1
*** HOLE CARDS ***
Dealt to 83dfe13b 
Dealt to d3c4014a 
Dealt to 5e0ca113 
Dealt to 921a0b3f 
Dealt to 31fdab54 
Dealt to Hero [Kc Qc]
921a0b3f: folds
31fdab54: folds
Hero: raises $0.15 to $0.25
83dfe13b: folds
d3c4014a: folds
5e0ca113: calls $0.15
*** FLOP *** [Jc Kd Ad]
5e0ca113: checks
Hero: checks
*** TURN *** [Jc Kd Ad] [3s]
5e0ca113: checks
Hero: bets $0.19
5e0ca113: folds
Uncalled bet ($0.19) returned to Hero
*** SHOWDOWN ***
Hero collected $0.53 from pot
*** SUMMARY ***
Total pot $0.55 | Rake $0.02 | Jackpot $0 | Bingo $0 | Fortune $0
Board [Jc Kd Ad 3s]
Seat 1: 83dfe13b (button) folded before Flop (didn't bet)
Seat 2: d3c4014a (small blind) folded before Flop
Seat 3: 5e0ca113 (big blind) folded on the Turn
Seat 4: 921a0b3f folded before Flop (didn't bet)
Seat 5: 31fdab54 folded before Flop (didn't bet)
Seat 6: Hero won ($0.53)


Poker Hand #RC1468389519: Hold'em No Limit  ($0.05/$0.1) - 2023/04/12 19:08:49
Table 'RushAndCash5614779' 6-max Seat #1 is the button
Seat 1: 588a268c ($12.86 in chips)
Seat 2: Hero ($8.67 in chips)
Seat 3: e6b0c676 ($11.56 in chips)
Seat 4: 118af7bc ($10 in chips)
Seat 5: fc29cdac ($16.57 in chips)
Seat 6: 744965be ($10.51 in chips)
Hero: posts small blind $0.05
e6b0c676: posts big blind $0.1
*** HOLE CARDS ***
Dealt to 588a268c 
Dealt to Hero [5d Th]
Dealt to e6b0c676 
Dealt to 118af7bc 
Dealt to fc29cdac 
Dealt to 744965be 
118af7bc: folds
fc29cdac: folds
744965be: raises $0.2 to $0.3
588a268c: folds
Hero: folds
e6b0c676: folds
Uncalled bet ($0.2) returned to 744965be
*** SHOWDOWN ***
744965be collected $0.25 from pot
*** SUMMARY ***
Total pot $0.25 | Rake $0 | Jackpot $0 | Bingo $0 | Fortune $0
Seat 1: 588a268c (button) folded before Flop (didn't bet)
Seat 2: Hero (small blind) folded before Flop
Seat 3: e6b0c676 (big blind) folded before Flop
Seat 4: 118af7bc folded before Flop (didn't bet)
Seat 5: fc29cdac folded before Flop (didn't bet)
Seat 6: 744965be collected ($0.25)


Poker Hand #RC1468389224: Hold'em No Limit  ($0.05/$0.1) - 2023/04/12 19:08:07
Table 'RushAndCash5614484' 6-max Seat #1 is the button
Seat 1: 66632ef3 ($10.22 in chips)
Seat 2: cdb2f412 ($10.19 in chips)
Seat 3: ea40cd2c ($10.36 in chips)
Seat 4: b02be98e ($18.23 in chips)
Seat 5: 9e2dc00d ($11.24 in chips)
Seat 6: Hero ($9.17 in chips)
cdb2f412: posts small blind $0.05
ea40cd2c: posts big blind $0.1
*** HOLE CARDS ***
Dealt to 66632ef3 
Dealt to cdb2f412 
Dealt to ea40cd2c 
Dealt to b02be98e 
Dealt to 9e2dc00d 
Dealt to Hero [Jd Kc]
b02be98e: folds
9e2dc00d: folds
Hero: raises $0.15 to $0.25
66632ef3: folds
cdb2f412: calls $0.2
ea40cd2c: calls $0.15
*** FLOP *** [Ts 3d 8d]
cdb2f412: bets $0.25
ea40cd2c: folds
Hero: calls $0.25
*** TURN *** [Ts 3d 8d] [6s]
cdb2f412: bets $0.94
Hero: folds
Uncalled bet ($0.94) returned to cdb2f412
*** SHOWDOWN ***
cdb2f412 collected $1.19 from pot
*** SUMMARY ***
Total pot $1.25 | Rake $0.06 | Jackpot $0 | Bingo $0 | Fortune $0
Board [Ts 3d 8d 6s]
Seat 1: 66632ef3 (button) folded before Flop (didn't bet)
Seat 2: cdb2f412 (small blind) won ($1.19)
Seat 3: ea40cd2c (big blind) folded on the Flop
Seat 4: b02be98e folded before Flop (didn't bet)
Seat 5: 9e2dc00d folded before Flop (didn't bet)
Seat 6: Hero folded on the Turn


Poker Hand #RC1468389156: Hold'em No Limit  ($0.05/$0.1) - 2023/04/12 19:07:58
Table 'RushAndCash5614416' 6-max Seat #1 is the button
Seat 1: 7815dbab ($23.66 in chips)
Seat 2: 588a268c ($12.76 in chips)
Seat 3: Hero ($9.27 in chips)
Seat 4: 46fcd3d4 ($8.98 in chips)
Seat 5: 7d6041fb ($18.16 in chips)
Seat 6: 2a0ad915 ($10 in chips)
588a268c: posts small blind $0.05
Hero: posts big blind $0.1
*** HOLE CARDS ***
Dealt to 7815dbab 
Dealt to 588a268c 
Dealt to Hero [8h Td]
Dealt to 46fcd3d4 
Dealt to 7d6041fb 
Dealt to 2a0ad915 
46fcd3d4: folds
7d6041fb: folds
2a0ad915: folds
7815dbab: folds
588a268c: raises $0.2 to $0.3
Hero: folds
Uncalled bet ($0.2) returned to 588a268c
*** SHOWDOWN ***
588a268c collected $0.2 from pot
*** SUMMARY ***
Total pot $0.2 | Rake $0 | Jackpot $0 | Bingo $0 | Fortune $0
Seat 1: 7815dbab (button) folded before Flop (didn't bet)
Seat 2: 588a268c (small blind) collected ($0.2)
Seat 3: Hero (big blind) folded before Flop
Seat 4: 46fcd3d4 folded before Flop (didn't bet)
Seat 5: 7d6041fb folded before Flop (didn't bet)
Seat 6: 2a0ad915 folded before Flop (didn't bet)


Poker Hand #RC1468389124: Hold'em No Limit  ($0.05/$0.1) - 2023/04/12 19:07:53
Table 'RushAndCash5614384' 6-max Seat #1 is the button
Seat 1: cb1d5a3c ($10 in chips)
Seat 2: e1f263c8 ($9.58 in chips)
Seat 3: 87f2f24 ($11.53 in chips)
Seat 4: 8d22595a ($10 in chips)
Seat 5: 265f36f4 ($16.33 in chips)
Seat 6: Hero ($9.27 in chips)
e1f263c8: posts small blind $0.05
87f2f24: posts big blind $0.1
*** HOLE CARDS ***
Dealt to cb1d5a3c 
Dealt to e1f263c8 
Dealt to 87f2f24 
Dealt to 8d22595a 
Dealt to 265f36f4 
Dealt to Hero [3c 2c]
8d22595a: raises $0.2 to $0.3
265f36f4: folds
Hero: folds
cb1d5a3c: folds
e1f263c8: folds
87f2f24: folds
Uncalled bet ($0.2) returned to 8d22595a
*** SHOWDOWN ***
8d22595a collected $0.25 from pot
*** SUMMARY ***
Total pot $0.25 | Rake $0 | Jackpot $0 | Bingo $0 | Fortune $0
Seat 1: cb1d5a3c (button) folded before Flop (didn't bet)
Seat 2: e1f263c8 (small blind) folded before Flop
Seat 3: 87f2f24 (big blind) folded before Flop
Seat 4: 8d22595a collected ($0.25)
Seat 5: 265f36f4 folded before Flop (didn't bet)
Seat 6: Hero folded before Flop (didn't bet)


Poker Hand #RC1468389098: Hold'em No Limit  ($0.05/$0.1) - 2023/04/12 19:07:49
Table 'RushAndCash5614358' 6-max Seat #1 is the button
Seat 1: a1f82121 ($31.44 in chips)
Seat 2: f2b01908 ($28.8 in chips)
Seat 3: 7d9214a4 ($10.76 in chips)
Seat 4: Hero ($9.27 in chips)
Seat 5: 750e9377 ($36.2 in chips)
Seat 6: 8809231a ($13.6 in chips)
f2b01908: posts small blind $0.05
7d9214a4: posts big blind $0.1
*** HOLE CARDS ***
Dealt to a1f82121 
Dealt to f2b01908 
Dealt to 7d9214a4 
Dealt to Hero [2h Ah]
Dealt to 750e9377 
Dealt to 8809231a 
Hero: folds
750e9377: folds
8809231a: folds
a1f82121: folds
f2b01908: folds
Uncalled bet ($0.05) returned to 7d9214a4
*** SHOWDOWN ***
7d9214a4 collected $0.1 from pot
*** SUMMARY ***
Total pot $0.1 | Rake $0 | Jackpot $0 | Bingo $0 | Fortune $0
Seat 1: a1f82121 (button) folded before Flop (didn't bet)
Seat 2: f2b01908 (small blind) folded before Flop
Seat 3: 7d9214a4 (big blind) collected ($0.1)
Seat 4: Hero folded before Flop (didn't bet)
Seat 5: 750e9377 folded before Flop (didn't bet)
Seat 6: 8809231a folded before Flop (didn't bet)


Poker Hand #RC1468389046: Hold'em No Limit  ($0.05/$0.1) - 2023/04/12 19:07:41
Table 'RushAndCash5614306' 6-max Seat #1 is the button
Seat 1: eea08caf ($11.68 in chips)
Seat 2: Hero ($9.32 in chips)
Seat 3: c0cd0f2 ($15.5 in chips)
Seat 4: 5da15ccc ($10.76 in chips)
Seat 5: bb03a8cb ($14.68 in chips)
Seat 6: 2e694c7e ($23.84 in chips)
Hero: posts small blind $0.05
c0cd0f2: posts big blind $0.1
*** HOLE CARDS ***
Dealt to eea08caf 
Dealt to Hero [3c 4s]
Dealt to c0cd0f2 
Dealt to 5da15ccc 
Dealt to bb03a8cb 
Dealt to 2e694c7e 
5da15ccc: folds
bb03a8cb: folds
2e694c7e: folds
eea08caf: folds
Hero: folds
Uncalled bet ($0.05) returned to c0cd0f2
*** SHOWDOWN ***
c0cd0f2 collected $0.1 from pot
*** SUMMARY ***
Total pot $0.1 | Rake $0 | Jackpot $0 | Bingo $0 | Fortune $0
Seat 1: eea08caf (button) folded before Flop (didn't bet)
Seat 2: Hero (small blind) folded before Flop
Seat 3: c0cd0f2 (big blind) collected ($0.1)
Seat 4: 5da15ccc folded before Flop (didn't bet)
Seat 5: bb03a8cb folded before Flop (didn't bet)
Seat 6: 2e694c7e folded before Flop (didn't bet)


Poker Hand #RC1468388991: Hold'em No Limit  ($0.05/$0.1) - 2023/04/12 19:07:33
Table 'RushAndCash5614251' 6-max Seat #1 is the button
Seat 1: a42dd805 ($11.87 in chips)
Seat 2: c56a6741 ($10.74 in chips)
Seat 3: Hero ($9.42 in chips)
Seat 4: 71621ffe ($11.79 in chips)
Seat 5: b1087382 ($10 in chips)
Seat 6: 5da15ccc ($10.76 in chips)
c56a6741: posts small blind $0.05
Hero: posts big blind $0.1
*** HOLE CARDS ***
Dealt to a42dd805 
Dealt to c56a6741 
Dealt to Hero [Ts 8d]
Dealt to 71621ffe 
Dealt to b1087382 
Dealt to 5da15ccc 
71621ffe: raises $0.12 to $0.22
b1087382: folds
5da15ccc: folds
a42dd805: folds
c56a6741: folds
Hero: folds
Uncalled bet ($0.12) returned to 71621ffe
*** SHOWDOWN ***
71621ffe collected $0.25 from pot
*** SUMMARY ***
Total pot $0.25 | Rake $0 | Jackpot $0 | Bingo $0 | Fortune $0
Seat 1: a42dd805 (button) folded before Flop (didn't bet)
Seat 2: c56a6741 (small blind) folded before Flop
Seat 3: Hero (big blind) folded before Flop
Seat 4: 71621ffe collected ($0.25)
Seat 5: b1087382 folded before Flop (didn't bet)
Seat 6: 5da15ccc folded before Flop (didn't bet)


Poker Hand #RC1468388864: Hold'em No Limit  ($0.05/$0.1) - 2023/04/12 19:07:15
Table 'RushAndCash5614124' 6-max Seat #1 is the button
Seat 1: Hero ($9.42 in chips)
Seat 2: c4a80d76 ($10.08 in chips)
Seat 3: 58cc637 ($10.86 in chips)
Seat 4: 62169933 ($10.05 in chips)
Seat 5: a49b99da ($30.39 in chips)
Seat 6: e1f263c8 ($9.68 in chips)
c4a80d76: posts small blind $0.05
58cc637: posts big blind $0.1
*** HOLE CARDS ***
Dealt to Hero [As 6h]
Dealt to c4a80d76 
Dealt to 58cc637 
Dealt to 62169933 
Dealt to a49b99da 
Dealt to e1f263c8 
62169933: folds
a49b99da: raises $0.12 to $0.22
e1f263c8: folds
Hero: folds
c4a80d76: folds
58cc637: folds
Uncalled bet ($0.12) returned to a49b99da
*** SHOWDOWN ***
a49b99da collected $0.25 from pot
*** SUMMARY ***
Total pot $0.25 | Rake $0 | Jackpot $0 | Bingo $0 | Fortune $0
Seat 1: Hero (button) folded before Flop (didn't bet)
Seat 2: c4a80d76 (small blind) folded before Flop
Seat 3: 58cc637 (big blind) folded before Flop
Seat 4: 62169933 folded before Flop (didn't bet)
Seat 5: a49b99da collected ($0.25)
Seat 6: e1f263c8 folded before Flop (didn't bet)


Poker Hand #RC1468388791: Hold'em No Limit  ($0.05/$0.1) - 2023/04/12 19:07:05
Table 'RushAndCash5614051' 6-max Seat #1 is the button
Seat 1: ec8d47d1 ($14.2 in chips)
Seat 2: b7d6ca ($18.52 in chips)
Seat 3: e6b0c676 ($11.66 in chips)
Seat 4: Hero ($9.42 in chips)
Seat 5: 7508db61 ($45.39 in chips)
Seat 6: 8c845fa8 ($13.32 in chips)
b7d6ca: posts small blind $0.05
e6b0c676: posts big blind $0.1
*** HOLE CARDS ***
Dealt to ec8d47d1 
Dealt to b7d6ca 
Dealt to e6b0c676 
Dealt to Hero [2h 9c]
Dealt to 7508db61 
Dealt to 8c845fa8 
Hero: folds
7508db61: folds
8c845fa8: folds
ec8d47d1: raises $0.15 to $0.25
b7d6ca: calls $0.2
e6b0c676: folds
*** FLOP *** [Ad 2s 8s]
b7d6ca: checks
ec8d47d1: checks
*** TURN *** [Ad 2s 8s] [9s]
b7d6ca: bets $0.3
ec8d47d1: calls $0.3
*** RIVER *** [Ad 2s 8s 9s] [2c]
b7d6ca: bets $0.6
ec8d47d1: folds
Uncalled bet ($0.6) returned to b7d6ca
*** SHOWDOWN ***
b7d6ca collected $1.14 from pot
*** SUMMARY ***
Total pot $1.2 | Rake $0.06 | Jackpot $0 | Bingo $0 | Fortune $0
Board [Ad 2s 8s 9s 2c]
Seat 1: ec8d47d1 (button) folded on the River
Seat 2: b7d6ca (small blind) won ($1.14)
Seat 3: e6b0c676 (big blind) folded before Flop
Seat 4: Hero folded before Flop (didn't bet)
Seat 5: 7508db61 folded before Flop (didn't bet)
Seat 6: 8c845fa8 folded before Flop (didn't bet)


Poker Hand #RC1468388677: Hold'em No Limit  ($0.05/$0.1) - 2023/04/12 19:06:48
Table 'RushAndCash5613937' 6-max Seat #1 is the button
Seat 1: 79d1f98a ($17.2 in chips)
Seat 2: c6eeb32f ($10.33 in chips)
Seat 3: 6c903ec8 ($14.71 in chips)
Seat 4: Hero ($9.42 in chips)
Seat 5: 4afd4208 ($10.32 in chips)
Seat 6: e190471b ($22.59 in chips)
c6eeb32f: posts small blind $0.05
6c903ec8: posts big blind $0.1
*** HOLE CARDS ***
Dealt to 79d1f98a 
Dealt to c6eeb32f 
Dealt to 6c903ec8 
Dealt to Hero [Kd 3s]
Dealt to 4afd4208 
Dealt to e190471b 
Hero: folds
4afd4208: folds
e190471b: folds
79d1f98a: raises $0.1 to $0.2
c6eeb32f: folds
6c903ec8: calls $0.1
*** FLOP *** [9d 4c 7s]
6c903ec8: checks
79d1f98a: bets $0.34
6c903ec8: folds
Uncalled bet ($0.34) returned to 79d1f98a
*** SHOWDOWN ***
79d1f98a collected $0.43 from pot
*** SUMMARY ***
Total pot $0.45 | Rake $0.02 | Jackpot $0 | Bingo $0 | Fortune $0
Board [9d 4c 7s]
Seat 1: 79d1f98a (button) won ($0.43)
Seat 2: c6eeb32f (small blind) folded before Flop
Seat 3: 6c903ec8 (big blind) folded on the Flop
Seat 4: Hero folded before Flop (didn't bet)
Seat 5: 4afd4208 folded before Flop (didn't bet)
Seat 6: e190471b folded before Flop (didn't bet)


Poker Hand #RC1468388618: Hold'em No Limit  ($0.05/$0.1) - 2023/04/12 19:06:39
Table 'RushAndCash5613878' 6-max Seat #1 is the button
Seat 1: 2e694c7e ($23.12 in chips)
Seat 2: 17afdc8e ($11.98 in chips)
Seat 3: 4c5e3a1d ($3.8 in chips)
Seat 4: ce2392b ($49.63 in chips)
Seat 5: 83dfe13b ($10.62 in chips)
Seat 6: Hero ($9.42 in chips)
17afdc8e: posts small blind $0.05
4c5e3a1d: posts big blind $0.1
*** HOLE CARDS ***
Dealt to 2e694c7e 
Dealt to 17afdc8e 
Dealt to 4c5e3a1d 
Dealt to ce2392b 
Dealt to 83dfe13b 
Dealt to Hero [8h 9c]
ce2392b: folds
83dfe13b: raises $0.1 to $0.2
Hero: folds
2e694c7e: raises $0.5 to $0.7
17afdc8e: folds
4c5e3a1d: calls $0.6
83dfe13b: folds
*** FLOP *** [As 2c 9d]
4c5e3a1d: checks
2e694c7e: bets $0.2
4c5e3a1d: folds
Uncalled bet ($0.2) returned to 2e694c7e
*** SHOWDOWN ***
2e694c7e collected $1.57 from pot
*** SUMMARY ***
Total pot $1.65 | Rake $0.08 | Jackpot $0 | Bingo $0 | Fortune $0
Board [As 2c 9d]
Seat 1: 2e694c7e (button) won ($1.57)
Seat 2: 17afdc8e (small blind) folded before Flop
Seat 3: 4c5e3a1d (big blind) folded on the Flop
Seat 4: ce2392b folded before Flop (didn't bet)
Seat 5: 83dfe13b folded before Flop
Seat 6: Hero folded before Flop (didn't bet)


Poker Hand #RC1468388587: Hold'em No Limit  ($0.05/$0.1) - 2023/04/12 19:06:34
Table 'RushAndCash5613847' 6-max Seat #1 is the button
Seat 1: Hero ($9.42 in chips)
Seat 2: bed651ef ($23.18 in chips)
Seat 3: 8883a606 ($10.15 in chips)
Seat 4: 3dca6066 ($12.58 in chips)
Seat 5: 4a23b929 ($10.23 in chips)
Seat 6: 5e2588a2 ($6.78 in chips)
bed651ef: posts small blind $0.05
8883a606: posts big blind $0.1
*** HOLE CARDS ***
Dealt to Hero [7h 3c]
Dealt to bed651ef 
Dealt to 8883a606 
Dealt to 3dca6066 
Dealt to 4a23b929 
Dealt to 5e2588a2 
3dca6066: folds
4a23b929: folds
5e2588a2: folds
Hero: folds
bed651ef: raises $0.2 to $0.3
8883a606: folds
Uncalled bet ($0.2) returned to bed651ef
*** SHOWDOWN ***
bed651ef collected $0.2 from pot
*** SUMMARY ***
Total pot $0.2 | Rake $0 | Jackpot $0 | Bingo $0 | Fortune $0
Seat 1: Hero (button) folded before Flop (didn't bet)
Seat 2: bed651ef (small blind) collected ($0.2)
Seat 3: 8883a606 (big blind) folded before Flop
Seat 4: 3dca6066 folded before Flop (didn't bet)
Seat 5: 4a23b929 folded before Flop (didn't bet)
Seat 6: 5e2588a2 folded before Flop (didn't bet)


Poker Hand #RC1468388463: Hold'em No Limit  ($0.05/$0.1) - 2023/04/12 19:06:16
Table 'RushAndCash5613723' 6-max Seat #1 is the button
Seat 1: 70a075c9 ($21.4 in chips)
Seat 2: Hero ($9.67 in chips)
Seat 3: 4a23b929 ($10 in chips)
Seat 4: 8de3d124 ($10 in chips)
Seat 5: 5dc53009 ($13.57 in chips)
Seat 6: 14695476 ($17.09 in chips)
Hero: posts small blind $0.05
4a23b929: posts big blind $0.1
*** HOLE CARDS ***
Dealt to 70a075c9 
Dealt to Hero [7d Jd]
Dealt to 4a23b929 
Dealt to 8de3d124 
Dealt to 5dc53009 
Dealt to 14695476 
8de3d124: folds
5dc53009: folds
14695476: folds
70a075c9: folds
Hero: raises $0.15 to $0.25
4a23b929: raises $0.65 to $0.9
Hero: folds
Uncalled bet ($0.65) returned to 4a23b929
*** SHOWDOWN ***
4a23b929 collected $0.48 from pot
*** SUMMARY ***
Total pot $0.5 | Rake $0.02 | Jackpot $0 | Bingo $0 | Fortune $0
Seat 1: 70a075c9 (button) folded before Flop (didn't bet)
Seat 2: Hero (small blind) folded before Flop
Seat 3: 4a23b929 (big blind) collected ($0.48)
Seat 4: 8de3d124 folded before Flop (didn't bet)
Seat 5: 5dc53009 folded before Flop (didn't bet)
Seat 6: 14695476 folded before Flop (didn't bet)


Poker Hand #RC1468388429: Hold'em No Limit  ($0.05/$0.1) - 2023/04/12 19:06:11
Table 'RushAndCash5613689' 6-max Seat #1 is the button
Seat 1: f1b8a68f ($8.85 in chips)
Seat 2: 50b345e4 ($10.05 in chips)
Seat 3: Hero ($9.77 in chips)
Seat 4: 7a7555a1 ($13.26 in chips)
Seat 5: beb23d2a ($10 in chips)
Seat 6: fae4e1b2 ($10.65 in chips)
50b345e4: posts small blind $0.05
Hero: posts big blind $0.1
*** HOLE CARDS ***
Dealt to f1b8a68f 
Dealt to 50b345e4 
Dealt to Hero [4d 7d]
Dealt to 7a7555a1 
Dealt to beb23d2a 
Dealt to fae4e1b2 
7a7555a1: raises $0.15 to $0.25
beb23d2a: folds
fae4e1b2: folds
f1b8a68f: folds
50b345e4: folds
Hero: folds
Uncalled bet ($0.15) returned to 7a7555a1
*** SHOWDOWN ***
7a7555a1 collected $0.25 from pot
*** SUMMARY ***
Total pot $0.25 | Rake $0 | Jackpot $0 | Bingo $0 | Fortune $0
Seat 1: f1b8a68f (button) folded before Flop (didn't bet)
Seat 2: 50b345e4 (small blind) folded before Flop
Seat 3: Hero (big blind) folded before Flop
Seat 4: 7a7555a1 collected ($0.25)
Seat 5: beb23d2a folded before Flop (didn't bet)
Seat 6: fae4e1b2 folded before Flop (didn't bet)


Poker Hand #RC1468388388: Hold'em No Limit  ($0.05/$0.1) - 2023/04/12 19:06:05
Table 'RushAndCash5613648' 6-max Seat #1 is the button
Seat 1: 42c88d3 ($13.44 in chips)
Seat 2: Hero ($9.82 in chips)
Seat 3: 23527ce7 ($6.51 in chips)
Seat 4: 58cc637 ($11.01 in chips)
Seat 5: d32ae893 ($10.23 in chips)
Seat 6: 3bc97b07 ($10.15 in chips)
Hero: posts small blind $0.05
23527ce7: posts big blind $0.1
*** HOLE CARDS ***
Dealt to 42c88d3 
Dealt to Hero [4h Qc]
Dealt to 23527ce7 
Dealt to 58cc637 
Dealt to d32ae893 
Dealt to 3bc97b07 
58cc637: folds
d32ae893: folds
3bc97b07: raises $0.15 to $0.25
42c88d3: folds
Hero: folds
23527ce7: folds
Uncalled bet ($0.15) returned to 3bc97b07
*** SHOWDOWN ***
3bc97b07 collected $0.25 from pot
*** SUMMARY ***
Total pot $0.25 | Rake $0 | Jackpot $0 | Bingo $0 | Fortune $0
Seat 1: 42c88d3 (button) folded before Flop (didn't bet)
Seat 2: Hero (small blind) folded before Flop
Seat 3: 23527ce7 (big blind) folded before Flop
Seat 4: 58cc637 folded before Flop (didn't bet)
Seat 5: d32ae893 folded before Flop (didn't bet)
Seat 6: 3bc97b07 collected ($0.25)


Poker Hand #RC1468388349: Hold'em No Limit  ($0.05/$0.1) - 2023/04/12 19:05:59
Table 'RushAndCash5613609' 6-max Seat #1 is the button
Seat 1: 82281e3b ($11.9 in chips)
Seat 2: ff632ebd ($10.68 in chips)
Seat 3: 6107bb1e ($11.06 in chips)
Seat 4: 316e1501 ($23.54 in chips)
Seat 5: Hero ($9.82 in chips)
Seat 6: 7a7555a1 ($13.31 in chips)
ff632ebd: posts small blind $0.05
6107bb1e: posts big blind $0.1
*** HOLE CARDS ***
Dealt to 82281e3b 
Dealt to ff632ebd 
Dealt to 6107bb1e 
Dealt to 316e1501 
Dealt to Hero [8s 5h]
Dealt to 7a7555a1 
316e1501: folds
Hero: folds
7a7555a1: folds
82281e3b: folds
ff632ebd: folds
Uncalled bet ($0.05) returned to 6107bb1e
*** SHOWDOWN ***
6107bb1e collected $0.1 from pot
*** SUMMARY ***
Total pot $0.1 | Rake $0 | Jackpot $0 | Bingo $0 | Fortune $0
Seat 1: 82281e3b (button) folded before Flop (didn't bet)
Seat 2: ff632ebd (small blind) folded before Flop
Seat 3: 6107bb1e (big blind) collected ($0.1)
Seat 4: 316e1501 folded before Flop (didn't bet)
Seat 5: Hero folded before Flop (didn't bet)
Seat 6: 7a7555a1 folded before Flop (didn't bet)


Poker Hand #RC1468388322: Hold'em No Limit  ($0.05/$0.1) - 2023/04/12 19:05:54
Table 'RushAndCash5613582' 6-max Seat #1 is the button
Seat 1: b1e983b9 ($10.92 in chips)
Seat 2: 2f63ffc3 ($10.28 in chips)
Seat 3: 81995f62 ($13.24 in chips)
Seat 4: 71621ffe ($12.09 in chips)
Seat 5: 55972646 ($13.04 in chips)
Seat 6: Hero ($9.82 in chips)
2f63ffc3: posts small blind $0.05
81995f62: posts big blind $0.1
*** HOLE CARDS ***
Dealt to b1e983b9 
Dealt to 2f63ffc3 
Dealt to 81995f62 
Dealt to 71621ffe 
Dealt to 55972646 
Dealt to Hero [8h Jh]
71621ffe: folds
55972646: raises $0.1 to $0.2
Hero: folds
b1e983b9: raises $0.52 to $0.72
2f63ffc3: folds
81995f62: folds
55972646: calls $0.52
*** FLOP *** [Kc Tc Qh]
55972646: checks
b1e983b9: bets $0.64
55972646: folds
Uncalled bet ($0.64) returned to b1e983b9
*** SHOWDOWN ***
b1e983b9 collected $1.51 from pot
*** SUMMARY ***
Total pot $1.59 | Rake $0.08 | Jackpot $0 | Bingo $0 | Fortune $0
Board [Kc Tc Qh]
Seat 1: b1e983b9 (button) won ($1.51)
Seat 2: 2f63ffc3 (small blind) folded before Flop
Seat 3: 81995f62 (big blind) folded before Flop
Seat 4: 71621ffe folded before Flop (didn't bet)
Seat 5: 55972646 folded on the Flop
Seat 6: Hero folded before Flop (didn't bet)


Poker Hand #RC1468388269: Hold'em No Limit  ($0.05/$0.1) - 2023/04/12 19:05:47
Table 'RushAndCash5613529' 6-max Seat #1 is the button
Seat 1: f8a25feb ($13.89 in chips)
Seat 2: 977c340b ($17.3 in chips)
Seat 3: 6e1708ef ($10.39 in chips)
Seat 4: 3e9ad104 ($16.12 in chips)
Seat 5: Hero ($9.82 in chips)
Seat 6: 7a7555a1 ($13.41 in chips)
977c340b: posts small blind $0.05
6e1708ef: posts big blind $0.1
*** HOLE CARDS ***
Dealt to f8a25feb 
Dealt to 977c340b 
Dealt to 6e1708ef 
Dealt to 3e9ad104 
Dealt to Hero [8s 2d]
Dealt to 7a7555a1 
3e9ad104: folds
Hero: folds
7a7555a1: folds
f8a25feb: folds
977c340b: raises $0.15 to $0.25
6e1708ef: folds
Uncalled bet ($0.15) returned to 977c340b
*** SHOWDOWN ***
977c340b collected $0.2 from pot
*** SUMMARY ***
Total pot $0.2 | Rake $0 | Jackpot $0 | Bingo $0 | Fortune $0
Seat 1: f8a25feb (button) folded before Flop (didn't bet)
Seat 2: 977c340b (small blind) collected ($0.2)
Seat 3: 6e1708ef (big blind) folded before Flop
Seat 4: 3e9ad104 folded before Flop (didn't bet)
Seat 5: Hero folded before Flop (didn't bet)
Seat 6: 7a7555a1 folded before Flop (didn't bet)


Poker Hand #RC1468388205: Hold'em No Limit  ($0.05/$0.1) - 2023/04/12 19:05:38
Table 'RushAndCash5613465' 6-max Seat #1 is the button
Seat 1: Hero ($9.82 in chips)
Seat 2: 3d2489bf ($10.89 in chips)
Seat 3: eb082207 ($11.08 in chips)
Seat 4: 84ae99a4 ($23.51 in chips)
Seat 5: 3a0b1130 ($11.95 in chips)
Seat 6: 3e673b5a ($22.15 in chips)
3d2489bf: posts small blind $0.05
eb082207: posts big blind $0.1
*** HOLE CARDS ***
Dealt to Hero [Ac 6h]
Dealt to 3d2489bf 
Dealt to eb082207 
Dealt to 84ae99a4 
Dealt to 3a0b1130 
Dealt to 3e673b5a 
84ae99a4: raises $0.2 to $0.3
3a0b1130: folds
3e673b5a: folds
Hero: folds
3d2489bf: folds
eb082207: folds
Uncalled bet ($0.2) returned to 84ae99a4
*** SHOWDOWN ***
84ae99a4 collected $0.25 from pot
*** SUMMARY ***
Total pot $0.25 | Rake $0 | Jackpot $0 | Bingo $0 | Fortune $0
Seat 1: Hero (button) folded before Flop (didn't bet)
Seat 2: 3d2489bf (small blind) folded before Flop
Seat 3: eb082207 (big blind) folded before Flop
Seat 4: 84ae99a4 collected ($0.25)
Seat 5: 3a0b1130 folded before Flop (didn't bet)
Seat 6: 3e673b5a folded before Flop (didn't bet)


Poker Hand #RC1468387953: Hold'em No Limit  ($0.05/$0.1) - 2023/04/12 19:05:03
Table 'RushAndCash5613213' 6-max Seat #1 is the button
Seat 1: b574e05 ($10 in chips)
Seat 2: 84ae99a4 ($23.24 in chips)
Seat 3: Hero ($10.12 in chips)
Seat 4: 7340cd62 ($11.89 in chips)
Seat 5: eb082207 ($10.66 in chips)
Seat 6: 3cd81c0 ($10.1 in chips)
84ae99a4: posts small blind $0.05
Hero: posts big blind $0.1
*** HOLE CARDS ***
Dealt to b574e05 
Dealt to 84ae99a4 
Dealt to Hero [7c 9c]
Dealt to 7340cd62 
Dealt to eb082207 
Dealt to 3cd81c0 
7340cd62: folds
eb082207: folds
3cd81c0: folds
b574e05: folds
84ae99a4: raises $0.2 to $0.3
Hero: calls $0.2
*** FLOP *** [Th 7h As]
84ae99a4: checks
Hero: checks
*** TURN *** [Th 7h As] [Qd]
84ae99a4: checks
Hero: checks
*** RIVER *** [Th 7h As Qd] [8d]
84ae99a4: checks
Hero: checks
84ae99a4: shows [Ad 2c] (Pair of Aces)
Hero: shows [7c 9c] (Pair of Sevens)
*** SHOWDOWN ***
84ae99a4 collected $0.57 from pot
*** SUMMARY ***
Total pot $0.6 | Rake $0.03 | Jackpot $0 | Bingo $0 | Fortune $0
Board [Th 7h As Qd 8d]
Seat 1: b574e05 (button) folded before Flop (didn't bet)
Seat 2: 84ae99a4 (small blind) showed [Ad 2c] and won ($0.57) with Pair of Aces
Seat 3: Hero (big blind) showed [7c 9c] and lost with Pair of Sevens
Seat 4: 7340cd62 folded before Flop (didn't bet)
Seat 5: eb082207 folded before Flop (didn't bet)
Seat 6: 3cd81c0 folded before Flop (didn't bet)


Poker Hand #RC1468387908: Hold'em No Limit  ($0.05/$0.1) - 2023/04/12 19:04:57
Table 'RushAndCash5613168' 6-max Seat #1 is the button
Seat 1: fd2cc110 ($10.28 in chips)
Seat 2: 4da094e9 ($10 in chips)
Seat 3: e7b3243f ($17.7 in chips)
Seat 4: Hero ($10.12 in chips)
Seat 5: 8aea79f8 ($9.48 in chips)
Seat 6: 9a236857 ($10.59 in chips)
4da094e9: posts small blind $0.05
e7b3243f: posts big blind $0.1
*** HOLE CARDS ***
Dealt to fd2cc110 
Dealt to 4da094e9 
Dealt to e7b3243f 
Dealt to Hero [Js 4c]
Dealt to 8aea79f8 
Dealt to 9a236857 
Hero: folds
8aea79f8: raises $0.15 to $0.25
9a236857: folds
fd2cc110: folds
4da094e9: folds
e7b3243f: calls $0.15
*** FLOP *** [3c 4d 7h]
e7b3243f: bets $0.19
8aea79f8: calls $0.19
*** TURN *** [3c 4d 7h] [Ac]
e7b3243f: bets $0.31
8aea79f8: calls $0.31
*** RIVER *** [3c 4d 7h Ac] [4s]
e7b3243f: checks
8aea79f8: checks
e7b3243f: shows [3h 2h] (Pair of Fours and Pair of Treys)
8aea79f8: shows [6h As] (Pair of Aces and Pair of Fours)
*** SHOWDOWN ***
8aea79f8 collected $1.48 from pot
*** SUMMARY ***
Total pot $1.55 | Rake $0.07 | Jackpot $0 | Bingo $0 | Fortune $0
Board [3c 4d 7h Ac 4s]
Seat 1: fd2cc110 (button) folded before Flop (didn't bet)
Seat 2: 4da094e9 (small blind) folded before Flop
Seat 3: e7b3243f (big blind) showed [3h 2h] and lost with Pair of Fours and Pair of Treys
Seat 4: Hero folded before Flop (didn't bet)
Seat 5: 8aea79f8 showed [6h As] and won ($1.48) with Pair of Aces and Pair of Fours
Seat 6: 9a236857 folded before Flop (didn't bet)


Poker Hand #RC1468387878: Hold'em No Limit  ($0.05/$0.1) - 2023/04/12 19:04:52
Table 'RushAndCash5613138' 6-max Seat #1 is the button
Seat 1: 7833ebf8 ($31.07 in chips)
Seat 2: 3a2d2163 ($14.56 in chips)
Seat 3: 1e3fa0f6 ($10.97 in chips)
Seat 4: Hero ($10.12 in chips)
Seat 5: 4b33fe04 ($11.4 in chips)
Seat 6: a4c579ca ($13.32 in chips)
3a2d2163: posts small blind $0.05
1e3fa0f6: posts big blind $0.1
*** HOLE CARDS ***
Dealt to 7833ebf8 
Dealt to 3a2d2163 
Dealt to 1e3fa0f6 
Dealt to Hero [6c Qh]
Dealt to 4b33fe04 
Dealt to a4c579ca 
Hero: folds
4b33fe04: folds
a4c579ca: raises $0.11 to $0.21
7833ebf8: calls $0.21
3a2d2163: folds
1e3fa0f6: folds
*** FLOP *** [4h 7h 9s]
a4c579ca: checks
7833ebf8: checks
*** TURN *** [4h 7h 9s] [6h]
a4c579ca: checks
7833ebf8: bets $0.38
a4c579ca: calls $0.38
*** RIVER *** [4h 7h 9s 6h] [Kd]
a4c579ca: bets $1
7833ebf8: calls $1
a4c579ca: shows [Td Ah] (Ace-High)
7833ebf8: shows [Ks Jh] (Pair of Kings)
*** SHOWDOWN ***
7833ebf8 collected $3.03 from pot
*** SUMMARY ***
Total pot $3.33 | Rake $0.15 | Jackpot $0.15 | Bingo $0 | Fortune $0
Board [4h 7h 9s 6h Kd]
Seat 1: 7833ebf8 (button) showed [Ks Jh] and won ($3.03) with Pair of Kings
Seat 2: 3a2d2163 (small blind) folded before Flop
Seat 3: 1e3fa0f6 (big blind) folded before Flop
Seat 4: Hero folded before Flop (didn't bet)
Seat 5: 4b33fe04 folded before Flop (didn't bet)
Seat 6: a4c579ca showed [Td Ah] and lost with Ace-High


Poker Hand #RC1468387504: Hold'em No Limit  ($0.05/$0.1) - 2023/04/12 19:03:59
Table 'RushAndCash5612764' 6-max Seat #1 is the button
Seat 1: d1da1715 ($23.3 in chips)
Seat 2: 33a288a7 ($18.78 in chips)
Seat 3: 3a2d2163 ($14.28 in chips)
Seat 4: 34e5528 ($9.06 in chips)
Seat 5: Hero ($10.37 in chips)
Seat 6: 6cfd03f9 ($10 in chips)
33a288a7: posts small blind $0.05
3a2d2163: posts big blind $0.1
*** HOLE CARDS ***
Dealt to d1da1715 
Dealt to 33a288a7 
Dealt to 3a2d2163 
Dealt to 34e5528 
Dealt to Hero [3c 3h]
Dealt to 6cfd03f9 
34e5528: folds
Hero: raises $0.15 to $0.25
6cfd03f9: folds
d1da1715: folds
33a288a7: folds
3a2d2163: calls $0.15
*** FLOP *** [5d 9c 5s]
3a2d2163: checks
Hero: checks
*** TURN *** [5d 9c 5s] [Ad]
3a2d2163: checks
Hero: checks
*** RIVER *** [5d 9c 5s Ad] [7s]
3a2d2163: checks
Hero: checks
3a2d2163: shows [9h 8h] (Pair of Nines and Pair of Fives)
Hero: shows [3c 3h] (Pair of Fives and Pair of Treys)
*** SHOWDOWN ***
3a2d2163 collected $0.53 from pot
*** SUMMARY ***
Total pot $0.55 | Rake $0.02 | Jackpot $0 | Bingo $0 | Fortune $0
Board [5d 9c 5s Ad 7s]
Seat 1: d1da1715 (button) folded before Flop (didn't bet)
Seat 2: 33a288a7 (small blind) folded before Flop
Seat 3: 3a2d2163 (big blind) showed [9h 8h] and won ($0.53) with Pair of Nines and Pair of Fives
Seat 4: 34e5528 folded before Flop (didn't bet)
Seat 5: Hero showed [3c 3h] and lost with Pair of Fives and Pair of Treys
Seat 6: 6cfd03f9 folded before Flop (didn't bet)


Poker Hand #RC1468387425: Hold'em No Limit  ($0.05/$0.1) - 2023/04/12 19:03:46
Table 'RushAndCash5612685' 6-max Seat #1 is the button
Seat 1: f3b515b4 ($13.4 in chips)
Seat 2: dff5826e ($3.18 in chips)
Seat 3: c0cd0f2 ($15.35 in chips)
Seat 4: Hero ($10.37 in chips)
Seat 5: e6b0c676 ($10.97 in chips)
Seat 6: d4483568 ($10.15 in chips)
dff5826e: posts small blind $0.05
c0cd0f2: posts big blind $0.1
*** HOLE CARDS ***
Dealt to f3b515b4 
Dealt to dff5826e 
Dealt to c0cd0f2 
Dealt to Hero [Ad 8c]
Dealt to e6b0c676 
Dealt to d4483568 
Hero: folds
e6b0c676: raises $0.15 to $0.25
d4483568: folds
f3b515b4: folds
dff5826e: folds
c0cd0f2: folds
Uncalled bet ($0.15) returned to e6b0c676
*** SHOWDOWN ***
e6b0c676 collected $0.25 from pot
*** SUMMARY ***
Total pot $0.25 | Rake $0 | Jackpot $0 | Bingo $0 | Fortune $0
Seat 1: f3b515b4 (button) folded before Flop (didn't bet)
Seat 2: dff5826e (small blind) folded before Flop
Seat 3: c0cd0f2 (big blind) folded before Flop
Seat 4: Hero folded before Flop (didn't bet)
Seat 5: e6b0c676 collected ($0.25)
Seat 6: d4483568 folded before Flop (didn't bet)


Poker Hand #RC1468386834: Hold'em No Limit  ($0.05/$0.1) - 2023/04/12 19:02:16
Table 'RushAndCash5612094' 6-max Seat #1 is the button
Seat 1: f801f346 ($11.33 in chips)
Seat 2: f3b515b4 ($11.85 in chips)
Seat 3: Hero ($11.98 in chips)
Seat 4: f9e2637 ($10.72 in chips)
Seat 5: 5e2588a2 ($11.21 in chips)
Seat 6: a31d9536 ($17.47 in chips)
f3b515b4: posts small blind $0.05
Hero: posts big blind $0.1
*** HOLE CARDS ***
Dealt to f801f346 
Dealt to f3b515b4 
Dealt to Hero [Kh Ts]
Dealt to f9e2637 
Dealt to 5e2588a2 
Dealt to a31d9536 
f9e2637: folds
5e2588a2: folds
a31d9536: raises $0.15 to $0.25
f801f346: folds
f3b515b4: calls $0.2
Hero: calls $0.15
*** FLOP *** [Ks Jh 4c]
f3b515b4: checks
Hero: checks
a31d9536: checks
*** TURN *** [Ks Jh 4c] [2h]
f3b515b4: bets $0.36
Hero: calls $0.36
a31d9536: folds
*** RIVER *** [Ks Jh 4c 2h] [As]
f3b515b4: bets $1
Hero: calls $1
f3b515b4: shows [Ad Js] (Pair of Aces and Pair of Jacks)
Hero: shows [Kh Ts] (Pair of Kings)
*** SHOWDOWN ***
f3b515b4 collected $3.16 from pot
*** SUMMARY ***
Total pot $3.47 | Rake $0.16 | Jackpot $0.15 | Bingo $0 | Fortune $0
Board [Ks Jh 4c 2h As]
Seat 1: f801f346 (button) folded before Flop (didn't bet)
Seat 2: f3b515b4 (small blind) showed [Ad Js] and won ($3.16) with Pair of Aces and Pair of Jacks
Seat 3: Hero (big blind) showed [Kh Ts] and lost with Pair of Kings
Seat 4: f9e2637 folded before Flop (didn't bet)
Seat 5: 5e2588a2 folded before Flop (didn't bet)
Seat 6: a31d9536 folded on the Turn


Poker Hand #RC1468386585: Hold'em No Limit  ($0.05/$0.1) - 2023/04/12 19:01:41
Table 'RushAndCash5611845' 6-max Seat #1 is the button
Seat 1: f9c5d167 ($10 in chips)
Seat 2: Hero ($11.75 in chips)
Seat 3: f3b515b4 ($12.1 in chips)
Seat 4: 82fa3321 ($16.44 in chips)
Seat 5: 3e673b5a ($20.42 in chips)
Seat 6: f11413c0 ($13.01 in chips)
Hero: posts small blind $0.05
f3b515b4: posts big blind $0.1
*** HOLE CARDS ***
Dealt to f9c5d167 
Dealt to Hero [6h 9h]
Dealt to f3b515b4 
Dealt to 82fa3321 
Dealt to 3e673b5a 
Dealt to f11413c0 
82fa3321: folds
3e673b5a: folds
f11413c0: folds
f9c5d167: folds
Hero: raises $0.15 to $0.25
f3b515b4: calls $0.15
*** FLOP *** [Ts 3s 4s]
Hero: checks
f3b515b4: checks
*** TURN *** [Ts 3s 4s] [4d]
Hero: checks
f3b515b4: checks
*** RIVER *** [Ts 3s 4s 4d] [6d]
Hero: checks
f3b515b4: checks
Hero: shows [6h 9h] (Pair of Sixes and Pair of Fours)
f3b515b4: shows [Jh 8h] (Pair of Fours)
*** SHOWDOWN ***
Hero collected $0.48 from pot
*** SUMMARY ***
Total pot $0.5 | Rake $0.02 | Jackpot $0 | Bingo $0 | Fortune $0
Board [Ts 3s 4s 4d 6d]
Seat 1: f9c5d167 (button) folded before Flop (didn't bet)
Seat 2: Hero (small blind) showed [6h 9h] and won ($0.48) with Pair of Sixes and Pair of Fours
Seat 3: f3b515b4 (big blind) showed [Jh 8h] and lost with Pair of Fours
Seat 4: 82fa3321 folded before Flop (didn't bet)
Seat 5: 3e673b5a folded before Flop (didn't bet)
Seat 6: f11413c0 folded before Flop (didn't bet)


Poker Hand #RC1468386554: Hold'em No Limit  ($0.05/$0.1) - 2023/04/12 19:01:35
Table 'RushAndCash5611814' 6-max Seat #1 is the button
Seat 1: Hero ($11.75 in chips)
Seat 2: fa2569cc ($18.4 in chips)
Seat 3: efe13270 ($10.69 in chips)
Seat 4: 9e2dc00d ($10.18 in chips)
Seat 5: bb9a7dc ($6.93 in chips)
Seat 6: 47eadcef ($29.97 in chips)
fa2569cc: posts small blind $0.05
efe13270: posts big blind $0.1
*** HOLE CARDS ***
Dealt to Hero [4s Qs]
Dealt to fa2569cc 
Dealt to efe13270 
Dealt to 9e2dc00d 
Dealt to bb9a7dc 
Dealt to 47eadcef 
9e2dc00d: raises $0.15 to $0.25
bb9a7dc: folds
47eadcef: calls $0.25
Hero: folds
fa2569cc: folds
efe13270: folds
*** FLOP *** [8s 3d 7c]
9e2dc00d: bets $0.33
47eadcef: calls $0.33
*** TURN *** [8s 3d 7c] [5d]
9e2dc00d: checks
47eadcef: bets $0.99
9e2dc00d: raises $1.85 to $2.84
47eadcef: folds
Uncalled bet ($1.85) returned to 9e2dc00d
*** SHOWDOWN ***
9e2dc00d collected $2.99 from pot
*** SUMMARY ***
Total pot $3.29 | Rake $0.15 | Jackpot $0.15 | Bingo $0 | Fortune $0
Board [8s 3d 7c 5d]
Seat 1: Hero (button) folded before Flop (didn't bet)
Seat 2: fa2569cc (small blind) folded before Flop
Seat 3: efe13270 (big blind) folded before Flop
Seat 4: 9e2dc00d won ($2.99)
Seat 5: bb9a7dc folded before Flop (didn't bet)
Seat 6: 47eadcef folded on the Turn


Poker Hand #RC1468386510: Hold'em No Limit  ($0.05/$0.1) - 2023/04/12 19:01:29
Table 'RushAndCash5611770' 6-max Seat #1 is the button
Seat 1: 55d57ad0 ($9.4 in chips)
Seat 2: 977c340b ($14.99 in chips)
Seat 3: 50ce1268 ($23.57 in chips)
Seat 4: Hero ($11.75 in chips)
Seat 5: 99a7bc39 ($10.07 in chips)
Seat 6: 70a075c9 ($10.86 in chips)
977c340b: posts small blind $0.05
50ce1268: posts big blind $0.1
*** HOLE CARDS ***
Dealt to 55d57ad0 
Dealt to 977c340b 
Dealt to 50ce1268 
Dealt to Hero [7h Ad]
Dealt to 99a7bc39 
Dealt to 70a075c9 
Hero: folds
99a7bc39: folds
70a075c9: folds
55d57ad0: raises $0.15 to $0.25
977c340b: calls $0.2
50ce1268: folds
*** FLOP *** [4s Kd Ts]
977c340b: checks
55d57ad0: bets $0.3
977c340b: calls $0.3
*** TURN *** [4s Kd Ts] [Td]
977c340b: checks
55d57ad0: bets $0.6
977c340b: raises $1.9 to $2.5
55d57ad0: calls $1.9
*** RIVER *** [4s Kd Ts Td] [2c]
977c340b: checks
55d57ad0: checks
977c340b: shows [8h Th] (Three Tens)
55d57ad0: shows [Ks Qd] (Pair of Kings and Pair of Tens)
*** SHOWDOWN ***
977c340b collected $5.75 from pot
*** SUMMARY ***
Total pot $6.2 | Rake $0.3 | Jackpot $0.15 | Bingo $0 | Fortune $0
Board [4s Kd Ts Td 2c]
Seat 1: 55d57ad0 (button) showed [Ks Qd] and lost with Pair of Kings and Pair of Tens
Seat 2: 977c340b (small blind) showed [8h Th] and won ($5.75) with Three Tens
Seat 3: 50ce1268 (big blind) folded before Flop
Seat 4: Hero folded before Flop (didn't bet)
Seat 5: 99a7bc39 folded before Flop (didn't bet)
Seat 6: 70a075c9 folded before Flop (didn't bet)


Poker Hand #RC1468386474: Hold'em No Limit  ($0.05/$0.1) - 2023/04/12 19:01:23
Table 'RushAndCash5611734' 6-max Seat #1 is the button
Seat 1: e6714e08 ($13.28 in chips)
Seat 2: bec07344 ($21.72 in chips)
Seat 3: 60143ad ($10.15 in chips)
Seat 4: Hero ($11.75 in chips)
Seat 5: 1475e8f0 ($40.56 in chips)
Seat 6: 4d2a11f5 ($12.42 in chips)
bec07344: posts small blind $0.05
60143ad: posts big blind $0.1
*** HOLE CARDS ***
Dealt to e6714e08 
Dealt to bec07344 
Dealt to 60143ad 
Dealt to Hero [Tc 9d]
Dealt to 1475e8f0 
Dealt to 4d2a11f5 
Hero: folds
1475e8f0: raises $0.15 to $0.25
4d2a11f5: folds
e6714e08: folds
bec07344: folds
60143ad: folds
Uncalled bet ($0.15) returned to 1475e8f0
*** SHOWDOWN ***
1475e8f0 collected $0.25 from pot
*** SUMMARY ***
Total pot $0.25 | Rake $0 | Jackpot $0 | Bingo $0 | Fortune $0
Seat 1: e6714e08 (button) folded before Flop (didn't bet)
Seat 2: bec07344 (small blind) folded before Flop
Seat 3: 60143ad (big blind) folded before Flop
Seat 4: Hero folded before Flop (didn't bet)
Seat 5: 1475e8f0 collected ($0.25)
Seat 6: 4d2a11f5 folded before Flop (didn't bet)


Poker Hand #RC1468386413: Hold'em No Limit  ($0.05/$0.1) - 2023/04/12 19:01:14
Table 'RushAndCash5611673' 6-max Seat #1 is the button
Seat 1: 7c3299a ($10 in chips)
Seat 2: 57b5f4da ($12.37 in chips)
Seat 3: Hero ($11.85 in chips)
Seat 4: 4a2ca0cb ($13.75 in chips)
Seat 5: 40bd9423 ($9.85 in chips)
Seat 6: a1f82121 ($31.84 in chips)
57b5f4da: posts small blind $0.05
Hero: posts big blind $0.1
*** HOLE CARDS ***
Dealt to 7c3299a 
Dealt to 57b5f4da 
Dealt to Hero [8s 5d]
Dealt to 4a2ca0cb 
Dealt to 40bd9423 
Dealt to a1f82121 
4a2ca0cb: raises $0.15 to $0.25
40bd9423: folds
a1f82121: folds
7c3299a: folds
57b5f4da: folds
Hero: folds
Uncalled bet ($0.15) returned to 4a2ca0cb
*** SHOWDOWN ***
4a2ca0cb collected $0.25 from pot
*** SUMMARY ***
Total pot $0.25 | Rake $0 | Jackpot $0 | Bingo $0 | Fortune $0
Seat 1: 7c3299a (button) folded before Flop (didn't bet)
Seat 2: 57b5f4da (small blind) folded before Flop
Seat 3: Hero (big blind) folded before Flop
Seat 4: 4a2ca0cb collected ($0.25)
Seat 5: 40bd9423 folded before Flop (didn't bet)
Seat 6: a1f82121 folded before Flop (didn't bet)


Poker Hand #RC1468386342: Hold'em No Limit  ($0.05/$0.1) - 2023/04/12 19:01:04
Table 'RushAndCash5611602' 6-max Seat #1 is the button
Seat 1: 72651f78 ($10.07 in chips)
Seat 2: 610eeaea ($13.5 in chips)
Seat 3: aeb3f50f ($10 in chips)
Seat 4: 229016d0 ($3.62 in chips)
Seat 5: Hero ($11.85 in chips)
Seat 6: 22f47a15 ($11.34 in chips)
610eeaea: posts small blind $0.05
aeb3f50f: posts big blind $0.1
*** HOLE CARDS ***
Dealt to 72651f78 
Dealt to 610eeaea 
Dealt to aeb3f50f 
Dealt to 229016d0 
Dealt to Hero [Qd Ts]
Dealt to 22f47a15 
229016d0: raises $0.2 to $0.3
Hero: folds
22f47a15: folds
72651f78: folds
610eeaea: folds
aeb3f50f: folds
Uncalled bet ($0.2) returned to 229016d0
*** SHOWDOWN ***
229016d0 collected $0.25 from pot
*** SUMMARY ***
Total pot $0.25 | Rake $0 | Jackpot $0 | Bingo $0 | Fortune $0
Seat 1: 72651f78 (button) folded before Flop (didn't bet)
Seat 2: 610eeaea (small blind) folded before Flop
Seat 3: aeb3f50f (big blind) folded before Flop
Seat 4: 229016d0 collected ($0.25)
Seat 5: Hero folded before Flop (didn't bet)
Seat 6: 22f47a15 folded before Flop (didn't bet)


Poker Hand #RC1468385769: Hold'em No Limit  ($0.05/$0.1) - 2023/04/12 18:59:38
Table 'RushAndCash5611029' 6-max Seat #1 is the button
Seat 1: Hero ($13.72 in chips)
Seat 2: 9112125b ($12.37 in chips)
Seat 3: 610eeaea ($11.91 in chips)
Seat 4: 3a2d2163 ($14.7 in chips)
Seat 5: 615363c0 ($14.59 in chips)
Seat 6: bfbfb4a ($7.1 in chips)
9112125b: posts small blind $0.05
610eeaea: posts big blind $0.1
*** HOLE CARDS ***
Dealt to Hero [Jc Ts]
Dealt to 9112125b 
Dealt to 610eeaea 
Dealt to 3a2d2163 
Dealt to 615363c0 
Dealt to bfbfb4a 
3a2d2163: folds
615363c0: folds
bfbfb4a: folds
Hero: raises $0.15 to $0.25
9112125b: folds
610eeaea: calls $0.15
*** FLOP *** [Qc 8d 6d]
610eeaea: checks
Hero: bets $0.28
610eeaea: calls $0.28
*** TURN *** [Qc 8d 6d] [9d]
610eeaea: checks
Hero: bets $0.37
610eeaea: raises $0.97 to $1.34
Hero: calls $0.97
*** RIVER *** [Qc 8d 6d 9d] [7d]
610eeaea: bets $2.51
Hero: folds
Uncalled bet ($2.51) returned to 610eeaea
610eeaea: shows [Td Jd] (Jack-High Straight Flush)
*** SHOWDOWN ***
610eeaea collected $3.46 from pot
*** SUMMARY ***
Total pot $3.79 | Rake $0.18 | Jackpot $0.15 | Bingo $0 | Fortune $0
Board [Qc 8d 6d 9d 7d]
Seat 1: Hero (button) folded on the River
Seat 2: 9112125b (small blind) folded before Flop
Seat 3: 610eeaea (big blind) showed [Td Jd] and won ($3.46) with Jack-High Straight Flush
Seat 4: 3a2d2163 folded before Flop (didn't bet)
Seat 5: 615363c0 folded before Flop (didn't bet)
Seat 6: bfbfb4a folded before Flop (didn't bet)


Poker Hand #RC1468385717: Hold'em No Limit  ($0.05/$0.1) - 2023/04/12 18:59:30
Table 'RushAndCash5610977' 6-max Seat #1 is the button
Seat 1: af7e86da ($12.41 in chips)
Seat 2: Hero ($13.77 in chips)
Seat 3: 1e3fa0f6 ($14.22 in chips)
Seat 4: 632c3876 ($10.58 in chips)
Seat 5: a0afbd55 ($10 in chips)
Seat 6: 36f24b9e ($12.8 in chips)
Hero: posts small blind $0.05
1e3fa0f6: posts big blind $0.1
*** HOLE CARDS ***
Dealt to af7e86da 
Dealt to Hero [3s 9s]
Dealt to 1e3fa0f6 
Dealt to 632c3876 
Dealt to a0afbd55 
Dealt to 36f24b9e 
632c3876: folds
a0afbd55: raises $0.15 to $0.25
36f24b9e: folds
af7e86da: folds
Hero: folds
1e3fa0f6: folds
Uncalled bet ($0.15) returned to a0afbd55
*** SHOWDOWN ***
a0afbd55 collected $0.25 from pot
*** SUMMARY ***
Total pot $0.25 | Rake $0 | Jackpot $0 | Bingo $0 | Fortune $0
Seat 1: af7e86da (button) folded before Flop (didn't bet)
Seat 2: Hero (small blind) folded before Flop
Seat 3: 1e3fa0f6 (big blind) folded before Flop
Seat 4: 632c3876 folded before Flop (didn't bet)
Seat 5: a0afbd55 collected ($0.25)
Seat 6: 36f24b9e folded before Flop (didn't bet)


Poker Hand #RC1468385666: Hold'em No Limit  ($0.05/$0.1) - 2023/04/12 18:59:22
Table 'RushAndCash5610926' 6-max Seat #1 is the button
Seat 1: e80f2281 ($10.12 in chips)
Seat 2: 3bf969ff ($10.35 in chips)
Seat 3: a930d8cf ($10.5 in chips)
Seat 4: be4cbe4e ($15.7 in chips)
Seat 5: 4bc7e34d ($10.19 in chips)
Seat 6: Hero ($13.77 in chips)
3bf969ff: posts small blind $0.05
a930d8cf: posts big blind $0.1
*** HOLE CARDS ***
Dealt to e80f2281 
Dealt to 3bf969ff 
Dealt to a930d8cf 
Dealt to be4cbe4e 
Dealt to 4bc7e34d 
Dealt to Hero [Td 5s]
be4cbe4e: raises $0.12 to $0.22
4bc7e34d: folds
Hero: folds
e80f2281: folds
3bf969ff: folds
a930d8cf: folds
Uncalled bet ($0.12) returned to be4cbe4e
*** SHOWDOWN ***
be4cbe4e collected $0.25 from pot
*** SUMMARY ***
Total pot $0.25 | Rake $0 | Jackpot $0 | Bingo $0 | Fortune $0
Seat 1: e80f2281 (button) folded before Flop (didn't bet)
Seat 2: 3bf969ff (small blind) folded before Flop
Seat 3: a930d8cf (big blind) folded before Flop
Seat 4: be4cbe4e collected ($0.25)
Seat 5: 4bc7e34d folded before Flop (didn't bet)
Seat 6: Hero folded before Flop (didn't bet)


Poker Hand #RC1468385610: Hold'em No Limit  ($0.05/$0.1) - 2023/04/12 18:59:13
Table 'RushAndCash5610870' 6-max Seat #1 is the button
Seat 1: Hero ($13.77 in chips)
Seat 2: cd5c1dcb ($10.63 in chips)
Seat 3: f0e972ed ($19.27 in chips)
Seat 4: 18b3f99 ($8.57 in chips)
Seat 5: a3401c1c ($8.37 in chips)
Seat 6: 7c146a13 ($24.55 in chips)
cd5c1dcb: posts small blind $0.05
f0e972ed: posts big blind $0.1
*** HOLE CARDS ***
Dealt to Hero [4c 6h]
Dealt to cd5c1dcb 
Dealt to f0e972ed 
Dealt to 18b3f99 
Dealt to a3401c1c 
Dealt to 7c146a13 
18b3f99: folds
a3401c1c: folds
7c146a13: folds
Hero: folds
cd5c1dcb: folds
Uncalled bet ($0.05) returned to f0e972ed
*** SHOWDOWN ***
f0e972ed collected $0.1 from pot
*** SUMMARY ***
Total pot $0.1 | Rake $0 | Jackpot $0 | Bingo $0 | Fortune $0
Seat 1: Hero (button) folded before Flop (didn't bet)
Seat 2: cd5c1dcb (small blind) folded before Flop
Seat 3: f0e972ed (big blind) collected ($0.1)
Seat 4: 18b3f99 folded before Flop (didn't bet)
Seat 5: a3401c1c folded before Flop (didn't bet)
Seat 6: 7c146a13 folded before Flop (didn't bet)


Poker Hand #RC1468385558: Hold'em No Limit  ($0.05/$0.1) - 2023/04/12 18:59:06
Table 'RushAndCash5610818' 6-max Seat #1 is the button
Seat 1: d8fc2ab2 ($12.8 in chips)
Seat 2: 5e2588a2 ($8.83 in chips)
Seat 3: 9d929d6 ($10.8 in chips)
Seat 4: 9354ac02 ($8.09 in chips)
Seat 5: 221cdbda ($5.29 in chips)
Seat 6: Hero ($13.77 in chips)
5e2588a2: posts small blind $0.05
9d929d6: posts big blind $0.1
*** HOLE CARDS ***
Dealt to d8fc2ab2 
Dealt to 5e2588a2 
Dealt to 9d929d6 
Dealt to 9354ac02 
Dealt to 221cdbda 
Dealt to Hero [6s 2c]
9354ac02: folds
221cdbda: folds
Hero: folds
d8fc2ab2: raises $0.15 to $0.25
5e2588a2: calls $0.2
9d929d6: folds
*** FLOP *** [4d 8c 4s]
5e2588a2: checks
d8fc2ab2: checks
*** TURN *** [4d 8c 4s] [6c]
5e2588a2: bets $0.3
d8fc2ab2: folds
Uncalled bet ($0.3) returned to 5e2588a2
*** SHOWDOWN ***
5e2588a2 collected $0.57 from pot
*** SUMMARY ***
Total pot $0.6 | Rake $0.03 | Jackpot $0 | Bingo $0 | Fortune $0
Board [4d 8c 4s 6c]
Seat 1: d8fc2ab2 (button) folded on the Turn
Seat 2: 5e2588a2 (small blind) won ($0.57)
Seat 3: 9d929d6 (big blind) folded before Flop
Seat 4: 9354ac02 folded before Flop (didn't bet)
Seat 5: 221cdbda folded before Flop (didn't bet)
Seat 6: Hero folded before Flop (didn't bet)


Poker Hand #RC1468385522: Hold'em No Limit  ($0.05/$0.1) - 2023/04/12 18:59:00
Table 'RushAndCash5610782' 6-max Seat #1 is the button
Seat 1: 55972646 ($6.97 in chips)
Seat 2: f11413c0 ($11.24 in chips)
Seat 3: 33a288a7 ($19.4 in chips)
Seat 4: e7ce73b3 ($20.02 in chips)
Seat 5: Hero ($13.77 in chips)
Seat 6: 1735332f ($10.43 in chips)
f11413c0: posts small blind $0.05
33a288a7: posts big blind $0.1
*** HOLE CARDS ***
Dealt to 55972646 
Dealt to f11413c0 
Dealt to 33a288a7 
Dealt to e7ce73b3 
Dealt to Hero [4h 5d]
Dealt to 1735332f 
e7ce73b3: folds
Hero: folds
1735332f: folds
55972646: folds
f11413c0: calls $0.05
33a288a7: raises $0.25 to $0.35
f11413c0: calls $0.25
*** FLOP *** [2c Ac Ts]
f11413c0: checks
33a288a7: bets $0.47
f11413c0: folds
Uncalled bet ($0.47) returned to 33a288a7
*** SHOWDOWN ***
33a288a7 collected $0.67 from pot
*** SUMMARY ***
Total pot $0.7 | Rake $0.03 | Jackpot $0 | Bingo $0 | Fortune $0
Board [2c Ac Ts]
Seat 1: 55972646 (button) folded before Flop (didn't bet)
Seat 2: f11413c0 (small blind) folded on the Flop
Seat 3: 33a288a7 (big blind) won ($0.67)
Seat 4: e7ce73b3 folded before Flop (didn't bet)
Seat 5: Hero folded before Flop (didn't bet)
Seat 6: 1735332f folded before Flop (didn't bet)


Poker Hand #RC1468385421: Hold'em No Limit  ($0.05/$0.1) - 2023/04/12 18:58:45
Table 'RushAndCash5610681' 6-max Seat #1 is the button
Seat 1: 802f332d ($11.24 in chips)
Seat 2: d060ad61 ($15.17 in chips)
Seat 3: Hero ($13.87 in chips)
Seat 4: 632c3876 ($10.15 in chips)
Seat 5: d56de772 ($21.31 in chips)
Seat 6: eeaf954d ($11.72 in chips)
d060ad61: posts small blind $0.05
Hero: posts big blind $0.1
*** HOLE CARDS ***
Dealt to 802f332d 
Dealt to d060ad61 
Dealt to Hero [8c 3d]
Dealt to 632c3876 
Dealt to d56de772 
Dealt to eeaf954d 
632c3876: folds
d56de772: folds
eeaf954d: folds
802f332d: raises $0.15 to $0.25
d060ad61: calls $0.2
Hero: folds
*** FLOP *** [4h Ks Th]
d060ad61: checks
802f332d: checks
*** TURN *** [4h Ks Th] [8d]
d060ad61: checks
802f332d: bets $0.2
d060ad61: folds
Uncalled bet ($0.2) returned to 802f332d
*** SHOWDOWN ***
802f332d collected $0.57 from pot
*** SUMMARY ***
Total pot $0.6 | Rake $0.03 | Jackpot $0 | Bingo $0 | Fortune $0
Board [4h Ks Th 8d]
Seat 1: 802f332d (button) won ($0.57)
Seat 2: d060ad61 (small blind) folded on the Turn
Seat 3: Hero (big blind) folded before Flop
Seat 4: 632c3876 folded before Flop (didn't bet)
Seat 5: d56de772 folded before Flop (didn't bet)
Seat 6: eeaf954d folded before Flop (didn't bet)


Poker Hand #RC1468385064: Hold'em No Limit  ($0.05/$0.1) - 2023/04/12 18:57:51
Table 'RushAndCash5610324' 6-max Seat #1 is the button
Seat 1: 99a8a5db ($26.96 in chips)
Seat 2: 642590aa ($6.82 in chips)
Seat 3: 802f332d ($11.77 in chips)
Seat 4: bcf48373 ($8.2 in chips)
Seat 5: d755c17e ($25.1 in chips)
Seat 6: Hero ($13.34 in chips)
642590aa: posts small blind $0.05
802f332d: posts big blind $0.1
*** HOLE CARDS ***
Dealt to 99a8a5db 
Dealt to 642590aa 
Dealt to 802f332d 
Dealt to bcf48373 
Dealt to d755c17e 
Dealt to Hero [As Tc]
bcf48373: folds
d755c17e: folds
Hero: raises $0.15 to $0.25
99a8a5db: folds
642590aa: folds
802f332d: calls $0.15
*** FLOP *** [9c 2h 6s]
802f332d: checks
Hero: checks
*** TURN *** [9c 2h 6s] [3s]
802f332d: bets $0.28
Hero: calls $0.28
*** RIVER *** [9c 2h 6s 3s] [Ac]
802f332d: checks
Hero: bets $0.37
802f332d: folds
Uncalled bet ($0.37) returned to Hero
*** SHOWDOWN ***
Hero collected $1.06 from pot
*** SUMMARY ***
Total pot $1.11 | Rake $0.05 | Jackpot $0 | Bingo $0 | Fortune $0
Board [9c 2h 6s 3s Ac]
Seat 1: 99a8a5db (button) folded before Flop (didn't bet)
Seat 2: 642590aa (small blind) folded before Flop
Seat 3: 802f332d (big blind) folded on the River
Seat 4: bcf48373 folded before Flop (didn't bet)
Seat 5: d755c17e folded before Flop (didn't bet)
Seat 6: Hero won ($1.06)


Poker Hand #RC1468384972: Hold'em No Limit  ($0.05/$0.1) - 2023/04/12 18:57:36
Table 'RushAndCash5610232' 6-max Seat #1 is the button
Seat 1: 9b06ba4d ($17.18 in chips)
Seat 2: Hero ($13.39 in chips)
Seat 3: 1c791eaf ($3.15 in chips)
Seat 4: 7833ebf8 ($30.73 in chips)
Seat 5: bc90efb6 ($12.05 in chips)
Seat 6: a49b99da ($31.22 in chips)
Hero: posts small blind $0.05
1c791eaf: posts big blind $0.1
*** HOLE CARDS ***
Dealt to 9b06ba4d 
Dealt to Hero [6h 2d]
Dealt to 1c791eaf 
Dealt to 7833ebf8 
Dealt to bc90efb6 
Dealt to a49b99da 
7833ebf8: folds
bc90efb6: folds
a49b99da: folds
9b06ba4d: calls $0.1
Hero: folds
1c791eaf: checks
*** FLOP *** [Qh 9h Kh]
1c791eaf: checks
9b06ba4d: checks
*** TURN *** [Qh 9h Kh] [Td]
1c791eaf: checks
9b06ba4d: bets $0.1
1c791eaf: folds
Uncalled bet ($0.1) returned to 9b06ba4d
*** SHOWDOWN ***
9b06ba4d collected $0.24 from pot
*** SUMMARY ***
Total pot $0.25 | Rake $0.01 | Jackpot $0 | Bingo $0 | Fortune $0
Board [Qh 9h Kh Td]
Seat 1: 9b06ba4d (button) won ($0.24)
Seat 2: Hero (small blind) folded before Flop
Seat 3: 1c791eaf (big blind) folded on the Turn
Seat 4: 7833ebf8 folded before Flop (didn't bet)
Seat 5: bc90efb6 folded before Flop (didn't bet)
Seat 6: a49b99da folded before Flop (didn't bet)


Poker Hand #RC1468334375: Hold'em No Limit  ($0.05/$0.1) - 2023/04/12 18:56:08
Table 'RushAndCash5609635' 6-max Seat #1 is the button
Seat 1: bc90efb6 ($10.66 in chips)
Seat 2: 6593fce5 ($11.05 in chips)
Seat 3: 2718c03d ($18.22 in chips)
Seat 4: a31d9536 ($18.77 in chips)
Seat 5: Hero ($14.77 in chips)
Seat 6: 9e2dc00d ($10.11 in chips)
6593fce5: posts small blind $0.05
2718c03d: posts big blind $0.1
*** HOLE CARDS ***
Dealt to bc90efb6 
Dealt to 6593fce5 
Dealt to 2718c03d 
Dealt to a31d9536 
Dealt to Hero [Qd Ks]
Dealt to 9e2dc00d 
a31d9536: folds
Hero: raises $0.15 to $0.25
9e2dc00d: folds
bc90efb6: calls $0.25
6593fce5: folds
2718c03d: folds
*** FLOP *** [Ts 3s 4c]
Hero: checks
bc90efb6: checks
*** TURN *** [Ts 3s 4c] [4d]
Hero: checks
bc90efb6: bets $0.33
Hero: calls $0.33
*** RIVER *** [Ts 3s 4c 4d] [Jd]
Hero: bets $0.8
bc90efb6: raises $2.19 to $2.99
Hero: folds
Uncalled bet ($2.19) returned to bc90efb6
*** SHOWDOWN ***
bc90efb6 collected $2.77 from pot
*** SUMMARY ***
Total pot $2.91 | Rake $0.14 | Jackpot $0 | Bingo $0 | Fortune $0
Board [Ts 3s 4c 4d Jd]
Seat 1: bc90efb6 (button) won ($2.77)
Seat 2: 6593fce5 (small blind) folded before Flop
Seat 3: 2718c03d (big blind) folded before Flop
Seat 4: a31d9536 folded before Flop (didn't bet)
Seat 5: Hero folded on the River
Seat 6: 9e2dc00d folded before Flop (didn't bet)


Poker Hand #RC1468334277: Hold'em No Limit  ($0.05/$0.1) - 2023/04/12 18:55:54
Table 'RushAndCash5609537' 6-max Seat #1 is the button
Seat 1: 5fa5be03 ($11.22 in chips)
Seat 2: Hero ($14.82 in chips)
Seat 3: ee235847 ($14.85 in chips)
Seat 4: aa28ab16 ($42.73 in chips)
Seat 5: 3327b2ba ($31.55 in chips)
Seat 6: faa9a4c6 ($17.02 in chips)
Hero: posts small blind $0.05
ee235847: posts big blind $0.1
*** HOLE CARDS ***
Dealt to 5fa5be03 
Dealt to Hero [Tc 9c]
Dealt to ee235847 
Dealt to aa28ab16 
Dealt to 3327b2ba 
Dealt to faa9a4c6 
aa28ab16: folds
3327b2ba: folds
faa9a4c6: raises $0.12 to $0.22
5fa5be03: raises $0.59 to $0.81
Hero: folds
ee235847: folds
faa9a4c6: raises $1.28 to $2.09
5fa5be03: raises $9.13 to $11.22 and is all-in
faa9a4c6: calls $9.13
5fa5be03: shows [Kc As]
faa9a4c6: shows [Qs Qh]
*** FIRST FLOP *** [3h Jc Ah]
*** FIRST TURN *** [3h Jc Ah] [8h]
*** FIRST RIVER *** [3h Jc Ah 8h] [6h]
*** SECOND FLOP *** [Ac Js 3s]
*** SECOND TURN *** [Ac Js 3s] [3c]
*** SECOND RIVER *** [Ac Js 3s 3c] [2c]
*** FIRST SHOWDOWN ***
faa9a4c6 collected $11.07 from pot
*** SECOND SHOWDOWN ***
5fa5be03 collected $11.07 from pot
*** SUMMARY ***
Total pot $22.59 | Rake $0.3 | Jackpot $0.15 | Bingo $0 | Fortune $0
Hand was run two times
FIRST Board [3h Jc Ah 8h 6h]
SECOND Board [Ac Js 3s 3c 2c]
Seat 1: 5fa5be03 (button) showed [Kc As] and lost with Pair of Aces, and won ($11.07) with Pair of Aces and Pair of Treys
Seat 2: Hero (small blind) folded before Flop
Seat 3: ee235847 (big blind) folded before Flop
Seat 4: aa28ab16 folded before Flop (didn't bet)
Seat 5: 3327b2ba folded before Flop (didn't bet)
Seat 6: faa9a4c6 showed [Qs Qh] and won ($11.07) with Ace High Flush, and lost with Pair of Queens and Pair of Treys


Poker Hand #RC1468334158: Hold'em No Limit  ($0.05/$0.1) - 2023/04/12 18:55:38
Table 'RushAndCash5609418' 6-max Seat #1 is the button
Seat 1: cc348aa5 ($10.15 in chips)
Seat 2: 69df284d ($10.61 in chips)
Seat 3: f3d17971 ($10.05 in chips)
Seat 4: Hero ($14.67 in chips)
Seat 5: 92b6be70 ($22.71 in chips)
Seat 6: 756cb7a4 ($12.83 in chips)
69df284d: posts small blind $0.05
f3d17971: posts big blind $0.1
*** HOLE CARDS ***
Dealt to cc348aa5 
Dealt to 69df284d 
Dealt to f3d17971 
Dealt to Hero [Th 9s]
Dealt to 92b6be70 
Dealt to 756cb7a4 
Hero: raises $0.15 to $0.25
92b6be70: folds
756cb7a4: folds
cc348aa5: folds
69df284d: folds
f3d17971: folds
Uncalled bet ($0.15) returned to Hero
*** SHOWDOWN ***
Hero collected $0.25 from pot
*** SUMMARY ***
Total pot $0.25 | Rake $0 | Jackpot $0 | Bingo $0 | Fortune $0
Seat 1: cc348aa5 (button) folded before Flop (didn't bet)
Seat 2: 69df284d (small blind) folded before Flop
Seat 3: f3d17971 (big blind) folded before Flop
Seat 4: Hero collected ($0.25)
Seat 5: 92b6be70 folded before Flop (didn't bet)
Seat 6: 756cb7a4 folded before Flop (didn't bet)


Poker Hand #RC1468334125: Hold'em No Limit  ($0.05/$0.1) - 2023/04/12 18:55:34
Table 'RushAndCash5609385' 6-max Seat #1 is the button
Seat 1: 5e23c0b4 ($8.64 in chips)
Seat 2: 473eb9e3 ($10.23 in chips)
Seat 3: Hero ($14.77 in chips)
Seat 4: 70c4190c ($14.86 in chips)
Seat 5: bc90efb6 ($10.66 in chips)
Seat 6: cc348aa5 ($10.15 in chips)
473eb9e3: posts small blind $0.05
Hero: posts big blind $0.1
*** HOLE CARDS ***
Dealt to 5e23c0b4 
Dealt to 473eb9e3 
Dealt to Hero [2s 5d]
Dealt to 70c4190c 
Dealt to bc90efb6 
Dealt to cc348aa5 
70c4190c: folds
bc90efb6: folds
cc348aa5: folds
5e23c0b4: raises $0.14 to $0.24
473eb9e3: folds
Hero: folds
Uncalled bet ($0.14) returned to 5e23c0b4
*** SHOWDOWN ***
5e23c0b4 collected $0.25 from pot
*** SUMMARY ***
Total pot $0.25 | Rake $0 | Jackpot $0 | Bingo $0 | Fortune $0
Seat 1: 5e23c0b4 (button) collected ($0.25)
Seat 2: 473eb9e3 (small blind) folded before Flop
Seat 3: Hero (big blind) folded before Flop
Seat 4: 70c4190c folded before Flop (didn't bet)
Seat 5: bc90efb6 folded before Flop (didn't bet)
Seat 6: cc348aa5 folded before Flop (didn't bet)


Poker Hand #RC1468333712: Hold'em No Limit  ($0.05/$0.1) - 2023/04/12 18:54:34
Table 'RushAndCash5608972' 6-max Seat #1 is the button
Seat 1: e5c4c00 ($21.18 in chips)
Seat 2: b26d57d7 ($5.53 in chips)
Seat 3: Hero ($14.4 in chips)
Seat 4: 7ef82913 ($13.29 in chips)
Seat 5: 3bf969ff ($10.15 in chips)
Seat 6: a5dfdb8 ($10.23 in chips)
b26d57d7: posts small blind $0.05
Hero: posts big blind $0.1
*** HOLE CARDS ***
Dealt to e5c4c00 
Dealt to b26d57d7 
Dealt to Hero [Kh Qs]
Dealt to 7ef82913 
Dealt to 3bf969ff 
Dealt to a5dfdb8 
7ef82913: folds
3bf969ff: raises $0.1 to $0.2
a5dfdb8: folds
e5c4c00: folds
b26d57d7: folds
Hero: calls $0.1
*** FLOP *** [4d 6d Kd]
Hero: checks
3bf969ff: bets $0.15
Hero: calls $0.15
*** TURN *** [4d 6d Kd] [8s]
Hero: checks
3bf969ff: checks
*** RIVER *** [4d 6d Kd 8s] [3s]
Hero: bets $0.25
3bf969ff: folds
Uncalled bet ($0.25) returned to Hero
*** SHOWDOWN ***
Hero collected $0.72 from pot
*** SUMMARY ***
Total pot $0.75 | Rake $0.03 | Jackpot $0 | Bingo $0 | Fortune $0
Board [4d 6d Kd 8s 3s]
Seat 1: e5c4c00 (button) folded before Flop (didn't bet)
Seat 2: b26d57d7 (small blind) folded before Flop
Seat 3: Hero (big blind) won ($0.72)
Seat 4: 7ef82913 folded before Flop (didn't bet)
Seat 5: 3bf969ff folded on the River
Seat 6: a5dfdb8 folded before Flop (didn't bet)


Poker Hand #RC1468333366: Hold'em No Limit  ($0.05/$0.1) - 2023/04/12 18:53:44
Table 'RushAndCash5608626' 6-max Seat #1 is the button
Seat 1: Hero ($14.84 in chips)
Seat 2: 886d4fdf ($9.66 in chips)
Seat 3: b26d57d7 ($5.08 in chips)
Seat 4: 945d04de ($10.19 in chips)
Seat 5: 241988ad ($25.94 in chips)
Seat 6: ce5404af ($20.54 in chips)
886d4fdf: posts small blind $0.05
b26d57d7: posts big blind $0.1
*** HOLE CARDS ***
Dealt to Hero [Qs Ad]
Dealt to 886d4fdf 
Dealt to b26d57d7 
Dealt to 945d04de 
Dealt to 241988ad 
Dealt to ce5404af 
945d04de: folds
241988ad: folds
ce5404af: folds
Hero: raises $0.15 to $0.25
886d4fdf: folds
b26d57d7: calls $0.15
*** FLOP *** [4d 6c 7h]
b26d57d7: checks
Hero: checks
*** TURN *** [4d 6c 7h] [4c]
b26d57d7: bets $0.19
Hero: calls $0.19
*** RIVER *** [4d 6c 7h 4c] [Tc]
b26d57d7: bets $0.31
Hero: folds
Uncalled bet ($0.31) returned to b26d57d7
b26d57d7: shows [5h] (Pair of Fours)
*** SHOWDOWN ***
b26d57d7 collected $0.89 from pot
*** SUMMARY ***
Total pot $0.93 | Rake $0.04 | Jackpot $0 | Bingo $0 | Fortune $0
Board [4d 6c 7h 4c Tc]
Seat 1: Hero (button) folded on the River
Seat 2: 886d4fdf (small blind) folded before Flop
Seat 3: b26d57d7 (big blind) showed [Ks 5h] and won ($0.89) with Pair of Fours
Seat 4: 945d04de folded before Flop (didn't bet)
Seat 5: 241988ad folded before Flop (didn't bet)
Seat 6: ce5404af folded before Flop (didn't bet)


Poker Hand #RC1468333234: Hold'em No Limit  ($0.05/$0.1) - 2023/04/12 18:53:24
Table 'RushAndCash5608494' 6-max Seat #1 is the button
Seat 1: ef62e698 ($11.51 in chips)
Seat 2: ff0e138c ($15.54 in chips)
Seat 3: 10e428c4 ($16.06 in chips)
Seat 4: Hero ($14.69 in chips)
Seat 5: be4cbe4e ($15.34 in chips)
Seat 6: af77d72e ($13.63 in chips)
ff0e138c: posts small blind $0.05
10e428c4: posts big blind $0.1
*** HOLE CARDS ***
Dealt to ef62e698 
Dealt to ff0e138c 
Dealt to 10e428c4 
Dealt to Hero [Ts As]
Dealt to be4cbe4e 
Dealt to af77d72e 
Hero: raises $0.15 to $0.25
be4cbe4e: folds
af77d72e: folds
ef62e698: folds
ff0e138c: folds
10e428c4: folds
Uncalled bet ($0.15) returned to Hero
*** SHOWDOWN ***
Hero collected $0.25 from pot
*** SUMMARY ***
Total pot $0.25 | Rake $0 | Jackpot $0 | Bingo $0 | Fortune $0
Seat 1: ef62e698 (button) folded before Flop (didn't bet)
Seat 2: ff0e138c (small blind) folded before Flop
Seat 3: 10e428c4 (big blind) folded before Flop
Seat 4: Hero collected ($0.25)
Seat 5: be4cbe4e folded before Flop (didn't bet)
Seat 6: af77d72e folded before Flop (didn't bet)


Poker Hand #RC1468332782: Hold'em No Limit  ($0.05/$0.1) - 2023/04/12 18:52:17
Table 'RushAndCash5608042' 6-max Seat #1 is the button
Seat 1: Hero ($15.16 in chips)
Seat 2: 57b5f4da ($13.67 in chips)
Seat 3: 4d0c21a6 ($5.16 in chips)
Seat 4: 632c3876 ($10.93 in chips)
Seat 5: ff0e138c ($14.97 in chips)
Seat 6: 252fffd3 ($10.21 in chips)
57b5f4da: posts small blind $0.05
4d0c21a6: posts big blind $0.1
*** HOLE CARDS ***
Dealt to Hero [3s 4s]
Dealt to 57b5f4da 
Dealt to 4d0c21a6 
Dealt to 632c3876 
Dealt to ff0e138c 
Dealt to 252fffd3 
632c3876: folds
ff0e138c: raises $0.15 to $0.25
252fffd3: folds
Hero: calls $0.25
57b5f4da: folds
4d0c21a6: folds
*** FLOP *** [3d 2h Tc]
ff0e138c: bets $0.22
Hero: calls $0.22
*** TURN *** [3d 2h Tc] [Kc]
ff0e138c: checks
Hero: checks
*** RIVER *** [3d 2h Tc Kc] [6h]
ff0e138c: bets $1.2
Hero: folds
Uncalled bet ($1.2) returned to ff0e138c
*** SHOWDOWN ***
ff0e138c collected $1.04 from pot
*** SUMMARY ***
Total pot $1.09 | Rake $0.05 | Jackpot $0 | Bingo $0 | Fortune $0
Board [3d 2h Tc Kc 6h]
Seat 1: Hero (button) folded on the River
Seat 2: 57b5f4da (small blind) folded before Flop
Seat 3: 4d0c21a6 (big blind) folded before Flop
Seat 4: 632c3876 folded before Flop (didn't bet)
Seat 5: ff0e138c won ($1.04)
Seat 6: 252fffd3 folded before Flop (didn't bet)


Poker Hand #RC1468332729: Hold'em No Limit  ($0.05/$0.1) - 2023/04/12 18:52:10
Table 'RushAndCash5607989' 6-max Seat #1 is the button
Seat 1: 5c6336fb ($9.07 in chips)
Seat 2: 221cdbda ($5 in chips)
Seat 3: 4b85bfdb ($1.88 in chips)
Seat 4: af77d72e ($13.63 in chips)
Seat 5: Hero ($15.16 in chips)
Seat 6: c0cd0f2 ($15.47 in chips)
221cdbda: posts small blind $0.05
4b85bfdb: posts big blind $0.1
*** HOLE CARDS ***
Dealt to 5c6336fb 
Dealt to 221cdbda 
Dealt to 4b85bfdb 
Dealt to af77d72e 
Dealt to Hero [9d Qh]
Dealt to c0cd0f2 
af77d72e: folds
Hero: folds
c0cd0f2: folds
5c6336fb: folds
221cdbda: raises $0.2 to $0.3
4b85bfdb: folds
Uncalled bet ($0.2) returned to 221cdbda
*** SHOWDOWN ***
221cdbda collected $0.2 from pot
*** SUMMARY ***
Total pot $0.2 | Rake $0 | Jackpot $0 | Bingo $0 | Fortune $0
Seat 1: 5c6336fb (button) folded before Flop (didn't bet)
Seat 2: 221cdbda (small blind) collected ($0.2)
Seat 3: 4b85bfdb (big blind) folded before Flop
Seat 4: af77d72e folded before Flop (didn't bet)
Seat 5: Hero folded before Flop (didn't bet)
Seat 6: c0cd0f2 folded before Flop (didn't bet)


Poker Hand #RC1468332255: Hold'em No Limit  ($0.05/$0.1) - 2023/04/12 18:51:04
Table 'RushAndCash5607515' 6-max Seat #1 is the button
Seat 1: 6d5254ff ($13.57 in chips)
Seat 2: 60143ad ($11.13 in chips)
Seat 3: db1c9219 ($10 in chips)
Seat 4: Hero ($16.24 in chips)
Seat 5: acc311b8 ($21.09 in chips)
Seat 6: d879b64c ($13.1 in chips)
60143ad: posts small blind $0.05
db1c9219: posts big blind $0.1
*** HOLE CARDS ***
Dealt to 6d5254ff 
Dealt to 60143ad 
Dealt to db1c9219 
Dealt to Hero [3s As]
Dealt to acc311b8 
Dealt to d879b64c 
Hero: raises $0.15 to $0.25
acc311b8: folds
d879b64c: folds
6d5254ff: folds
60143ad: folds
db1c9219: calls $0.15
*** FLOP *** [2c Ad Qs]
db1c9219: checks
Hero: checks
*** TURN *** [2c Ad Qs] [5h]
db1c9219: bets $0.39
Hero: calls $0.39
*** RIVER *** [2c Ad Qs 5h] [2d]
db1c9219: checks
Hero: bets $0.44
db1c9219: calls $0.44
Hero: shows [3s As] (Pair of Aces and Pair of Twos)
db1c9219: shows [Qc Ah] (Pair of Aces and Pair of Queens)
*** SHOWDOWN ***
db1c9219 collected $2.1 from pot
*** SUMMARY ***
Total pot $2.21 | Rake $0.11 | Jackpot $0 | Bingo $0 | Fortune $0
Board [2c Ad Qs 5h 2d]
Seat 1: 6d5254ff (button) folded before Flop (didn't bet)
Seat 2: 60143ad (small blind) folded before Flop
Seat 3: db1c9219 (big blind) showed [Qc Ah] and won ($2.1) with Pair of Aces and Pair of Queens
Seat 4: Hero showed [3s As] and lost with Pair of Aces and Pair of Twos
Seat 5: acc311b8 folded before Flop (didn't bet)
Seat 6: d879b64c folded before Flop (didn't bet)


Poker Hand #RC1468332194: Hold'em No Limit  ($0.05/$0.1) - 2023/04/12 18:50:56
Table 'RushAndCash5607454' 6-max Seat #1 is the button
Seat 1: 36f24b9e ($11.28 in chips)
Seat 2: Hero ($16.29 in chips)
Seat 3: 241988ad ($25.87 in chips)
Seat 4: 98e602e6 ($17.47 in chips)
Seat 5: 596e7ce8 ($11.13 in chips)
Seat 6: 628a3e84 ($10 in chips)
Hero: posts small blind $0.05
241988ad: posts big blind $0.1
*** HOLE CARDS ***
Dealt to 36f24b9e 
Dealt to Hero [6c 5s]
Dealt to 241988ad 
Dealt to 98e602e6 
Dealt to 596e7ce8 
Dealt to 628a3e84 
98e602e6: folds
596e7ce8: folds
628a3e84: folds
36f24b9e: raises $0.1 to $0.2
Hero: folds
241988ad: folds
Uncalled bet ($0.1) returned to 36f24b9e
*** SHOWDOWN ***
36f24b9e collected $0.25 from pot
*** SUMMARY ***
Total pot $0.25 | Rake $0 | Jackpot $0 | Bingo $0 | Fortune $0
Seat 1: 36f24b9e (button) collected ($0.25)
Seat 2: Hero (small blind) folded before Flop
Seat 3: 241988ad (big blind) folded before Flop
Seat 4: 98e602e6 folded before Flop (didn't bet)
Seat 5: 596e7ce8 folded before Flop (didn't bet)
Seat 6: 628a3e84 folded before Flop (didn't bet)


Poker Hand #RC1468332139: Hold'em No Limit  ($0.05/$0.1) - 2023/04/12 18:50:49
Table 'RushAndCash5607399' 6-max Seat #1 is the button
Seat 1: aab40ca1 ($11.45 in chips)
Seat 2: 3ea05dd1 ($11.18 in chips)
Seat 3: a26ad7e4 ($22.86 in chips)
Seat 4: 290b9185 ($15.76 in chips)
Seat 5: 12086bc4 ($24.31 in chips)
Seat 6: Hero ($16.14 in chips)
3ea05dd1: posts small blind $0.05
a26ad7e4: posts big blind $0.1
*** HOLE CARDS ***
Dealt to aab40ca1 
Dealt to 3ea05dd1 
Dealt to a26ad7e4 
Dealt to 290b9185 
Dealt to 12086bc4 
Dealt to Hero [5c Jh]
290b9185: folds
12086bc4: raises $0.2 to $0.3
Hero: folds
aab40ca1: folds
3ea05dd1: folds
a26ad7e4: folds
Uncalled bet ($0.2) returned to 12086bc4
*** SHOWDOWN ***
12086bc4 collected $0.25 from pot
*** SUMMARY ***
Total pot $0.25 | Rake $0 | Jackpot $0 | Bingo $0 | Fortune $0
Seat 1: aab40ca1 (button) folded before Flop (didn't bet)
Seat 2: 3ea05dd1 (small blind) folded before Flop
Seat 3: a26ad7e4 (big blind) folded before Flop
Seat 4: 290b9185 folded before Flop (didn't bet)
Seat 5: 12086bc4 collected ($0.25)
Seat 6: Hero folded before Flop (didn't bet)


Poker Hand #RC1468332098: Hold'em No Limit  ($0.05/$0.1) - 2023/04/12 18:50:43
Table 'RushAndCash5607358' 6-max Seat #1 is the button
Seat 1: c1853f20 ($7.84 in chips)
Seat 2: c4cc61b3 ($10.23 in chips)
Seat 3: cebca560 ($14.75 in chips)
Seat 4: d6ab6f8a ($10.37 in chips)
Seat 5: 4271af66 ($4.3 in chips)
Seat 6: Hero ($16.14 in chips)
c4cc61b3: posts small blind $0.05
cebca560: posts big blind $0.1
*** HOLE CARDS ***
Dealt to c1853f20 
Dealt to c4cc61b3 
Dealt to cebca560 
Dealt to d6ab6f8a 
Dealt to 4271af66 
Dealt to Hero [2c Td]
d6ab6f8a: raises $0.2 to $0.3
4271af66: calls $0.3
Hero: folds
c1853f20: calls $0.3
c4cc61b3: folds
cebca560: folds
*** FLOP *** [6c 8d Th]
d6ab6f8a: bets $0.35
4271af66: raises $0.35 to $0.7
c1853f20: calls $0.7
d6ab6f8a: calls $0.35
*** TURN *** [6c 8d Th] [6s]
d6ab6f8a: checks
4271af66: checks
c1853f20: bets $0.5
d6ab6f8a: calls $0.5
4271af66: calls $0.5
*** RIVER *** [6c 8d Th 6s] [7c]
d6ab6f8a: checks
4271af66: checks
c1853f20: bets $1.55
d6ab6f8a: calls $1.55
4271af66: folds
c1853f20: shows [9d 7d] (Tens-High Straight)
d6ab6f8a: shows [Ts As] (Pair of Tens and Pair of Sixes)
*** SHOWDOWN ***
c1853f20 collected $7.3 from pot
*** SUMMARY ***
Total pot $7.75 | Rake $0.3 | Jackpot $0.15 | Bingo $0 | Fortune $0
Board [6c 8d Th 6s 7c]
Seat 1: c1853f20 (button) showed [9d 7d] and won ($7.3) with Tens-High Straight
Seat 2: c4cc61b3 (small blind) folded before Flop
Seat 3: cebca560 (big blind) folded before Flop
Seat 4: d6ab6f8a showed [Ts As] and lost with Pair of Tens and Pair of Sixes
Seat 5: 4271af66 folded on the River
Seat 6: Hero folded before Flop (didn't bet)


Poker Hand #RC1468332060: Hold'em No Limit  ($0.05/$0.1) - 2023/04/12 18:50:39
Table 'RushAndCash5607320' 6-max Seat #1 is the button
Seat 1: 4e220891 ($26.43 in chips)
Seat 2: c1853f20 ($7.89 in chips)
Seat 3: 9bba65bf ($27.42 in chips)
Seat 4: Hero ($16.14 in chips)
Seat 5: 36623a12 ($27.27 in chips)
Seat 6: b0ca19b5 ($19.08 in chips)
c1853f20: posts small blind $0.05
9bba65bf: posts big blind $0.1
*** HOLE CARDS ***
Dealt to 4e220891 
Dealt to c1853f20 
Dealt to 9bba65bf 
Dealt to Hero [6s Kd]
Dealt to 36623a12 
Dealt to b0ca19b5 
Hero: folds
36623a12: folds
b0ca19b5: folds
4e220891: folds
c1853f20: folds
Uncalled bet ($0.05) returned to 9bba65bf
*** SHOWDOWN ***
9bba65bf collected $0.1 from pot
*** SUMMARY ***
Total pot $0.1 | Rake $0 | Jackpot $0 | Bingo $0 | Fortune $0
Seat 1: 4e220891 (button) folded before Flop (didn't bet)
Seat 2: c1853f20 (small blind) folded before Flop
Seat 3: 9bba65bf (big blind) collected ($0.1)
Seat 4: Hero folded before Flop (didn't bet)
Seat 5: 36623a12 folded before Flop (didn't bet)
Seat 6: b0ca19b5 folded before Flop (didn't bet)


Poker Hand #RC1468332008: Hold'em No Limit  ($0.05/$0.1) - 2023/04/12 18:50:32
Table 'RushAndCash5607268' 6-max Seat #1 is the button
Seat 1: 1f1a72ec ($5.21 in chips)
Seat 2: ef855eb5 ($10.37 in chips)
Seat 3: Hero ($16.24 in chips)
Seat 4: 6441fc6f ($10.08 in chips)
Seat 5: bb03a8cb ($17.02 in chips)
Seat 6: 6652f68 ($13.09 in chips)
ef855eb5: posts small blind $0.05
Hero: posts big blind $0.1
*** HOLE CARDS ***
Dealt to 1f1a72ec 
Dealt to ef855eb5 
Dealt to Hero [7c 8h]
Dealt to 6441fc6f 
Dealt to bb03a8cb 
Dealt to 6652f68 
6441fc6f: folds
bb03a8cb: folds
6652f68: folds
1f1a72ec: folds
ef855eb5: folds
Uncalled bet ($0.05) returned to Hero
*** SHOWDOWN ***
Hero collected $0.1 from pot
*** SUMMARY ***
Total pot $0.1 | Rake $0 | Jackpot $0 | Bingo $0 | Fortune $0
Seat 1: 1f1a72ec (button) folded before Flop (didn't bet)
Seat 2: ef855eb5 (small blind) folded before Flop
Seat 3: Hero (big blind) collected ($0.1)
Seat 4: 6441fc6f folded before Flop (didn't bet)
Seat 5: bb03a8cb folded before Flop (didn't bet)
Seat 6: 6652f68 folded before Flop (didn't bet)


Poker Hand #RC1468331964: Hold'em No Limit  ($0.05/$0.1) - 2023/04/12 18:50:26
Table 'RushAndCash5607224' 6-max Seat #1 is the button
Seat 1: Hero ($16.24 in chips)
Seat 2: 4d0c21a6 ($4.73 in chips)
Seat 3: 9112125b ($10.48 in chips)
Seat 4: 992468d1 ($21.18 in chips)
Seat 5: 27df0055 ($15.38 in chips)
Seat 6: a7a61589 ($10.05 in chips)
4d0c21a6: posts small blind $0.05
9112125b: posts big blind $0.1
*** HOLE CARDS ***
Dealt to Hero [3c 2c]
Dealt to 4d0c21a6 
Dealt to 9112125b 
Dealt to 992468d1 
Dealt to 27df0055 
Dealt to a7a61589 
992468d1: folds
27df0055: folds
a7a61589: folds
Hero: folds
4d0c21a6: folds
Uncalled bet ($0.05) returned to 9112125b
*** SHOWDOWN ***
9112125b collected $0.1 from pot
*** SUMMARY ***
Total pot $0.1 | Rake $0 | Jackpot $0 | Bingo $0 | Fortune $0
Seat 1: Hero (button) folded before Flop (didn't bet)
Seat 2: 4d0c21a6 (small blind) folded before Flop
Seat 3: 9112125b (big blind) collected ($0.1)
Seat 4: 992468d1 folded before Flop (didn't bet)
Seat 5: 27df0055 folded before Flop (didn't bet)
Seat 6: a7a61589 folded before Flop (didn't bet)


Poker Hand #RC1468331912: Hold'em No Limit  ($0.05/$0.1) - 2023/04/12 18:50:20
Table 'RushAndCash5607172' 6-max Seat #1 is the button
Seat 1: 936e20d7 ($24.27 in chips)
Seat 2: Hero ($16.29 in chips)
Seat 3: 4b33fe04 ($12.48 in chips)
Seat 4: 24db761 ($10.67 in chips)
Seat 5: 34d09902 ($11.77 in chips)
Seat 6: a0b6861c ($15.63 in chips)
Hero: posts small blind $0.05
4b33fe04: posts big blind $0.1
*** HOLE CARDS ***
Dealt to 936e20d7 
Dealt to Hero [9s 4s]
Dealt to 4b33fe04 
Dealt to 24db761 
Dealt to 34d09902 
Dealt to a0b6861c 
24db761: folds
34d09902: folds
a0b6861c: folds
936e20d7: folds
Hero: folds
Uncalled bet ($0.05) returned to 4b33fe04
*** SHOWDOWN ***
4b33fe04 collected $0.1 from pot
*** SUMMARY ***
Total pot $0.1 | Rake $0 | Jackpot $0 | Bingo $0 | Fortune $0
Seat 1: 936e20d7 (button) folded before Flop (didn't bet)
Seat 2: Hero (small blind) folded before Flop
Seat 3: 4b33fe04 (big blind) collected ($0.1)
Seat 4: 24db761 folded before Flop (didn't bet)
Seat 5: 34d09902 folded before Flop (didn't bet)
Seat 6: a0b6861c folded before Flop (didn't bet)


Poker Hand #RC1468331847: Hold'em No Limit  ($0.05/$0.1) - 2023/04/12 18:50:10
Table 'RushAndCash5607107' 6-max Seat #1 is the button
Seat 1: Hero ($16.29 in chips)
Seat 2: 9aa0bcbf ($11.78 in chips)
Seat 3: a02c69bd ($10 in chips)
Seat 4: 1936082a ($10.38 in chips)
Seat 5: 61500afa ($38.98 in chips)
Seat 6: f14a32b ($12.19 in chips)
9aa0bcbf: posts small blind $0.05
a02c69bd: posts big blind $0.1
*** HOLE CARDS ***
Dealt to Hero [5s Js]
Dealt to 9aa0bcbf 
Dealt to a02c69bd 
Dealt to 1936082a 
Dealt to 61500afa 
Dealt to f14a32b 
1936082a: folds
61500afa: folds
f14a32b: folds
Hero: folds
9aa0bcbf: folds
Uncalled bet ($0.05) returned to a02c69bd
*** SHOWDOWN ***
a02c69bd collected $0.1 from pot
*** SUMMARY ***
Total pot $0.1 | Rake $0 | Jackpot $0 | Bingo $0 | Fortune $0
Seat 1: Hero (button) folded before Flop (didn't bet)
Seat 2: 9aa0bcbf (small blind) folded before Flop
Seat 3: a02c69bd (big blind) collected ($0.1)
Seat 4: 1936082a folded before Flop (didn't bet)
Seat 5: 61500afa folded before Flop (didn't bet)
Seat 6: f14a32b folded before Flop (didn't bet)


Poker Hand #RC1468331797: Hold'em No Limit  ($0.05/$0.1) - 2023/04/12 18:50:03
Table 'RushAndCash5607057' 6-max Seat #1 is the button
Seat 1: 34d09902 ($11.62 in chips)
Seat 2: 433f085b ($17.49 in chips)
Seat 3: 1735332f ($10.07 in chips)
Seat 4: 42678dcd ($10.39 in chips)
Seat 5: Hero ($16.29 in chips)
Seat 6: 4a2ca0cb ($10.99 in chips)
433f085b: posts small blind $0.05
1735332f: posts big blind $0.1
*** HOLE CARDS ***
Dealt to 34d09902 
Dealt to 433f085b 
Dealt to 1735332f 
Dealt to 42678dcd 
Dealt to Hero [Jc 5c]
Dealt to 4a2ca0cb 
42678dcd: folds
Hero: folds
4a2ca0cb: folds
34d09902: raises $0.15 to $0.25
433f085b: folds
1735332f: folds
Uncalled bet ($0.15) returned to 34d09902
*** SHOWDOWN ***
34d09902 collected $0.25 from pot
*** SUMMARY ***
Total pot $0.25 | Rake $0 | Jackpot $0 | Bingo $0 | Fortune $0
Seat 1: 34d09902 (button) collected ($0.25)
Seat 2: 433f085b (small blind) folded before Flop
Seat 3: 1735332f (big blind) folded before Flop
Seat 4: 42678dcd folded before Flop (didn't bet)
Seat 5: Hero folded before Flop (didn't bet)
Seat 6: 4a2ca0cb folded before Flop (didn't bet)


Poker Hand #RC1468331695: Hold'em No Limit  ($0.05/$0.1) - 2023/04/12 18:49:49
Table 'RushAndCash5606955' 6-max Seat #1 is the button
Seat 1: 87aa56fb ($22.16 in chips)
Seat 2: Hero ($16.34 in chips)
Seat 3: b0ca19b5 ($19.46 in chips)
Seat 4: f11413c0 ($10.91 in chips)
Seat 5: 84ae99a4 ($11.6 in chips)
Seat 6: 636e64e0 ($8.76 in chips)
Hero: posts small blind $0.05
b0ca19b5: posts big blind $0.1
*** HOLE CARDS ***
Dealt to 87aa56fb 
Dealt to Hero [3c Ac]
Dealt to b0ca19b5 
Dealt to f11413c0 
Dealt to 84ae99a4 
Dealt to 636e64e0 
f11413c0: folds
84ae99a4: folds
636e64e0: raises $0.13 to $0.23
87aa56fb: folds
Hero: folds
b0ca19b5: folds
Uncalled bet ($0.13) returned to 636e64e0
*** SHOWDOWN ***
636e64e0 collected $0.25 from pot
*** SUMMARY ***
Total pot $0.25 | Rake $0 | Jackpot $0 | Bingo $0 | Fortune $0
Seat 1: 87aa56fb (button) folded before Flop (didn't bet)
Seat 2: Hero (small blind) folded before Flop
Seat 3: b0ca19b5 (big blind) folded before Flop
Seat 4: f11413c0 folded before Flop (didn't bet)
Seat 5: 84ae99a4 folded before Flop (didn't bet)
Seat 6: 636e64e0 collected ($0.25)


Poker Hand #RC1468331579: Hold'em No Limit  ($0.05/$0.1) - 2023/04/12 18:49:34
Table 'RushAndCash5606839' 6-max Seat #1 is the button
Seat 1: 7b910fc5 ($10 in chips)
Seat 2: e4f6782f ($12.64 in chips)
Seat 3: 942902a6 ($31.38 in chips)
Seat 4: 756cb7a4 ($10.05 in chips)
Seat 5: 766bb722 ($10 in chips)
Seat 6: Hero ($16.19 in chips)
e4f6782f: posts small blind $0.05
942902a6: posts big blind $0.1
*** HOLE CARDS ***
Dealt to 7b910fc5 
Dealt to e4f6782f 
Dealt to 942902a6 
Dealt to 756cb7a4 
Dealt to 766bb722 
Dealt to Hero [Ah 7h]
756cb7a4: folds
766bb722: folds
Hero: raises $0.15 to $0.25
7b910fc5: folds
e4f6782f: folds
942902a6: folds
Uncalled bet ($0.15) returned to Hero
*** SHOWDOWN ***
Hero collected $0.25 from pot
*** SUMMARY ***
Total pot $0.25 | Rake $0 | Jackpot $0 | Bingo $0 | Fortune $0
Seat 1: 7b910fc5 (button) folded before Flop (didn't bet)
Seat 2: e4f6782f (small blind) folded before Flop
Seat 3: 942902a6 (big blind) folded before Flop
Seat 4: 756cb7a4 folded before Flop (didn't bet)
Seat 5: 766bb722 folded before Flop (didn't bet)
Seat 6: Hero collected ($0.25)


Poker Hand #RC1468331433: Hold'em No Limit  ($0.05/$0.1) - 2023/04/12 18:49:14
Table 'RushAndCash5606693' 6-max Seat #1 is the button
Seat 1: 37727d3f ($11.39 in chips)
Seat 2: 945d04de ($10.05 in chips)
Seat 3: Hero ($16.29 in chips)
Seat 4: b135a85 ($23.41 in chips)
Seat 5: 789916a1 ($17.06 in chips)
Seat 6: 1ad0f897 ($23.96 in chips)
945d04de: posts small blind $0.05
Hero: posts big blind $0.1
*** HOLE CARDS ***
Dealt to 37727d3f 
Dealt to 945d04de 
Dealt to Hero [Ts 6d]
Dealt to b135a85 
Dealt to 789916a1 
Dealt to 1ad0f897 
b135a85: raises $0.15 to $0.25
789916a1: folds
1ad0f897: folds
37727d3f: folds
945d04de: folds
Hero: folds
Uncalled bet ($0.15) returned to b135a85
*** SHOWDOWN ***
b135a85 collected $0.25 from pot
*** SUMMARY ***
Total pot $0.25 | Rake $0 | Jackpot $0 | Bingo $0 | Fortune $0
Seat 1: 37727d3f (button) folded before Flop (didn't bet)
Seat 2: 945d04de (small blind) folded before Flop
Seat 3: Hero (big blind) folded before Flop
Seat 4: b135a85 collected ($0.25)
Seat 5: 789916a1 folded before Flop (didn't bet)
Seat 6: 1ad0f897 folded before Flop (didn't bet)


Poker Hand #RC1468331399: Hold'em No Limit  ($0.05/$0.1) - 2023/04/12 18:49:09
Table 'RushAndCash5606659' 6-max Seat #1 is the button
Seat 1: 144f6425 ($9.85 in chips)
Seat 2: 229f0f32 ($16.77 in chips)
Seat 3: cbf5fbf3 ($11.92 in chips)
Seat 4: 7047cde4 ($11.03 in chips)
Seat 5: 772a09fd ($10.2 in chips)
Seat 6: Hero ($16.29 in chips)
229f0f32: posts small blind $0.05
cbf5fbf3: posts big blind $0.1
*** HOLE CARDS ***
Dealt to 144f6425 
Dealt to 229f0f32 
Dealt to cbf5fbf3 
Dealt to 7047cde4 
Dealt to 772a09fd 
Dealt to Hero [5h Kc]
7047cde4: folds
772a09fd: folds
Hero: folds
144f6425: folds
229f0f32: raises $0.2 to $0.3
cbf5fbf3: folds
Uncalled bet ($0.2) returned to 229f0f32
*** SHOWDOWN ***
229f0f32 collected $0.2 from pot
*** SUMMARY ***
Total pot $0.2 | Rake $0 | Jackpot $0 | Bingo $0 | Fortune $0
Seat 1: 144f6425 (button) folded before Flop (didn't bet)
Seat 2: 229f0f32 (small blind) collected ($0.2)
Seat 3: cbf5fbf3 (big blind) folded before Flop
Seat 4: 7047cde4 folded before Flop (didn't bet)
Seat 5: 772a09fd folded before Flop (didn't bet)
Seat 6: Hero folded before Flop (didn't bet)


Poker Hand #RC1468331355: Hold'em No Limit  ($0.05/$0.1) - 2023/04/12 18:49:04
Table 'RushAndCash5606615' 6-max Seat #1 is the button
Seat 1: fa2569cc ($17.98 in chips)
Seat 2: 43d7a994 ($10.05 in chips)
Seat 3: 8f64e703 ($11.54 in chips)
Seat 4: 96be5e3c ($3.75 in chips)
Seat 5: 77b0e65c ($40.42 in chips)
Seat 6: Hero ($16.29 in chips)
43d7a994: posts small blind $0.05
8f64e703: posts big blind $0.1
*** HOLE CARDS ***
Dealt to fa2569cc 
Dealt to 43d7a994 
Dealt to 8f64e703 
Dealt to 96be5e3c 
Dealt to 77b0e65c 
Dealt to Hero [6d 8h]
96be5e3c: folds
77b0e65c: folds
Hero: folds
fa2569cc: folds
43d7a994: folds
Uncalled bet ($0.05) returned to 8f64e703
*** SHOWDOWN ***
8f64e703 collected $0.1 from pot
*** SUMMARY ***
Total pot $0.1 | Rake $0 | Jackpot $0 | Bingo $0 | Fortune $0
Seat 1: fa2569cc (button) folded before Flop (didn't bet)
Seat 2: 43d7a994 (small blind) folded before Flop
Seat 3: 8f64e703 (big blind) collected ($0.1)
Seat 4: 96be5e3c folded before Flop (didn't bet)
Seat 5: 77b0e65c folded before Flop (didn't bet)
Seat 6: Hero folded before Flop (didn't bet)


Poker Hand #RC1468331304: Hold'em No Limit  ($0.05/$0.1) - 2023/04/12 18:48:56
Table 'RushAndCash5606564' 6-max Seat #1 is the button
Seat 1: fecc79bb ($10.58 in chips)
Seat 2: dbd20385 ($4.4 in chips)
Seat 3: 83bb8dfe ($18.36 in chips)
Seat 4: Hero ($16.29 in chips)
Seat 5: 942902a6 ($31.33 in chips)
Seat 6: 4be79b08 ($13.56 in chips)
dbd20385: posts small blind $0.05
83bb8dfe: posts big blind $0.1
*** HOLE CARDS ***
Dealt to fecc79bb 
Dealt to dbd20385 
Dealt to 83bb8dfe 
Dealt to Hero [6d 3d]
Dealt to 942902a6 
Dealt to 4be79b08 
Hero: folds
942902a6: folds
4be79b08: folds
fecc79bb: folds
dbd20385: folds
Uncalled bet ($0.05) returned to 83bb8dfe
*** SHOWDOWN ***
83bb8dfe collected $0.1 from pot
*** SUMMARY ***
Total pot $0.1 | Rake $0 | Jackpot $0 | Bingo $0 | Fortune $0
Seat 1: fecc79bb (button) folded before Flop (didn't bet)
Seat 2: dbd20385 (small blind) folded before Flop
Seat 3: 83bb8dfe (big blind) collected ($0.1)
Seat 4: Hero folded before Flop (didn't bet)
Seat 5: 942902a6 folded before Flop (didn't bet)
Seat 6: 4be79b08 folded before Flop (didn't bet)


Poker Hand #RC1468331248: Hold'em No Limit  ($0.05/$0.1) - 2023/04/12 18:48:50
Table 'RushAndCash5606508' 6-max Seat #1 is the button
Seat 1: eb082207 ($11.05 in chips)
Seat 2: 23102071 ($7.66 in chips)
Seat 3: 5f0f435a ($20.35 in chips)
Seat 4: a26ad7e4 ($23.21 in chips)
Seat 5: Hero ($16.29 in chips)
Seat 6: e3b29587 ($15.49 in chips)
23102071: posts small blind $0.05
5f0f435a: posts big blind $0.1
*** HOLE CARDS ***
Dealt to eb082207 
Dealt to 23102071 
Dealt to 5f0f435a 
Dealt to a26ad7e4 
Dealt to Hero [Jc 7s]
Dealt to e3b29587 
a26ad7e4: folds
Hero: folds
e3b29587: raises $0.2 to $0.3
eb082207: folds
23102071: folds
5f0f435a: calls $0.2
*** FLOP *** [4h Jh 9c]
5f0f435a: bets $0.65
e3b29587: calls $0.65
*** TURN *** [4h Jh 9c] [Qs]
5f0f435a: bets $1.47
e3b29587: calls $1.47
*** RIVER *** [4h Jh 9c Qs] [7d]
5f0f435a: bets $3.67
e3b29587: folds
Uncalled bet ($3.67) returned to 5f0f435a
*** SHOWDOWN ***
5f0f435a collected $4.51 from pot
*** SUMMARY ***
Total pot $4.89 | Rake $0.23 | Jackpot $0.15 | Bingo $0 | Fortune $0
Board [4h Jh 9c Qs 7d]
Seat 1: eb082207 (button) folded before Flop (didn't bet)
Seat 2: 23102071 (small blind) folded before Flop
Seat 3: 5f0f435a (big blind) won ($4.51)
Seat 4: a26ad7e4 folded before Flop (didn't bet)
Seat 5: Hero folded before Flop (didn't bet)
Seat 6: e3b29587 folded on the River


Poker Hand #RC1468330795: Hold'em No Limit  ($0.05/$0.1) - 2023/04/12 18:47:47
Table 'RushAndCash5606055' 6-max Seat #1 is the button
Seat 1: 756cb7a4 ($10 in chips)
Seat 2: 5f0f435a ($19.62 in chips)
Seat 3: a31d9536 ($18.21 in chips)
Seat 4: Hero ($16.99 in chips)
Seat 5: d0469d32 ($10 in chips)
Seat 6: 2fe97adf ($6.3 in chips)
5f0f435a: posts small blind $0.05
a31d9536: posts big blind $0.1
*** HOLE CARDS ***
Dealt to 756cb7a4 
Dealt to 5f0f435a 
Dealt to a31d9536 
Dealt to Hero [As Jc]
Dealt to d0469d32 
Dealt to 2fe97adf 
Hero: raises $0.15 to $0.25
d0469d32: folds
2fe97adf: folds
756cb7a4: folds
5f0f435a: calls $0.2
a31d9536: folds
*** FLOP *** [4h 2d 5d]
5f0f435a: checks
Hero: checks
*** TURN *** [4h 2d 5d] [Qc]
5f0f435a: bets $0.45
Hero: calls $0.45
*** RIVER *** [4h 2d 5d Qc] [Th]
5f0f435a: bets $1.5
Hero: folds
Uncalled bet ($1.5) returned to 5f0f435a
*** SHOWDOWN ***
5f0f435a collected $1.43 from pot
*** SUMMARY ***
Total pot $1.5 | Rake $0.07 | Jackpot $0 | Bingo $0 | Fortune $0
Board [4h 2d 5d Qc Th]
Seat 1: 756cb7a4 (button) folded before Flop (didn't bet)
Seat 2: 5f0f435a (small blind) won ($1.43)
Seat 3: a31d9536 (big blind) folded before Flop
Seat 4: Hero folded on the River
Seat 5: d0469d32 folded before Flop (didn't bet)
Seat 6: 2fe97adf folded before Flop (didn't bet)


Poker Hand #RC1468330679: Hold'em No Limit  ($0.05/$0.1) - 2023/04/12 18:47:30
Table 'RushAndCash5605939' 6-max Seat #1 is the button
Seat 1: 9b62d688 ($9.65 in chips)
Seat 2: bb9f0f7c ($13.72 in chips)
Seat 3: Hero ($17.09 in chips)
Seat 4: 5b43b796 ($11.48 in chips)
Seat 5: 433f085b ($18.14 in chips)
Seat 6: b7d6ca ($15.32 in chips)
bb9f0f7c: posts small blind $0.05
Hero: posts big blind $0.1
*** HOLE CARDS ***
Dealt to 9b62d688 
Dealt to bb9f0f7c 
Dealt to Hero [Qc 8c]
Dealt to 5b43b796 
Dealt to 433f085b 
Dealt to b7d6ca 
5b43b796: folds
433f085b: folds
b7d6ca: raises $0.15 to $0.25
9b62d688: folds
bb9f0f7c: folds
Hero: folds
Uncalled bet ($0.15) returned to b7d6ca
*** SHOWDOWN ***
b7d6ca collected $0.25 from pot
*** SUMMARY ***
Total pot $0.25 | Rake $0 | Jackpot $0 | Bingo $0 | Fortune $0
Seat 1: 9b62d688 (button) folded before Flop (didn't bet)
Seat 2: bb9f0f7c (small blind) folded before Flop
Seat 3: Hero (big blind) folded before Flop
Seat 4: 5b43b796 folded before Flop (didn't bet)
Seat 5: 433f085b folded before Flop (didn't bet)
Seat 6: b7d6ca collected ($0.25)


Poker Hand #RC1468330592: Hold'em No Limit  ($0.05/$0.1) - 2023/04/12 18:47:18
Table 'RushAndCash5605852' 6-max Seat #1 is the button
Seat 1: 2f8b5e0c ($13.63 in chips)
Seat 2: Hero ($17.14 in chips)
Seat 3: 754a87f7 ($10.57 in chips)
Seat 4: 9801bacb ($10.81 in chips)
Seat 5: e4df519e ($10 in chips)
Seat 6: 433f085b ($18.14 in chips)
Hero: posts small blind $0.05
754a87f7: posts big blind $0.1
*** HOLE CARDS ***
Dealt to 2f8b5e0c 
Dealt to Hero [5s Qd]
Dealt to 754a87f7 
Dealt to 9801bacb 
Dealt to e4df519e 
Dealt to 433f085b 
9801bacb: folds
e4df519e: folds
433f085b: folds
2f8b5e0c: folds
Hero: folds
Uncalled bet ($0.05) returned to 754a87f7
*** SHOWDOWN ***
754a87f7 collected $0.1 from pot
*** SUMMARY ***
Total pot $0.1 | Rake $0 | Jackpot $0 | Bingo $0 | Fortune $0
Seat 1: 2f8b5e0c (button) folded before Flop (didn't bet)
Seat 2: Hero (small blind) folded before Flop
Seat 3: 754a87f7 (big blind) collected ($0.1)
Seat 4: 9801bacb folded before Flop (didn't bet)
Seat 5: e4df519e folded before Flop (didn't bet)
Seat 6: 433f085b folded before Flop (didn't bet)


Poker Hand #RC1468330393: Hold'em No Limit  ($0.05/$0.1) - 2023/04/12 18:46:51
Table 'RushAndCash5605653' 6-max Seat #1 is the button
Seat 1: Hero ($16.81 in chips)
Seat 2: 754a87f7 ($10.62 in chips)
Seat 3: 4b33fe04 ($15.14 in chips)
Seat 4: ec825e33 ($15.7 in chips)
Seat 5: 9801bacb ($11.01 in chips)
Seat 6: ca8146 ($18.51 in chips)
754a87f7: posts small blind $0.05
4b33fe04: posts big blind $0.1
*** HOLE CARDS ***
Dealt to Hero [4s 5s]
Dealt to 754a87f7 
Dealt to 4b33fe04 
Dealt to ec825e33 
Dealt to 9801bacb 
Dealt to ca8146 
ec825e33: folds
9801bacb: raises $0.1 to $0.2
ca8146: folds
Hero: calls $0.2
754a87f7: folds
4b33fe04: folds
*** FLOP *** [Ah Ac 6s]
9801bacb: checks
Hero: bets $0.19
9801bacb: folds
Uncalled bet ($0.19) returned to Hero
*** SHOWDOWN ***
Hero collected $0.53 from pot
*** SUMMARY ***
Total pot $0.55 | Rake $0.02 | Jackpot $0 | Bingo $0 | Fortune $0
Board [Ah Ac 6s]
Seat 1: Hero (button) won ($0.53)
Seat 2: 754a87f7 (small blind) folded before Flop
Seat 3: 4b33fe04 (big blind) folded before Flop
Seat 4: ec825e33 folded before Flop (didn't bet)
Seat 5: 9801bacb folded on the Flop
Seat 6: ca8146 folded before Flop (didn't bet)


Poker Hand #RC1468330354: Hold'em No Limit  ($0.05/$0.1) - 2023/04/12 18:46:45
Table 'RushAndCash5605614' 6-max Seat #1 is the button
Seat 1: 9a6e2d23 ($19.25 in chips)
Seat 2: 1b43483 ($22.14 in chips)
Seat 3: 27df0055 ($15.5 in chips)
Seat 4: 6108a2fc ($10.07 in chips)
Seat 5: Hero ($16.81 in chips)
Seat 6: 9aa0bcbf ($12.3 in chips)
1b43483: posts small blind $0.05
27df0055: posts big blind $0.1
*** HOLE CARDS ***
Dealt to 9a6e2d23 
Dealt to 1b43483 
Dealt to 27df0055 
Dealt to 6108a2fc 
Dealt to Hero [4s 2s]
Dealt to 9aa0bcbf 
6108a2fc: folds
Hero: folds
9aa0bcbf: folds
9a6e2d23: raises $0.1 to $0.2
1b43483: folds
27df0055: folds
Uncalled bet ($0.1) returned to 9a6e2d23
*** SHOWDOWN ***
9a6e2d23 collected $0.25 from pot
*** SUMMARY ***
Total pot $0.25 | Rake $0 | Jackpot $0 | Bingo $0 | Fortune $0
Seat 1: 9a6e2d23 (button) collected ($0.25)
Seat 2: 1b43483 (small blind) folded before Flop
Seat 3: 27df0055 (big blind) folded before Flop
Seat 4: 6108a2fc folded before Flop (didn't bet)
Seat 5: Hero folded before Flop (didn't bet)
Seat 6: 9aa0bcbf folded before Flop (didn't bet)


Poker Hand #RC1468330313: Hold'em No Limit  ($0.05/$0.1) - 2023/04/12 18:46:39
Table 'RushAndCash5605573' 6-max Seat #1 is the button
Seat 1: 2b4d2fdc ($12.63 in chips)
Seat 2: 4df7250d ($20.45 in chips)
Seat 3: 9112125b ($10.65 in chips)
Seat 4: 1d9d44cb ($10.05 in chips)
Seat 5: Hero ($16.81 in chips)
Seat 6: 43d7a994 ($10 in chips)
4df7250d: posts small blind $0.05
9112125b: posts big blind $0.1
*** HOLE CARDS ***
Dealt to 2b4d2fdc 
Dealt to 4df7250d 
Dealt to 9112125b 
Dealt to 1d9d44cb 
Dealt to Hero [Jc 2h]
Dealt to 43d7a994 
1d9d44cb: folds
Hero: folds
43d7a994: folds
2b4d2fdc: raises $0.15 to $0.25
4df7250d: folds
9112125b: folds
Uncalled bet ($0.15) returned to 2b4d2fdc
*** SHOWDOWN ***
2b4d2fdc collected $0.25 from pot
*** SUMMARY ***
Total pot $0.25 | Rake $0 | Jackpot $0 | Bingo $0 | Fortune $0
Seat 1: 2b4d2fdc (button) collected ($0.25)
Seat 2: 4df7250d (small blind) folded before Flop
Seat 3: 9112125b (big blind) folded before Flop
Seat 4: 1d9d44cb folded before Flop (didn't bet)
Seat 5: Hero folded before Flop (didn't bet)
Seat 6: 43d7a994 folded before Flop (didn't bet)


Poker Hand #RC1468330266: Hold'em No Limit  ($0.05/$0.1) - 2023/04/12 18:46:34
Table 'RushAndCash5605526' 6-max Seat #1 is the button
Seat 1: 6372d866 ($21.96 in chips)
Seat 2: eb082207 ($10.25 in chips)
Seat 3: a8f4faee ($11.57 in chips)
Seat 4: 36623a12 ($30.29 in chips)
Seat 5: Hero ($16.81 in chips)
Seat 6: a5e9fa24 ($10 in chips)
eb082207: posts small blind $0.05
a8f4faee: posts big blind $0.1
*** HOLE CARDS ***
Dealt to 6372d866 
Dealt to eb082207 
Dealt to a8f4faee 
Dealt to 36623a12 
Dealt to Hero [2h Qh]
Dealt to a5e9fa24 
36623a12: folds
Hero: folds
a5e9fa24: folds
6372d866: folds
eb082207: raises $0.2 to $0.3
a8f4faee: calls $0.2
*** FLOP *** [Kh Ah Kc]
eb082207: bets $0.2
a8f4faee: calls $0.2
*** TURN *** [Kh Ah Kc] [8d]
eb082207: checks
a8f4faee: checks
*** RIVER *** [Kh Ah Kc 8d] [4h]
eb082207: checks
a8f4faee: bets $0.33
eb082207: folds
Uncalled bet ($0.33) returned to a8f4faee
*** SHOWDOWN ***
a8f4faee collected $0.94 from pot
*** SUMMARY ***
Total pot $1 | Rake $0.06 | Jackpot $0 | Bingo $0 | Fortune $0
Board [Kh Ah Kc 8d 4h]
Seat 1: 6372d866 (button) folded before Flop (didn't bet)
Seat 2: eb082207 (small blind) folded on the River
Seat 3: a8f4faee (big blind) won ($0.94)
Seat 4: 36623a12 folded before Flop (didn't bet)
Seat 5: Hero folded before Flop (didn't bet)
Seat 6: a5e9fa24 folded before Flop (didn't bet)


Poker Hand #RC1468330163: Hold'em No Limit  ($0.05/$0.1) - 2023/04/12 18:46:19
Table 'RushAndCash5605423' 6-max Seat #1 is the button
Seat 1: 529e8e9a ($20.78 in chips)
Seat 2: b4c2f9f9 ($9.97 in chips)
Seat 3: Hero ($16.91 in chips)
Seat 4: 78fd7a64 ($14.59 in chips)
Seat 5: 992468d1 ($14.46 in chips)
Seat 6: 37727d3f ($11.48 in chips)
b4c2f9f9: posts small blind $0.05
Hero: posts big blind $0.1
*** HOLE CARDS ***
Dealt to 529e8e9a 
Dealt to b4c2f9f9 
Dealt to Hero [Jc 2c]
Dealt to 78fd7a64 
Dealt to 992468d1 
Dealt to 37727d3f 
78fd7a64: folds
992468d1: raises $0.12 to $0.22
37727d3f: folds
529e8e9a: raises $0.59 to $0.81
b4c2f9f9: folds
Hero: folds
992468d1: raises $1.77 to $2.58
529e8e9a: calls $1.77
*** FLOP *** [Qd 8c Kc]
992468d1: checks
529e8e9a: bets $1.76
992468d1: calls $1.76
*** TURN *** [Qd 8c Kc] [4d]
992468d1: checks
529e8e9a: bets $16.44 and is all-in
992468d1: calls $10.12 and is all-in
Uncalled bet ($6.32) returned to 529e8e9a
529e8e9a: shows [Kh Qh] (Pair of Kings and Pair of Queens)
992468d1: shows [Ah As] (Pair of Aces)
529e8e9a: Chooses to EV Cashout 
*** RIVER *** [Qd 8c Kc 4d] [8d]
529e8e9a: Receives Cashout ($14.56)
*** SHOWDOWN ***
992468d1 collected $28.62 from pot
*** SUMMARY ***
Total pot $29.07 | Rake $0.3 | Jackpot $0.15 | Bingo $0 | Fortune $0
Board [Qd 8c Kc 4d 8d]
Seat 1: 529e8e9a (button) showed [Kh Qh] and lost with Pair of Kings and Pair of Queens, EV Cashout ($0)
Seat 2: b4c2f9f9 (small blind) folded before Flop
Seat 3: Hero (big blind) folded before Flop
Seat 4: 78fd7a64 folded before Flop (didn't bet)
Seat 5: 992468d1 showed [Ah As] and won ($28.62) with Pair of Aces and Pair of Eights
Seat 6: 37727d3f folded before Flop (didn't bet)


Poker Hand #RC1468329905: Hold'em No Limit  ($0.05/$0.1) - 2023/04/12 18:45:46
Table 'RushAndCash5605165' 6-max Seat #1 is the button
Seat 1: 8c6cfe67 ($10.82 in chips)
Seat 2: Hero ($17.21 in chips)
Seat 3: b4c2f9f9 ($9.7 in chips)
Seat 4: 22f47a15 ($10.37 in chips)
Seat 5: 36f24b9e ($10.86 in chips)
Seat 6: 6e3138bc ($11.34 in chips)
Hero: posts small blind $0.05
b4c2f9f9: posts big blind $0.1
*** HOLE CARDS ***
Dealt to 8c6cfe67 
Dealt to Hero [6c As]
Dealt to b4c2f9f9 
Dealt to 22f47a15 
Dealt to 36f24b9e 
Dealt to 6e3138bc 
22f47a15: folds
36f24b9e: folds
6e3138bc: folds
8c6cfe67: folds
Hero: raises $0.2 to $0.3
b4c2f9f9: calls $0.2
*** FLOP *** [Jc 5d 8h]
Hero: checks
b4c2f9f9: bets $0.3
Hero: folds
Uncalled bet ($0.3) returned to b4c2f9f9
*** SHOWDOWN ***
b4c2f9f9 collected $0.57 from pot
*** SUMMARY ***
Total pot $0.6 | Rake $0.03 | Jackpot $0 | Bingo $0 | Fortune $0
Board [Jc 5d 8h]
Seat 1: 8c6cfe67 (button) folded before Flop (didn't bet)
Seat 2: Hero (small blind) folded on the Flop
Seat 3: b4c2f9f9 (big blind) won ($0.57)
Seat 4: 22f47a15 folded before Flop (didn't bet)
Seat 5: 36f24b9e folded before Flop (didn't bet)
Seat 6: 6e3138bc folded before Flop (didn't bet)


Poker Hand #RC1468329778: Hold'em No Limit  ($0.05/$0.1) - 2023/04/12 18:45:29
Table 'RushAndCash5605038' 6-max Seat #1 is the button
Seat 1: Hero ($17.21 in chips)
Seat 2: 1f58de2 ($47.34 in chips)
Seat 3: ad130b2 ($15.4 in chips)
Seat 4: a7a61589 ($15.08 in chips)
Seat 5: d4483568 ($11.36 in chips)
Seat 6: 89dd6b86 ($12.74 in chips)
1f58de2: posts small blind $0.05
ad130b2: posts big blind $0.1
*** HOLE CARDS ***
Dealt to Hero [4h 6d]
Dealt to 1f58de2 
Dealt to ad130b2 
Dealt to a7a61589 
Dealt to d4483568 
Dealt to 89dd6b86 
a7a61589: folds
d4483568: folds
89dd6b86: raises $0.15 to $0.25
Hero: folds
1f58de2: calls $0.2
ad130b2: calls $0.15
*** FLOP *** [Jc Th Jh]
1f58de2: checks
ad130b2: checks
89dd6b86: checks
*** TURN *** [Jc Th Jh] [7c]
1f58de2: checks
ad130b2: checks
89dd6b86: checks
*** RIVER *** [Jc Th Jh 7c] [4s]
1f58de2: bets $0.25
ad130b2: folds
89dd6b86: folds
Uncalled bet ($0.25) returned to 1f58de2
*** SHOWDOWN ***
1f58de2 collected $0.72 from pot
*** SUMMARY ***
Total pot $0.75 | Rake $0.03 | Jackpot $0 | Bingo $0 | Fortune $0
Board [Jc Th Jh 7c 4s]
Seat 1: Hero (button) folded before Flop (didn't bet)
Seat 2: 1f58de2 (small blind) won ($0.72)
Seat 3: ad130b2 (big blind) folded on the River
Seat 4: a7a61589 folded before Flop (didn't bet)
Seat 5: d4483568 folded before Flop (didn't bet)
Seat 6: 89dd6b86 folded on the River


Poker Hand #RC1468329712: Hold'em No Limit  ($0.05/$0.1) - 2023/04/12 18:45:20
Table 'RushAndCash5604972' 6-max Seat #1 is the button
Seat 1: 6441fc6f ($10.1 in chips)
Seat 2: Hero ($17.26 in chips)
Seat 3: 6d5254ff ($10.38 in chips)
Seat 4: b1087382 ($10.62 in chips)
Seat 5: cf6ea5ea ($16.21 in chips)
Seat 6: e7ce73b3 ($15.13 in chips)
Hero: posts small blind $0.05
6d5254ff: posts big blind $0.1
*** HOLE CARDS ***
Dealt to 6441fc6f 
Dealt to Hero [4h 5d]
Dealt to 6d5254ff 
Dealt to b1087382 
Dealt to cf6ea5ea 
Dealt to e7ce73b3 
b1087382: folds
cf6ea5ea: folds
e7ce73b3: folds
6441fc6f: folds
Hero: folds
Uncalled bet ($0.05) returned to 6d5254ff
*** SHOWDOWN ***
6d5254ff collected $0.1 from pot
*** SUMMARY ***
Total pot $0.1 | Rake $0 | Jackpot $0 | Bingo $0 | Fortune $0
Seat 1: 6441fc6f (button) folded before Flop (didn't bet)
Seat 2: Hero (small blind) folded before Flop
Seat 3: 6d5254ff (big blind) collected ($0.1)
Seat 4: b1087382 folded before Flop (didn't bet)
Seat 5: cf6ea5ea folded before Flop (didn't bet)
Seat 6: e7ce73b3 folded before Flop (didn't bet)


Poker Hand #RC1468329587: Hold'em No Limit  ($0.05/$0.1) - 2023/04/12 18:45:01
Table 'RushAndCash5604847' 6-max Seat #1 is the button
Seat 1: de8b37ab ($26.85 in chips)
Seat 2: e2985e7f ($10.28 in chips)
Seat 3: e5f59a66 ($10 in chips)
Seat 4: ccfa1b39 ($18.43 in chips)
Seat 5: 10c21897 ($13.29 in chips)
Seat 6: Hero ($17.26 in chips)
e2985e7f: posts small blind $0.05
e5f59a66: posts big blind $0.1
*** HOLE CARDS ***
Dealt to de8b37ab 
Dealt to e2985e7f 
Dealt to e5f59a66 
Dealt to ccfa1b39 
Dealt to 10c21897 
Dealt to Hero [Kc 2d]
ccfa1b39: folds
10c21897: folds
Hero: folds
de8b37ab: folds
e2985e7f: folds
Uncalled bet ($0.05) returned to e5f59a66
*** SHOWDOWN ***
e5f59a66 collected $0.1 from pot
*** SUMMARY ***
Total pot $0.1 | Rake $0 | Jackpot $0 | Bingo $0 | Fortune $0
Seat 1: de8b37ab (button) folded before Flop (didn't bet)
Seat 2: e2985e7f (small blind) folded before Flop
Seat 3: e5f59a66 (big blind) collected ($0.1)
Seat 4: ccfa1b39 folded before Flop (didn't bet)
Seat 5: 10c21897 folded before Flop (didn't bet)
Seat 6: Hero folded before Flop (didn't bet)


Poker Hand #RC1468329116: Hold'em No Limit  ($0.05/$0.1) - 2023/04/12 18:43:56
Table 'RushAndCash5604376' 6-max Seat #1 is the button
Seat 1: Hero ($17.51 in chips)
Seat 2: 829e5fe4 ($3.11 in chips)
Seat 3: e2985e7f ($10 in chips)
Seat 4: 19d1b007 ($4.63 in chips)
Seat 5: 1c91bf60 ($13.91 in chips)
Seat 6: cbf5fbf3 ($10 in chips)
829e5fe4: posts small blind $0.05
e2985e7f: posts big blind $0.1
*** HOLE CARDS ***
Dealt to Hero [Ah 5d]
Dealt to 829e5fe4 
Dealt to e2985e7f 
Dealt to 19d1b007 
Dealt to 1c91bf60 
Dealt to cbf5fbf3 
19d1b007: folds
1c91bf60: folds
cbf5fbf3: folds
Hero: raises $0.15 to $0.25
829e5fe4: folds
e2985e7f: calls $0.15
*** FLOP *** [Ks Qs Js]
e2985e7f: checks
Hero: checks
*** TURN *** [Ks Qs Js] [9d]
e2985e7f: checks
Hero: checks
*** RIVER *** [Ks Qs Js 9d] [Kh]
e2985e7f: checks
Hero: checks
e2985e7f: shows [7c Qd] (Pair of Kings and Pair of Queens)
Hero: shows [Ah 5d] (Pair of Kings)
*** SHOWDOWN ***
e2985e7f collected $0.53 from pot
*** SUMMARY ***
Total pot $0.55 | Rake $0.02 | Jackpot $0 | Bingo $0 | Fortune $0
Board [Ks Qs Js 9d Kh]
Seat 1: Hero (button) showed [Ah 5d] and lost with Pair of Kings
Seat 2: 829e5fe4 (small blind) folded before Flop
Seat 3: e2985e7f (big blind) showed [7c Qd] and won ($0.53) with Pair of Kings and Pair of Queens
Seat 4: 19d1b007 folded before Flop (didn't bet)
Seat 5: 1c91bf60 folded before Flop (didn't bet)
Seat 6: cbf5fbf3 folded before Flop (didn't bet)


Poker Hand #RC1468328986: Hold'em No Limit  ($0.05/$0.1) - 2023/04/12 18:43:39
Table 'RushAndCash5604246' 6-max Seat #1 is the button
Seat 1: e4f6782f ($10 in chips)
Seat 2: ac7fce4a ($25.01 in chips)
Seat 3: 9f6c7ed2 ($9.85 in chips)
Seat 4: 921a0b3f ($12.42 in chips)
Seat 5: Hero ($17.36 in chips)
Seat 6: f14a32b ($10.55 in chips)
ac7fce4a: posts small blind $0.05
9f6c7ed2: posts big blind $0.1
*** HOLE CARDS ***
Dealt to e4f6782f 
Dealt to ac7fce4a 
Dealt to 9f6c7ed2 
Dealt to 921a0b3f 
Dealt to Hero [Ks Jc]
Dealt to f14a32b 
921a0b3f: folds
Hero: raises $0.15 to $0.25
f14a32b: folds
e4f6782f: folds
ac7fce4a: folds
9f6c7ed2: folds
Uncalled bet ($0.15) returned to Hero
*** SHOWDOWN ***
Hero collected $0.25 from pot
*** SUMMARY ***
Total pot $0.25 | Rake $0 | Jackpot $0 | Bingo $0 | Fortune $0
Seat 1: e4f6782f (button) folded before Flop (didn't bet)
Seat 2: ac7fce4a (small blind) folded before Flop
Seat 3: 9f6c7ed2 (big blind) folded before Flop
Seat 4: 921a0b3f folded before Flop (didn't bet)
Seat 5: Hero collected ($0.25)
Seat 6: f14a32b folded before Flop (didn't bet)


Poker Hand #RC1468328886: Hold'em No Limit  ($0.05/$0.1) - 2023/04/12 18:43:25
Table 'RushAndCash5604146' 6-max Seat #1 is the button
Seat 1: 1bd3bc3d ($12.95 in chips)
Seat 2: 1f58de2 ($46.15 in chips)
Seat 3: Hero ($17.46 in chips)
Seat 4: e3b29587 ($12.24 in chips)
Seat 5: 162fea2f ($17.17 in chips)
Seat 6: cc348aa5 ($10.9 in chips)
1f58de2: posts small blind $0.05
Hero: posts big blind $0.1
*** HOLE CARDS ***
Dealt to 1bd3bc3d 
Dealt to 1f58de2 
Dealt to Hero [7d Js]
Dealt to e3b29587 
Dealt to 162fea2f 
Dealt to cc348aa5 
e3b29587: folds
162fea2f: raises $0.13 to $0.23
cc348aa5: folds
1bd3bc3d: folds
1f58de2: calls $0.18
Hero: folds
*** FLOP *** [4c Kh Jh]
1f58de2: checks
162fea2f: bets $0.2
1f58de2: calls $0.2
*** TURN *** [4c Kh Jh] [8s]
1f58de2: checks
162fea2f: checks
*** RIVER *** [4c Kh Jh 8s] [8d]
1f58de2: bets $0.32
162fea2f: calls $0.32
1f58de2: shows [7c 7s] (Pair of Eights and Pair of Sevens)
162fea2f: shows [Ac Qd] (Pair of Eights)
*** SHOWDOWN ***
1f58de2 collected $1.52 from pot
*** SUMMARY ***
Total pot $1.6 | Rake $0.08 | Jackpot $0 | Bingo $0 | Fortune $0
Board [4c Kh Jh 8s 8d]
Seat 1: 1bd3bc3d (button) folded before Flop (didn't bet)
Seat 2: 1f58de2 (small blind) showed [7c 7s] and won ($1.52) with Pair of Eights and Pair of Sevens
Seat 3: Hero (big blind) folded before Flop
Seat 4: e3b29587 folded before Flop (didn't bet)
Seat 5: 162fea2f showed [Ac Qd] and lost with Pair of Eights
Seat 6: cc348aa5 folded before Flop (didn't bet)


Poker Hand #RC1468328818: Hold'em No Limit  ($0.05/$0.1) - 2023/04/12 18:43:16
Table 'RushAndCash5604078' 6-max Seat #1 is the button
Seat 1: 4d250817 ($22.04 in chips)
Seat 2: 4a95f8f6 ($16.49 in chips)
Seat 3: 3a4f05b0 ($8.92 in chips)
Seat 4: 4afd4208 ($15.81 in chips)
Seat 5: Hero ($17.46 in chips)
Seat 6: c9c743d2 ($12.64 in chips)
4a95f8f6: posts small blind $0.05
3a4f05b0: posts big blind $0.1
*** HOLE CARDS ***
Dealt to 4d250817 
Dealt to 4a95f8f6 
Dealt to 3a4f05b0 
Dealt to 4afd4208 
Dealt to Hero [4h 3h]
Dealt to c9c743d2 
4afd4208: raises $0.12 to $0.22
Hero: folds
c9c743d2: folds
4d250817: folds
4a95f8f6: folds
3a4f05b0: raises $0.83 to $1.05
4afd4208: folds
Uncalled bet ($0.83) returned to 3a4f05b0
*** SHOWDOWN ***
3a4f05b0 collected $0.47 from pot
*** SUMMARY ***
Total pot $0.49 | Rake $0.02 | Jackpot $0 | Bingo $0 | Fortune $0
Seat 1: 4d250817 (button) folded before Flop (didn't bet)
Seat 2: 4a95f8f6 (small blind) folded before Flop
Seat 3: 3a4f05b0 (big blind) collected ($0.47)
Seat 4: 4afd4208 folded before Flop
Seat 5: Hero folded before Flop (didn't bet)
Seat 6: c9c743d2 folded before Flop (didn't bet)


Poker Hand #RC1468328783: Hold'em No Limit  ($0.05/$0.1) - 2023/04/12 18:43:11
Table 'RushAndCash5604043' 6-max Seat #1 is the button
Seat 1: c60f4314 ($11.23 in chips)
Seat 2: 6c903ec8 ($10.05 in chips)
Seat 3: 636e64e0 ($9.13 in chips)
Seat 4: Hero ($17.46 in chips)
Seat 5: bc90efb6 ($10.35 in chips)
Seat 6: 4ce87bc2 ($11.04 in chips)
6c903ec8: posts small blind $0.05
636e64e0: posts big blind $0.1
*** HOLE CARDS ***
Dealt to c60f4314 
Dealt to 6c903ec8 
Dealt to 636e64e0 
Dealt to Hero [7c Jc]
Dealt to bc90efb6 
Dealt to 4ce87bc2 
Hero: folds
bc90efb6: raises $0.2 to $0.3
4ce87bc2: folds
c60f4314: folds
6c903ec8: folds
636e64e0: calls $0.2
*** FLOP *** [Kh 2h 5c]
636e64e0: checks
bc90efb6: bets $0.49
636e64e0: folds
Uncalled bet ($0.49) returned to bc90efb6
*** SHOWDOWN ***
bc90efb6 collected $0.62 from pot
*** SUMMARY ***
Total pot $0.65 | Rake $0.03 | Jackpot $0 | Bingo $0 | Fortune $0
Board [Kh 2h 5c]
Seat 1: c60f4314 (button) folded before Flop (didn't bet)
Seat 2: 6c903ec8 (small blind) folded before Flop
Seat 3: 636e64e0 (big blind) folded on the Flop
Seat 4: Hero folded before Flop (didn't bet)
Seat 5: bc90efb6 won ($0.62)
Seat 6: 4ce87bc2 folded before Flop (didn't bet)


Poker Hand #RC1468328745: Hold'em No Limit  ($0.05/$0.1) - 2023/04/12 18:43:07
Table 'RushAndCash5604005' 6-max Seat #1 is the button
Seat 1: 58628743 ($20.1 in chips)
Seat 2: af77d72e ($14.07 in chips)
Seat 3: dbd20385 ($2.39 in chips)
Seat 4: 8431f1ca ($9.52 in chips)
Seat 5: Hero ($17.46 in chips)
Seat 6: 756cb7a4 ($10 in chips)
af77d72e: posts small blind $0.05
dbd20385: posts big blind $0.1
*** HOLE CARDS ***
Dealt to 58628743 
Dealt to af77d72e 
Dealt to dbd20385 
Dealt to 8431f1ca 
Dealt to Hero [6c Tc]
Dealt to 756cb7a4 
8431f1ca: folds
Hero: folds
756cb7a4: folds
58628743: folds
af77d72e: raises $0.2 to $0.3
dbd20385: folds
Uncalled bet ($0.2) returned to af77d72e
*** SHOWDOWN ***
af77d72e collected $0.2 from pot
*** SUMMARY ***
Total pot $0.2 | Rake $0 | Jackpot $0 | Bingo $0 | Fortune $0
Seat 1: 58628743 (button) folded before Flop (didn't bet)
Seat 2: af77d72e (small blind) collected ($0.2)
Seat 3: dbd20385 (big blind) folded before Flop
Seat 4: 8431f1ca folded before Flop (didn't bet)
Seat 5: Hero folded before Flop (didn't bet)
Seat 6: 756cb7a4 folded before Flop (didn't bet)


Poker Hand #RC1468328579: Hold'em No Limit  ($0.05/$0.1) - 2023/04/12 18:42:43
Table 'RushAndCash5603839' 6-max Seat #1 is the button
Seat 1: Hero ($17.71 in chips)
Seat 2: a9d87900 ($19.23 in chips)
Seat 3: 1475e8f0 ($35.69 in chips)
Seat 4: 3e9ad104 ($15.64 in chips)
Seat 5: f45b0545 ($9.15 in chips)
Seat 6: 9d33fbc2 ($4.31 in chips)
a9d87900: posts small blind $0.05
1475e8f0: posts big blind $0.1
*** HOLE CARDS ***
Dealt to Hero [Ts Ah]
Dealt to a9d87900 
Dealt to 1475e8f0 
Dealt to 3e9ad104 
Dealt to f45b0545 
Dealt to 9d33fbc2 
3e9ad104: folds
f45b0545: folds
9d33fbc2: raises $0.15 to $0.25
Hero: calls $0.25
a9d87900: folds
1475e8f0: calls $0.15
*** FLOP *** [Kh 5s 6c]
1475e8f0: checks
9d33fbc2: bets $0.28
Hero: folds
1475e8f0: calls $0.28
*** TURN *** [Kh 5s 6c] [Tc]
1475e8f0: checks
9d33fbc2: bets $0.48
1475e8f0: folds
Uncalled bet ($0.48) returned to 9d33fbc2
*** SHOWDOWN ***
9d33fbc2 collected $1.3 from pot
*** SUMMARY ***
Total pot $1.36 | Rake $0.06 | Jackpot $0 | Bingo $0 | Fortune $0
Board [Kh 5s 6c Tc]
Seat 1: Hero (button) folded on the Flop
Seat 2: a9d87900 (small blind) folded before Flop
Seat 3: 1475e8f0 (big blind) folded on the Turn
Seat 4: 3e9ad104 folded before Flop (didn't bet)
Seat 5: f45b0545 folded before Flop (didn't bet)
Seat 6: 9d33fbc2 won ($1.3)


Poker Hand #RC1468328518: Hold'em No Limit  ($0.05/$0.1) - 2023/04/12 18:42:33
Table 'RushAndCash5603778' 6-max Seat #1 is the button
Seat 1: 4a2ca0cb ($12.48 in chips)
Seat 2: Hero ($17.61 in chips)
Seat 3: cbf5fbf3 ($10.15 in chips)
Seat 4: 76b30415 ($9.89 in chips)
Seat 5: bb4b6a70 ($20.54 in chips)
Seat 6: 54530467 ($10 in chips)
Hero: posts small blind $0.05
cbf5fbf3: posts big blind $0.1
*** HOLE CARDS ***
Dealt to 4a2ca0cb 
Dealt to Hero [6d Td]
Dealt to cbf5fbf3 
Dealt to 76b30415 
Dealt to bb4b6a70 
Dealt to 54530467 
76b30415: folds
bb4b6a70: folds
54530467: folds
4a2ca0cb: folds
Hero: folds
Uncalled bet ($0.05) returned to cbf5fbf3
*** SHOWDOWN ***
cbf5fbf3 collected $0.1 from pot
*** SUMMARY ***
Total pot $0.1 | Rake $0 | Jackpot $0 | Bingo $0 | Fortune $0
Seat 1: 4a2ca0cb (button) folded before Flop (didn't bet)
Seat 2: Hero (small blind) folded before Flop
Seat 3: cbf5fbf3 (big blind) collected ($0.1)
Seat 4: 76b30415 folded before Flop (didn't bet)
Seat 5: bb4b6a70 folded before Flop (didn't bet)
Seat 6: 54530467 folded before Flop (didn't bet)


Poker Hand #RC1468328391: Hold'em No Limit  ($0.05/$0.1) - 2023/04/12 18:42:17
Table 'RushAndCash5603651' 6-max Seat #1 is the button
Seat 1: 3d9dd182 ($21.6 in chips)
Seat 2: 5806eb86 ($10.05 in chips)
Seat 3: Hero ($17.71 in chips)
Seat 4: 23361022 ($11.29 in chips)
Seat 5: fc29cdac ($15.92 in chips)
Seat 6: c9c743d2 ($13.04 in chips)
5806eb86: posts small blind $0.05
Hero: posts big blind $0.1
*** HOLE CARDS ***
Dealt to 3d9dd182 
Dealt to 5806eb86 
Dealt to Hero [8h 2s]
Dealt to 23361022 
Dealt to fc29cdac 
Dealt to c9c743d2 
23361022: folds
fc29cdac: folds
c9c743d2: folds
3d9dd182: folds
5806eb86: folds
Uncalled bet ($0.05) returned to Hero
*** SHOWDOWN ***
Hero collected $0.1 from pot
*** SUMMARY ***
Total pot $0.1 | Rake $0 | Jackpot $0 | Bingo $0 | Fortune $0
Seat 1: 3d9dd182 (button) folded before Flop (didn't bet)
Seat 2: 5806eb86 (small blind) folded before Flop
Seat 3: Hero (big blind) collected ($0.1)
Seat 4: 23361022 folded before Flop (didn't bet)
Seat 5: fc29cdac folded before Flop (didn't bet)
Seat 6: c9c743d2 folded before Flop (didn't bet)


Poker Hand #RC1468328290: Hold'em No Limit  ($0.05/$0.1) - 2023/04/12 18:42:04
Table 'RushAndCash5603550' 6-max Seat #1 is the button
Seat 1: 6c0cbd3 ($11.43 in chips)
Seat 2: 17afdc8e ($10 in chips)
Seat 3: 50b345e4 ($19.79 in chips)
Seat 4: 316e1501 ($22.43 in chips)
Seat 5: 74aedd93 ($10.48 in chips)
Seat 6: Hero ($17.71 in chips)
17afdc8e: posts small blind $0.05
50b345e4: posts big blind $0.1
*** HOLE CARDS ***
Dealt to 6c0cbd3 
Dealt to 17afdc8e 
Dealt to 50b345e4 
Dealt to 316e1501 
Dealt to 74aedd93 
Dealt to Hero [5s Qc]
316e1501: raises $0.15 to $0.25
74aedd93: calls $0.25
Hero: folds
6c0cbd3: folds
17afdc8e: folds
50b345e4: calls $0.15
*** FLOP *** [Kd 6s 9c]
50b345e4: checks
316e1501: checks
74aedd93: checks
*** TURN *** [Kd 6s 9c] [9s]
50b345e4: bets $0.5
316e1501: folds
74aedd93: folds
Uncalled bet ($0.5) returned to 50b345e4
*** SHOWDOWN ***
50b345e4 collected $0.76 from pot
*** SUMMARY ***
Total pot $0.8 | Rake $0.04 | Jackpot $0 | Bingo $0 | Fortune $0
Board [Kd 6s 9c 9s]
Seat 1: 6c0cbd3 (button) folded before Flop (didn't bet)
Seat 2: 17afdc8e (small blind) folded before Flop
Seat 3: 50b345e4 (big blind) won ($0.76)
Seat 4: 316e1501 folded on the Turn
Seat 5: 74aedd93 folded on the Turn
Seat 6: Hero folded before Flop (didn't bet)


Poker Hand #RC1468328243: Hold'em No Limit  ($0.05/$0.1) - 2023/04/12 18:41:55
Table 'RushAndCash5603503' 6-max Seat #1 is the button
Seat 1: 3327b2ba ($30.05 in chips)
Seat 2: 7a370937 ($13.27 in chips)
Seat 3: 5f0f435a ($21.97 in chips)
Seat 4: Hero ($17.71 in chips)
Seat 5: c68adfea ($7.72 in chips)
Seat 6: 921a0b3f ($11.99 in chips)
7a370937: posts small blind $0.05
5f0f435a: posts big blind $0.1
*** HOLE CARDS ***
Dealt to 3327b2ba 
Dealt to 7a370937 
Dealt to 5f0f435a 
Dealt to Hero [Ks 8s]
Dealt to c68adfea 
Dealt to 921a0b3f 
Hero: folds
c68adfea: folds
921a0b3f: folds
3327b2ba: folds
7a370937: folds
Uncalled bet ($0.05) returned to 5f0f435a
*** SHOWDOWN ***
5f0f435a collected $0.1 from pot
*** SUMMARY ***
Total pot $0.1 | Rake $0 | Jackpot $0 | Bingo $0 | Fortune $0
Seat 1: 3327b2ba (button) folded before Flop (didn't bet)
Seat 2: 7a370937 (small blind) folded before Flop
Seat 3: 5f0f435a (big blind) collected ($0.1)
Seat 4: Hero folded before Flop (didn't bet)
Seat 5: c68adfea folded before Flop (didn't bet)
Seat 6: 921a0b3f folded before Flop (didn't bet)


Poker Hand #RC1468327753: Hold'em No Limit  ($0.05/$0.1) - 2023/04/12 18:40:46
Table 'RushAndCash5603013' 6-max Seat #1 is the button
Seat 1: 5f0f435a ($22.22 in chips)
Seat 2: 9b856ea5 ($10 in chips)
Seat 3: 7a370937 ($13.52 in chips)
Seat 4: a52123ae ($18.07 in chips)
Seat 5: 1ab2dc44 ($10 in chips)
Seat 6: Hero ($17.2 in chips)
9b856ea5: posts small blind $0.05
7a370937: posts big blind $0.1
*** HOLE CARDS ***
Dealt to 5f0f435a 
Dealt to 9b856ea5 
Dealt to 7a370937 
Dealt to a52123ae 
Dealt to 1ab2dc44 
Dealt to Hero [5c 5h]
a52123ae: folds
1ab2dc44: folds
Hero: raises $0.15 to $0.25
5f0f435a: calls $0.25
9b856ea5: folds
7a370937: calls $0.15
*** FLOP *** [Jh 6h Qh]
7a370937: checks
Hero: checks
5f0f435a: checks
*** TURN *** [Jh 6h Qh] [3c]
7a370937: checks
Hero: checks
5f0f435a: checks
*** RIVER *** [Jh 6h Qh 3c] [9s]
7a370937: checks
Hero: checks
5f0f435a: checks
7a370937: shows [Kd 5d] (King-High)
Hero: shows [5c 5h] (Pair of Fives)
5f0f435a: shows [3h As] (Pair of Treys)
*** SHOWDOWN ***
Hero collected $0.76 from pot
*** SUMMARY ***
Total pot $0.8 | Rake $0.04 | Jackpot $0 | Bingo $0 | Fortune $0
Board [Jh 6h Qh 3c 9s]
Seat 1: 5f0f435a (button) showed [3h As] and lost with Pair of Treys
Seat 2: 9b856ea5 (small blind) folded before Flop
Seat 3: 7a370937 (big blind) showed [Kd 5d] and lost with King-High
Seat 4: a52123ae folded before Flop (didn't bet)
Seat 5: 1ab2dc44 folded before Flop (didn't bet)
Seat 6: Hero showed [5c 5h] and won ($0.76) with Pair of Fives


Poker Hand #RC1468327698: Hold'em No Limit  ($0.05/$0.1) - 2023/04/12 18:40:38
Table 'RushAndCash5602958' 6-max Seat #1 is the button
Seat 1: Hero ($17.2 in chips)
Seat 2: 89dd6b86 ($10.63 in chips)
Seat 3: ce5404af ($14.87 in chips)
Seat 4: 8796732 ($13.82 in chips)
Seat 5: 2a4ecd95 ($10.08 in chips)
Seat 6: 60a8ec18 ($10 in chips)
89dd6b86: posts small blind $0.05
ce5404af: posts big blind $0.1
*** HOLE CARDS ***
Dealt to Hero [4d 5s]
Dealt to 89dd6b86 
Dealt to ce5404af 
Dealt to 8796732 
Dealt to 2a4ecd95 
Dealt to 60a8ec18 
8796732: raises $0.12 to $0.22
2a4ecd95: folds
60a8ec18: folds
Hero: folds
89dd6b86: folds
ce5404af: folds
Uncalled bet ($0.12) returned to 8796732
*** SHOWDOWN ***
8796732 collected $0.25 from pot
*** SUMMARY ***
Total pot $0.25 | Rake $0 | Jackpot $0 | Bingo $0 | Fortune $0
Seat 1: Hero (button) folded before Flop (didn't bet)
Seat 2: 89dd6b86 (small blind) folded before Flop
Seat 3: ce5404af (big blind) folded before Flop
Seat 4: 8796732 collected ($0.25)
Seat 5: 2a4ecd95 folded before Flop (didn't bet)
Seat 6: 60a8ec18 folded before Flop (didn't bet)


Poker Hand #RC1468327563: Hold'em No Limit  ($0.05/$0.1) - 2023/04/12 18:40:18
Table 'RushAndCash5602823' 6-max Seat #1 is the button
Seat 1: 31fdab54 ($11.33 in chips)
Seat 2: Hero ($17.25 in chips)
Seat 3: 162fea2f ($17.4 in chips)
Seat 4: 67a70cd2 ($10.95 in chips)
Seat 5: f34db6e ($3.3 in chips)
Seat 6: 205a6583 ($16.14 in chips)
Hero: posts small blind $0.05
162fea2f: posts big blind $0.1
*** HOLE CARDS ***
Dealt to 31fdab54 
Dealt to Hero [Qh 3s]
Dealt to 162fea2f 
Dealt to 67a70cd2 
Dealt to f34db6e 
Dealt to 205a6583 
67a70cd2: folds
f34db6e: folds
205a6583: raises $0.13 to $0.23
31fdab54: folds
Hero: folds
162fea2f: folds
Uncalled bet ($0.13) returned to 205a6583
*** SHOWDOWN ***
205a6583 collected $0.25 from pot
*** SUMMARY ***
Total pot $0.25 | Rake $0 | Jackpot $0 | Bingo $0 | Fortune $0
Seat 1: 31fdab54 (button) folded before Flop (didn't bet)
Seat 2: Hero (small blind) folded before Flop
Seat 3: 162fea2f (big blind) folded before Flop
Seat 4: 67a70cd2 folded before Flop (didn't bet)
Seat 5: f34db6e folded before Flop (didn't bet)
Seat 6: 205a6583 collected ($0.25)


Poker Hand #RC1468327491: Hold'em No Limit  ($0.05/$0.1) - 2023/04/12 18:40:08
Table 'RushAndCash5602751' 6-max Seat #1 is the button
Seat 1: 64a95da0 ($17.31 in chips)
Seat 2: af7e86da ($10.05 in chips)
Seat 3: Hero ($17.2 in chips)
Seat 4: d3039a1 ($10.33 in chips)
Seat 5: f34db6e ($3.3 in chips)
Seat 6: 89dd6b86 ($10.63 in chips)
af7e86da: posts small blind $0.05
Hero: posts big blind $0.1
*** HOLE CARDS ***
Dealt to 64a95da0 
Dealt to af7e86da 
Dealt to Hero [7h 7d]
Dealt to d3039a1 
Dealt to f34db6e 
Dealt to 89dd6b86 
d3039a1: folds
f34db6e: folds
89dd6b86: folds
64a95da0: folds
af7e86da: folds
Uncalled bet ($0.05) returned to Hero
*** SHOWDOWN ***
Hero collected $0.1 from pot
*** SUMMARY ***
Total pot $0.1 | Rake $0 | Jackpot $0 | Bingo $0 | Fortune $0
Seat 1: 64a95da0 (button) folded before Flop (didn't bet)
Seat 2: af7e86da (small blind) folded before Flop
Seat 3: Hero (big blind) collected ($0.1)
Seat 4: d3039a1 folded before Flop (didn't bet)
Seat 5: f34db6e folded before Flop (didn't bet)
Seat 6: 89dd6b86 folded before Flop (didn't bet)


Poker Hand #RC1468327455: Hold'em No Limit  ($0.05/$0.1) - 2023/04/12 18:40:03
Table 'RushAndCash5602715' 6-max Seat #1 is the button
Seat 1: fe699d00 ($11.46 in chips)
Seat 2: 46692597 ($17.35 in chips)
Seat 3: 6652f68 ($12.71 in chips)
Seat 4: Hero ($17.2 in chips)
Seat 5: d56de772 ($23.02 in chips)
Seat 6: 501ff0ab ($10.05 in chips)
46692597: posts small blind $0.05
6652f68: posts big blind $0.1
*** HOLE CARDS ***
Dealt to fe699d00 
Dealt to 46692597 
Dealt to 6652f68 
Dealt to Hero [Ts 7s]
Dealt to d56de772 
Dealt to 501ff0ab 
Hero: folds
d56de772: folds
501ff0ab: folds
fe699d00: folds
46692597: folds
Uncalled bet ($0.05) returned to 6652f68
*** SHOWDOWN ***
6652f68 collected $0.1 from pot
*** SUMMARY ***
Total pot $0.1 | Rake $0 | Jackpot $0 | Bingo $0 | Fortune $0
Seat 1: fe699d00 (button) folded before Flop (didn't bet)
Seat 2: 46692597 (small blind) folded before Flop
Seat 3: 6652f68 (big blind) collected ($0.1)
Seat 4: Hero folded before Flop (didn't bet)
Seat 5: d56de772 folded before Flop (didn't bet)
Seat 6: 501ff0ab folded before Flop (didn't bet)


Poker Hand #RC1468327370: Hold'em No Limit  ($0.05/$0.1) - 2023/04/12 18:39:52
Table 'RushAndCash5602630' 6-max Seat #1 is the button
Seat 1: fd164dc5 ($13.3 in chips)
Seat 2: 221cdbda ($16.29 in chips)
Seat 3: bbfd2baf ($10.49 in chips)
Seat 4: Hero ($17.2 in chips)
Seat 5: 4d250817 ($22.16 in chips)
Seat 6: d56de772 ($23.02 in chips)
221cdbda: posts small blind $0.05
bbfd2baf: posts big blind $0.1
*** HOLE CARDS ***
Dealt to fd164dc5 
Dealt to 221cdbda 
Dealt to bbfd2baf 
Dealt to Hero [2s Td]
Dealt to 4d250817 
Dealt to d56de772 
Hero: folds
4d250817: folds
d56de772: folds
fd164dc5: folds
221cdbda: folds
Uncalled bet ($0.05) returned to bbfd2baf
*** SHOWDOWN ***
bbfd2baf collected $0.1 from pot
*** SUMMARY ***
Total pot $0.1 | Rake $0 | Jackpot $0 | Bingo $0 | Fortune $0
Seat 1: fd164dc5 (button) folded before Flop (didn't bet)
Seat 2: 221cdbda (small blind) folded before Flop
Seat 3: bbfd2baf (big blind) collected ($0.1)
Seat 4: Hero folded before Flop (didn't bet)
Seat 5: 4d250817 folded before Flop (didn't bet)
Seat 6: d56de772 folded before Flop (didn't bet)


Poker Hand #RC1468327314: Hold'em No Limit  ($0.05/$0.1) - 2023/04/12 18:39:45
Table 'RushAndCash5602574' 6-max Seat #1 is the button
Seat 1: b0ca19b5 ($12.86 in chips)
Seat 2: 59a9bc80 ($17.64 in chips)
Seat 3: b18def7c ($9.44 in chips)
Seat 4: Hero ($17.2 in chips)
Seat 5: d4af8d45 ($7.59 in chips)
Seat 6: ab327216 ($10 in chips)
59a9bc80: posts small blind $0.05
b18def7c: posts big blind $0.1
*** HOLE CARDS ***
Dealt to b0ca19b5 
Dealt to 59a9bc80 
Dealt to b18def7c 
Dealt to Hero [9h 7s]
Dealt to d4af8d45 
Dealt to ab327216 
Hero: folds
d4af8d45: folds
ab327216: folds
b0ca19b5: folds
59a9bc80: folds
Uncalled bet ($0.05) returned to b18def7c
*** SHOWDOWN ***
b18def7c collected $0.1 from pot
*** SUMMARY ***
Total pot $0.1 | Rake $0 | Jackpot $0 | Bingo $0 | Fortune $0
Seat 1: b0ca19b5 (button) folded before Flop (didn't bet)
Seat 2: 59a9bc80 (small blind) folded before Flop
Seat 3: b18def7c (big blind) collected ($0.1)
Seat 4: Hero folded before Flop (didn't bet)
Seat 5: d4af8d45 folded before Flop (didn't bet)
Seat 6: ab327216 folded before Flop (didn't bet)


Poker Hand #RC1468327211: Hold'em No Limit  ($0.05/$0.1) - 2023/04/12 18:39:29
Table 'RushAndCash5602471' 6-max Seat #1 is the button
Seat 1: 4c5e3a1d ($21.19 in chips)
Seat 2: a31d9536 ($17.57 in chips)
Seat 3: Hero ($17.3 in chips)
Seat 4: 28326fd ($11.62 in chips)
Seat 5: b9533439 ($24.2 in chips)
Seat 6: df794f64 ($12.43 in chips)
a31d9536: posts small blind $0.05
Hero: posts big blind $0.1
*** HOLE CARDS ***
Dealt to 4c5e3a1d 
Dealt to a31d9536 
Dealt to Hero [8h Td]
Dealt to 28326fd 
Dealt to b9533439 
Dealt to df794f64 
28326fd: raises $0.13 to $0.23
b9533439: folds
df794f64: folds
4c5e3a1d: folds
a31d9536: folds
Hero: folds
Uncalled bet ($0.13) returned to 28326fd
*** SHOWDOWN ***
28326fd collected $0.25 from pot
*** SUMMARY ***
Total pot $0.25 | Rake $0 | Jackpot $0 | Bingo $0 | Fortune $0
Seat 1: 4c5e3a1d (button) folded before Flop (didn't bet)
Seat 2: a31d9536 (small blind) folded before Flop
Seat 3: Hero (big blind) folded before Flop
Seat 4: 28326fd collected ($0.25)
Seat 5: b9533439 folded before Flop (didn't bet)
Seat 6: df794f64 folded before Flop (didn't bet)


Poker Hand #RC1468327116: Hold'em No Limit  ($0.05/$0.1) - 2023/04/12 18:39:17
Table 'RushAndCash5602376' 6-max Seat #1 is the button
Seat 1: 6b581e6a ($10.23 in chips)
Seat 2: Hero ($17.35 in chips)
Seat 3: 17afdc8e ($10 in chips)
Seat 4: 425886d7 ($8.65 in chips)
Seat 5: b135a85 ($10.69 in chips)
Seat 6: de8b37ab ($21.52 in chips)
Hero: posts small blind $0.05
17afdc8e: posts big blind $0.1
*** HOLE CARDS ***
Dealt to 6b581e6a 
Dealt to Hero [Jd 8h]
Dealt to 17afdc8e 
Dealt to 425886d7 
Dealt to b135a85 
Dealt to de8b37ab 
425886d7: raises $0.2 to $0.3
b135a85: folds
de8b37ab: folds
6b581e6a: folds
Hero: folds
17afdc8e: folds
Uncalled bet ($0.2) returned to 425886d7
*** SHOWDOWN ***
425886d7 collected $0.25 from pot
*** SUMMARY ***
Total pot $0.25 | Rake $0 | Jackpot $0 | Bingo $0 | Fortune $0
Seat 1: 6b581e6a (button) folded before Flop (didn't bet)
Seat 2: Hero (small blind) folded before Flop
Seat 3: 17afdc8e (big blind) folded before Flop
Seat 4: 425886d7 collected ($0.25)
Seat 5: b135a85 folded before Flop (didn't bet)
Seat 6: de8b37ab folded before Flop (didn't bet)


Poker Hand #RC1468327027: Hold'em No Limit  ($0.05/$0.1) - 2023/04/12 18:39:04
Table 'RushAndCash5602287' 6-max Seat #1 is the button
Seat 1: Hero ($17.2 in chips)
Seat 2: cd38710e ($12.64 in chips)
Seat 3: 6173bd66 ($14.65 in chips)
Seat 4: 3e9ad104 ($15.72 in chips)
Seat 5: 983eb1d1 ($42.04 in chips)
Seat 6: 7c146a13 ($23.45 in chips)
cd38710e: posts small blind $0.05
6173bd66: posts big blind $0.1
*** HOLE CARDS ***
Dealt to Hero [As Kd]
Dealt to cd38710e 
Dealt to 6173bd66 
Dealt to 3e9ad104 
Dealt to 983eb1d1 
Dealt to 7c146a13 
3e9ad104: folds
983eb1d1: folds
7c146a13: folds
Hero: raises $0.15 to $0.25
cd38710e: folds
6173bd66: folds
Uncalled bet ($0.15) returned to Hero
*** SHOWDOWN ***
Hero collected $0.25 from pot
*** SUMMARY ***
Total pot $0.25 | Rake $0 | Jackpot $0 | Bingo $0 | Fortune $0
Seat 1: Hero (button) collected ($0.25)
Seat 2: cd38710e (small blind) folded before Flop
Seat 3: 6173bd66 (big blind) folded before Flop
Seat 4: 3e9ad104 folded before Flop (didn't bet)
Seat 5: 983eb1d1 folded before Flop (didn't bet)
Seat 6: 7c146a13 folded before Flop (didn't bet)


Poker Hand #RC1468326987: Hold'em No Limit  ($0.05/$0.1) - 2023/04/12 18:38:58
Table 'RushAndCash5602247' 6-max Seat #1 is the button
Seat 1: 66074236 ($20.37 in chips)
Seat 2: a60f0a99 ($10.43 in chips)
Seat 3: c9c743d2 ($15.87 in chips)
Seat 4: faa9a4c6 ($14.68 in chips)
Seat 5: Hero ($17.2 in chips)
Seat 6: c1853f20 ($3.72 in chips)
a60f0a99: posts small blind $0.05
c9c743d2: posts big blind $0.1
*** HOLE CARDS ***
Dealt to 66074236 
Dealt to a60f0a99 
Dealt to c9c743d2 
Dealt to faa9a4c6 
Dealt to Hero [5d 6h]
Dealt to c1853f20 
faa9a4c6: folds
Hero: folds
c1853f20: folds
66074236: raises $0.1 to $0.2
a60f0a99: folds
c9c743d2: folds
Uncalled bet ($0.1) returned to 66074236
*** SHOWDOWN ***
66074236 collected $0.25 from pot
*** SUMMARY ***
Total pot $0.25 | Rake $0 | Jackpot $0 | Bingo $0 | Fortune $0
Seat 1: 66074236 (button) collected ($0.25)
Seat 2: a60f0a99 (small blind) folded before Flop
Seat 3: c9c743d2 (big blind) folded before Flop
Seat 4: faa9a4c6 folded before Flop (didn't bet)
Seat 5: Hero folded before Flop (didn't bet)
Seat 6: c1853f20 folded before Flop (didn't bet)


Poker Hand #RC1468325839: Hold'em No Limit  ($0.05/$0.1) - 2023/04/12 18:36:12
Table 'RushAndCash5601099' 6-max Seat #1 is the button
Seat 1: e677061e ($12.76 in chips)
Seat 2: 61500afa ($41.11 in chips)
Seat 3: 5aeaa886 ($10.62 in chips)
Seat 4: Hero ($16.61 in chips)
Seat 5: a7a61589 ($14.86 in chips)
Seat 6: 6c2ce13a ($11.54 in chips)
61500afa: posts small blind $0.05
5aeaa886: posts big blind $0.1
*** HOLE CARDS ***
Dealt to e677061e 
Dealt to 61500afa 
Dealt to 5aeaa886 
Dealt to Hero [2s 2h]
Dealt to a7a61589 
Dealt to 6c2ce13a 
Hero: raises $0.15 to $0.25
a7a61589: folds
6c2ce13a: folds
e677061e: folds
61500afa: calls $0.2
5aeaa886: folds
*** FLOP *** [Jh 4s 7c]
61500afa: checks
Hero: checks
*** TURN *** [Jh 4s 7c] [Kh]
61500afa: checks
Hero: checks
*** RIVER *** [Jh 4s 7c Kh] [2c]
61500afa: checks
Hero: bets $0.3
61500afa: calls $0.3
Hero: shows [2s 2h] (Three Twos)
61500afa: shows [8s 8h] (Pair of Eights)
*** SHOWDOWN ***
Hero collected $1.14 from pot
*** SUMMARY ***
Total pot $1.2 | Rake $0.06 | Jackpot $0 | Bingo $0 | Fortune $0
Board [Jh 4s 7c Kh 2c]
Seat 1: e677061e (button) folded before Flop (didn't bet)
Seat 2: 61500afa (small blind) showed [8s 8h] and lost with Pair of Eights
Seat 3: 5aeaa886 (big blind) folded before Flop
Seat 4: Hero showed [2s 2h] and won ($1.14) with Three Twos
Seat 5: a7a61589 folded before Flop (didn't bet)
Seat 6: 6c2ce13a folded before Flop (didn't bet)


Poker Hand #RC1468325802: Hold'em No Limit  ($0.05/$0.1) - 2023/04/12 18:36:06
Table 'RushAndCash5601062' 6-max Seat #1 is the button
Seat 1: 6b968ff6 ($10.99 in chips)
Seat 2: 794d5e3d ($12.2 in chips)
Seat 3: 7f1c7377 ($10 in chips)
Seat 4: a7a61589 ($14.86 in chips)
Seat 5: a84e6d0a ($35.4 in chips)
Seat 6: Hero ($16.61 in chips)
794d5e3d: posts small blind $0.05
7f1c7377: posts big blind $0.1
*** HOLE CARDS ***
Dealt to 6b968ff6 
Dealt to 794d5e3d 
Dealt to 7f1c7377 
Dealt to a7a61589 
Dealt to a84e6d0a 
Dealt to Hero [4h 3d]
a7a61589: folds
a84e6d0a: folds
Hero: folds
6b968ff6: raises $0.15 to $0.25
794d5e3d: folds
7f1c7377: folds
Uncalled bet ($0.15) returned to 6b968ff6
*** SHOWDOWN ***
6b968ff6 collected $0.25 from pot
*** SUMMARY ***
Total pot $0.25 | Rake $0 | Jackpot $0 | Bingo $0 | Fortune $0
Seat 1: 6b968ff6 (button) collected ($0.25)
Seat 2: 794d5e3d (small blind) folded before Flop
Seat 3: 7f1c7377 (big blind) folded before Flop
Seat 4: a7a61589 folded before Flop (didn't bet)
Seat 5: a84e6d0a folded before Flop (didn't bet)
Seat 6: Hero folded before Flop (didn't bet)


Poker Hand #RC1468325176: Hold'em No Limit  ($0.05/$0.1) - 2023/04/12 18:34:34
Table 'RushAndCash5600436' 6-max Seat #1 is the button
Seat 1: Hero ($18.24 in chips)
Seat 2: a0b6861c ($17.01 in chips)
Seat 3: a7a61589 ($13.48 in chips)
Seat 4: 5b43b796 ($11.39 in chips)
Seat 5: 46d5fa65 ($10 in chips)
Seat 6: 31fdab54 ($10.9 in chips)
a0b6861c: posts small blind $0.05
a7a61589: posts big blind $0.1
*** HOLE CARDS ***
Dealt to Hero [Jd Qh]
Dealt to a0b6861c 
Dealt to a7a61589 
Dealt to 5b43b796 
Dealt to 46d5fa65 
Dealt to 31fdab54 
5b43b796: folds
46d5fa65: folds
31fdab54: folds
Hero: raises $0.15 to $0.25
a0b6861c: folds
a7a61589: calls $0.15
*** FLOP *** [Qs Qc 7s]
a7a61589: bets $0.55
Hero: calls $0.55
*** TURN *** [Qs Qc 7s] [Ah]
a7a61589: bets $0.83
Hero: calls $0.83
*** RIVER *** [Qs Qc 7s Ah] [9c]
a7a61589: bets $3.5
Hero: folds
Uncalled bet ($3.5) returned to a7a61589
Hero: shows [Jd Qh] (Three Queens)
a7a61589: shows [3h 3c] (Pair of Queens and Pair of Treys)
*** SHOWDOWN ***
a7a61589 collected $3.01 from pot
*** SUMMARY ***
Total pot $3.31 | Rake $0.15 | Jackpot $0.15 | Bingo $0 | Fortune $0
Board [Qs Qc 7s Ah 9c]
Seat 1: Hero (button) folded on the River
Seat 2: a0b6861c (small blind) folded before Flop
Seat 3: a7a61589 (big blind) showed [3h 3c] and won ($3.01) with Pair of Queens and Pair of Treys
Seat 4: 5b43b796 folded before Flop (didn't bet)
Seat 5: 46d5fa65 folded before Flop (didn't bet)
Seat 6: 31fdab54 folded before Flop (didn't bet)


Poker Hand #RC1468324872: Hold'em No Limit  ($0.05/$0.1) - 2023/04/12 18:33:55
Table 'RushAndCash5600132' 6-max Seat #1 is the button
Seat 1: ea50a791 ($12.67 in chips)
Seat 2: Hero ($17.97 in chips)
Seat 3: 5b43b796 ($11.69 in chips)
Seat 4: bb4b6a70 ($22.52 in chips)
Seat 5: ef068a5d ($15.17 in chips)
Seat 6: 82914606 ($11.44 in chips)
Hero: posts small blind $0.05
5b43b796: posts big blind $0.1
*** HOLE CARDS ***
Dealt to ea50a791 
Dealt to Hero [9c 8s]
Dealt to 5b43b796 
Dealt to bb4b6a70 
Dealt to ef068a5d 
Dealt to 82914606 
bb4b6a70: folds
ef068a5d: folds
82914606: folds
ea50a791: folds
Hero: raises $0.2 to $0.3
5b43b796: calls $0.2
*** FLOP *** [Kd 6s 6h]
Hero: bets $0.2
5b43b796: folds
Uncalled bet ($0.2) returned to Hero
*** SHOWDOWN ***
Hero collected $0.57 from pot
*** SUMMARY ***
Total pot $0.6 | Rake $0.03 | Jackpot $0 | Bingo $0 | Fortune $0
Board [Kd 6s 6h]
Seat 1: ea50a791 (button) folded before Flop (didn't bet)
Seat 2: Hero (small blind) won ($0.57)
Seat 3: 5b43b796 (big blind) folded on the Flop
Seat 4: bb4b6a70 folded before Flop (didn't bet)
Seat 5: ef068a5d folded before Flop (didn't bet)
Seat 6: 82914606 folded before Flop (didn't bet)


Poker Hand #RC1468284469: Hold'em No Limit  ($0.05/$0.1) - 2023/04/12 18:33:02
Table 'RushAndCash5599729' 6-max Seat #1 is the button
Seat 1: 286c1f09 ($13.44 in chips)
Seat 2: b135a85 ($10 in chips)
Seat 3: Hero ($17.69 in chips)
Seat 4: 1936082a ($10 in chips)
Seat 5: 3d32ab14 ($10.15 in chips)
Seat 6: 26e3e906 ($13.15 in chips)
b135a85: posts small blind $0.05
Hero: posts big blind $0.1
*** HOLE CARDS ***
Dealt to 286c1f09 
Dealt to b135a85 
Dealt to Hero [8h Kd]
Dealt to 1936082a 
Dealt to 3d32ab14 
Dealt to 26e3e906 
1936082a: raises $0.15 to $0.25
3d32ab14: folds
26e3e906: folds
286c1f09: folds
b135a85: folds
Hero: calls $0.15
*** FLOP *** [7h Js 9d]
Hero: checks
1936082a: checks
*** TURN *** [7h Js 9d] [Qd]
Hero: bets $0.28
1936082a: folds
Uncalled bet ($0.28) returned to Hero
*** SHOWDOWN ***
Hero collected $0.53 from pot
*** SUMMARY ***
Total pot $0.55 | Rake $0.02 | Jackpot $0 | Bingo $0 | Fortune $0
Board [7h Js 9d Qd]
Seat 1: 286c1f09 (button) folded before Flop (didn't bet)
Seat 2: b135a85 (small blind) folded before Flop
Seat 3: Hero (big blind) won ($0.53)
Seat 4: 1936082a folded on the Turn
Seat 5: 3d32ab14 folded before Flop (didn't bet)
Seat 6: 26e3e906 folded before Flop (didn't bet)


Poker Hand #RC1468284360: Hold'em No Limit  ($0.05/$0.1) - 2023/04/12 18:32:49
Table 'RushAndCash5599620' 6-max Seat #1 is the button
Seat 1: a9d87900 ($19.99 in chips)
Seat 2: de31a04f ($9.74 in chips)
Seat 3: 290b9185 ($14.53 in chips)
Seat 4: 205a6583 ($17.05 in chips)
Seat 5: 5441fbd ($10 in chips)
Seat 6: Hero ($17.54 in chips)
de31a04f: posts small blind $0.05
290b9185: posts big blind $0.1
*** HOLE CARDS ***
Dealt to a9d87900 
Dealt to de31a04f 
Dealt to 290b9185 
Dealt to 205a6583 
Dealt to 5441fbd 
Dealt to Hero [Ah 6h]
205a6583: folds
5441fbd: folds
Hero: raises $0.15 to $0.25
a9d87900: folds
de31a04f: folds
290b9185: folds
Uncalled bet ($0.15) returned to Hero
*** SHOWDOWN ***
Hero collected $0.25 from pot
*** SUMMARY ***
Total pot $0.25 | Rake $0 | Jackpot $0 | Bingo $0 | Fortune $0
Seat 1: a9d87900 (button) folded before Flop (didn't bet)
Seat 2: de31a04f (small blind) folded before Flop
Seat 3: 290b9185 (big blind) folded before Flop
Seat 4: 205a6583 folded before Flop (didn't bet)
Seat 5: 5441fbd folded before Flop (didn't bet)
Seat 6: Hero collected ($0.25)


Poker Hand #RC1468284321: Hold'em No Limit  ($0.05/$0.1) - 2023/04/12 18:32:43
Table 'RushAndCash5599581' 6-max Seat #1 is the button
Seat 1: 5cff914c ($21.45 in chips)
Seat 2: 34f6a951 ($10.05 in chips)
Seat 3: c0894846 ($47.03 in chips)
Seat 4: 501ff0ab ($11.08 in chips)
Seat 5: a5dfdb8 ($10.05 in chips)
Seat 6: Hero ($17.54 in chips)
34f6a951: posts small blind $0.05
c0894846: posts big blind $0.1
*** HOLE CARDS ***
Dealt to 5cff914c 
Dealt to 34f6a951 
Dealt to c0894846 
Dealt to 501ff0ab 
Dealt to a5dfdb8 
Dealt to Hero [Kh 3c]
501ff0ab: folds
a5dfdb8: folds
Hero: folds
5cff914c: raises $0.2 to $0.3
34f6a951: folds
c0894846: folds
Uncalled bet ($0.2) returned to 5cff914c
*** SHOWDOWN ***
5cff914c collected $0.25 from pot
*** SUMMARY ***
Total pot $0.25 | Rake $0 | Jackpot $0 | Bingo $0 | Fortune $0
Seat 1: 5cff914c (button) collected ($0.25)
Seat 2: 34f6a951 (small blind) folded before Flop
Seat 3: c0894846 (big blind) folded before Flop
Seat 4: 501ff0ab folded before Flop (didn't bet)
Seat 5: a5dfdb8 folded before Flop (didn't bet)
Seat 6: Hero folded before Flop (didn't bet)


Poker Hand #RC1468284225: Hold'em No Limit  ($0.05/$0.1) - 2023/04/12 18:32:30
Table 'RushAndCash5599485' 6-max Seat #1 is the button
Seat 1: 69bb4488 ($11.94 in chips)
Seat 2: 3560bd5b ($40.19 in chips)
Seat 3: 1511a9a5 ($10.15 in chips)
Seat 4: Hero ($17.39 in chips)
Seat 5: 4f6cafac ($9.36 in chips)
Seat 6: 936e20d7 ($22.87 in chips)
3560bd5b: posts small blind $0.05
1511a9a5: posts big blind $0.1
*** HOLE CARDS ***
Dealt to 69bb4488 
Dealt to 3560bd5b 
Dealt to 1511a9a5 
Dealt to Hero [Kh Kd]
Dealt to 4f6cafac 
Dealt to 936e20d7 
Hero: raises $0.15 to $0.25
4f6cafac: folds
936e20d7: folds
69bb4488: folds
3560bd5b: folds
1511a9a5: folds
Uncalled bet ($0.15) returned to Hero
*** SHOWDOWN ***
Hero collected $0.25 from pot
*** SUMMARY ***
Total pot $0.25 | Rake $0 | Jackpot $0 | Bingo $0 | Fortune $0
Seat 1: 69bb4488 (button) folded before Flop (didn't bet)
Seat 2: 3560bd5b (small blind) folded before Flop
Seat 3: 1511a9a5 (big blind) folded before Flop
Seat 4: Hero collected ($0.25)
Seat 5: 4f6cafac folded before Flop (didn't bet)
Seat 6: 936e20d7 folded before Flop (didn't bet)


Poker Hand #RC1468283889: Hold'em No Limit  ($0.05/$0.1) - 2023/04/12 18:31:46
Table 'RushAndCash5599149' 6-max Seat #1 is the button
Seat 1: Hero ($16.83 in chips)
Seat 2: 936e20d7 ($23.12 in chips)
Seat 3: af993ef7 ($11.85 in chips)
Seat 4: d1da1715 ($22.23 in chips)
Seat 5: 3560bd5b ($40.44 in chips)
Seat 6: a52123ae ($15.9 in chips)
936e20d7: posts small blind $0.05
af993ef7: posts big blind $0.1
*** HOLE CARDS ***
Dealt to Hero [Th Qh]
Dealt to 936e20d7 
Dealt to af993ef7 
Dealt to d1da1715 
Dealt to 3560bd5b 
Dealt to a52123ae 
d1da1715: folds
3560bd5b: raises $0.15 to $0.25
a52123ae: folds
Hero: calls $0.25
936e20d7: calls $0.2
af993ef7: folds
*** FLOP *** [4c Ah 4h]
936e20d7: checks
3560bd5b: checks
Hero: bets $0.43
936e20d7: folds
3560bd5b: folds
Uncalled bet ($0.43) returned to Hero
*** SHOWDOWN ***
Hero collected $0.81 from pot
*** SUMMARY ***
Total pot $0.85 | Rake $0.04 | Jackpot $0 | Bingo $0 | Fortune $0
Board [4c Ah 4h]
Seat 1: Hero (button) won ($0.81)
Seat 2: 936e20d7 (small blind) folded on the Flop
Seat 3: af993ef7 (big blind) folded before Flop
Seat 4: d1da1715 folded before Flop (didn't bet)
Seat 5: 3560bd5b folded on the Flop
Seat 6: a52123ae folded before Flop (didn't bet)


Poker Hand #RC1468283819: Hold'em No Limit  ($0.05/$0.1) - 2023/04/12 18:31:35
Table 'RushAndCash5599079' 6-max Seat #1 is the button
Seat 1: 7ebc3d93 ($14.05 in chips)
Seat 2: Hero ($16.88 in chips)
Seat 3: eaa86ce3 ($21.58 in chips)
Seat 4: f12b18da ($37.46 in chips)
Seat 5: 9801bacb ($10.15 in chips)
Seat 6: 854615fb ($18.34 in chips)
Hero: posts small blind $0.05
eaa86ce3: posts big blind $0.1
*** HOLE CARDS ***
Dealt to 7ebc3d93 
Dealt to Hero [3s Tc]
Dealt to eaa86ce3 
Dealt to f12b18da 
Dealt to 9801bacb 
Dealt to 854615fb 
f12b18da: folds
9801bacb: folds
854615fb: folds
7ebc3d93: folds
Hero: folds
Uncalled bet ($0.05) returned to eaa86ce3
*** SHOWDOWN ***
eaa86ce3 collected $0.1 from pot
*** SUMMARY ***
Total pot $0.1 | Rake $0 | Jackpot $0 | Bingo $0 | Fortune $0
Seat 1: 7ebc3d93 (button) folded before Flop (didn't bet)
Seat 2: Hero (small blind) folded before Flop
Seat 3: eaa86ce3 (big blind) collected ($0.1)
Seat 4: f12b18da folded before Flop (didn't bet)
Seat 5: 9801bacb folded before Flop (didn't bet)
Seat 6: 854615fb folded before Flop (didn't bet)


Poker Hand #RC1468283712: Hold'em No Limit  ($0.05/$0.1) - 2023/04/12 18:31:20
Table 'RushAndCash5598972' 6-max Seat #1 is the button
Seat 1: 7a370937 ($10 in chips)
Seat 2: d4af8d45 ($11.19 in chips)
Seat 3: Hero ($16.98 in chips)
Seat 4: 4d250817 ($25.15 in chips)
Seat 5: cf7ecf57 ($12.53 in chips)
Seat 6: 1735332f ($14.24 in chips)
d4af8d45: posts small blind $0.05
Hero: posts big blind $0.1
*** HOLE CARDS ***
Dealt to 7a370937 
Dealt to d4af8d45 
Dealt to Hero [Th 3d]
Dealt to 4d250817 
Dealt to cf7ecf57 
Dealt to 1735332f 
4d250817: folds
cf7ecf57: folds
1735332f: folds
7a370937: raises $0.1 to $0.2
d4af8d45: folds
Hero: folds
Uncalled bet ($0.1) returned to 7a370937
*** SHOWDOWN ***
7a370937 collected $0.25 from pot
*** SUMMARY ***
Total pot $0.25 | Rake $0 | Jackpot $0 | Bingo $0 | Fortune $0
Seat 1: 7a370937 (button) collected ($0.25)
Seat 2: d4af8d45 (small blind) folded before Flop
Seat 3: Hero (big blind) folded before Flop
Seat 4: 4d250817 folded before Flop (didn't bet)
Seat 5: cf7ecf57 folded before Flop (didn't bet)
Seat 6: 1735332f folded before Flop (didn't bet)


Poker Hand #RC1468283675: Hold'em No Limit  ($0.05/$0.1) - 2023/04/12 18:31:15
Table 'RushAndCash5598935' 6-max Seat #1 is the button
Seat 1: 6cfb4bef ($10.05 in chips)
Seat 2: 5fe1aa83 ($1.21 in chips)
Seat 3: 936e20d7 ($23.22 in chips)
Seat 4: b2093b12 ($10.61 in chips)
Seat 5: Hero ($16.98 in chips)
Seat 6: 33d931de ($10.17 in chips)
5fe1aa83: posts small blind $0.05
936e20d7: posts big blind $0.1
*** HOLE CARDS ***
Dealt to 6cfb4bef 
Dealt to 5fe1aa83 
Dealt to 936e20d7 
Dealt to b2093b12 
Dealt to Hero [5s 7d]
Dealt to 33d931de 
b2093b12: raises $0.2 to $0.3
Hero: folds
33d931de: folds
6cfb4bef: folds
5fe1aa83: folds
936e20d7: folds
Uncalled bet ($0.2) returned to b2093b12
*** SHOWDOWN ***
b2093b12 collected $0.25 from pot
*** SUMMARY ***
Total pot $0.25 | Rake $0 | Jackpot $0 | Bingo $0 | Fortune $0
Seat 1: 6cfb4bef (button) folded before Flop (didn't bet)
Seat 2: 5fe1aa83 (small blind) folded before Flop
Seat 3: 936e20d7 (big blind) folded before Flop
Seat 4: b2093b12 collected ($0.25)
Seat 5: Hero folded before Flop (didn't bet)
Seat 6: 33d931de folded before Flop (didn't bet)


Poker Hand #RC1468283625: Hold'em No Limit  ($0.05/$0.1) - 2023/04/12 18:31:09
Table 'RushAndCash5598885' 6-max Seat #1 is the button
Seat 1: 803f5990 ($10.15 in chips)
Seat 2: 1b43483 ($25.43 in chips)
Seat 3: 8b94cc3d ($13.98 in chips)
Seat 4: eeaf954d ($10.1 in chips)
Seat 5: Hero ($16.98 in chips)
Seat 6: 6128dab9 ($6.88 in chips)
1b43483: posts small blind $0.05
8b94cc3d: posts big blind $0.1
*** HOLE CARDS ***
Dealt to 803f5990 
Dealt to 1b43483 
Dealt to 8b94cc3d 
Dealt to eeaf954d 
Dealt to Hero [7s Kh]
Dealt to 6128dab9 
eeaf954d: folds
Hero: folds
6128dab9: folds
803f5990: folds
1b43483: folds
Uncalled bet ($0.05) returned to 8b94cc3d
*** SHOWDOWN ***
8b94cc3d collected $0.1 from pot
*** SUMMARY ***
Total pot $0.1 | Rake $0 | Jackpot $0 | Bingo $0 | Fortune $0
Seat 1: 803f5990 (button) folded before Flop (didn't bet)
Seat 2: 1b43483 (small blind) folded before Flop
Seat 3: 8b94cc3d (big blind) collected ($0.1)
Seat 4: eeaf954d folded before Flop (didn't bet)
Seat 5: Hero folded before Flop (didn't bet)
Seat 6: 6128dab9 folded before Flop (didn't bet)


Poker Hand #RC1468283557: Hold'em No Limit  ($0.05/$0.1) - 2023/04/12 18:30:58
Table 'RushAndCash5598817' 6-max Seat #1 is the button
Seat 1: c6444e76 ($4.48 in chips)
Seat 2: d441649c ($14.48 in chips)
Seat 3: b02da198 ($16.71 in chips)
Seat 4: d56de772 ($10.37 in chips)
Seat 5: Hero ($16.98 in chips)
Seat 6: 8cf611c6 ($24.94 in chips)
d441649c: posts small blind $0.05
b02da198: posts big blind $0.1
*** HOLE CARDS ***
Dealt to c6444e76 
Dealt to d441649c 
Dealt to b02da198 
Dealt to d56de772 
Dealt to Hero [4h 8s]
Dealt to 8cf611c6 
d56de772: folds
Hero: folds
8cf611c6: folds
c6444e76: folds
d441649c: folds
Uncalled bet ($0.05) returned to b02da198
*** SHOWDOWN ***
b02da198 collected $0.1 from pot
*** SUMMARY ***
Total pot $0.1 | Rake $0 | Jackpot $0 | Bingo $0 | Fortune $0
Seat 1: c6444e76 (button) folded before Flop (didn't bet)
Seat 2: d441649c (small blind) folded before Flop
Seat 3: b02da198 (big blind) collected ($0.1)
Seat 4: d56de772 folded before Flop (didn't bet)
Seat 5: Hero folded before Flop (didn't bet)
Seat 6: 8cf611c6 folded before Flop (didn't bet)


Poker Hand #RC1468283511: Hold'em No Limit  ($0.05/$0.1) - 2023/04/12 18:30:50
Table 'RushAndCash5598771' 6-max Seat #1 is the button
Seat 1: 6593fce5 ($14.42 in chips)
Seat 2: 386486d8 ($11.08 in chips)
Seat 3: ed691db5 ($11.31 in chips)
Seat 4: 9bba65bf ($31.1 in chips)
Seat 5: Hero ($16.98 in chips)
Seat 6: 290b9185 ($14.21 in chips)
386486d8: posts small blind $0.05
ed691db5: posts big blind $0.1
*** HOLE CARDS ***
Dealt to 6593fce5 
Dealt to 386486d8 
Dealt to ed691db5 
Dealt to 9bba65bf 
Dealt to Hero [5h 9c]
Dealt to 290b9185 
9bba65bf: folds
Hero: folds
290b9185: raises $0.15 to $0.25
6593fce5: folds
386486d8: folds
ed691db5: folds
Uncalled bet ($0.15) returned to 290b9185
*** SHOWDOWN ***
290b9185 collected $0.25 from pot
*** SUMMARY ***
Total pot $0.25 | Rake $0 | Jackpot $0 | Bingo $0 | Fortune $0
Seat 1: 6593fce5 (button) folded before Flop (didn't bet)
Seat 2: 386486d8 (small blind) folded before Flop
Seat 3: ed691db5 (big blind) folded before Flop
Seat 4: 9bba65bf folded before Flop (didn't bet)
Seat 5: Hero folded before Flop (didn't bet)
Seat 6: 290b9185 collected ($0.25)


Poker Hand #RC1468283055: Hold'em No Limit  ($0.05/$0.1) - 2023/04/12 18:29:44
Table 'RushAndCash5598315' 6-max Seat #1 is the button
Seat 1: Hero ($15.65 in chips)
Seat 2: dedf4996 ($11.58 in chips)
Seat 3: 533ec07e ($19.16 in chips)
Seat 4: 511a5af4 ($10 in chips)
Seat 5: 8d88a403 ($10 in chips)
Seat 6: 39a9f50d ($6.82 in chips)
dedf4996: posts small blind $0.05
533ec07e: posts big blind $0.1
*** HOLE CARDS ***
Dealt to Hero [Ad Ah]
Dealt to dedf4996 
Dealt to 533ec07e 
Dealt to 511a5af4 
Dealt to 8d88a403 
Dealt to 39a9f50d 
511a5af4: folds
8d88a403: raises $0.1 to $0.2
39a9f50d: folds
Hero: raises $0.42 to $0.62
dedf4996: folds
533ec07e: folds
8d88a403: calls $0.42
*** FLOP *** [4s Js 9s]
8d88a403: checks
Hero: bets $0.7
8d88a403: calls $0.7
*** TURN *** [4s Js 9s] [9h]
8d88a403: checks
Hero: bets $1.4
8d88a403: folds
Uncalled bet ($1.4) returned to Hero
*** SHOWDOWN ***
Hero collected $2.65 from pot
*** SUMMARY ***
Total pot $2.79 | Rake $0.14 | Jackpot $0 | Bingo $0 | Fortune $0
Board [4s Js 9s 9h]
Seat 1: Hero (button) won ($2.65)
Seat 2: dedf4996 (small blind) folded before Flop
Seat 3: 533ec07e (big blind) folded before Flop
Seat 4: 511a5af4 folded before Flop (didn't bet)
Seat 5: 8d88a403 folded on the Turn
Seat 6: 39a9f50d folded before Flop (didn't bet)


Poker Hand #RC1468283022: Hold'em No Limit  ($0.05/$0.1) - 2023/04/12 18:29:39
Table 'RushAndCash5598282' 6-max Seat #1 is the button
Seat 1: 33a288a7 ($20.97 in chips)
Seat 2: 229f0f32 ($13.08 in chips)
Seat 3: Hero ($15.75 in chips)
Seat 4: b7a7ddac ($14.76 in chips)
Seat 5: 8b013a7e ($16.87 in chips)
Seat 6: a5dfdb8 ($10 in chips)
229f0f32: posts small blind $0.05
Hero: posts big blind $0.1
*** HOLE CARDS ***
Dealt to 33a288a7 
Dealt to 229f0f32 
Dealt to Hero [Ts 3d]
Dealt to b7a7ddac 
Dealt to 8b013a7e 
Dealt to a5dfdb8 
b7a7ddac: raises $0.15 to $0.25
8b013a7e: raises $0.45 to $0.7
a5dfdb8: folds
33a288a7: folds
229f0f32: folds
Hero: folds
b7a7ddac: calls $0.45
*** FLOP *** [8d Th 4s]
b7a7ddac: checks
8b013a7e: checks
*** TURN *** [8d Th 4s] [8s]
b7a7ddac: bets $0.5
8b013a7e: calls $0.5
*** RIVER *** [8d Th 4s 8s] [Kc]
b7a7ddac: checks
8b013a7e: bets $1.4
b7a7ddac: raises $2.8 to $4.2
8b013a7e: folds
Uncalled bet ($2.8) returned to b7a7ddac
*** SHOWDOWN ***
b7a7ddac collected $4.94 from pot
*** SUMMARY ***
Total pot $5.35 | Rake $0.26 | Jackpot $0.15 | Bingo $0 | Fortune $0
Board [8d Th 4s 8s Kc]
Seat 1: 33a288a7 (button) folded before Flop (didn't bet)
Seat 2: 229f0f32 (small blind) folded before Flop
Seat 3: Hero (big blind) folded before Flop
Seat 4: b7a7ddac won ($4.94)
Seat 5: 8b013a7e folded on the River
Seat 6: a5dfdb8 folded before Flop (didn't bet)


Poker Hand #RC1468282991: Hold'em No Limit  ($0.05/$0.1) - 2023/04/12 18:29:35
Table 'RushAndCash5598251' 6-max Seat #1 is the button
Seat 1: a02c69bd ($10.05 in chips)
Seat 2: Hero ($15.8 in chips)
Seat 3: f6fa0331 ($10.15 in chips)
Seat 4: 789916a1 ($10 in chips)
Seat 5: f52f2ead ($13.88 in chips)
Seat 6: c6e8fb39 ($10 in chips)
Hero: posts small blind $0.05
f6fa0331: posts big blind $0.1
*** HOLE CARDS ***
Dealt to a02c69bd 
Dealt to Hero [6c 2c]
Dealt to f6fa0331 
Dealt to 789916a1 
Dealt to f52f2ead 
Dealt to c6e8fb39 
789916a1: folds
f52f2ead: folds
c6e8fb39: folds
a02c69bd: raises $0.15 to $0.25
Hero: folds
f6fa0331: folds
Uncalled bet ($0.15) returned to a02c69bd
*** SHOWDOWN ***
a02c69bd collected $0.25 from pot
*** SUMMARY ***
Total pot $0.25 | Rake $0 | Jackpot $0 | Bingo $0 | Fortune $0
Seat 1: a02c69bd (button) collected ($0.25)
Seat 2: Hero (small blind) folded before Flop
Seat 3: f6fa0331 (big blind) folded before Flop
Seat 4: 789916a1 folded before Flop (didn't bet)
Seat 5: f52f2ead folded before Flop (didn't bet)
Seat 6: c6e8fb39 folded before Flop (didn't bet)


Poker Hand #RC1468282957: Hold'em No Limit  ($0.05/$0.1) - 2023/04/12 18:29:31
Table 'RushAndCash5598217' 6-max Seat #1 is the button
Seat 1: 1ea30741 ($33.22 in chips)
Seat 2: 70dd2245 ($11.02 in chips)
Seat 3: ba4d0ff6 ($16.42 in chips)
Seat 4: 8b013a7e ($16.92 in chips)
Seat 5: Hero ($15.8 in chips)
Seat 6: e57f93b7 ($20.24 in chips)
70dd2245: posts small blind $0.05
ba4d0ff6: posts big blind $0.1
*** HOLE CARDS ***
Dealt to 1ea30741 
Dealt to 70dd2245 
Dealt to ba4d0ff6 
Dealt to 8b013a7e 
Dealt to Hero [Qd 3h]
Dealt to e57f93b7 
8b013a7e: folds
Hero: folds
e57f93b7: folds
1ea30741: folds
70dd2245: folds
Uncalled bet ($0.05) returned to ba4d0ff6
*** SHOWDOWN ***
ba4d0ff6 collected $0.1 from pot
*** SUMMARY ***
Total pot $0.1 | Rake $0 | Jackpot $0 | Bingo $0 | Fortune $0
Seat 1: 1ea30741 (button) folded before Flop (didn't bet)
Seat 2: 70dd2245 (small blind) folded before Flop
Seat 3: ba4d0ff6 (big blind) collected ($0.1)
Seat 4: 8b013a7e folded before Flop (didn't bet)
Seat 5: Hero folded before Flop (didn't bet)
Seat 6: e57f93b7 folded before Flop (didn't bet)


Poker Hand #RC1468282880: Hold'em No Limit  ($0.05/$0.1) - 2023/04/12 18:29:21
Table 'RushAndCash5598140' 6-max Seat #1 is the button
Seat 1: 34c6bba9 ($10.12 in chips)
Seat 2: 9f9bac42 ($13.5 in chips)
Seat 3: 4df7250d ($23.27 in chips)
Seat 4: Hero ($15.8 in chips)
Seat 5: a162ce80 ($11.8 in chips)
Seat 6: e4c97335 ($11.99 in chips)
9f9bac42: posts small blind $0.05
4df7250d: posts big blind $0.1
*** HOLE CARDS ***
Dealt to 34c6bba9 
Dealt to 9f9bac42 
Dealt to 4df7250d 
Dealt to Hero [7h 2d]
Dealt to a162ce80 
Dealt to e4c97335 
Hero: folds
a162ce80: folds
e4c97335: raises $0.2 to $0.3
34c6bba9: calls $0.3
9f9bac42: folds
4df7250d: folds
*** FLOP *** [6s Ts 3h]
e4c97335: checks
34c6bba9: bets $0.4
e4c97335: calls $0.4
*** TURN *** [6s Ts 3h] [6d]
e4c97335: checks
34c6bba9: checks
*** RIVER *** [6s Ts 3h 6d] [3c]
e4c97335: checks
34c6bba9: checks
e4c97335: shows [Qh Ah] (Pair of Sixes and Pair of Treys)
34c6bba9: shows [4c 4s] (Pair of Sixes and Pair of Fours)
*** SHOWDOWN ***
34c6bba9 collected $1.48 from pot
*** SUMMARY ***
Total pot $1.55 | Rake $0.07 | Jackpot $0 | Bingo $0 | Fortune $0
Board [6s Ts 3h 6d 3c]
Seat 1: 34c6bba9 (button) showed [4c 4s] and won ($1.48) with Pair of Sixes and Pair of Fours
Seat 2: 9f9bac42 (small blind) folded before Flop
Seat 3: 4df7250d (big blind) folded before Flop
Seat 4: Hero folded before Flop (didn't bet)
Seat 5: a162ce80 folded before Flop (didn't bet)
Seat 6: e4c97335 showed [Qh Ah] and lost with Pair of Sixes and Pair of Treys


Poker Hand #RC1468282819: Hold'em No Limit  ($0.05/$0.1) - 2023/04/12 18:29:13
Table 'RushAndCash5598079' 6-max Seat #1 is the button
Seat 1: Hero ($15.8 in chips)
Seat 2: 286c1f09 ($13.69 in chips)
Seat 3: 27c922fe ($26.77 in chips)
Seat 4: a3eae145 ($10.33 in chips)
Seat 5: 92b6be70 ($12.65 in chips)
Seat 6: 6b968ff6 ($10.19 in chips)
286c1f09: posts small blind $0.05
27c922fe: posts big blind $0.1
*** HOLE CARDS ***
Dealt to Hero [Ts 8c]
Dealt to 286c1f09 
Dealt to 27c922fe 
Dealt to a3eae145 
Dealt to 92b6be70 
Dealt to 6b968ff6 
a3eae145: folds
92b6be70: folds
6b968ff6: folds
Hero: folds
286c1f09: folds
Uncalled bet ($0.05) returned to 27c922fe
*** SHOWDOWN ***
27c922fe collected $0.1 from pot
*** SUMMARY ***
Total pot $0.1 | Rake $0 | Jackpot $0 | Bingo $0 | Fortune $0
Seat 1: Hero (button) folded before Flop (didn't bet)
Seat 2: 286c1f09 (small blind) folded before Flop
Seat 3: 27c922fe (big blind) collected ($0.1)
Seat 4: a3eae145 folded before Flop (didn't bet)
Seat 5: 92b6be70 folded before Flop (didn't bet)
Seat 6: 6b968ff6 folded before Flop (didn't bet)


Poker Hand #RC1468282756: Hold'em No Limit  ($0.05/$0.1) - 2023/04/12 18:29:03
Table 'RushAndCash5598016' 6-max Seat #1 is the button
Seat 1: fc29cdac ($18.54 in chips)
Seat 2: 8b013a7e ($16.77 in chips)
Seat 3: Hero ($15.9 in chips)
Seat 4: bb965e88 ($10 in chips)
Seat 5: a6647fbe ($14.44 in chips)
Seat 6: a52123ae ($16.74 in chips)
8b013a7e: posts small blind $0.05
Hero: posts big blind $0.1
*** HOLE CARDS ***
Dealt to fc29cdac 
Dealt to 8b013a7e 
Dealt to Hero [3h Qc]
Dealt to bb965e88 
Dealt to a6647fbe 
Dealt to a52123ae 
bb965e88: folds
a6647fbe: folds
a52123ae: folds
fc29cdac: folds
8b013a7e: raises $0.2 to $0.3
Hero: folds
Uncalled bet ($0.2) returned to 8b013a7e
*** SHOWDOWN ***
8b013a7e collected $0.2 from pot
*** SUMMARY ***
Total pot $0.2 | Rake $0 | Jackpot $0 | Bingo $0 | Fortune $0
Seat 1: fc29cdac (button) folded before Flop (didn't bet)
Seat 2: 8b013a7e (small blind) collected ($0.2)
Seat 3: Hero (big blind) folded before Flop
Seat 4: bb965e88 folded before Flop (didn't bet)
Seat 5: a6647fbe folded before Flop (didn't bet)
Seat 6: a52123ae folded before Flop (didn't bet)


Poker Hand #RC1468282724: Hold'em No Limit  ($0.05/$0.1) - 2023/04/12 18:28:59
Table 'RushAndCash5597984' 6-max Seat #1 is the button
Seat 1: f0e972ed ($23.47 in chips)
Seat 2: Hero ($15.95 in chips)
Seat 3: 9801bacb ($10.15 in chips)
Seat 4: d56de772 ($10.05 in chips)
Seat 5: 80d7f85f ($10.92 in chips)
Seat 6: a6647fbe ($14.44 in chips)
Hero: posts small blind $0.05
9801bacb: posts big blind $0.1
*** HOLE CARDS ***
Dealt to f0e972ed 
Dealt to Hero [7d 4h]
Dealt to 9801bacb 
Dealt to d56de772 
Dealt to 80d7f85f 
Dealt to a6647fbe 
d56de772: folds
80d7f85f: folds
a6647fbe: folds
f0e972ed: raises $0.15 to $0.25
Hero: folds
9801bacb: folds
Uncalled bet ($0.15) returned to f0e972ed
*** SHOWDOWN ***
f0e972ed collected $0.25 from pot
*** SUMMARY ***
Total pot $0.25 | Rake $0 | Jackpot $0 | Bingo $0 | Fortune $0
Seat 1: f0e972ed (button) collected ($0.25)
Seat 2: Hero (small blind) folded before Flop
Seat 3: 9801bacb (big blind) folded before Flop
Seat 4: d56de772 folded before Flop (didn't bet)
Seat 5: 80d7f85f folded before Flop (didn't bet)
Seat 6: a6647fbe folded before Flop (didn't bet)


Poker Hand #RC1468282670: Hold'em No Limit  ($0.05/$0.1) - 2023/04/12 18:28:52
Table 'RushAndCash5597930' 6-max Seat #1 is the button
Seat 1: 5441fbd ($11.05 in chips)
Seat 2: 18f4621d ($10 in chips)
Seat 3: b05782e ($18.64 in chips)
Seat 4: Hero ($15.95 in chips)
Seat 5: a60f0a99 ($9.22 in chips)
Seat 6: 15e962d7 ($11.98 in chips)
18f4621d: posts small blind $0.05
b05782e: posts big blind $0.1
*** HOLE CARDS ***
Dealt to 5441fbd 
Dealt to 18f4621d 
Dealt to b05782e 
Dealt to Hero [Ts Qc]
Dealt to a60f0a99 
Dealt to 15e962d7 
Hero: folds
a60f0a99: folds
15e962d7: folds
5441fbd: raises $0.15 to $0.25
18f4621d: folds
b05782e: calls $0.15
*** FLOP *** [Ad Jc 9c]
b05782e: checks
5441fbd: bets $0.3
b05782e: calls $0.3
*** TURN *** [Ad Jc 9c] [5d]
b05782e: checks
5441fbd: checks
*** RIVER *** [Ad Jc 9c 5d] [5s]
b05782e: checks
5441fbd: bets $1.75
b05782e: folds
Uncalled bet ($1.75) returned to 5441fbd
*** SHOWDOWN ***
5441fbd collected $1.1 from pot
*** SUMMARY ***
Total pot $1.15 | Rake $0.05 | Jackpot $0 | Bingo $0 | Fortune $0
Board [Ad Jc 9c 5d 5s]
Seat 1: 5441fbd (button) won ($1.1)
Seat 2: 18f4621d (small blind) folded before Flop
Seat 3: b05782e (big blind) folded on the River
Seat 4: Hero folded before Flop (didn't bet)
Seat 5: a60f0a99 folded before Flop (didn't bet)
Seat 6: 15e962d7 folded before Flop (didn't bet)


Poker Hand #RC1468282628: Hold'em No Limit  ($0.05/$0.1) - 2023/04/12 18:28:46
Table 'RushAndCash5597888' 6-max Seat #1 is the button
Seat 1: 3560bd5b ($42.34 in chips)
Seat 2: 221cdbda ($20.1 in chips)
Seat 3: 169335dd ($10.05 in chips)
Seat 4: Hero ($15.95 in chips)
Seat 5: cf6ea5ea ($18.67 in chips)
Seat 6: 61f0698e ($9.79 in chips)
221cdbda: posts small blind $0.05
169335dd: posts big blind $0.1
*** HOLE CARDS ***
Dealt to 3560bd5b 
Dealt to 221cdbda 
Dealt to 169335dd 
Dealt to Hero [7d 4s]
Dealt to cf6ea5ea 
Dealt to 61f0698e 
Hero: folds
cf6ea5ea: folds
61f0698e: folds
3560bd5b: raises $0.15 to $0.25
221cdbda: folds
169335dd: folds
Uncalled bet ($0.15) returned to 3560bd5b
*** SHOWDOWN ***
3560bd5b collected $0.25 from pot
*** SUMMARY ***
Total pot $0.25 | Rake $0 | Jackpot $0 | Bingo $0 | Fortune $0
Seat 1: 3560bd5b (button) collected ($0.25)
Seat 2: 221cdbda (small blind) folded before Flop
Seat 3: 169335dd (big blind) folded before Flop
Seat 4: Hero folded before Flop (didn't bet)
Seat 5: cf6ea5ea folded before Flop (didn't bet)
Seat 6: 61f0698e folded before Flop (didn't bet)


Poker Hand #RC1468282586: Hold'em No Limit  ($0.05/$0.1) - 2023/04/12 18:28:41
Table 'RushAndCash5597846' 6-max Seat #1 is the button
Seat 1: cbfcaa07 ($10.43 in chips)
Seat 2: 2430a11c ($4.32 in chips)
Seat 3: e86b4e44 ($14.61 in chips)
Seat 4: Hero ($15.95 in chips)
Seat 5: f92d70a8 ($11.23 in chips)
Seat 6: bf98f6d2 ($11.4 in chips)
2430a11c: posts small blind $0.05
e86b4e44: posts big blind $0.1
*** HOLE CARDS ***
Dealt to cbfcaa07 
Dealt to 2430a11c 
Dealt to e86b4e44 
Dealt to Hero [2d 3s]
Dealt to f92d70a8 
Dealt to bf98f6d2 
Hero: folds
f92d70a8: folds
bf98f6d2: folds
cbfcaa07: folds
2430a11c: raises $0.2 to $0.3
e86b4e44: calls $0.2
*** FLOP *** [Jh 9c 7c]
2430a11c: checks
e86b4e44: bets $0.23
2430a11c: folds
Uncalled bet ($0.23) returned to e86b4e44
*** SHOWDOWN ***
e86b4e44 collected $0.57 from pot
*** SUMMARY ***
Total pot $0.6 | Rake $0.03 | Jackpot $0 | Bingo $0 | Fortune $0
Board [Jh 9c 7c]
Seat 1: cbfcaa07 (button) folded before Flop (didn't bet)
Seat 2: 2430a11c (small blind) folded on the Flop
Seat 3: e86b4e44 (big blind) won ($0.57)
Seat 4: Hero folded before Flop (didn't bet)
Seat 5: f92d70a8 folded before Flop (didn't bet)
Seat 6: bf98f6d2 folded before Flop (didn't bet)


Poker Hand #RC1468282536: Hold'em No Limit  ($0.05/$0.1) - 2023/04/12 18:28:34
Table 'RushAndCash5597796' 6-max Seat #1 is the button
Seat 1: Hero ($15.95 in chips)
Seat 2: c6444e76 ($3.96 in chips)
Seat 3: d3c2495c ($9.11 in chips)
Seat 4: 90b25cbf ($12.09 in chips)
Seat 5: 7ebc3d93 ($12.84 in chips)
Seat 6: f4de99bb ($11.89 in chips)
c6444e76: posts small blind $0.05
d3c2495c: posts big blind $0.1
*** HOLE CARDS ***
Dealt to Hero [7c Kd]
Dealt to c6444e76 
Dealt to d3c2495c 
Dealt to 90b25cbf 
Dealt to 7ebc3d93 
Dealt to f4de99bb 
90b25cbf: raises $0.15 to $0.25
7ebc3d93: folds
f4de99bb: folds
Hero: folds
c6444e76: folds
d3c2495c: folds
Uncalled bet ($0.15) returned to 90b25cbf
*** SHOWDOWN ***
90b25cbf collected $0.25 from pot
*** SUMMARY ***
Total pot $0.25 | Rake $0 | Jackpot $0 | Bingo $0 | Fortune $0
Seat 1: Hero (button) folded before Flop (didn't bet)
Seat 2: c6444e76 (small blind) folded before Flop
Seat 3: d3c2495c (big blind) folded before Flop
Seat 4: 90b25cbf collected ($0.25)
Seat 5: 7ebc3d93 folded before Flop (didn't bet)
Seat 6: f4de99bb folded before Flop (didn't bet)


Poker Hand #RC1468280732: Hold'em No Limit  ($0.05/$0.1) - 2023/04/12 18:24:40
Table 'RushAndCash5595992' 6-max Seat #1 is the button
Seat 1: 61e64b25 ($10.63 in chips)
Seat 2: Hero ($17.15 in chips)
Seat 3: 9b00f25b ($10.15 in chips)
Seat 4: 405535ec ($10.85 in chips)
Seat 5: fd863c49 ($7.64 in chips)
Seat 6: d89e0e61 ($11.19 in chips)
Hero: posts small blind $0.05
9b00f25b: posts big blind $0.1
*** HOLE CARDS ***
Dealt to 61e64b25 
Dealt to Hero [Qd Kh]
Dealt to 9b00f25b 
Dealt to 405535ec 
Dealt to fd863c49 
Dealt to d89e0e61 
405535ec: raises $0.2 to $0.3
fd863c49: folds
d89e0e61: folds
61e64b25: folds
Hero: raises $0.9 to $1.2
9b00f25b: folds
405535ec: raises $9.65 to $10.85 and is all-in
Hero: folds
Uncalled bet ($9.65) returned to 405535ec
*** SHOWDOWN ***
405535ec collected $2.38 from pot
*** SUMMARY ***
Total pot $2.5 | Rake $0.12 | Jackpot $0 | Bingo $0 | Fortune $0
Seat 1: 61e64b25 (button) folded before Flop (didn't bet)
Seat 2: Hero (small blind) folded before Flop
Seat 3: 9b00f25b (big blind) folded before Flop
Seat 4: 405535ec collected ($2.38)
Seat 5: fd863c49 folded before Flop (didn't bet)
Seat 6: d89e0e61 folded before Flop (didn't bet)


Poker Hand #RC1468280161: Hold'em No Limit  ($0.05/$0.1) - 2023/04/12 18:23:20
Table 'RushAndCash5595421' 6-max Seat #1 is the button
Seat 1: 107f293 ($14.04 in chips)
Seat 2: 87aa56fb ($22.85 in chips)
Seat 3: Hero ($17.57 in chips)
Seat 4: 4fe062a6 ($10 in chips)
Seat 5: ef398147 ($12.25 in chips)
Seat 6: fd863c49 ($7.02 in chips)
87aa56fb: posts small blind $0.05
Hero: posts big blind $0.1
*** HOLE CARDS ***
Dealt to 107f293 
Dealt to 87aa56fb 
Dealt to Hero [8s Js]
Dealt to 4fe062a6 
Dealt to ef398147 
Dealt to fd863c49 
4fe062a6: folds
ef398147: folds
fd863c49: raises $0.1 to $0.2
107f293: calls $0.2
87aa56fb: folds
Hero: calls $0.1
*** FLOP *** [2s 4c Ac]
Hero: bets $0.22
fd863c49: calls $0.22
107f293: folds
*** TURN *** [2s 4c Ac] [7h]
Hero: checks
fd863c49: checks
*** RIVER *** [2s 4c Ac 7h] [Td]
Hero: checks
fd863c49: bets $0.55
Hero: folds
Uncalled bet ($0.55) returned to fd863c49
*** SHOWDOWN ***
fd863c49 collected $1.04 from pot
*** SUMMARY ***
Total pot $1.09 | Rake $0.05 | Jackpot $0 | Bingo $0 | Fortune $0
Board [2s 4c Ac 7h Td]
Seat 1: 107f293 (button) folded on the Flop
Seat 2: 87aa56fb (small blind) folded before Flop
Seat 3: Hero (big blind) folded on the River
Seat 4: 4fe062a6 folded before Flop (didn't bet)
Seat 5: ef398147 folded before Flop (didn't bet)
Seat 6: fd863c49 won ($1.04)


Poker Hand #RC1468280117: Hold'em No Limit  ($0.05/$0.1) - 2023/04/12 18:23:13
Table 'RushAndCash5595377' 6-max Seat #1 is the button
Seat 1: 2c448700 ($10.17 in chips)
Seat 2: fa99b63e ($16.7 in chips)
Seat 3: a1f461 ($9.29 in chips)
Seat 4: Hero ($17.57 in chips)
Seat 5: faa9a4c6 ($16.08 in chips)
Seat 6: 3d9dd182 ($26.14 in chips)
fa99b63e: posts small blind $0.05
a1f461: posts big blind $0.1
*** HOLE CARDS ***
Dealt to 2c448700 
Dealt to fa99b63e 
Dealt to a1f461 
Dealt to Hero [Jh 2c]
Dealt to faa9a4c6 
Dealt to 3d9dd182 
Hero: folds
faa9a4c6: folds
3d9dd182: raises $0.15 to $0.25
2c448700: raises $0.5 to $0.75
fa99b63e: folds
a1f461: folds
3d9dd182: calls $0.5
*** FLOP *** [9c As Qd]
3d9dd182: checks
2c448700: bets $0.55
3d9dd182: folds
Uncalled bet ($0.55) returned to 2c448700
*** SHOWDOWN ***
2c448700 collected $1.57 from pot
*** SUMMARY ***
Total pot $1.65 | Rake $0.08 | Jackpot $0 | Bingo $0 | Fortune $0
Board [9c As Qd]
Seat 1: 2c448700 (button) won ($1.57)
Seat 2: fa99b63e (small blind) folded before Flop
Seat 3: a1f461 (big blind) folded before Flop
Seat 4: Hero folded before Flop (didn't bet)
Seat 5: faa9a4c6 folded before Flop (didn't bet)
Seat 6: 3d9dd182 folded on the Flop


Poker Hand #RC1468280051: Hold'em No Limit  ($0.05/$0.1) - 2023/04/12 18:23:04
Table 'RushAndCash5595311' 6-max Seat #1 is the button
Seat 1: f89d54f1 ($53.4 in chips)
Seat 2: 6a54e5c1 ($24.01 in chips)
Seat 3: cc348aa5 ($10.19 in chips)
Seat 4: a2f03845 ($11.12 in chips)
Seat 5: Hero ($17.57 in chips)
Seat 6: a446ad22 ($2.28 in chips)
6a54e5c1: posts small blind $0.05
cc348aa5: posts big blind $0.1
*** HOLE CARDS ***
Dealt to f89d54f1 
Dealt to 6a54e5c1 
Dealt to cc348aa5 
Dealt to a2f03845 
Dealt to Hero [Tc Qh]
Dealt to a446ad22 
a2f03845: folds
Hero: folds
a446ad22: folds
f89d54f1: folds
6a54e5c1: raises $0.1 to $0.2
cc348aa5: calls $0.1
*** FLOP *** [Jh 8h Kd]
6a54e5c1: bets $0.14
cc348aa5: calls $0.14
*** TURN *** [Jh 8h Kd] [Kh]
6a54e5c1: bets $0.23
cc348aa5: folds
Uncalled bet ($0.23) returned to 6a54e5c1
*** SHOWDOWN ***
6a54e5c1 collected $0.65 from pot
*** SUMMARY ***
Total pot $0.68 | Rake $0.03 | Jackpot $0 | Bingo $0 | Fortune $0
Board [Jh 8h Kd Kh]
Seat 1: f89d54f1 (button) folded before Flop (didn't bet)
Seat 2: 6a54e5c1 (small blind) won ($0.65)
Seat 3: cc348aa5 (big blind) folded on the Turn
Seat 4: a2f03845 folded before Flop (didn't bet)
Seat 5: Hero folded before Flop (didn't bet)
Seat 6: a446ad22 folded before Flop (didn't bet)


Poker Hand #RC1468279306: Hold'em No Limit  ($0.05/$0.1) - 2023/04/12 18:21:27
Table 'RushAndCash5594566' 6-max Seat #1 is the button
Seat 1: 8cf611c6 ($22.73 in chips)
Seat 2: 7e6b9746 ($11.74 in chips)
Seat 3: 290b9185 ($12.77 in chips)
Seat 4: Hero ($9.73 in chips)
Seat 5: 1bd3bc3d ($10.57 in chips)
Seat 6: d10723ed ($12.81 in chips)
7e6b9746: posts small blind $0.05
290b9185: posts big blind $0.1
*** HOLE CARDS ***
Dealt to 8cf611c6 
Dealt to 7e6b9746 
Dealt to 290b9185 
Dealt to Hero [3h 3s]
Dealt to 1bd3bc3d 
Dealt to d10723ed 
Hero: raises $0.15 to $0.25
1bd3bc3d: folds
d10723ed: folds
8cf611c6: folds
7e6b9746: calls $0.2
290b9185: calls $0.15
*** FLOP *** [3c Js Th]
7e6b9746: bets $0.38
290b9185: calls $0.38
Hero: raises $1.24 to $1.62
7e6b9746: calls $1.24
290b9185: folds
*** TURN *** [3c Js Th] [8d]
7e6b9746: checks
Hero: bets $1.75
7e6b9746: calls $1.75
*** RIVER *** [3c Js Th 8d] [2s]
7e6b9746: checks
Hero: bets $4.04
7e6b9746: calls $4.04
Hero: shows [3h 3s] (Three Treys)
7e6b9746: shows [Jc Ah] (Pair of Jacks)
*** SHOWDOWN ***
Hero collected $15.5 from pot
*** SUMMARY ***
Total pot $15.95 | Rake $0.3 | Jackpot $0.15 | Bingo $0 | Fortune $0
Board [3c Js Th 8d 2s]
Seat 1: 8cf611c6 (button) folded before Flop (didn't bet)
Seat 2: 7e6b9746 (small blind) showed [Jc Ah] and lost with Pair of Jacks
Seat 3: 290b9185 (big blind) folded on the Flop
Seat 4: Hero showed [3h 3s] and won ($15.5) with Three Treys
Seat 5: 1bd3bc3d folded before Flop (didn't bet)
Seat 6: d10723ed folded before Flop (didn't bet)


Poker Hand #RC1468279232: Hold'em No Limit  ($0.05/$0.1) - 2023/04/12 18:21:18
Table 'RushAndCash5594492' 6-max Seat #1 is the button
Seat 1: 4ce76220 ($13.78 in chips)
Seat 2: 6fa83554 ($10 in chips)
Seat 3: 62629f4b ($4.97 in chips)
Seat 4: c0cdd00b ($22.03 in chips)
Seat 5: 94205352 ($13.99 in chips)
Seat 6: Hero ($9.73 in chips)
6fa83554: posts small blind $0.05
62629f4b: posts big blind $0.1
*** HOLE CARDS ***
Dealt to 4ce76220 
Dealt to 6fa83554 
Dealt to 62629f4b 
Dealt to c0cdd00b 
Dealt to 94205352 
Dealt to Hero [3s 2h]
c0cdd00b: folds
94205352: folds
Hero: folds
4ce76220: folds
6fa83554: raises $0.2 to $0.3
62629f4b: calls $0.2
*** FLOP *** [9d Qh Tc]
6fa83554: checks
62629f4b: checks
*** TURN *** [9d Qh Tc] [7d]
6fa83554: bets $0.35
62629f4b: folds
Uncalled bet ($0.35) returned to 6fa83554
*** SHOWDOWN ***
6fa83554 collected $0.57 from pot
*** SUMMARY ***
Total pot $0.6 | Rake $0.03 | Jackpot $0 | Bingo $0 | Fortune $0
Board [9d Qh Tc 7d]
Seat 1: 4ce76220 (button) folded before Flop (didn't bet)
Seat 2: 6fa83554 (small blind) won ($0.57)
Seat 3: 62629f4b (big blind) folded on the Turn
Seat 4: c0cdd00b folded before Flop (didn't bet)
Seat 5: 94205352 folded before Flop (didn't bet)
Seat 6: Hero folded before Flop (didn't bet)


Poker Hand #RC1468279109: Hold'em No Limit  ($0.05/$0.1) - 2023/04/12 18:21:02
Table 'RushAndCash5594369' 6-max Seat #1 is the button
Seat 1: c402f02f ($10.15 in chips)
Seat 2: Hero ($9.78 in chips)
Seat 3: ed4f2de6 ($11.68 in chips)
Seat 4: 8103b0c3 ($12.78 in chips)
Seat 5: 62f870ea ($39.56 in chips)
Seat 6: edc5a8fa ($9.98 in chips)
Hero: posts small blind $0.05
ed4f2de6: posts big blind $0.1
*** HOLE CARDS ***
Dealt to c402f02f 
Dealt to Hero [Ac Jd]
Dealt to ed4f2de6 
Dealt to 8103b0c3 
Dealt to 62f870ea 
Dealt to edc5a8fa 
8103b0c3: folds
62f870ea: raises $0.15 to $0.25
edc5a8fa: folds
c402f02f: folds
Hero: folds
ed4f2de6: folds
Uncalled bet ($0.15) returned to 62f870ea
*** SHOWDOWN ***
62f870ea collected $0.25 from pot
*** SUMMARY ***
Total pot $0.25 | Rake $0 | Jackpot $0 | Bingo $0 | Fortune $0
Seat 1: c402f02f (button) folded before Flop (didn't bet)
Seat 2: Hero (small blind) folded before Flop
Seat 3: ed4f2de6 (big blind) folded before Flop
Seat 4: 8103b0c3 folded before Flop (didn't bet)
Seat 5: 62f870ea collected ($0.25)
Seat 6: edc5a8fa folded before Flop (didn't bet)


Poker Hand #RC1468278977: Hold'em No Limit  ($0.05/$0.1) - 2023/04/12 18:20:46
Table 'RushAndCash5594237' 6-max Seat #1 is the button
Seat 1: 8c6cfe67 ($11.47 in chips)
Seat 2: d1da1715 ($24.01 in chips)
Seat 3: Hero ($9.88 in chips)
Seat 4: 1c3bcef4 ($17.8 in chips)
Seat 5: 9bba65bf ($34.61 in chips)
Seat 6: 8b013a7e ($14.74 in chips)
d1da1715: posts small blind $0.05
Hero: posts big blind $0.1
*** HOLE CARDS ***
Dealt to 8c6cfe67 
Dealt to d1da1715 
Dealt to Hero [5s 2c]
Dealt to 1c3bcef4 
Dealt to 9bba65bf 
Dealt to 8b013a7e 
1c3bcef4: folds
9bba65bf: folds
8b013a7e: folds
8c6cfe67: raises $0.2 to $0.3
d1da1715: folds
Hero: folds
Uncalled bet ($0.2) returned to 8c6cfe67
*** SHOWDOWN ***
8c6cfe67 collected $0.25 from pot
*** SUMMARY ***
Total pot $0.25 | Rake $0 | Jackpot $0 | Bingo $0 | Fortune $0
Seat 1: 8c6cfe67 (button) collected ($0.25)
Seat 2: d1da1715 (small blind) folded before Flop
Seat 3: Hero (big blind) folded before Flop
Seat 4: 1c3bcef4 folded before Flop (didn't bet)
Seat 5: 9bba65bf folded before Flop (didn't bet)
Seat 6: 8b013a7e folded before Flop (didn't bet)


Poker Hand #RC1468278867: Hold'em No Limit  ($0.05/$0.1) - 2023/04/12 18:20:31
Table 'RushAndCash5594127' 6-max Seat #1 is the button
Seat 1: Hero ($9.88 in chips)
Seat 2: 27c922fe ($13.6 in chips)
Seat 3: 84b46d34 ($10.45 in chips)
Seat 4: e11ac207 ($10.54 in chips)
Seat 5: 4179b602 ($13.2 in chips)
Seat 6: b0c34841 ($22.07 in chips)
27c922fe: posts small blind $0.05
84b46d34: posts big blind $0.1
*** HOLE CARDS ***
Dealt to Hero [9s 5s]
Dealt to 27c922fe 
Dealt to 84b46d34 
Dealt to e11ac207 
Dealt to 4179b602 
Dealt to b0c34841 
e11ac207: folds
4179b602: folds
b0c34841: folds
Hero: folds
27c922fe: folds
Uncalled bet ($0.05) returned to 84b46d34
*** SHOWDOWN ***
84b46d34 collected $0.1 from pot
*** SUMMARY ***
Total pot $0.1 | Rake $0 | Jackpot $0 | Bingo $0 | Fortune $0
Seat 1: Hero (button) folded before Flop (didn't bet)
Seat 2: 27c922fe (small blind) folded before Flop
Seat 3: 84b46d34 (big blind) collected ($0.1)
Seat 4: e11ac207 folded before Flop (didn't bet)
Seat 5: 4179b602 folded before Flop (didn't bet)
Seat 6: b0c34841 folded before Flop (didn't bet)


Poker Hand #RC1468278808: Hold'em No Limit  ($0.05/$0.1) - 2023/04/12 18:20:24
Table 'RushAndCash5594068' 6-max Seat #1 is the button
Seat 1: 1511a9a5 ($11.55 in chips)
Seat 2: ee032002 ($9.23 in chips)
Seat 3: 3b843e73 ($3.47 in chips)
Seat 4: Hero ($9.88 in chips)
Seat 5: 4df7250d ($23.53 in chips)
Seat 6: 31fdab54 ($10 in chips)
ee032002: posts small blind $0.05
3b843e73: posts big blind $0.1
*** HOLE CARDS ***
Dealt to 1511a9a5 
Dealt to ee032002 
Dealt to 3b843e73 
Dealt to Hero [7d 2h]
Dealt to 4df7250d 
Dealt to 31fdab54 
Hero: folds
4df7250d: raises $0.15 to $0.25
31fdab54: folds
1511a9a5: folds
ee032002: folds
3b843e73: calls $0.15
*** FLOP *** [Th Jd 8c]
3b843e73: checks
4df7250d: bets $0.28
3b843e73: folds
Uncalled bet ($0.28) returned to 4df7250d
*** SHOWDOWN ***
4df7250d collected $0.53 from pot
*** SUMMARY ***
Total pot $0.55 | Rake $0.02 | Jackpot $0 | Bingo $0 | Fortune $0
Board [Th Jd 8c]
Seat 1: 1511a9a5 (button) folded before Flop (didn't bet)
Seat 2: ee032002 (small blind) folded before Flop
Seat 3: 3b843e73 (big blind) folded on the Flop
Seat 4: Hero folded before Flop (didn't bet)
Seat 5: 4df7250d won ($0.53)
Seat 6: 31fdab54 folded before Flop (didn't bet)


Poker Hand #RC1468278758: Hold'em No Limit  ($0.05/$0.1) - 2023/04/12 18:20:17
Table 'RushAndCash5594018' 6-max Seat #1 is the button
Seat 1: bf98f6d2 ($10 in chips)
Seat 2: c1853f20 ($9.9 in chips)
Seat 3: d4483568 ($12.26 in chips)
Seat 4: 1511a9a5 ($11.55 in chips)
Seat 5: 7f05483e ($38.31 in chips)
Seat 6: Hero ($9.88 in chips)
c1853f20: posts small blind $0.05
d4483568: posts big blind $0.1
*** HOLE CARDS ***
Dealt to bf98f6d2 
Dealt to c1853f20 
Dealt to d4483568 
Dealt to 1511a9a5 
Dealt to 7f05483e 
Dealt to Hero [6s 3c]
1511a9a5: folds
7f05483e: folds
Hero: folds
bf98f6d2: folds
c1853f20: raises $0.1 to $0.2
d4483568: folds
Uncalled bet ($0.1) returned to c1853f20
*** SHOWDOWN ***
c1853f20 collected $0.2 from pot
*** SUMMARY ***
Total pot $0.2 | Rake $0 | Jackpot $0 | Bingo $0 | Fortune $0
Seat 1: bf98f6d2 (button) folded before Flop (didn't bet)
Seat 2: c1853f20 (small blind) collected ($0.2)
Seat 3: d4483568 (big blind) folded before Flop
Seat 4: 1511a9a5 folded before Flop (didn't bet)
Seat 5: 7f05483e folded before Flop (didn't bet)
Seat 6: Hero folded before Flop (didn't bet)


Poker Hand #RC1468278713: Hold'em No Limit  ($0.05/$0.1) - 2023/04/12 18:20:13
Table 'RushAndCash5593973' 6-max Seat #1 is the button
Seat 1: Hero ($9.88 in chips)
Seat 2: 8dae9450 ($9.7 in chips)
Seat 3: a84e6d0a ($20.7 in chips)
Seat 4: 51712fd3 ($11.61 in chips)
Seat 5: 6bb948b2 ($35.01 in chips)
Seat 6: 3bf969ff ($10 in chips)
8dae9450: posts small blind $0.05
a84e6d0a: posts big blind $0.1
*** HOLE CARDS ***
Dealt to Hero [6s Ts]
Dealt to 8dae9450 
Dealt to a84e6d0a 
Dealt to 51712fd3 
Dealt to 6bb948b2 
Dealt to 3bf969ff 
51712fd3: folds
6bb948b2: folds
3bf969ff: folds
Hero: folds
8dae9450: raises $0.15 to $0.25
a84e6d0a: calls $0.15
*** FLOP *** [4c Qd Ad]
8dae9450: bets $0.38
a84e6d0a: folds
Uncalled bet ($0.38) returned to 8dae9450
*** SHOWDOWN ***
8dae9450 collected $0.48 from pot
*** SUMMARY ***
Total pot $0.5 | Rake $0.02 | Jackpot $0 | Bingo $0 | Fortune $0
Board [4c Qd Ad]
Seat 1: Hero (button) folded before Flop (didn't bet)
Seat 2: 8dae9450 (small blind) won ($0.48)
Seat 3: a84e6d0a (big blind) folded on the Flop
Seat 4: 51712fd3 folded before Flop (didn't bet)
Seat 5: 6bb948b2 folded before Flop (didn't bet)
Seat 6: 3bf969ff folded before Flop (didn't bet)


Poker Hand #RC1468278660: Hold'em No Limit  ($0.05/$0.1) - 2023/04/12 18:20:05
Table 'RushAndCash5593920' 6-max Seat #1 is the button
Seat 1: 6bb948b2 ($35.01 in chips)
Seat 2: 74221099 ($12.32 in chips)
Seat 3: Hero ($9.98 in chips)
Seat 4: 86aa7b6b ($27.06 in chips)
Seat 5: 3e9ad104 ($11.08 in chips)
Seat 6: 23445e4c ($14.8 in chips)
74221099: posts small blind $0.05
Hero: posts big blind $0.1
*** HOLE CARDS ***
Dealt to 6bb948b2 
Dealt to 74221099 
Dealt to Hero [4h Js]
Dealt to 86aa7b6b 
Dealt to 3e9ad104 
Dealt to 23445e4c 
86aa7b6b: folds
3e9ad104: folds
23445e4c: folds
6bb948b2: folds
74221099: raises $0.14 to $0.24
Hero: folds
Uncalled bet ($0.14) returned to 74221099
*** SHOWDOWN ***
74221099 collected $0.2 from pot
*** SUMMARY ***
Total pot $0.2 | Rake $0 | Jackpot $0 | Bingo $0 | Fortune $0
Seat 1: 6bb948b2 (button) folded before Flop (didn't bet)
Seat 2: 74221099 (small blind) collected ($0.2)
Seat 3: Hero (big blind) folded before Flop
Seat 4: 86aa7b6b folded before Flop (didn't bet)
Seat 5: 3e9ad104 folded before Flop (didn't bet)
Seat 6: 23445e4c folded before Flop (didn't bet)


Poker Hand #RC1468278588: Hold'em No Limit  ($0.05/$0.1) - 2023/04/12 18:19:56
Table 'RushAndCash5593848' 6-max Seat #1 is the button
Seat 1: bb4eedbf ($34.5 in chips)
Seat 2: Hero ($10.03 in chips)
Seat 3: a5e9fa24 ($10 in chips)
Seat 4: 96ca7d0 ($21.74 in chips)
Seat 5: a84e6d0a ($20.55 in chips)
Seat 6: 23445e4c ($14.8 in chips)
Hero: posts small blind $0.05
a5e9fa24: posts big blind $0.1
*** HOLE CARDS ***
Dealt to bb4eedbf 
Dealt to Hero [2c 8c]
Dealt to a5e9fa24 
Dealt to 96ca7d0 
Dealt to a84e6d0a 
Dealt to 23445e4c 
96ca7d0: folds
a84e6d0a: raises $0.15 to $0.25
23445e4c: folds
bb4eedbf: folds
Hero: folds
a5e9fa24: folds
Uncalled bet ($0.15) returned to a84e6d0a
*** SHOWDOWN ***
a84e6d0a collected $0.25 from pot
*** SUMMARY ***
Total pot $0.25 | Rake $0 | Jackpot $0 | Bingo $0 | Fortune $0
Seat 1: bb4eedbf (button) folded before Flop (didn't bet)
Seat 2: Hero (small blind) folded before Flop
Seat 3: a5e9fa24 (big blind) folded before Flop
Seat 4: 96ca7d0 folded before Flop (didn't bet)
Seat 5: a84e6d0a collected ($0.25)
Seat 6: 23445e4c folded before Flop (didn't bet)


Poker Hand #RC1468278522: Hold'em No Limit  ($0.05/$0.1) - 2023/04/12 18:19:48
Table 'RushAndCash5593782' 6-max Seat #1 is the button
Seat 1: 42fd626c ($12.38 in chips)
Seat 2: 99d3ba41 ($11.75 in chips)
Seat 3: 35fa52fa ($11.09 in chips)
Seat 4: Hero ($10.03 in chips)
Seat 5: ce2392b ($54.79 in chips)
Seat 6: a9bc15c5 ($16.89 in chips)
99d3ba41: posts small blind $0.05
35fa52fa: posts big blind $0.1
*** HOLE CARDS ***
Dealt to 42fd626c 
Dealt to 99d3ba41 
Dealt to 35fa52fa 
Dealt to Hero [Jc 2h]
Dealt to ce2392b 
Dealt to a9bc15c5 
Hero: folds
ce2392b: folds
a9bc15c5: folds
42fd626c: folds
99d3ba41: folds
Uncalled bet ($0.05) returned to 35fa52fa
*** SHOWDOWN ***
35fa52fa collected $0.1 from pot
*** SUMMARY ***
Total pot $0.1 | Rake $0 | Jackpot $0 | Bingo $0 | Fortune $0
Seat 1: 42fd626c (button) folded before Flop (didn't bet)
Seat 2: 99d3ba41 (small blind) folded before Flop
Seat 3: 35fa52fa (big blind) collected ($0.1)
Seat 4: Hero folded before Flop (didn't bet)
Seat 5: ce2392b folded before Flop (didn't bet)
Seat 6: a9bc15c5 folded before Flop (didn't bet)


Poker Hand #RC1468278481: Hold'em No Limit  ($0.05/$0.1) - 2023/04/12 18:19:43
Table 'RushAndCash5593741' 6-max Seat #1 is the button
Seat 1: b135a85 ($10 in chips)
Seat 2: 6b968ff6 ($12.27 in chips)
Seat 3: bb4b6a70 ($18.42 in chips)
Seat 4: a49b99da ($21.52 in chips)
Seat 5: 8c9d64e1 ($10 in chips)
Seat 6: Hero ($10.03 in chips)
6b968ff6: posts small blind $0.05
bb4b6a70: posts big blind $0.1
*** HOLE CARDS ***
Dealt to b135a85 
Dealt to 6b968ff6 
Dealt to bb4b6a70 
Dealt to a49b99da 
Dealt to 8c9d64e1 
Dealt to Hero [8d 9h]
a49b99da: folds
8c9d64e1: folds
Hero: folds
b135a85: folds
6b968ff6: folds
Uncalled bet ($0.05) returned to bb4b6a70
*** SHOWDOWN ***
bb4b6a70 collected $0.1 from pot
*** SUMMARY ***
Total pot $0.1 | Rake $0 | Jackpot $0 | Bingo $0 | Fortune $0
Seat 1: b135a85 (button) folded before Flop (didn't bet)
Seat 2: 6b968ff6 (small blind) folded before Flop
Seat 3: bb4b6a70 (big blind) collected ($0.1)
Seat 4: a49b99da folded before Flop (didn't bet)
Seat 5: 8c9d64e1 folded before Flop (didn't bet)
Seat 6: Hero folded before Flop (didn't bet)


Poker Hand #RC1468278436: Hold'em No Limit  ($0.05/$0.1) - 2023/04/12 18:19:36
Table 'RushAndCash5593696' 6-max Seat #1 is the button
Seat 1: c9de789b ($20.57 in chips)
Seat 2: 90b25cbf ($10 in chips)
Seat 3: 52f5fbbd ($5.45 in chips)
Seat 4: 4e220891 ($10.77 in chips)
Seat 5: Hero ($10.03 in chips)
Seat 6: fbfe38b2 ($14.17 in chips)
90b25cbf: posts small blind $0.05
52f5fbbd: posts big blind $0.1
*** HOLE CARDS ***
Dealt to c9de789b 
Dealt to 90b25cbf 
Dealt to 52f5fbbd 
Dealt to 4e220891 
Dealt to Hero [8c Kc]
Dealt to fbfe38b2 
4e220891: folds
Hero: folds
fbfe38b2: folds
c9de789b: raises $0.15 to $0.25
90b25cbf: folds
52f5fbbd: folds
Uncalled bet ($0.15) returned to c9de789b
*** SHOWDOWN ***
c9de789b collected $0.25 from pot
*** SUMMARY ***
Total pot $0.25 | Rake $0 | Jackpot $0 | Bingo $0 | Fortune $0
Seat 1: c9de789b (button) collected ($0.25)
Seat 2: 90b25cbf (small blind) folded before Flop
Seat 3: 52f5fbbd (big blind) folded before Flop
Seat 4: 4e220891 folded before Flop (didn't bet)
Seat 5: Hero folded before Flop (didn't bet)
Seat 6: fbfe38b2 folded before Flop (didn't bet)


Poker Hand #RC1468278384: Hold'em No Limit  ($0.05/$0.1) - 2023/04/12 18:19:29
Table 'RushAndCash5593644' 6-max Seat #1 is the button
Seat 1: b66ce66f ($11.95 in chips)
Seat 2: Hero ($10.08 in chips)
Seat 3: bb33ba33 ($10 in chips)
Seat 4: 4a60dcf ($8.55 in chips)
Seat 5: 6bb948b2 ($34.86 in chips)
Seat 6: 37bceca3 ($20.29 in chips)
Hero: posts small blind $0.05
bb33ba33: posts big blind $0.1
*** HOLE CARDS ***
Dealt to b66ce66f 
Dealt to Hero [4c 2d]
Dealt to bb33ba33 
Dealt to 4a60dcf 
Dealt to 6bb948b2 
Dealt to 37bceca3 
4a60dcf: folds
6bb948b2: folds
37bceca3: folds
b66ce66f: folds
Hero: folds
Uncalled bet ($0.05) returned to bb33ba33
*** SHOWDOWN ***
bb33ba33 collected $0.1 from pot
*** SUMMARY ***
Total pot $0.1 | Rake $0 | Jackpot $0 | Bingo $0 | Fortune $0
Seat 1: b66ce66f (button) folded before Flop (didn't bet)
Seat 2: Hero (small blind) folded before Flop
Seat 3: bb33ba33 (big blind) collected ($0.1)
Seat 4: 4a60dcf folded before Flop (didn't bet)
Seat 5: 6bb948b2 folded before Flop (didn't bet)
Seat 6: 37bceca3 folded before Flop (didn't bet)


Poker Hand #RC1468278267: Hold'em No Limit  ($0.05/$0.1) - 2023/04/12 18:19:13
Table 'RushAndCash5593527' 6-max Seat #1 is the button
Seat 1: 4afd4208 ($17.36 in chips)
Seat 2: d4483568 ($12.31 in chips)
Seat 3: Hero ($10.18 in chips)
Seat 4: 960281ce ($13.11 in chips)
Seat 5: d32ca085 ($10 in chips)
Seat 6: 87aa56fb ($23.91 in chips)
d4483568: posts small blind $0.05
Hero: posts big blind $0.1
*** HOLE CARDS ***
Dealt to 4afd4208 
Dealt to d4483568 
Dealt to Hero [8c 4h]
Dealt to 960281ce 
Dealt to d32ca085 
Dealt to 87aa56fb 
960281ce: folds
d32ca085: folds
87aa56fb: raises $0.2 to $0.3
4afd4208: raises $0.6 to $0.9
d4483568: folds
Hero: folds
87aa56fb: calls $0.6
*** FLOP *** [7h 7c 5d]
87aa56fb: checks
4afd4208: bets $0.7
87aa56fb: folds
Uncalled bet ($0.7) returned to 4afd4208
*** SHOWDOWN ***
4afd4208 collected $1.86 from pot
*** SUMMARY ***
Total pot $1.95 | Rake $0.09 | Jackpot $0 | Bingo $0 | Fortune $0
Board [7h 7c 5d]
Seat 1: 4afd4208 (button) won ($1.86)
Seat 2: d4483568 (small blind) folded before Flop
Seat 3: Hero (big blind) folded before Flop
Seat 4: 960281ce folded before Flop (didn't bet)
Seat 5: d32ca085 folded before Flop (didn't bet)
Seat 6: 87aa56fb folded on the Flop


Poker Hand #RC1468278162: Hold'em No Limit  ($0.05/$0.1) - 2023/04/12 18:18:59
Table 'RushAndCash5593422' 6-max Seat #1 is the button
Seat 1: 2b4d2fdc ($10.27 in chips)
Seat 2: 2f65b7d5 ($8.08 in chips)
Seat 3: 8bad8f31 ($9.29 in chips)
Seat 4: 3113428d ($8.83 in chips)
Seat 5: Hero ($10.18 in chips)
Seat 6: b1736c18 ($12.82 in chips)
2f65b7d5: posts small blind $0.05
8bad8f31: posts big blind $0.1
*** HOLE CARDS ***
Dealt to 2b4d2fdc 
Dealt to 2f65b7d5 
Dealt to 8bad8f31 
Dealt to 3113428d 
Dealt to Hero [6h Jc]
Dealt to b1736c18 
3113428d: folds
Hero: folds
b1736c18: folds
2b4d2fdc: raises $0.15 to $0.25
2f65b7d5: folds
8bad8f31: calls $0.15
*** FLOP *** [As 8c 3h]
8bad8f31: checks
2b4d2fdc: bets $0.36
8bad8f31: calls $0.36
*** TURN *** [As 8c 3h] [Ad]
8bad8f31: checks
2b4d2fdc: checks
*** RIVER *** [As 8c 3h Ad] [3c]
8bad8f31: checks
2b4d2fdc: checks
8bad8f31: shows [2d 4s] (Pair of Aces and Pair of Treys)
2b4d2fdc: shows [7d 9d] (Pair of Aces and Pair of Treys)
*** SHOWDOWN ***
2b4d2fdc collected $1.2 from pot
*** SUMMARY ***
Total pot $1.27 | Rake $0.07 | Jackpot $0 | Bingo $0 | Fortune $0
Board [As 8c 3h Ad 3c]
Seat 1: 2b4d2fdc (button) showed [7d 9d] and won ($1.2) with Pair of Aces and Pair of Treys
Seat 2: 2f65b7d5 (small blind) folded before Flop
Seat 3: 8bad8f31 (big blind) showed [2d 4s] and lost with Pair of Aces and Pair of Treys
Seat 4: 3113428d folded before Flop (didn't bet)
Seat 5: Hero folded before Flop (didn't bet)
Seat 6: b1736c18 folded before Flop (didn't bet)


Poker Hand #RC1468278109: Hold'em No Limit  ($0.05/$0.1) - 2023/04/12 18:18:52
Table 'RushAndCash5593369' 6-max Seat #1 is the button
Seat 1: Hero ($10.18 in chips)
Seat 2: 401e388e ($10.93 in chips)
Seat 3: 91fab394 ($37.39 in chips)
Seat 4: f0e972ed ($19.5 in chips)
Seat 5: b42a5836 ($11.3 in chips)
Seat 6: eb6a06d4 ($10 in chips)
401e388e: posts small blind $0.05
91fab394: posts big blind $0.1
*** HOLE CARDS ***
Dealt to Hero [Qh 3d]
Dealt to 401e388e 
Dealt to 91fab394 
Dealt to f0e972ed 
Dealt to b42a5836 
Dealt to eb6a06d4 
f0e972ed: raises $0.1 to $0.2
b42a5836: folds
eb6a06d4: folds
Hero: folds
401e388e: folds
91fab394: calls $0.1
*** FLOP *** [7d Qd 4h]
91fab394: checks
f0e972ed: bets $0.15
91fab394: folds
Uncalled bet ($0.15) returned to f0e972ed
*** SHOWDOWN ***
f0e972ed collected $0.43 from pot
*** SUMMARY ***
Total pot $0.45 | Rake $0.02 | Jackpot $0 | Bingo $0 | Fortune $0
Board [7d Qd 4h]
Seat 1: Hero (button) folded before Flop (didn't bet)
Seat 2: 401e388e (small blind) folded before Flop
Seat 3: 91fab394 (big blind) folded on the Flop
Seat 4: f0e972ed won ($0.43)
Seat 5: b42a5836 folded before Flop (didn't bet)
Seat 6: eb6a06d4 folded before Flop (didn't bet)


Poker Hand #RC1468277632: Hold'em No Limit  ($0.05/$0.1) - 2023/04/12 18:17:50
Table 'RushAndCash5592892' 6-max Seat #1 is the button
Seat 1: dedf4996 ($10.97 in chips)
Seat 2: 91fab394 ($36.92 in chips)
Seat 3: c52e73c1 ($10 in chips)
Seat 4: Hero ($10.43 in chips)
Seat 5: ed6c91c ($10 in chips)
Seat 6: a49b99da ($21.19 in chips)
91fab394: posts small blind $0.05
c52e73c1: posts big blind $0.1
*** HOLE CARDS ***
Dealt to dedf4996 
Dealt to 91fab394 
Dealt to c52e73c1 
Dealt to Hero [7h Ah]
Dealt to ed6c91c 
Dealt to a49b99da 
Hero: raises $0.15 to $0.25
ed6c91c: folds
a49b99da: folds
dedf4996: folds
91fab394: calls $0.2
c52e73c1: calls $0.15
*** FLOP *** [Ts 9s 4h]
91fab394: checks
c52e73c1: checks
Hero: checks
*** TURN *** [Ts 9s 4h] [4s]
91fab394: checks
c52e73c1: checks
Hero: checks
*** RIVER *** [Ts 9s 4h 4s] [Qd]
91fab394: bets $0.75
c52e73c1: folds
Hero: folds
Uncalled bet ($0.75) returned to 91fab394
*** SHOWDOWN ***
91fab394 collected $0.72 from pot
*** SUMMARY ***
Total pot $0.75 | Rake $0.03 | Jackpot $0 | Bingo $0 | Fortune $0
Board [Ts 9s 4h 4s Qd]
Seat 1: dedf4996 (button) folded before Flop (didn't bet)
Seat 2: 91fab394 (small blind) won ($0.72)
Seat 3: c52e73c1 (big blind) folded on the River
Seat 4: Hero folded on the River
Seat 5: ed6c91c folded before Flop (didn't bet)
Seat 6: a49b99da folded before Flop (didn't bet)


Poker Hand #RC1468277541: Hold'em No Limit  ($0.05/$0.1) - 2023/04/12 18:17:38
Table 'RushAndCash5592801' 6-max Seat #1 is the button
Seat 1: 6fc34073 ($10.47 in chips)
Seat 2: 2691a768 ($6.43 in chips)
Seat 3: 68a19d88 ($13.75 in chips)
Seat 4: Hero ($10.43 in chips)
Seat 5: 7dc0228f ($28.1 in chips)
Seat 6: 1b214f81 ($33.26 in chips)
2691a768: posts small blind $0.05
68a19d88: posts big blind $0.1
*** HOLE CARDS ***
Dealt to 6fc34073 
Dealt to 2691a768 
Dealt to 68a19d88 
Dealt to Hero [6s 7h]
Dealt to 7dc0228f 
Dealt to 1b214f81 
Hero: folds
7dc0228f: folds
1b214f81: folds
6fc34073: folds
2691a768: raises $0.13 to $0.23
68a19d88: folds
Uncalled bet ($0.13) returned to 2691a768
*** SHOWDOWN ***
2691a768 collected $0.2 from pot
*** SUMMARY ***
Total pot $0.2 | Rake $0 | Jackpot $0 | Bingo $0 | Fortune $0
Seat 1: 6fc34073 (button) folded before Flop (didn't bet)
Seat 2: 2691a768 (small blind) collected ($0.2)
Seat 3: 68a19d88 (big blind) folded before Flop
Seat 4: Hero folded before Flop (didn't bet)
Seat 5: 7dc0228f folded before Flop (didn't bet)
Seat 6: 1b214f81 folded before Flop (didn't bet)


Poker Hand #RC1468277493: Hold'em No Limit  ($0.05/$0.1) - 2023/04/12 18:17:33
Table 'RushAndCash5592753' 6-max Seat #1 is the button
Seat 1: Hero ($10.43 in chips)
Seat 2: a16dd762 ($24.96 in chips)
Seat 3: 34c6bba9 ($11.82 in chips)
Seat 4: c72a910e ($12.12 in chips)
Seat 5: 1bfc7b79 ($10 in chips)
Seat 6: d1da1715 ($23.77 in chips)
a16dd762: posts small blind $0.05
34c6bba9: posts big blind $0.1
*** HOLE CARDS ***
Dealt to Hero [Tc 4s]
Dealt to a16dd762 
Dealt to 34c6bba9 
Dealt to c72a910e 
Dealt to 1bfc7b79 
Dealt to d1da1715 
c72a910e: folds
1bfc7b79: raises $0.1 to $0.2
d1da1715: folds
Hero: folds
a16dd762: raises $0.8 to $1
34c6bba9: raises $1.8 to $2.8
1bfc7b79: folds
a16dd762: raises $22.16 to $24.96 and is all-in
34c6bba9: calls $9.02 and is all-in
Uncalled bet ($13.14) returned to a16dd762
a16dd762: shows [Ah Ad]
34c6bba9: shows [Js Jc]
*** FIRST FLOP *** [2c 3h 8d]
*** FIRST TURN *** [2c 3h 8d] [6s]
*** FIRST RIVER *** [2c 3h 8d 6s] [9d]
*** SECOND FLOP *** [9s 8s 7d]
*** SECOND TURN *** [9s 8s 7d] [Td]
*** SECOND RIVER *** [9s 8s 7d Td] [2h]
*** FIRST SHOWDOWN ***
a16dd762 collected $11.7 from pot
*** SECOND SHOWDOWN ***
34c6bba9 collected $11.69 from pot
*** SUMMARY ***
Total pot $23.84 | Rake $0.3 | Jackpot $0.15 | Bingo $0 | Fortune $0
Hand was run two times
FIRST Board [2c 3h 8d 6s 9d]
SECOND Board [9s 8s 7d Td 2h]
Seat 1: Hero (button) folded before Flop (didn't bet)
Seat 2: a16dd762 (small blind) showed [Ah Ad] and won ($11.7) with Pair of Aces, and lost with Pair of Aces
Seat 3: 34c6bba9 (big blind) showed [Js Jc] and lost with Pair of Jacks, and won ($11.69) with Jacks-High Straight
Seat 4: c72a910e folded before Flop (didn't bet)
Seat 5: 1bfc7b79 folded before Flop
Seat 6: d1da1715 folded before Flop (didn't bet)


Poker Hand #RC1468277407: Hold'em No Limit  ($0.05/$0.1) - 2023/04/12 18:17:22
Table 'RushAndCash5592667' 6-max Seat #1 is the button
Seat 1: 268d1bee ($16.46 in chips)
Seat 2: Hero ($10.33 in chips)
Seat 3: 31772e48 ($12.78 in chips)
Seat 4: 99d3ba41 ($12.39 in chips)
Seat 5: d441649c ($10.24 in chips)
Seat 6: 9f9bac42 ($11.7 in chips)
Hero: posts small blind $0.05
31772e48: posts big blind $0.1
*** HOLE CARDS ***
Dealt to 268d1bee 
Dealt to Hero [7h 6h]
Dealt to 31772e48 
Dealt to 99d3ba41 
Dealt to d441649c 
Dealt to 9f9bac42 
99d3ba41: folds
d441649c: raises $0.15 to $0.25
9f9bac42: folds
268d1bee: folds
Hero: folds
31772e48: folds
Uncalled bet ($0.15) returned to d441649c
*** SHOWDOWN ***
d441649c collected $0.25 from pot
*** SUMMARY ***
Total pot $0.25 | Rake $0 | Jackpot $0 | Bingo $0 | Fortune $0
Seat 1: 268d1bee (button) folded before Flop (didn't bet)
Seat 2: Hero (small blind) folded before Flop
Seat 3: 31772e48 (big blind) folded before Flop
Seat 4: 99d3ba41 folded before Flop (didn't bet)
Seat 5: d441649c collected ($0.25)
Seat 6: 9f9bac42 folded before Flop (didn't bet)


Poker Hand #RC1468277370: Hold'em No Limit  ($0.05/$0.1) - 2023/04/12 18:17:18
Table 'RushAndCash5592630' 6-max Seat #1 is the button
Seat 1: bcfb9a91 ($15.57 in chips)
Seat 2: 1eac1ea3 ($17.8 in chips)
Seat 3: Hero ($10.43 in chips)
Seat 4: 6d2f0373 ($20.53 in chips)
Seat 5: 48e9ca7a ($11.67 in chips)
Seat 6: 50b345e4 ($10 in chips)
1eac1ea3: posts small blind $0.05
Hero: posts big blind $0.1
*** HOLE CARDS ***
Dealt to bcfb9a91 
Dealt to 1eac1ea3 
Dealt to Hero [4c 7s]
Dealt to 6d2f0373 
Dealt to 48e9ca7a 
Dealt to 50b345e4 
6d2f0373: folds
48e9ca7a: folds
50b345e4: folds
bcfb9a91: folds
1eac1ea3: folds
Uncalled bet ($0.05) returned to Hero
*** SHOWDOWN ***
Hero collected $0.1 from pot
*** SUMMARY ***
Total pot $0.1 | Rake $0 | Jackpot $0 | Bingo $0 | Fortune $0
Seat 1: bcfb9a91 (button) folded before Flop (didn't bet)
Seat 2: 1eac1ea3 (small blind) folded before Flop
Seat 3: Hero (big blind) collected ($0.1)
Seat 4: 6d2f0373 folded before Flop (didn't bet)
Seat 5: 48e9ca7a folded before Flop (didn't bet)
Seat 6: 50b345e4 folded before Flop (didn't bet)


Poker Hand #RC1468277315: Hold'em No Limit  ($0.05/$0.1) - 2023/04/12 18:17:10
Table 'RushAndCash5592575' 6-max Seat #1 is the button
Seat 1: 518a2b78 ($15.54 in chips)
Seat 2: d4edd1d3 ($10.68 in chips)
Seat 3: b44e34f3 ($11.4 in chips)
Seat 4: 303fc163 ($9.89 in chips)
Seat 5: Hero ($10.43 in chips)
Seat 6: 3b843e73 ($4.29 in chips)
d4edd1d3: posts small blind $0.05
b44e34f3: posts big blind $0.1
*** HOLE CARDS ***
Dealt to 518a2b78 
Dealt to d4edd1d3 
Dealt to b44e34f3 
Dealt to 303fc163 
Dealt to Hero [6h 2h]
Dealt to 3b843e73 
303fc163: folds
Hero: folds
3b843e73: folds
518a2b78: folds
d4edd1d3: folds
Uncalled bet ($0.05) returned to b44e34f3
*** SHOWDOWN ***
b44e34f3 collected $0.1 from pot
*** SUMMARY ***
Total pot $0.1 | Rake $0 | Jackpot $0 | Bingo $0 | Fortune $0
Seat 1: 518a2b78 (button) folded before Flop (didn't bet)
Seat 2: d4edd1d3 (small blind) folded before Flop
Seat 3: b44e34f3 (big blind) collected ($0.1)
Seat 4: 303fc163 folded before Flop (didn't bet)
Seat 5: Hero folded before Flop (didn't bet)
Seat 6: 3b843e73 folded before Flop (didn't bet)


Poker Hand #RC1468277207: Hold'em No Limit  ($0.05/$0.1) - 2023/04/12 18:16:57
Table 'RushAndCash5592467' 6-max Seat #1 is the button
Seat 1: f5f21a55 ($10 in chips)
Seat 2: a600137b ($12.77 in chips)
Seat 3: c889e4ef ($43.93 in chips)
Seat 4: f95f3ec6 ($11.78 in chips)
Seat 5: e2ec5807 ($10.95 in chips)
Seat 6: Hero ($10.43 in chips)
a600137b: posts small blind $0.05
c889e4ef: posts big blind $0.1
*** HOLE CARDS ***
Dealt to f5f21a55 
Dealt to a600137b 
Dealt to c889e4ef 
Dealt to f95f3ec6 
Dealt to e2ec5807 
Dealt to Hero [Th 8h]
f95f3ec6: folds
e2ec5807: folds
Hero: folds
f5f21a55: folds
a600137b: raises $0.2 to $0.3
c889e4ef: folds
Uncalled bet ($0.2) returned to a600137b
*** SHOWDOWN ***
a600137b collected $0.2 from pot
*** SUMMARY ***
Total pot $0.2 | Rake $0 | Jackpot $0 | Bingo $0 | Fortune $0
Seat 1: f5f21a55 (button) folded before Flop (didn't bet)
Seat 2: a600137b (small blind) collected ($0.2)
Seat 3: c889e4ef (big blind) folded before Flop
Seat 4: f95f3ec6 folded before Flop (didn't bet)
Seat 5: e2ec5807 folded before Flop (didn't bet)
Seat 6: Hero folded before Flop (didn't bet)


Poker Hand #RC1468277031: Hold'em No Limit  ($0.05/$0.1) - 2023/04/12 18:16:33
Table 'RushAndCash5592291' 6-max Seat #1 is the button
Seat 1: 756dfd9 ($13.35 in chips)
Seat 2: b66ce66f ($12.8 in chips)
Seat 3: 794d5e3d ($14.12 in chips)
Seat 4: cdb4bc04 ($10 in chips)
Seat 5: Hero ($10.28 in chips)
Seat 6: 33a288a7 ($21.26 in chips)
b66ce66f: posts small blind $0.05
794d5e3d: posts big blind $0.1
*** HOLE CARDS ***
Dealt to 756dfd9 
Dealt to b66ce66f 
Dealt to 794d5e3d 
Dealt to cdb4bc04 
Dealt to Hero [8h As]
Dealt to 33a288a7 
cdb4bc04: folds
Hero: raises $0.15 to $0.25
33a288a7: folds
756dfd9: folds
b66ce66f: folds
794d5e3d: folds
Uncalled bet ($0.15) returned to Hero
*** SHOWDOWN ***
Hero collected $0.25 from pot
*** SUMMARY ***
Total pot $0.25 | Rake $0 | Jackpot $0 | Bingo $0 | Fortune $0
Seat 1: 756dfd9 (button) folded before Flop (didn't bet)
Seat 2: b66ce66f (small blind) folded before Flop
Seat 3: 794d5e3d (big blind) folded before Flop
Seat 4: cdb4bc04 folded before Flop (didn't bet)
Seat 5: Hero collected ($0.25)
Seat 6: 33a288a7 folded before Flop (didn't bet)


Poker Hand #RC1468276995: Hold'em No Limit  ($0.05/$0.1) - 2023/04/12 18:16:29
Table 'RushAndCash5592255' 6-max Seat #1 is the button
Seat 1: bfbec681 ($13.71 in chips)
Seat 2: 4acb18e6 ($10.19 in chips)
Seat 3: aebceced ($9.66 in chips)
Seat 4: c2ef0297 ($13.5 in chips)
Seat 5: Hero ($10.28 in chips)
Seat 6: 96e539e3 ($17 in chips)
4acb18e6: posts small blind $0.05
aebceced: posts big blind $0.1
*** HOLE CARDS ***
Dealt to bfbec681 
Dealt to 4acb18e6 
Dealt to aebceced 
Dealt to c2ef0297 
Dealt to Hero [8d Qs]
Dealt to 96e539e3 
c2ef0297: folds
Hero: folds
96e539e3: raises $0.15 to $0.25
bfbec681: folds
4acb18e6: folds
aebceced: calls $0.15
*** FLOP *** [6s Tc Kd]
aebceced: checks
96e539e3: bets $0.28
aebceced: calls $0.28
*** TURN *** [6s Tc Kd] [Ac]
aebceced: checks
96e539e3: bets $0.37
aebceced: raises $0.68 to $1.05
96e539e3: folds
Uncalled bet ($0.68) returned to aebceced
*** SHOWDOWN ***
aebceced collected $1.76 from pot
*** SUMMARY ***
Total pot $1.85 | Rake $0.09 | Jackpot $0 | Bingo $0 | Fortune $0
Board [6s Tc Kd Ac]
Seat 1: bfbec681 (button) folded before Flop (didn't bet)
Seat 2: 4acb18e6 (small blind) folded before Flop
Seat 3: aebceced (big blind) won ($1.76)
Seat 4: c2ef0297 folded before Flop (didn't bet)
Seat 5: Hero folded before Flop (didn't bet)
Seat 6: 96e539e3 folded on the Turn


Poker Hand #RC1468276863: Hold'em No Limit  ($0.05/$0.1) - 2023/04/12 18:16:10
Table 'RushAndCash5592123' 6-max Seat #1 is the button
Seat 1: Hero ($10.28 in chips)
Seat 2: 290b9185 ($12.99 in chips)
Seat 3: 34c6bba9 ($12.12 in chips)
Seat 4: 367e8694 ($12.01 in chips)
Seat 5: b0c34841 ($20.03 in chips)
Seat 6: 405535ec ($10 in chips)
290b9185: posts small blind $0.05
34c6bba9: posts big blind $0.1
*** HOLE CARDS ***
Dealt to Hero [3s Ah]
Dealt to 290b9185 
Dealt to 34c6bba9 
Dealt to 367e8694 
Dealt to b0c34841 
Dealt to 405535ec 
367e8694: folds
b0c34841: folds
405535ec: raises $0.2 to $0.3
Hero: folds
290b9185: folds
34c6bba9: folds
Uncalled bet ($0.2) returned to 405535ec
*** SHOWDOWN ***
405535ec collected $0.25 from pot
*** SUMMARY ***
Total pot $0.25 | Rake $0 | Jackpot $0 | Bingo $0 | Fortune $0
Seat 1: Hero (button) folded before Flop (didn't bet)
Seat 2: 290b9185 (small blind) folded before Flop
Seat 3: 34c6bba9 (big blind) folded before Flop
Seat 4: 367e8694 folded before Flop (didn't bet)
Seat 5: b0c34841 folded before Flop (didn't bet)
Seat 6: 405535ec collected ($0.25)


Poker Hand #RC1468276823: Hold'em No Limit  ($0.05/$0.1) - 2023/04/12 18:16:05
Table 'RushAndCash5592083' 6-max Seat #1 is the button
Seat 1: 5b43b796 ($10.15 in chips)
Seat 2: Hero ($10.33 in chips)
Seat 3: c97b9c20 ($11.87 in chips)
Seat 4: 794d5e3d ($14.17 in chips)
Seat 5: cad9781d ($11.03 in chips)
Seat 6: cf6ea5ea ($17.98 in chips)
Hero: posts small blind $0.05
c97b9c20: posts big blind $0.1
*** HOLE CARDS ***
Dealt to 5b43b796 
Dealt to Hero [2h 9s]
Dealt to c97b9c20 
Dealt to 794d5e3d 
Dealt to cad9781d 
Dealt to cf6ea5ea 
794d5e3d: folds
cad9781d: raises $0.15 to $0.25
cf6ea5ea: folds
5b43b796: folds
Hero: folds
c97b9c20: folds
Uncalled bet ($0.15) returned to cad9781d
*** SHOWDOWN ***
cad9781d collected $0.25 from pot
*** SUMMARY ***
Total pot $0.25 | Rake $0 | Jackpot $0 | Bingo $0 | Fortune $0
Seat 1: 5b43b796 (button) folded before Flop (didn't bet)
Seat 2: Hero (small blind) folded before Flop
Seat 3: c97b9c20 (big blind) folded before Flop
Seat 4: 794d5e3d folded before Flop (didn't bet)
Seat 5: cad9781d collected ($0.25)
Seat 6: cf6ea5ea folded before Flop (didn't bet)


Poker Hand #RC1468276768: Hold'em No Limit  ($0.05/$0.1) - 2023/04/12 18:15:57
Table 'RushAndCash5592028' 6-max Seat #1 is the button
Seat 1: 39331aac ($26.71 in chips)
Seat 2: 1eac1ea3 ($18.1 in chips)
Seat 3: Hero ($10.28 in chips)
Seat 4: 9f9bac42 ($9.18 in chips)
Seat 5: 8c5cec9f ($9.96 in chips)
Seat 6: d1da1715 ($23.56 in chips)
1eac1ea3: posts small blind $0.05
Hero: posts big blind $0.1
*** HOLE CARDS ***
Dealt to 39331aac 
Dealt to 1eac1ea3 
Dealt to Hero [Ah 8c]
Dealt to 9f9bac42 
Dealt to 8c5cec9f 
Dealt to d1da1715 
9f9bac42: folds
8c5cec9f: folds
d1da1715: folds
39331aac: folds
1eac1ea3: folds
Uncalled bet ($0.05) returned to Hero
*** SHOWDOWN ***
Hero collected $0.1 from pot
*** SUMMARY ***
Total pot $0.1 | Rake $0 | Jackpot $0 | Bingo $0 | Fortune $0
Seat 1: 39331aac (button) folded before Flop (didn't bet)
Seat 2: 1eac1ea3 (small blind) folded before Flop
Seat 3: Hero (big blind) collected ($0.1)
Seat 4: 9f9bac42 folded before Flop (didn't bet)
Seat 5: 8c5cec9f folded before Flop (didn't bet)
Seat 6: d1da1715 folded before Flop (didn't bet)


Poker Hand #RC1468276736: Hold'em No Limit  ($0.05/$0.1) - 2023/04/12 18:15:53
Table 'RushAndCash5591996' 6-max Seat #1 is the button
Seat 1: 8f9a6467 ($22.36 in chips)
Seat 2: cc12baf6 ($8.89 in chips)
Seat 3: b44e34f3 ($11.04 in chips)
Seat 4: Hero ($10.28 in chips)
Seat 5: 11723cce ($33.72 in chips)
Seat 6: 615363c0 ($9.3 in chips)
cc12baf6: posts small blind $0.05
b44e34f3: posts big blind $0.1
*** HOLE CARDS ***
Dealt to 8f9a6467 
Dealt to cc12baf6 
Dealt to b44e34f3 
Dealt to Hero [Qc 9h]
Dealt to 11723cce 
Dealt to 615363c0 
Hero: folds
11723cce: raises $0.1 to $0.2
615363c0: folds
8f9a6467: folds
cc12baf6: folds
b44e34f3: calls $0.1
*** FLOP *** [7s 3d 3c]
b44e34f3: checks
11723cce: bets $0.2
b44e34f3: calls $0.2
*** TURN *** [7s 3d 3c] [5c]
b44e34f3: checks
11723cce: checks
*** RIVER *** [7s 3d 3c 5c] [Jh]
b44e34f3: bets $0.6
11723cce: folds
Uncalled bet ($0.6) returned to b44e34f3
*** SHOWDOWN ***
b44e34f3 collected $0.81 from pot
*** SUMMARY ***
Total pot $0.85 | Rake $0.04 | Jackpot $0 | Bingo $0 | Fortune $0
Board [7s 3d 3c 5c Jh]
Seat 1: 8f9a6467 (button) folded before Flop (didn't bet)
Seat 2: cc12baf6 (small blind) folded before Flop
Seat 3: b44e34f3 (big blind) won ($0.81)
Seat 4: Hero folded before Flop (didn't bet)
Seat 5: 11723cce folded on the River
Seat 6: 615363c0 folded before Flop (didn't bet)


Poker Hand #RC1468276704: Hold'em No Limit  ($0.05/$0.1) - 2023/04/12 18:15:49
Table 'RushAndCash5591964' 6-max Seat #1 is the button
Seat 1: 61e64b25 ($13.15 in chips)
Seat 2: 960d982c ($14.38 in chips)
Seat 3: f2b01908 ($18.82 in chips)
Seat 4: b1736c18 ($12.54 in chips)
Seat 5: d95c6456 ($10.22 in chips)
Seat 6: Hero ($10.28 in chips)
960d982c: posts small blind $0.05
f2b01908: posts big blind $0.1
*** HOLE CARDS ***
Dealt to 61e64b25 
Dealt to 960d982c 
Dealt to f2b01908 
Dealt to b1736c18 
Dealt to d95c6456 
Dealt to Hero [8d 5c]
b1736c18: folds
d95c6456: folds
Hero: folds
61e64b25: folds
960d982c: raises $0.2 to $0.3
f2b01908: raises $0.7 to $1
960d982c: raises $1.5 to $2.5
f2b01908: raises $15.5 to $18
960d982c: folds
Uncalled bet ($15.5) returned to f2b01908
*** SHOWDOWN ***
f2b01908 collected $4.61 from pot
*** SUMMARY ***
Total pot $5 | Rake $0.24 | Jackpot $0.15 | Bingo $0 | Fortune $0
Seat 1: 61e64b25 (button) folded before Flop (didn't bet)
Seat 2: 960d982c (small blind) folded before Flop
Seat 3: f2b01908 (big blind) collected ($4.61)
Seat 4: b1736c18 folded before Flop (didn't bet)
Seat 5: d95c6456 folded before Flop (didn't bet)
Seat 6: Hero folded before Flop (didn't bet)


Poker Hand #RC1468276471: Hold'em No Limit  ($0.05/$0.1) - 2023/04/12 18:15:19
Table 'RushAndCash5591731' 6-max Seat #1 is the button
Seat 1: dc03186e ($55.61 in chips)
Seat 2: 37bc01f ($35.87 in chips)
Seat 3: 557f8789 ($10 in chips)
Seat 4: 921a0b3f ($19.23 in chips)
Seat 5: Hero ($10 in chips)
Seat 6: 7359f62b ($8.89 in chips)
37bc01f: posts small blind $0.05
557f8789: posts big blind $0.1
*** HOLE CARDS ***
Dealt to dc03186e 
Dealt to 37bc01f 
Dealt to 557f8789 
Dealt to 921a0b3f 
Dealt to Hero [Qd Ad]
Dealt to 7359f62b 
921a0b3f: folds
Hero: raises $0.15 to $0.25
7359f62b: folds
dc03186e: folds
37bc01f: folds
557f8789: calls $0.15
*** FLOP *** [Qh 5h 3s]
557f8789: checks
Hero: bets $0.28
557f8789: folds
Uncalled bet ($0.28) returned to Hero
*** SHOWDOWN ***
Hero collected $0.53 from pot
*** SUMMARY ***
Total pot $0.55 | Rake $0.02 | Jackpot $0 | Bingo $0 | Fortune $0
Board [Qh 5h 3s]
Seat 1: dc03186e (button) folded before Flop (didn't bet)
Seat 2: 37bc01f (small blind) folded before Flop
Seat 3: 557f8789 (big blind) folded on the Flop
Seat 4: 921a0b3f folded before Flop (didn't bet)
Seat 5: Hero won ($0.53)
Seat 6: 7359f62b folded before Flop (didn't bet)


Poker Hand #RC1468276434: Hold'em No Limit  ($0.05/$0.1) - 2023/04/12 18:15:14
Table 'RushAndCash5591694' 6-max Seat #1 is the button
Seat 1: Hero ($10 in chips)
Seat 2: 119a9d01 ($27.91 in chips)
Seat 3: bb03a8cb ($19.45 in chips)
Seat 4: 7051ef4f ($10.25 in chips)
Seat 5: ecbd5529 ($31.98 in chips)
Seat 6: c8b9f617 ($16.47 in chips)
119a9d01: posts small blind $0.05
bb03a8cb: posts big blind $0.1
*** HOLE CARDS ***
Dealt to Hero [3c 7h]
Dealt to 119a9d01 
Dealt to bb03a8cb 
Dealt to 7051ef4f 
Dealt to ecbd5529 
Dealt to c8b9f617 
7051ef4f: folds
ecbd5529: folds
c8b9f617: raises $0.12 to $0.22
Hero: folds
119a9d01: folds
bb03a8cb: calls $0.12
*** FLOP *** [6h 4h 7d]
bb03a8cb: checks
c8b9f617: bets $0.25
bb03a8cb: raises $0.5 to $0.75
c8b9f617: folds
Uncalled bet ($0.5) returned to bb03a8cb
*** SHOWDOWN ***
bb03a8cb collected $0.94 from pot
*** SUMMARY ***
Total pot $0.99 | Rake $0.05 | Jackpot $0 | Bingo $0 | Fortune $0
Board [6h 4h 7d]
Seat 1: Hero (button) folded before Flop (didn't bet)
Seat 2: 119a9d01 (small blind) folded before Flop
Seat 3: bb03a8cb (big blind) won ($0.94)
Seat 4: 7051ef4f folded before Flop (didn't bet)
Seat 5: ecbd5529 folded before Flop (didn't bet)
Seat 6: c8b9f617 folded on the Flop


Poker Hand #RC1468276354: Hold'em No Limit  ($0.05/$0.1) - 2023/04/12 18:15:03
Table 'RushAndCash5591614' 6-max Seat #1 is the button
Seat 1: 8c9d64e1 ($10.1 in chips)
Seat 2: Hero ($10.05 in chips)
Seat 3: 9577cf26 ($11.05 in chips)
Seat 4: 7e209a24 ($12.97 in chips)
Seat 5: 533ec07e ($10.54 in chips)
Seat 6: a49b99da ($22.28 in chips)
Hero: posts small blind $0.05
9577cf26: posts big blind $0.1
*** HOLE CARDS ***
Dealt to 8c9d64e1 
Dealt to Hero [5h 3h]
Dealt to 9577cf26 
Dealt to 7e209a24 
Dealt to 533ec07e 
Dealt to a49b99da 
7e209a24: folds
533ec07e: folds
a49b99da: raises $0.12 to $0.22
8c9d64e1: folds
Hero: folds
9577cf26: raises $0.88 to $1.1
a49b99da: folds
Uncalled bet ($0.88) returned to 9577cf26
*** SHOWDOWN ***
9577cf26 collected $0.47 from pot
*** SUMMARY ***
Total pot $0.49 | Rake $0.02 | Jackpot $0 | Bingo $0 | Fortune $0
Seat 1: 8c9d64e1 (button) folded before Flop (didn't bet)
Seat 2: Hero (small blind) folded before Flop
Seat 3: 9577cf26 (big blind) collected ($0.47)
Seat 4: 7e209a24 folded before Flop (didn't bet)
Seat 5: 533ec07e folded before Flop (didn't bet)
Seat 6: a49b99da folded before Flop


Poker Hand #RC1468276296: Hold'em No Limit  ($0.05/$0.1) - 2023/04/12 18:14:56
Table 'RushAndCash5591556' 6-max Seat #1 is the button
Seat 1: f95f3ec6 ($11.32 in chips)
Seat 2: 533ec07e ($10.59 in chips)
Seat 3: Hero ($10 in chips)
Seat 4: bb03a8cb ($19.45 in chips)
Seat 5: 27b47572 ($17.4 in chips)
Seat 6: 9f9bac42 ($9.33 in chips)
533ec07e: posts small blind $0.05
Hero: posts big blind $0.1
*** HOLE CARDS ***
Dealt to f95f3ec6 
Dealt to 533ec07e 
Dealt to Hero [2c 3s]
Dealt to bb03a8cb 
Dealt to 27b47572 
Dealt to 9f9bac42 
bb03a8cb: folds
27b47572: folds
9f9bac42: folds
f95f3ec6: folds
533ec07e: folds
Uncalled bet ($0.05) returned to Hero
*** SHOWDOWN ***
Hero collected $0.1 from pot
*** SUMMARY ***
Total pot $0.1 | Rake $0 | Jackpot $0 | Bingo $0 | Fortune $0
Seat 1: f95f3ec6 (button) folded before Flop (didn't bet)
Seat 2: 533ec07e (small blind) folded before Flop
Seat 3: Hero (big blind) collected ($0.1)
Seat 4: bb03a8cb folded before Flop (didn't bet)
Seat 5: 27b47572 folded before Flop (didn't bet)
Seat 6: 9f9bac42 folded before Flop (didn't bet)


