Poker Hand #RC1450379526: Hold'em No Limit  ($0.05/$0.1) - 2023/04/04 14:51:39
Table 'RushAndCash1754786' 6-max Seat #1 is the button
Seat 1: 52909264 ($11.13 in chips)
Seat 2: Hero ($23.33 in chips)
Seat 3: 5513bfa4 ($16.68 in chips)
Seat 4: f57683b7 ($19.89 in chips)
Seat 5: 780de5fe ($11.97 in chips)
Seat 6: 8205b559 ($10.4 in chips)
Hero: posts small blind $0.05
5513bfa4: posts big blind $0.1
*** HOLE CARDS ***
Dealt to 52909264 
Dealt to Hero [2s 4d]
Dealt to 5513bfa4 
Dealt to f57683b7 
Dealt to 780de5fe 
Dealt to 8205b559 
f57683b7: folds
780de5fe: folds
8205b559: raises $0.15 to $0.25
52909264: calls $0.25
Hero: folds
5513bfa4: folds
*** FLOP *** [7h Jd 5h]
8205b559: checks
52909264: bets $0.4
8205b559: folds
Uncalled bet ($0.4) returned to 52909264
*** SHOWDOWN ***
52909264 collected $0.62 from pot
*** SUMMARY ***
Total pot $0.65 | Rake $0.03 | Jackpot $0 | Bingo $0 | Fortune $0
Board [7h Jd 5h]
Seat 1: 52909264 (button) won ($0.62)
Seat 2: Hero (small blind) folded before Flop
Seat 3: 5513bfa4 (big blind) folded before Flop
Seat 4: f57683b7 folded before Flop (didn't bet)
Seat 5: 780de5fe folded before Flop (didn't bet)
Seat 6: 8205b559 folded on the Flop


Poker Hand #RC1450379407: Hold'em No Limit  ($0.05/$0.1) - 2023/04/04 14:51:20
Table 'RushAndCash1754667' 6-max Seat #1 is the button
Seat 1: 643daeff ($10.1 in chips)
Seat 2: 68c8bbb ($13.78 in chips)
Seat 3: Hero ($23.43 in chips)
Seat 4: 1866d954 ($10.86 in chips)
Seat 5: f321e6eb ($11.77 in chips)
Seat 6: 9854c1ea ($9.79 in chips)
68c8bbb: posts small blind $0.05
Hero: posts big blind $0.1
*** HOLE CARDS ***
Dealt to 643daeff 
Dealt to 68c8bbb 
Dealt to Hero [5c Qh]
Dealt to 1866d954 
Dealt to f321e6eb 
Dealt to 9854c1ea 
1866d954: raises $0.2 to $0.3
f321e6eb: folds
9854c1ea: raises $0.6 to $0.9
643daeff: folds
68c8bbb: folds
Hero: folds
1866d954: folds
Uncalled bet ($0.6) returned to 9854c1ea
*** SHOWDOWN ***
9854c1ea collected $0.72 from pot
*** SUMMARY ***
Total pot $0.75 | Rake $0.03 | Jackpot $0 | Bingo $0 | Fortune $0
Seat 1: 643daeff (button) folded before Flop (didn't bet)
Seat 2: 68c8bbb (small blind) folded before Flop
Seat 3: Hero (big blind) folded before Flop
Seat 4: 1866d954 folded before Flop
Seat 5: f321e6eb folded before Flop (didn't bet)
Seat 6: 9854c1ea collected ($0.72)


Poker Hand #RC1450379220: Hold'em No Limit  ($0.05/$0.1) - 2023/04/04 14:50:53
Table 'RushAndCash1754480' 6-max Seat #1 is the button
Seat 1: 727d212d ($5.8 in chips)
Seat 2: 818830c3 ($10 in chips)
Seat 3: e8ae3c9 ($11.66 in chips)
Seat 4: Hero ($23.68 in chips)
Seat 5: ecbc5035 ($11.64 in chips)
Seat 6: a2e80610 ($23.66 in chips)
818830c3: posts small blind $0.05
e8ae3c9: posts big blind $0.1
*** HOLE CARDS ***
Dealt to 727d212d 
Dealt to 818830c3 
Dealt to e8ae3c9 
Dealt to Hero [Ks Qh]
Dealt to ecbc5035 
Dealt to a2e80610 
Hero: raises $0.15 to $0.25
ecbc5035: folds
a2e80610: folds
727d212d: calls $0.25
818830c3: raises $1.05 to $1.3
e8ae3c9: folds
Hero: folds
727d212d: folds
Uncalled bet ($1.05) returned to 818830c3
*** SHOWDOWN ***
818830c3 collected $0.81 from pot
*** SUMMARY ***
Total pot $0.85 | Rake $0.04 | Jackpot $0 | Bingo $0 | Fortune $0
Seat 1: 727d212d (button) folded before Flop
Seat 2: 818830c3 (small blind) collected ($0.81)
Seat 3: e8ae3c9 (big blind) folded before Flop
Seat 4: Hero folded before Flop
Seat 5: ecbc5035 folded before Flop (didn't bet)
Seat 6: a2e80610 folded before Flop (didn't bet)


Poker Hand #RC1450379126: Hold'em No Limit  ($0.05/$0.1) - 2023/04/04 14:50:40
Table 'RushAndCash1754386' 6-max Seat #1 is the button
Seat 1: 1da34acd ($15.74 in chips)
Seat 2: 2fd774d9 ($10.05 in chips)
Seat 3: 1ccd95b5 ($4.35 in chips)
Seat 4: be44eaa6 ($10.33 in chips)
Seat 5: Hero ($23.53 in chips)
Seat 6: 28ed879f ($30.58 in chips)
2fd774d9: posts small blind $0.05
1ccd95b5: posts big blind $0.1
*** HOLE CARDS ***
Dealt to 1da34acd 
Dealt to 2fd774d9 
Dealt to 1ccd95b5 
Dealt to be44eaa6 
Dealt to Hero [Jc Kd]
Dealt to 28ed879f 
be44eaa6: folds
Hero: raises $0.15 to $0.25
28ed879f: folds
1da34acd: folds
2fd774d9: folds
1ccd95b5: folds
Uncalled bet ($0.15) returned to Hero
*** SHOWDOWN ***
Hero collected $0.25 from pot
*** SUMMARY ***
Total pot $0.25 | Rake $0 | Jackpot $0 | Bingo $0 | Fortune $0
Seat 1: 1da34acd (button) folded before Flop (didn't bet)
Seat 2: 2fd774d9 (small blind) folded before Flop
Seat 3: 1ccd95b5 (big blind) folded before Flop
Seat 4: be44eaa6 folded before Flop (didn't bet)
Seat 5: Hero collected ($0.25)
Seat 6: 28ed879f folded before Flop (didn't bet)


Poker Hand #RC1450378907: Hold'em No Limit  ($0.05/$0.1) - 2023/04/04 14:50:12
Table 'RushAndCash1754167' 6-max Seat #1 is the button
Seat 1: c881b007 ($8.5 in chips)
Seat 2: 28ed879f ($30.26 in chips)
Seat 3: fb9b516b ($17.25 in chips)
Seat 4: d0a1549 ($10.05 in chips)
Seat 5: Hero ($23.78 in chips)
Seat 6: ec19b48e ($9.8 in chips)
28ed879f: posts small blind $0.05
fb9b516b: posts big blind $0.1
*** HOLE CARDS ***
Dealt to c881b007 
Dealt to 28ed879f 
Dealt to fb9b516b 
Dealt to d0a1549 
Dealt to Hero [Qc Jh]
Dealt to ec19b48e 
d0a1549: folds
Hero: raises $0.15 to $0.25
ec19b48e: folds
c881b007: folds
28ed879f: raises $0.85 to $1.1
fb9b516b: folds
Hero: folds
Uncalled bet ($0.85) returned to 28ed879f
*** SHOWDOWN ***
28ed879f collected $0.57 from pot
*** SUMMARY ***
Total pot $0.6 | Rake $0.03 | Jackpot $0 | Bingo $0 | Fortune $0
Seat 1: c881b007 (button) folded before Flop (didn't bet)
Seat 2: 28ed879f (small blind) collected ($0.57)
Seat 3: fb9b516b (big blind) folded before Flop
Seat 4: d0a1549 folded before Flop (didn't bet)
Seat 5: Hero folded before Flop
Seat 6: ec19b48e folded before Flop (didn't bet)


Poker Hand #RC1450378771: Hold'em No Limit  ($0.05/$0.1) - 2023/04/04 14:49:51
Table 'RushAndCash1754031' 6-max Seat #1 is the button
Seat 1: Hero ($23.63 in chips)
Seat 2: a1f075c9 ($11.15 in chips)
Seat 3: 57e952c2 ($33.09 in chips)
Seat 4: 8b95c921 ($10 in chips)
Seat 5: d38e0934 ($28.12 in chips)
Seat 6: 583ead96 ($11.06 in chips)
a1f075c9: posts small blind $0.05
57e952c2: posts big blind $0.1
*** HOLE CARDS ***
Dealt to Hero [Ac 8d]
Dealt to a1f075c9 
Dealt to 57e952c2 
Dealt to 8b95c921 
Dealt to d38e0934 
Dealt to 583ead96 
8b95c921: folds
d38e0934: folds
583ead96: folds
Hero: raises $0.15 to $0.25
a1f075c9: folds
57e952c2: folds
Uncalled bet ($0.15) returned to Hero
*** SHOWDOWN ***
Hero collected $0.25 from pot
*** SUMMARY ***
Total pot $0.25 | Rake $0 | Jackpot $0 | Bingo $0 | Fortune $0
Seat 1: Hero (button) collected ($0.25)
Seat 2: a1f075c9 (small blind) folded before Flop
Seat 3: 57e952c2 (big blind) folded before Flop
Seat 4: 8b95c921 folded before Flop (didn't bet)
Seat 5: d38e0934 folded before Flop (didn't bet)
Seat 6: 583ead96 folded before Flop (didn't bet)


Poker Hand #RC1450378743: Hold'em No Limit  ($0.05/$0.1) - 2023/04/04 14:49:48
Table 'RushAndCash1754003' 6-max Seat #1 is the button
Seat 1: c7ae08ec ($19.58 in chips)
Seat 2: 49db3fd7 ($15.46 in chips)
Seat 3: 804a5af4 ($10.43 in chips)
Seat 4: Hero ($23.63 in chips)
Seat 5: eb101c52 ($10.37 in chips)
Seat 6: 5e46a96d ($37.15 in chips)
49db3fd7: posts small blind $0.05
804a5af4: posts big blind $0.1
*** HOLE CARDS ***
Dealt to c7ae08ec 
Dealt to 49db3fd7 
Dealt to 804a5af4 
Dealt to Hero [2h Js]
Dealt to eb101c52 
Dealt to 5e46a96d 
Hero: folds
eb101c52: raises $0.13 to $0.23
5e46a96d: calls $0.23
c7ae08ec: folds
49db3fd7: folds
804a5af4: folds
*** FLOP *** [Qs Th 3d]
eb101c52: bets $0.3
5e46a96d: calls $0.3
*** TURN *** [Qs Th 3d] [Qc]
eb101c52: checks
5e46a96d: bets $0.91
eb101c52: folds
Uncalled bet ($0.91) returned to 5e46a96d
*** SHOWDOWN ***
5e46a96d collected $1.15 from pot
*** SUMMARY ***
Total pot $1.21 | Rake $0.06 | Jackpot $0 | Bingo $0 | Fortune $0
Board [Qs Th 3d Qc]
Seat 1: c7ae08ec (button) folded before Flop (didn't bet)
Seat 2: 49db3fd7 (small blind) folded before Flop
Seat 3: 804a5af4 (big blind) folded before Flop
Seat 4: Hero folded before Flop (didn't bet)
Seat 5: eb101c52 folded on the Turn
Seat 6: 5e46a96d won ($1.15)


Poker Hand #RC1450378642: Hold'em No Limit  ($0.05/$0.1) - 2023/04/04 14:49:34
Table 'RushAndCash1753902' 6-max Seat #1 is the button
Seat 1: b610b4ff ($10.01 in chips)
Seat 2: Hero ($23.53 in chips)
Seat 3: 4d66519d ($10.51 in chips)
Seat 4: ec6bfae0 ($24.02 in chips)
Seat 5: 86024cf7 ($10 in chips)
Seat 6: 9680503a ($10.84 in chips)
Hero: posts small blind $0.05
4d66519d: posts big blind $0.1
*** HOLE CARDS ***
Dealt to b610b4ff 
Dealt to Hero [7c 6h]
Dealt to 4d66519d 
Dealt to ec6bfae0 
Dealt to 86024cf7 
Dealt to 9680503a 
ec6bfae0: folds
86024cf7: folds
9680503a: folds
b610b4ff: folds
Hero: raises $0.2 to $0.3
4d66519d: folds
Uncalled bet ($0.2) returned to Hero
*** SHOWDOWN ***
Hero collected $0.2 from pot
*** SUMMARY ***
Total pot $0.2 | Rake $0 | Jackpot $0 | Bingo $0 | Fortune $0
Seat 1: b610b4ff (button) folded before Flop (didn't bet)
Seat 2: Hero (small blind) collected ($0.2)
Seat 3: 4d66519d (big blind) folded before Flop
Seat 4: ec6bfae0 folded before Flop (didn't bet)
Seat 5: 86024cf7 folded before Flop (didn't bet)
Seat 6: 9680503a folded before Flop (didn't bet)


Poker Hand #RC1450378614: Hold'em No Limit  ($0.05/$0.1) - 2023/04/04 14:49:30
Table 'RushAndCash1753874' 6-max Seat #1 is the button
Seat 1: 8f6afbfd ($10 in chips)
Seat 2: b610b4ff ($10.06 in chips)
Seat 3: Hero ($23.63 in chips)
Seat 4: 38f92473 ($20.91 in chips)
Seat 5: ddcf6ea7 ($8.77 in chips)
Seat 6: 784fb968 ($10.51 in chips)
b610b4ff: posts small blind $0.05
Hero: posts big blind $0.1
*** HOLE CARDS ***
Dealt to 8f6afbfd 
Dealt to b610b4ff 
Dealt to Hero [2h 3s]
Dealt to 38f92473 
Dealt to ddcf6ea7 
Dealt to 784fb968 
38f92473: folds
ddcf6ea7: folds
784fb968: folds
8f6afbfd: raises $0.13 to $0.23
b610b4ff: folds
Hero: folds
Uncalled bet ($0.13) returned to 8f6afbfd
*** SHOWDOWN ***
8f6afbfd collected $0.25 from pot
*** SUMMARY ***
Total pot $0.25 | Rake $0 | Jackpot $0 | Bingo $0 | Fortune $0
Seat 1: 8f6afbfd (button) collected ($0.25)
Seat 2: b610b4ff (small blind) folded before Flop
Seat 3: Hero (big blind) folded before Flop
Seat 4: 38f92473 folded before Flop (didn't bet)
Seat 5: ddcf6ea7 folded before Flop (didn't bet)
Seat 6: 784fb968 folded before Flop (didn't bet)


Poker Hand #RC1450378549: Hold'em No Limit  ($0.05/$0.1) - 2023/04/04 14:49:21
Table 'RushAndCash1753809' 6-max Seat #1 is the button
Seat 1: Hero ($23.63 in chips)
Seat 2: 483f65b3 ($11.79 in chips)
Seat 3: 993c5684 ($10.15 in chips)
Seat 4: 49bf5312 ($15.15 in chips)
Seat 5: 6fa93048 ($19.81 in chips)
Seat 6: 15d76cd1 ($10.15 in chips)
483f65b3: posts small blind $0.05
993c5684: posts big blind $0.1
*** HOLE CARDS ***
Dealt to Hero [5h Jd]
Dealt to 483f65b3 
Dealt to 993c5684 
Dealt to 49bf5312 
Dealt to 6fa93048 
Dealt to 15d76cd1 
49bf5312: raises $0.1 to $0.2
6fa93048: folds
15d76cd1: folds
Hero: folds
483f65b3: folds
993c5684: calls $0.1
*** FLOP *** [3d 8d As]
993c5684: checks
49bf5312: checks
*** TURN *** [3d 8d As] [7c]
993c5684: checks
49bf5312: bets $0.34
993c5684: folds
Uncalled bet ($0.34) returned to 49bf5312
*** SHOWDOWN ***
49bf5312 collected $0.43 from pot
*** SUMMARY ***
Total pot $0.45 | Rake $0.02 | Jackpot $0 | Bingo $0 | Fortune $0
Board [3d 8d As 7c]
Seat 1: Hero (button) folded before Flop (didn't bet)
Seat 2: 483f65b3 (small blind) folded before Flop
Seat 3: 993c5684 (big blind) folded on the Turn
Seat 4: 49bf5312 won ($0.43)
Seat 5: 6fa93048 folded before Flop (didn't bet)
Seat 6: 15d76cd1 folded before Flop (didn't bet)


Poker Hand #RC1450378516: Hold'em No Limit  ($0.05/$0.1) - 2023/04/04 14:49:17
Table 'RushAndCash1753776' 6-max Seat #1 is the button
Seat 1: 3c526892 ($14.6 in chips)
Seat 2: 217d5a2 ($10.79 in chips)
Seat 3: 2465da3d ($10 in chips)
Seat 4: c7ae08ec ($19.73 in chips)
Seat 5: Hero ($23.63 in chips)
Seat 6: 291cb632 ($8.6 in chips)
217d5a2: posts small blind $0.05
2465da3d: posts big blind $0.1
*** HOLE CARDS ***
Dealt to 3c526892 
Dealt to 217d5a2 
Dealt to 2465da3d 
Dealt to c7ae08ec 
Dealt to Hero [8h 3c]
Dealt to 291cb632 
c7ae08ec: folds
Hero: folds
291cb632: folds
3c526892: raises $0.12 to $0.22
217d5a2: folds
2465da3d: folds
Uncalled bet ($0.12) returned to 3c526892
*** SHOWDOWN ***
3c526892 collected $0.25 from pot
*** SUMMARY ***
Total pot $0.25 | Rake $0 | Jackpot $0 | Bingo $0 | Fortune $0
Seat 1: 3c526892 (button) collected ($0.25)
Seat 2: 217d5a2 (small blind) folded before Flop
Seat 3: 2465da3d (big blind) folded before Flop
Seat 4: c7ae08ec folded before Flop (didn't bet)
Seat 5: Hero folded before Flop (didn't bet)
Seat 6: 291cb632 folded before Flop (didn't bet)


Poker Hand #RC1450378460: Hold'em No Limit  ($0.05/$0.1) - 2023/04/04 14:49:08
Table 'RushAndCash1753720' 6-max Seat #1 is the button
Seat 1: c8e0106 ($9.44 in chips)
Seat 2: bc9ef348 ($28.34 in chips)
Seat 3: f321e6eb ($10.15 in chips)
Seat 4: cb6740ba ($10.28 in chips)
Seat 5: Hero ($23.63 in chips)
Seat 6: 11ae0d2a ($16.63 in chips)
bc9ef348: posts small blind $0.05
f321e6eb: posts big blind $0.1
*** HOLE CARDS ***
Dealt to c8e0106 
Dealt to bc9ef348 
Dealt to f321e6eb 
Dealt to cb6740ba 
Dealt to Hero [Qh Td]
Dealt to 11ae0d2a 
cb6740ba: folds
Hero: folds
11ae0d2a: folds
c8e0106: folds
bc9ef348: folds
Uncalled bet ($0.05) returned to f321e6eb
*** SHOWDOWN ***
f321e6eb collected $0.1 from pot
*** SUMMARY ***
Total pot $0.1 | Rake $0 | Jackpot $0 | Bingo $0 | Fortune $0
Seat 1: c8e0106 (button) folded before Flop (didn't bet)
Seat 2: bc9ef348 (small blind) folded before Flop
Seat 3: f321e6eb (big blind) collected ($0.1)
Seat 4: cb6740ba folded before Flop (didn't bet)
Seat 5: Hero folded before Flop (didn't bet)
Seat 6: 11ae0d2a folded before Flop (didn't bet)


Poker Hand #RC1450378207: Hold'em No Limit  ($0.05/$0.1) - 2023/04/04 14:48:32
Table 'RushAndCash1753467' 6-max Seat #1 is the button
Seat 1: 3cfedddd ($12.51 in chips)
Seat 2: d74e30f2 ($29.5 in chips)
Seat 3: 758c4283 ($58.2 in chips)
Seat 4: c8e0106 ($9.64 in chips)
Seat 5: Hero ($23.3 in chips)
Seat 6: 512454f2 ($9.17 in chips)
d74e30f2: posts small blind $0.05
758c4283: posts big blind $0.1
*** HOLE CARDS ***
Dealt to 3cfedddd 
Dealt to d74e30f2 
Dealt to 758c4283 
Dealt to c8e0106 
Dealt to Hero [8c 9c]
Dealt to 512454f2 
c8e0106: raises $0.1 to $0.2
Hero: calls $0.2
512454f2: folds
3cfedddd: folds
d74e30f2: folds
758c4283: folds
*** FLOP *** [9s 8h 6h]
c8e0106: checks
Hero: bets $0.28
c8e0106: folds
Uncalled bet ($0.28) returned to Hero
*** SHOWDOWN ***
Hero collected $0.53 from pot
*** SUMMARY ***
Total pot $0.55 | Rake $0.02 | Jackpot $0 | Bingo $0 | Fortune $0
Board [9s 8h 6h]
Seat 1: 3cfedddd (button) folded before Flop (didn't bet)
Seat 2: d74e30f2 (small blind) folded before Flop
Seat 3: 758c4283 (big blind) folded before Flop
Seat 4: c8e0106 folded on the Flop
Seat 5: Hero won ($0.53)
Seat 6: 512454f2 folded before Flop (didn't bet)


Poker Hand #RC1450378170: Hold'em No Limit  ($0.05/$0.1) - 2023/04/04 14:48:27
Table 'RushAndCash1753430' 6-max Seat #1 is the button
Seat 1: ee3b6612 ($11.45 in chips)
Seat 2: d45f12df ($12.01 in chips)
Seat 3: fdfa6ed9 ($10.28 in chips)
Seat 4: 48e8cf66 ($10.65 in chips)
Seat 5: Hero ($23.3 in chips)
Seat 6: 7bcb6d06 ($10.3 in chips)
d45f12df: posts small blind $0.05
fdfa6ed9: posts big blind $0.1
*** HOLE CARDS ***
Dealt to ee3b6612 
Dealt to d45f12df 
Dealt to fdfa6ed9 
Dealt to 48e8cf66 
Dealt to Hero [9h 2c]
Dealt to 7bcb6d06 
48e8cf66: folds
Hero: folds
7bcb6d06: folds
ee3b6612: folds
d45f12df: folds
Uncalled bet ($0.05) returned to fdfa6ed9
*** SHOWDOWN ***
fdfa6ed9 collected $0.1 from pot
*** SUMMARY ***
Total pot $0.1 | Rake $0 | Jackpot $0 | Bingo $0 | Fortune $0
Seat 1: ee3b6612 (button) folded before Flop (didn't bet)
Seat 2: d45f12df (small blind) folded before Flop
Seat 3: fdfa6ed9 (big blind) collected ($0.1)
Seat 4: 48e8cf66 folded before Flop (didn't bet)
Seat 5: Hero folded before Flop (didn't bet)
Seat 6: 7bcb6d06 folded before Flop (didn't bet)


Poker Hand #RC1450378083: Hold'em No Limit  ($0.05/$0.1) - 2023/04/04 14:48:15
Table 'RushAndCash1753343' 6-max Seat #1 is the button
Seat 1: 581ed5d3 ($9.85 in chips)
Seat 2: fc84db1c ($13.29 in chips)
Seat 3: Hero ($23.4 in chips)
Seat 4: 57c9a64a ($10.58 in chips)
Seat 5: e3047465 ($15.3 in chips)
Seat 6: 9f197db6 ($11.2 in chips)
fc84db1c: posts small blind $0.05
Hero: posts big blind $0.1
*** HOLE CARDS ***
Dealt to 581ed5d3 
Dealt to fc84db1c 
Dealt to Hero [Ts 8s]
Dealt to 57c9a64a 
Dealt to e3047465 
Dealt to 9f197db6 
57c9a64a: folds
e3047465: folds
9f197db6: raises $0.15 to $0.25
581ed5d3: folds
fc84db1c: folds
Hero: folds
Uncalled bet ($0.15) returned to 9f197db6
*** SHOWDOWN ***
9f197db6 collected $0.25 from pot
*** SUMMARY ***
Total pot $0.25 | Rake $0 | Jackpot $0 | Bingo $0 | Fortune $0
Seat 1: 581ed5d3 (button) folded before Flop (didn't bet)
Seat 2: fc84db1c (small blind) folded before Flop
Seat 3: Hero (big blind) folded before Flop
Seat 4: 57c9a64a folded before Flop (didn't bet)
Seat 5: e3047465 folded before Flop (didn't bet)
Seat 6: 9f197db6 collected ($0.25)


Poker Hand #RC1450378005: Hold'em No Limit  ($0.05/$0.1) - 2023/04/04 14:48:05
Table 'RushAndCash1753265' 6-max Seat #1 is the button
Seat 1: 566fa0b8 ($8.49 in chips)
Seat 2: f9512238 ($10.2 in chips)
Seat 3: 6ea383f5 ($8.28 in chips)
Seat 4: 50e63ec5 ($10.15 in chips)
Seat 5: 741f86e ($27.62 in chips)
Seat 6: Hero ($23.25 in chips)
f9512238: posts small blind $0.05
6ea383f5: posts big blind $0.1
*** HOLE CARDS ***
Dealt to 566fa0b8 
Dealt to f9512238 
Dealt to 6ea383f5 
Dealt to 50e63ec5 
Dealt to 741f86e 
Dealt to Hero [Ah Kh]
50e63ec5: folds
741f86e: folds
Hero: raises $0.15 to $0.25
566fa0b8: folds
f9512238: folds
6ea383f5: folds
Uncalled bet ($0.15) returned to Hero
*** SHOWDOWN ***
Hero collected $0.25 from pot
*** SUMMARY ***
Total pot $0.25 | Rake $0 | Jackpot $0 | Bingo $0 | Fortune $0
Seat 1: 566fa0b8 (button) folded before Flop (didn't bet)
Seat 2: f9512238 (small blind) folded before Flop
Seat 3: 6ea383f5 (big blind) folded before Flop
Seat 4: 50e63ec5 folded before Flop (didn't bet)
Seat 5: 741f86e folded before Flop (didn't bet)
Seat 6: Hero collected ($0.25)


Poker Hand #RC1450377967: Hold'em No Limit  ($0.05/$0.1) - 2023/04/04 14:48:00
Table 'RushAndCash1753227' 6-max Seat #1 is the button
Seat 1: Hero ($23.25 in chips)
Seat 2: c2f174d4 ($16.7 in chips)
Seat 3: a57b416d ($11.82 in chips)
Seat 4: 1b78e29b ($10.05 in chips)
Seat 5: bc701a91 ($16.74 in chips)
Seat 6: 4e476148 ($21.53 in chips)
c2f174d4: posts small blind $0.05
a57b416d: posts big blind $0.1
*** HOLE CARDS ***
Dealt to Hero [6c 7s]
Dealt to c2f174d4 
Dealt to a57b416d 
Dealt to 1b78e29b 
Dealt to bc701a91 
Dealt to 4e476148 
1b78e29b: raises $0.15 to $0.25
bc701a91: folds
4e476148: folds
Hero: folds
c2f174d4: folds
a57b416d: calls $0.15
*** FLOP *** [9s Th 5s]
a57b416d: checks
1b78e29b: bets $0.38
a57b416d: calls $0.38
*** TURN *** [9s Th 5s] [Ts]
a57b416d: checks
1b78e29b: bets $0.9
a57b416d: folds
Uncalled bet ($0.9) returned to 1b78e29b
*** SHOWDOWN ***
1b78e29b collected $1.25 from pot
*** SUMMARY ***
Total pot $1.31 | Rake $0.06 | Jackpot $0 | Bingo $0 | Fortune $0
Board [9s Th 5s Ts]
Seat 1: Hero (button) folded before Flop (didn't bet)
Seat 2: c2f174d4 (small blind) folded before Flop
Seat 3: a57b416d (big blind) folded on the Turn
Seat 4: 1b78e29b won ($1.25)
Seat 5: bc701a91 folded before Flop (didn't bet)
Seat 6: 4e476148 folded before Flop (didn't bet)


Poker Hand #RC1450377919: Hold'em No Limit  ($0.05/$0.1) - 2023/04/04 14:47:53
Table 'RushAndCash1753179' 6-max Seat #1 is the button
Seat 1: 4eb6fbce ($7.67 in chips)
Seat 2: Hero ($23.3 in chips)
Seat 3: f3f3cbf1 ($10.32 in chips)
Seat 4: dc696855 ($3.22 in chips)
Seat 5: 20e8a68f ($12.41 in chips)
Seat 6: c69b92b ($10.38 in chips)
Hero: posts small blind $0.05
f3f3cbf1: posts big blind $0.1
*** HOLE CARDS ***
Dealt to 4eb6fbce 
Dealt to Hero [6h 4d]
Dealt to f3f3cbf1 
Dealt to dc696855 
Dealt to 20e8a68f 
Dealt to c69b92b 
dc696855: folds
20e8a68f: raises $0.12 to $0.22
c69b92b: folds
4eb6fbce: folds
Hero: folds
f3f3cbf1: calls $0.12
*** FLOP *** [Ad Jd 9c]
f3f3cbf1: checks
20e8a68f: bets $0.35
f3f3cbf1: folds
Uncalled bet ($0.35) returned to 20e8a68f
*** SHOWDOWN ***
20e8a68f collected $0.47 from pot
*** SUMMARY ***
Total pot $0.49 | Rake $0.02 | Jackpot $0 | Bingo $0 | Fortune $0
Board [Ad Jd 9c]
Seat 1: 4eb6fbce (button) folded before Flop (didn't bet)
Seat 2: Hero (small blind) folded before Flop
Seat 3: f3f3cbf1 (big blind) folded on the Flop
Seat 4: dc696855 folded before Flop (didn't bet)
Seat 5: 20e8a68f won ($0.47)
Seat 6: c69b92b folded before Flop (didn't bet)


Poker Hand #RC1450377867: Hold'em No Limit  ($0.05/$0.1) - 2023/04/04 14:47:46
Table 'RushAndCash1753127' 6-max Seat #1 is the button
Seat 1: 193814d4 ($9.31 in chips)
Seat 2: 217d5a2 ($11.29 in chips)
Seat 3: d7352f68 ($3.71 in chips)
Seat 4: df711b8c ($17.42 in chips)
Seat 5: ff162dd9 ($10.75 in chips)
Seat 6: Hero ($23.3 in chips)
217d5a2: posts small blind $0.05
d7352f68: posts big blind $0.1
*** HOLE CARDS ***
Dealt to 193814d4 
Dealt to 217d5a2 
Dealt to d7352f68 
Dealt to df711b8c 
Dealt to ff162dd9 
Dealt to Hero [Tc 7h]
df711b8c: folds
ff162dd9: folds
Hero: folds
193814d4: folds
217d5a2: folds
Uncalled bet ($0.05) returned to d7352f68
*** SHOWDOWN ***
d7352f68 collected $0.1 from pot
*** SUMMARY ***
Total pot $0.1 | Rake $0 | Jackpot $0 | Bingo $0 | Fortune $0
Seat 1: 193814d4 (button) folded before Flop (didn't bet)
Seat 2: 217d5a2 (small blind) folded before Flop
Seat 3: d7352f68 (big blind) collected ($0.1)
Seat 4: df711b8c folded before Flop (didn't bet)
Seat 5: ff162dd9 folded before Flop (didn't bet)
Seat 6: Hero folded before Flop (didn't bet)


Poker Hand #RC1450377805: Hold'em No Limit  ($0.05/$0.1) - 2023/04/04 14:47:38
Table 'RushAndCash1753065' 6-max Seat #1 is the button
Seat 1: 7f6021e7 ($25.16 in chips)
Seat 2: 20207f05 ($12.46 in chips)
Seat 3: 8f6afbfd ($10.18 in chips)
Seat 4: 8950a390 ($11.87 in chips)
Seat 5: a0aeb849 ($10.97 in chips)
Seat 6: Hero ($23.3 in chips)
20207f05: posts small blind $0.05
8f6afbfd: posts big blind $0.1
*** HOLE CARDS ***
Dealt to 7f6021e7 
Dealt to 20207f05 
Dealt to 8f6afbfd 
Dealt to 8950a390 
Dealt to a0aeb849 
Dealt to Hero [Jc 9s]
8950a390: folds
a0aeb849: folds
Hero: folds
7f6021e7: raises $0.15 to $0.25
20207f05: folds
8f6afbfd: folds
Uncalled bet ($0.15) returned to 7f6021e7
*** SHOWDOWN ***
7f6021e7 collected $0.25 from pot
*** SUMMARY ***
Total pot $0.25 | Rake $0 | Jackpot $0 | Bingo $0 | Fortune $0
Seat 1: 7f6021e7 (button) collected ($0.25)
Seat 2: 20207f05 (small blind) folded before Flop
Seat 3: 8f6afbfd (big blind) folded before Flop
Seat 4: 8950a390 folded before Flop (didn't bet)
Seat 5: a0aeb849 folded before Flop (didn't bet)
Seat 6: Hero folded before Flop (didn't bet)


Poker Hand #RC1450377727: Hold'em No Limit  ($0.05/$0.1) - 2023/04/04 14:47:26
Table 'RushAndCash1752987' 6-max Seat #1 is the button
Seat 1: e5034dea ($3.05 in chips)
Seat 2: Hero ($23.35 in chips)
Seat 3: f1057c61 ($8.06 in chips)
Seat 4: 291cb632 ($8.25 in chips)
Seat 5: 31e3dd17 ($10 in chips)
Seat 6: ec851339 ($15.2 in chips)
Hero: posts small blind $0.05
f1057c61: posts big blind $0.1
*** HOLE CARDS ***
Dealt to e5034dea 
Dealt to Hero [Ah 7s]
Dealt to f1057c61 
Dealt to 291cb632 
Dealt to 31e3dd17 
Dealt to ec851339 
291cb632: raises $0.2 to $0.3
31e3dd17: folds
ec851339: folds
e5034dea: calls $0.3
Hero: folds
f1057c61: folds
*** FLOP *** [Kh 2h Ad]
291cb632: checks
e5034dea: checks
*** TURN *** [Kh 2h Ad] [9d]
291cb632: checks
e5034dea: checks
*** RIVER *** [Kh 2h Ad 9d] [4d]
291cb632: bets $0.57
e5034dea: folds
Uncalled bet ($0.57) returned to 291cb632
*** SHOWDOWN ***
291cb632 collected $0.72 from pot
*** SUMMARY ***
Total pot $0.75 | Rake $0.03 | Jackpot $0 | Bingo $0 | Fortune $0
Board [Kh 2h Ad 9d 4d]
Seat 1: e5034dea (button) folded on the River
Seat 2: Hero (small blind) folded before Flop
Seat 3: f1057c61 (big blind) folded before Flop
Seat 4: 291cb632 won ($0.72)
Seat 5: 31e3dd17 folded before Flop (didn't bet)
Seat 6: ec851339 folded before Flop (didn't bet)


Poker Hand #RC1450377646: Hold'em No Limit  ($0.05/$0.1) - 2023/04/04 14:47:16
Table 'RushAndCash1752906' 6-max Seat #1 is the button
Seat 1: c69b92b ($10.23 in chips)
Seat 2: 7a4b5ba7 ($16.1 in chips)
Seat 3: Hero ($23.45 in chips)
Seat 4: 20207f05 ($12.31 in chips)
Seat 5: 627ce908 ($4.2 in chips)
Seat 6: 6fec5d5 ($11.39 in chips)
7a4b5ba7: posts small blind $0.05
Hero: posts big blind $0.1
*** HOLE CARDS ***
Dealt to c69b92b 
Dealt to 7a4b5ba7 
Dealt to Hero [9d 4c]
Dealt to 20207f05 
Dealt to 627ce908 
Dealt to 6fec5d5 
20207f05: folds
627ce908: raises $0.1 to $0.2
6fec5d5: calls $0.2
c69b92b: folds
7a4b5ba7: folds
Hero: folds
*** FLOP *** [Ad Th Jd]
627ce908: bets $0.28
6fec5d5: calls $0.28
*** TURN *** [Ad Th Jd] [9h]
627ce908: bets $1.11
6fec5d5: calls $1.11
*** RIVER *** [Ad Th Jd 9h] [8c]
627ce908: bets $2.61 and is all-in
6fec5d5: folds
Uncalled bet ($2.61) returned to 627ce908
*** SHOWDOWN ***
627ce908 collected $3.03 from pot
*** SUMMARY ***
Total pot $3.33 | Rake $0.15 | Jackpot $0.15 | Bingo $0 | Fortune $0
Board [Ad Th Jd 9h 8c]
Seat 1: c69b92b (button) folded before Flop (didn't bet)
Seat 2: 7a4b5ba7 (small blind) folded before Flop
Seat 3: Hero (big blind) folded before Flop
Seat 4: 20207f05 folded before Flop (didn't bet)
Seat 5: 627ce908 won ($3.03)
Seat 6: 6fec5d5 folded on the River


Poker Hand #RC1450377605: Hold'em No Limit  ($0.05/$0.1) - 2023/04/04 14:47:09
Table 'RushAndCash1752865' 6-max Seat #1 is the button
Seat 1: d19a8146 ($12.92 in chips)
Seat 2: df711b8c ($17.47 in chips)
Seat 3: 892df41c ($11.25 in chips)
Seat 4: 7b67d849 ($8.01 in chips)
Seat 5: 940344f3 ($18.83 in chips)
Seat 6: Hero ($23.45 in chips)
df711b8c: posts small blind $0.05
892df41c: posts big blind $0.1
*** HOLE CARDS ***
Dealt to d19a8146 
Dealt to df711b8c 
Dealt to 892df41c 
Dealt to 7b67d849 
Dealt to 940344f3 
Dealt to Hero [Qh 2h]
7b67d849: folds
940344f3: raises $0.15 to $0.25
Hero: folds
d19a8146: folds
df711b8c: folds
892df41c: calls $0.15
*** FLOP *** [3c 3s 2d]
892df41c: checks
940344f3: bets $0.35
892df41c: calls $0.35
*** TURN *** [3c 3s 2d] [9s]
892df41c: checks
940344f3: bets $0.94
892df41c: folds
Uncalled bet ($0.94) returned to 940344f3
*** SHOWDOWN ***
940344f3 collected $1.19 from pot
*** SUMMARY ***
Total pot $1.25 | Rake $0.06 | Jackpot $0 | Bingo $0 | Fortune $0
Board [3c 3s 2d 9s]
Seat 1: d19a8146 (button) folded before Flop (didn't bet)
Seat 2: df711b8c (small blind) folded before Flop
Seat 3: 892df41c (big blind) folded on the Turn
Seat 4: 7b67d849 folded before Flop (didn't bet)
Seat 5: 940344f3 won ($1.19)
Seat 6: Hero folded before Flop (didn't bet)


Poker Hand #RC1450377550: Hold'em No Limit  ($0.05/$0.1) - 2023/04/04 14:47:01
Table 'RushAndCash1752810' 6-max Seat #1 is the button
Seat 1: 58d0444f ($10.38 in chips)
Seat 2: a8ea8cad ($18.65 in chips)
Seat 3: cee00378 ($14.21 in chips)
Seat 4: e267d807 ($11.58 in chips)
Seat 5: Hero ($23.45 in chips)
Seat 6: fb7ce946 ($15.01 in chips)
a8ea8cad: posts small blind $0.05
cee00378: posts big blind $0.1
*** HOLE CARDS ***
Dealt to 58d0444f 
Dealt to a8ea8cad 
Dealt to cee00378 
Dealt to e267d807 
Dealt to Hero [8s 2c]
Dealt to fb7ce946 
e267d807: raises $0.1 to $0.2
Hero: folds
fb7ce946: calls $0.2
58d0444f: raises $0.85 to $1.05
a8ea8cad: folds
cee00378: folds
e267d807: calls $0.85
fb7ce946: folds
*** FLOP *** [7c 3d 2d]
e267d807: checks
58d0444f: bets $0.94
e267d807: calls $0.94
*** TURN *** [7c 3d 2d] [9s]
e267d807: checks
58d0444f: checks
*** RIVER *** [7c 3d 2d 9s] [6c]
e267d807: bets $1.43
58d0444f: folds
Uncalled bet ($1.43) returned to e267d807
*** SHOWDOWN ***
e267d807 collected $3.98 from pot
*** SUMMARY ***
Total pot $4.33 | Rake $0.2 | Jackpot $0.15 | Bingo $0 | Fortune $0
Board [7c 3d 2d 9s 6c]
Seat 1: 58d0444f (button) folded on the River
Seat 2: a8ea8cad (small blind) folded before Flop
Seat 3: cee00378 (big blind) folded before Flop
Seat 4: e267d807 won ($3.98)
Seat 5: Hero folded before Flop (didn't bet)
Seat 6: fb7ce946 folded before Flop


Poker Hand #RC1450377520: Hold'em No Limit  ($0.05/$0.1) - 2023/04/04 14:46:56
Table 'RushAndCash1752780' 6-max Seat #1 is the button
Seat 1: Hero ($23.45 in chips)
Seat 2: 31e3dd17 ($10 in chips)
Seat 3: 6b66106c ($12.79 in chips)
Seat 4: 741f86e ($28.07 in chips)
Seat 5: ddd94c0c ($26.53 in chips)
Seat 6: f20b2d13 ($6.9 in chips)
31e3dd17: posts small blind $0.05
6b66106c: posts big blind $0.1
*** HOLE CARDS ***
Dealt to Hero [4h 8c]
Dealt to 31e3dd17 
Dealt to 6b66106c 
Dealt to 741f86e 
Dealt to ddd94c0c 
Dealt to f20b2d13 
741f86e: raises $0.2 to $0.3
ddd94c0c: folds
f20b2d13: folds
Hero: folds
31e3dd17: folds
6b66106c: raises $0.9 to $1.2
741f86e: folds
Uncalled bet ($0.9) returned to 6b66106c
*** SHOWDOWN ***
6b66106c collected $0.62 from pot
*** SUMMARY ***
Total pot $0.65 | Rake $0.03 | Jackpot $0 | Bingo $0 | Fortune $0
Seat 1: Hero (button) folded before Flop (didn't bet)
Seat 2: 31e3dd17 (small blind) folded before Flop
Seat 3: 6b66106c (big blind) collected ($0.62)
Seat 4: 741f86e folded before Flop
Seat 5: ddd94c0c folded before Flop (didn't bet)
Seat 6: f20b2d13 folded before Flop (didn't bet)


Poker Hand #RC1450377434: Hold'em No Limit  ($0.05/$0.1) - 2023/04/04 14:46:43
Table 'RushAndCash1752694' 6-max Seat #1 is the button
Seat 1: 5b16ccb7 ($5.32 in chips)
Seat 2: 84aa1b77 ($15.75 in chips)
Seat 3: 3045dbe5 ($10.62 in chips)
Seat 4: a4e7cb4a ($20.95 in chips)
Seat 5: Hero ($23.45 in chips)
Seat 6: c3ddf73a ($11.92 in chips)
84aa1b77: posts small blind $0.05
3045dbe5: posts big blind $0.1
*** HOLE CARDS ***
Dealt to 5b16ccb7 
Dealt to 84aa1b77 
Dealt to 3045dbe5 
Dealt to a4e7cb4a 
Dealt to Hero [7s 6h]
Dealt to c3ddf73a 
a4e7cb4a: folds
Hero: folds
c3ddf73a: folds
5b16ccb7: folds
84aa1b77: folds
Uncalled bet ($0.05) returned to 3045dbe5
*** SHOWDOWN ***
3045dbe5 collected $0.1 from pot
*** SUMMARY ***
Total pot $0.1 | Rake $0 | Jackpot $0 | Bingo $0 | Fortune $0
Seat 1: 5b16ccb7 (button) folded before Flop (didn't bet)
Seat 2: 84aa1b77 (small blind) folded before Flop
Seat 3: 3045dbe5 (big blind) collected ($0.1)
Seat 4: a4e7cb4a folded before Flop (didn't bet)
Seat 5: Hero folded before Flop (didn't bet)
Seat 6: c3ddf73a folded before Flop (didn't bet)


Poker Hand #RC1450377314: Hold'em No Limit  ($0.05/$0.1) - 2023/04/04 14:46:26
Table 'RushAndCash1752574' 6-max Seat #1 is the button
Seat 1: c9ad33e9 ($6.97 in chips)
Seat 2: 5e46a96d ($41.44 in chips)
Seat 3: cce2256c ($11.73 in chips)
Seat 4: f93a571f ($16.61 in chips)
Seat 5: 394051de ($10.7 in chips)
Seat 6: Hero ($23.3 in chips)
5e46a96d: posts small blind $0.05
cce2256c: posts big blind $0.1
*** HOLE CARDS ***
Dealt to c9ad33e9 
Dealt to 5e46a96d 
Dealt to cce2256c 
Dealt to f93a571f 
Dealt to 394051de 
Dealt to Hero [8d 7d]
f93a571f: folds
394051de: folds
Hero: raises $0.15 to $0.25
c9ad33e9: folds
5e46a96d: folds
cce2256c: folds
Uncalled bet ($0.15) returned to Hero
*** SHOWDOWN ***
Hero collected $0.25 from pot
*** SUMMARY ***
Total pot $0.25 | Rake $0 | Jackpot $0 | Bingo $0 | Fortune $0
Seat 1: c9ad33e9 (button) folded before Flop (didn't bet)
Seat 2: 5e46a96d (small blind) folded before Flop
Seat 3: cce2256c (big blind) folded before Flop
Seat 4: f93a571f folded before Flop (didn't bet)
Seat 5: 394051de folded before Flop (didn't bet)
Seat 6: Hero collected ($0.25)


Poker Hand #RC1450377198: Hold'em No Limit  ($0.05/$0.1) - 2023/04/04 14:46:09
Table 'RushAndCash1752458' 6-max Seat #1 is the button
Seat 1: 20ee6254 ($55.79 in chips)
Seat 2: Hero ($23.35 in chips)
Seat 3: 83a3b3ab ($26.04 in chips)
Seat 4: ef943114 ($10 in chips)
Seat 5: 85a9f93e ($11.1 in chips)
Seat 6: 538c0372 ($10.39 in chips)
Hero: posts small blind $0.05
83a3b3ab: posts big blind $0.1
*** HOLE CARDS ***
Dealt to 20ee6254 
Dealt to Hero [8h Kc]
Dealt to 83a3b3ab 
Dealt to ef943114 
Dealt to 85a9f93e 
Dealt to 538c0372 
ef943114: folds
85a9f93e: folds
538c0372: folds
20ee6254: raises $0.1 to $0.2
Hero: folds
83a3b3ab: calls $0.1
*** FLOP *** [9d Ad Qd]
83a3b3ab: checks
20ee6254: bets $0.34
83a3b3ab: folds
Uncalled bet ($0.34) returned to 20ee6254
*** SHOWDOWN ***
20ee6254 collected $0.43 from pot
*** SUMMARY ***
Total pot $0.45 | Rake $0.02 | Jackpot $0 | Bingo $0 | Fortune $0
Board [9d Ad Qd]
Seat 1: 20ee6254 (button) won ($0.43)
Seat 2: Hero (small blind) folded before Flop
Seat 3: 83a3b3ab (big blind) folded on the Flop
Seat 4: ef943114 folded before Flop (didn't bet)
Seat 5: 85a9f93e folded before Flop (didn't bet)
Seat 6: 538c0372 folded before Flop (didn't bet)


Poker Hand #RC1450377034: Hold'em No Limit  ($0.05/$0.1) - 2023/04/04 14:45:46
Table 'RushAndCash1752294' 6-max Seat #1 is the button
Seat 1: a6735809 ($9.12 in chips)
Seat 2: 7bed5d55 ($18.98 in chips)
Seat 3: Hero ($23.45 in chips)
Seat 4: ab80b11a ($11.9 in chips)
Seat 5: ab0a3406 ($7.95 in chips)
Seat 6: 12260f7f ($12.59 in chips)
7bed5d55: posts small blind $0.05
Hero: posts big blind $0.1
*** HOLE CARDS ***
Dealt to a6735809 
Dealt to 7bed5d55 
Dealt to Hero [2h Jc]
Dealt to ab80b11a 
Dealt to ab0a3406 
Dealt to 12260f7f 
ab80b11a: folds
ab0a3406: folds
12260f7f: raises $0.2 to $0.3
a6735809: raises $0.57 to $0.87
7bed5d55: folds
Hero: folds
12260f7f: raises $1.89 to $2.76
a6735809: calls $1.89
*** FLOP *** [4h Ts 8s]
12260f7f: bets $8.2
a6735809: calls $6.36 and is all-in
Uncalled bet ($1.84) returned to 12260f7f
12260f7f: shows [Kc Kh] (Pair of Kings)
a6735809: shows [Td Ad] (Pair of Tens)
*** TURN *** [4h Ts 8s] [Qh]
*** RIVER *** [4h Ts 8s Qh] [9c]
*** SHOWDOWN ***
12260f7f collected $17.94 from pot
*** SUMMARY ***
Total pot $18.39 | Rake $0.3 | Jackpot $0.15 | Bingo $0 | Fortune $0
Board [4h Ts 8s Qh 9c]
Seat 1: a6735809 (button) showed [Td Ad] and lost with Pair of Tens
Seat 2: 7bed5d55 (small blind) folded before Flop
Seat 3: Hero (big blind) folded before Flop
Seat 4: ab80b11a folded before Flop (didn't bet)
Seat 5: ab0a3406 folded before Flop (didn't bet)
Seat 6: 12260f7f showed [Kc Kh] and won ($17.94) with Pair of Kings


Poker Hand #RC1450376992: Hold'em No Limit  ($0.05/$0.1) - 2023/04/04 14:45:40
Table 'RushAndCash1752252' 6-max Seat #1 is the button
Seat 1: 290a9499 ($34.37 in chips)
Seat 2: 8671171 ($12.77 in chips)
Seat 3: 5e46a96d ($41.79 in chips)
Seat 4: 7b67d849 ($8.21 in chips)
Seat 5: 293a8661 ($13.04 in chips)
Seat 6: Hero ($23.45 in chips)
8671171: posts small blind $0.05
5e46a96d: posts big blind $0.1
*** HOLE CARDS ***
Dealt to 290a9499 
Dealt to 8671171 
Dealt to 5e46a96d 
Dealt to 7b67d849 
Dealt to 293a8661 
Dealt to Hero [6h Qc]
7b67d849: raises $0.2 to $0.3
293a8661: folds
Hero: folds
290a9499: folds
8671171: folds
5e46a96d: folds
Uncalled bet ($0.2) returned to 7b67d849
*** SHOWDOWN ***
7b67d849 collected $0.25 from pot
*** SUMMARY ***
Total pot $0.25 | Rake $0 | Jackpot $0 | Bingo $0 | Fortune $0
Seat 1: 290a9499 (button) folded before Flop (didn't bet)
Seat 2: 8671171 (small blind) folded before Flop
Seat 3: 5e46a96d (big blind) folded before Flop
Seat 4: 7b67d849 collected ($0.25)
Seat 5: 293a8661 folded before Flop (didn't bet)
Seat 6: Hero folded before Flop (didn't bet)


Poker Hand #RC1450376885: Hold'em No Limit  ($0.05/$0.1) - 2023/04/04 14:45:23
Table 'RushAndCash1752145' 6-max Seat #1 is the button
Seat 1: Hero ($23.45 in chips)
Seat 2: cd204f5b ($13.11 in chips)
Seat 3: 1d0fff82 ($10 in chips)
Seat 4: 7ac88f4f ($14.58 in chips)
Seat 5: e35428b6 ($10.41 in chips)
Seat 6: 42e3142f ($10.15 in chips)
cd204f5b: posts small blind $0.05
1d0fff82: posts big blind $0.1
*** HOLE CARDS ***
Dealt to Hero [Ts 9c]
Dealt to cd204f5b 
Dealt to 1d0fff82 
Dealt to 7ac88f4f 
Dealt to e35428b6 
Dealt to 42e3142f 
7ac88f4f: folds
e35428b6: folds
42e3142f: raises $0.1 to $0.2
Hero: folds
cd204f5b: folds
1d0fff82: folds
Uncalled bet ($0.1) returned to 42e3142f
*** SHOWDOWN ***
42e3142f collected $0.25 from pot
*** SUMMARY ***
Total pot $0.25 | Rake $0 | Jackpot $0 | Bingo $0 | Fortune $0
Seat 1: Hero (button) folded before Flop (didn't bet)
Seat 2: cd204f5b (small blind) folded before Flop
Seat 3: 1d0fff82 (big blind) folded before Flop
Seat 4: 7ac88f4f folded before Flop (didn't bet)
Seat 5: e35428b6 folded before Flop (didn't bet)
Seat 6: 42e3142f collected ($0.25)


Poker Hand #RC1450376763: Hold'em No Limit  ($0.05/$0.1) - 2023/04/04 14:45:08
Table 'RushAndCash1752023' 6-max Seat #1 is the button
Seat 1: Hero ($23.45 in chips)
Seat 2: 757489f1 ($27.89 in chips)
Seat 3: de4bbac9 ($10.74 in chips)
Seat 4: e6227d3f ($4.84 in chips)
Seat 5: 472687b6 ($11.06 in chips)
Seat 6: 5bf8256e ($9.69 in chips)
757489f1: posts small blind $0.05
de4bbac9: posts big blind $0.1
*** HOLE CARDS ***
Dealt to Hero [7h 5s]
Dealt to 757489f1 
Dealt to de4bbac9 
Dealt to e6227d3f 
Dealt to 472687b6 
Dealt to 5bf8256e 
e6227d3f: raises $0.12 to $0.22
472687b6: folds
5bf8256e: folds
Hero: folds
757489f1: folds
de4bbac9: calls $0.12
*** FLOP *** [Th Js 7c]
de4bbac9: checks
e6227d3f: bets $0.25
de4bbac9: calls $0.25
*** TURN *** [Th Js 7c] [As]
de4bbac9: checks
e6227d3f: bets $0.6
de4bbac9: calls $0.6
*** RIVER *** [Th Js 7c As] [3d]
de4bbac9: checks
e6227d3f: bets $3.77 and is all-in
de4bbac9: folds
Uncalled bet ($3.77) returned to e6227d3f
*** SHOWDOWN ***
e6227d3f collected $2.08 from pot
*** SUMMARY ***
Total pot $2.19 | Rake $0.11 | Jackpot $0 | Bingo $0 | Fortune $0
Board [Th Js 7c As 3d]
Seat 1: Hero (button) folded before Flop (didn't bet)
Seat 2: 757489f1 (small blind) folded before Flop
Seat 3: de4bbac9 (big blind) folded on the River
Seat 4: e6227d3f won ($2.08)
Seat 5: 472687b6 folded before Flop (didn't bet)
Seat 6: 5bf8256e folded before Flop (didn't bet)


Poker Hand #RC1450376644: Hold'em No Limit  ($0.05/$0.1) - 2023/04/04 14:44:52
Table 'RushAndCash1751904' 6-max Seat #1 is the button
Seat 1: a64a1b05 ($12.92 in chips)
Seat 2: Hero ($23.5 in chips)
Seat 3: 538c0372 ($10.72 in chips)
Seat 4: 44a253d8 ($10 in chips)
Seat 5: d023f4eb ($10 in chips)
Seat 6: 274dbb1c ($10 in chips)
Hero: posts small blind $0.05
538c0372: posts big blind $0.1
*** HOLE CARDS ***
Dealt to a64a1b05 
Dealt to Hero [5c Jc]
Dealt to 538c0372 
Dealt to 44a253d8 
Dealt to d023f4eb 
Dealt to 274dbb1c 
44a253d8: folds
d023f4eb: folds
274dbb1c: folds
a64a1b05: raises $0.1 to $0.2
Hero: folds
538c0372: folds
Uncalled bet ($0.1) returned to a64a1b05
*** SHOWDOWN ***
a64a1b05 collected $0.25 from pot
*** SUMMARY ***
Total pot $0.25 | Rake $0 | Jackpot $0 | Bingo $0 | Fortune $0
Seat 1: a64a1b05 (button) collected ($0.25)
Seat 2: Hero (small blind) folded before Flop
Seat 3: 538c0372 (big blind) folded before Flop
Seat 4: 44a253d8 folded before Flop (didn't bet)
Seat 5: d023f4eb folded before Flop (didn't bet)
Seat 6: 274dbb1c folded before Flop (didn't bet)


Poker Hand #RC1450376590: Hold'em No Limit  ($0.05/$0.1) - 2023/04/04 14:44:45
Table 'RushAndCash1751850' 6-max Seat #1 is the button
Seat 1: e932cece ($11.54 in chips)
Seat 2: 337857b6 ($10.17 in chips)
Seat 3: ceb2b99e ($10.02 in chips)
Seat 4: Hero ($23.5 in chips)
Seat 5: b9e733ee ($45.1 in chips)
Seat 6: 7032ce80 ($10 in chips)
337857b6: posts small blind $0.05
ceb2b99e: posts big blind $0.1
*** HOLE CARDS ***
Dealt to e932cece 
Dealt to 337857b6 
Dealt to ceb2b99e 
Dealt to Hero [6d 8d]
Dealt to b9e733ee 
Dealt to 7032ce80 
Hero: folds
b9e733ee: raises $0.1 to $0.2
7032ce80: folds
e932cece: calls $0.2
337857b6: folds
ceb2b99e: folds
*** FLOP *** [Kh 8h 3h]
b9e733ee: bets $0.2
e932cece: calls $0.2
*** TURN *** [Kh 8h 3h] [9s]
b9e733ee: checks
e932cece: bets $0.49
b9e733ee: folds
Uncalled bet ($0.49) returned to e932cece
*** SHOWDOWN ***
e932cece collected $0.91 from pot
*** SUMMARY ***
Total pot $0.95 | Rake $0.04 | Jackpot $0 | Bingo $0 | Fortune $0
Board [Kh 8h 3h 9s]
Seat 1: e932cece (button) won ($0.91)
Seat 2: 337857b6 (small blind) folded before Flop
Seat 3: ceb2b99e (big blind) folded before Flop
Seat 4: Hero folded before Flop (didn't bet)
Seat 5: b9e733ee folded on the Turn
Seat 6: 7032ce80 folded before Flop (didn't bet)


Poker Hand #RC1450376348: Hold'em No Limit  ($0.05/$0.1) - 2023/04/04 14:44:14
Table 'RushAndCash1751608' 6-max Seat #1 is the button
Seat 1: ceb2b99e ($10.12 in chips)
Seat 2: 1e2ecf57 ($16.07 in chips)
Seat 3: Hero ($23.04 in chips)
Seat 4: 627ce908 ($4.61 in chips)
Seat 5: 58d0444f ($10.15 in chips)
Seat 6: 5a3a4f59 ($11.39 in chips)
1e2ecf57: posts small blind $0.05
Hero: posts big blind $0.1
*** HOLE CARDS ***
Dealt to ceb2b99e 
Dealt to 1e2ecf57 
Dealt to Hero [Ah Ks]
Dealt to 627ce908 
Dealt to 58d0444f 
Dealt to 5a3a4f59 
627ce908: folds
58d0444f: folds
5a3a4f59: folds
ceb2b99e: calls $0.1
1e2ecf57: raises $0.3 to $0.4
Hero: raises $0.8 to $1.2
ceb2b99e: folds
1e2ecf57: folds
Uncalled bet ($0.8) returned to Hero
*** SHOWDOWN ***
Hero collected $0.86 from pot
*** SUMMARY ***
Total pot $0.9 | Rake $0.04 | Jackpot $0 | Bingo $0 | Fortune $0
Seat 1: ceb2b99e (button) folded before Flop
Seat 2: 1e2ecf57 (small blind) folded before Flop
Seat 3: Hero (big blind) collected ($0.86)
Seat 4: 627ce908 folded before Flop (didn't bet)
Seat 5: 58d0444f folded before Flop (didn't bet)
Seat 6: 5a3a4f59 folded before Flop (didn't bet)


Poker Hand #RC1450376317: Hold'em No Limit  ($0.05/$0.1) - 2023/04/04 14:44:09
Table 'RushAndCash1751577' 6-max Seat #1 is the button
Seat 1: 8c9c61fd ($9.85 in chips)
Seat 2: 33c10f8b ($25.16 in chips)
Seat 3: ff72411c ($12.78 in chips)
Seat 4: 4dcae4d2 ($18.34 in chips)
Seat 5: Hero ($23.04 in chips)
Seat 6: 4ce6673c ($12.15 in chips)
33c10f8b: posts small blind $0.05
ff72411c: posts big blind $0.1
*** HOLE CARDS ***
Dealt to 8c9c61fd 
Dealt to 33c10f8b 
Dealt to ff72411c 
Dealt to 4dcae4d2 
Dealt to Hero [8s Qs]
Dealt to 4ce6673c 
4dcae4d2: folds
Hero: folds
4ce6673c: raises $0.12 to $0.22
8c9c61fd: folds
33c10f8b: folds
ff72411c: calls $0.12
*** FLOP *** [2h 6c Ac]
ff72411c: checks
4ce6673c: bets $0.25
ff72411c: folds
Uncalled bet ($0.25) returned to 4ce6673c
*** SHOWDOWN ***
4ce6673c collected $0.46 from pot
*** SUMMARY ***
Total pot $0.49 | Rake $0.03 | Jackpot $0 | Bingo $0 | Fortune $0
Board [2h 6c Ac]
Seat 1: 8c9c61fd (button) folded before Flop (didn't bet)
Seat 2: 33c10f8b (small blind) folded before Flop
Seat 3: ff72411c (big blind) folded on the Flop
Seat 4: 4dcae4d2 folded before Flop (didn't bet)
Seat 5: Hero folded before Flop (didn't bet)
Seat 6: 4ce6673c won ($0.46)


Poker Hand #RC1450376246: Hold'em No Limit  ($0.05/$0.1) - 2023/04/04 14:44:00
Table 'RushAndCash1751506' 6-max Seat #1 is the button
Seat 1: 8d2c45a4 ($23.94 in chips)
Seat 2: 524e6945 ($10.46 in chips)
Seat 3: Hero ($22.99 in chips)
Seat 4: 8271b321 ($12.57 in chips)
Seat 5: 341593af ($11.77 in chips)
Seat 6: 7ac88f4f ($13.8 in chips)
524e6945: posts small blind $0.05
Hero: posts big blind $0.1
*** HOLE CARDS ***
Dealt to 8d2c45a4 
Dealt to 524e6945 
Dealt to Hero [Kd Jh]
Dealt to 8271b321 
Dealt to 341593af 
Dealt to 7ac88f4f 
8271b321: folds
341593af: folds
7ac88f4f: folds
8d2c45a4: folds
524e6945: folds
Uncalled bet ($0.05) returned to Hero
*** SHOWDOWN ***
Hero collected $0.1 from pot
*** SUMMARY ***
Total pot $0.1 | Rake $0 | Jackpot $0 | Bingo $0 | Fortune $0
Seat 1: 8d2c45a4 (button) folded before Flop (didn't bet)
Seat 2: 524e6945 (small blind) folded before Flop
Seat 3: Hero (big blind) collected ($0.1)
Seat 4: 8271b321 folded before Flop (didn't bet)
Seat 5: 341593af folded before Flop (didn't bet)
Seat 6: 7ac88f4f folded before Flop (didn't bet)


Poker Hand #RC1450376211: Hold'em No Limit  ($0.05/$0.1) - 2023/04/04 14:43:55
Table 'RushAndCash1751471' 6-max Seat #1 is the button
Seat 1: 13d477b0 ($5.71 in chips)
Seat 2: db128ee7 ($25.7 in chips)
Seat 3: 56e525a4 ($7.55 in chips)
Seat 4: 50e63ec5 ($11.71 in chips)
Seat 5: Hero ($22.99 in chips)
Seat 6: 7e925928 ($31.8 in chips)
db128ee7: posts small blind $0.05
56e525a4: posts big blind $0.1
*** HOLE CARDS ***
Dealt to 13d477b0 
Dealt to db128ee7 
Dealt to 56e525a4 
Dealt to 50e63ec5 
Dealt to Hero [8h Qc]
Dealt to 7e925928 
50e63ec5: folds
Hero: folds
7e925928: folds
13d477b0: folds
db128ee7: folds
Uncalled bet ($0.05) returned to 56e525a4
*** SHOWDOWN ***
56e525a4 collected $0.1 from pot
*** SUMMARY ***
Total pot $0.1 | Rake $0 | Jackpot $0 | Bingo $0 | Fortune $0
Seat 1: 13d477b0 (button) folded before Flop (didn't bet)
Seat 2: db128ee7 (small blind) folded before Flop
Seat 3: 56e525a4 (big blind) collected ($0.1)
Seat 4: 50e63ec5 folded before Flop (didn't bet)
Seat 5: Hero folded before Flop (didn't bet)
Seat 6: 7e925928 folded before Flop (didn't bet)


Poker Hand #RC1450331763: Hold'em No Limit  ($0.05/$0.1) - 2023/04/04 14:33:04
Table 'RushAndCash1747023' 6-max Seat #1 is the button
Seat 1: ff162dd9 ($10 in chips)
Seat 2: fabe8371 ($5.2 in chips)
Seat 3: 73cafe2 ($10.65 in chips)
Seat 4: 3cbc814b ($4.54 in chips)
Seat 5: d7dbc6b1 ($10 in chips)
Seat 6: Hero ($23.91 in chips)
fabe8371: posts small blind $0.05
73cafe2: posts big blind $0.1
*** HOLE CARDS ***
Dealt to ff162dd9 
Dealt to fabe8371 
Dealt to 73cafe2 
Dealt to 3cbc814b 
Dealt to d7dbc6b1 
Dealt to Hero [Jc Js]
3cbc814b: raises $0.2 to $0.3
d7dbc6b1: folds
Hero: raises $0.62 to $0.92
ff162dd9: folds
fabe8371: raises $2.24 to $3.16
73cafe2: folds
3cbc814b: folds
Hero: folds
Uncalled bet ($2.24) returned to fabe8371
*** SHOWDOWN ***
fabe8371 collected $2.13 from pot
*** SUMMARY ***
Total pot $2.24 | Rake $0.11 | Jackpot $0 | Bingo $0 | Fortune $0
Seat 1: ff162dd9 (button) folded before Flop (didn't bet)
Seat 2: fabe8371 (small blind) collected ($2.13)
Seat 3: 73cafe2 (big blind) folded before Flop
Seat 4: 3cbc814b folded before Flop
Seat 5: d7dbc6b1 folded before Flop (didn't bet)
Seat 6: Hero folded before Flop


Poker Hand #RC1450331698: Hold'em No Limit  ($0.05/$0.1) - 2023/04/04 14:32:55
Table 'RushAndCash1746958' 6-max Seat #1 is the button
Seat 1: 27a352c5 ($9.75 in chips)
Seat 2: Hero ($23.96 in chips)
Seat 3: 3d7eeb7c ($11.51 in chips)
Seat 4: d74e30f2 ($31.78 in chips)
Seat 5: a68ddb6d ($30.74 in chips)
Seat 6: a8594abd ($75.38 in chips)
Hero: posts small blind $0.05
3d7eeb7c: posts big blind $0.1
*** HOLE CARDS ***
Dealt to 27a352c5 
Dealt to Hero [3c Kd]
Dealt to 3d7eeb7c 
Dealt to d74e30f2 
Dealt to a68ddb6d 
Dealt to a8594abd 
d74e30f2: folds
a68ddb6d: folds
a8594abd: folds
27a352c5: raises $0.1 to $0.2
Hero: folds
3d7eeb7c: calls $0.1
*** FLOP *** [Qh Qc 8c]
3d7eeb7c: checks
27a352c5: bets $0.15
3d7eeb7c: folds
Uncalled bet ($0.15) returned to 27a352c5
*** SHOWDOWN ***
27a352c5 collected $0.43 from pot
*** SUMMARY ***
Total pot $0.45 | Rake $0.02 | Jackpot $0 | Bingo $0 | Fortune $0
Board [Qh Qc 8c]
Seat 1: 27a352c5 (button) won ($0.43)
Seat 2: Hero (small blind) folded before Flop
Seat 3: 3d7eeb7c (big blind) folded on the Flop
Seat 4: d74e30f2 folded before Flop (didn't bet)
Seat 5: a68ddb6d folded before Flop (didn't bet)
Seat 6: a8594abd folded before Flop (didn't bet)


Poker Hand #RC1450331630: Hold'em No Limit  ($0.05/$0.1) - 2023/04/04 14:32:45
Table 'RushAndCash1746890' 6-max Seat #1 is the button
Seat 1: cce2256c ($13.11 in chips)
Seat 2: e0a2b2b6 ($11.21 in chips)
Seat 3: 44c63f1d ($10.74 in chips)
Seat 4: Hero ($23.96 in chips)
Seat 5: 8205b559 ($10.46 in chips)
Seat 6: ac61705 ($11.37 in chips)
e0a2b2b6: posts small blind $0.05
44c63f1d: posts big blind $0.1
*** HOLE CARDS ***
Dealt to cce2256c 
Dealt to e0a2b2b6 
Dealt to 44c63f1d 
Dealt to Hero [4s Qc]
Dealt to 8205b559 
Dealt to ac61705 
Hero: folds
8205b559: folds
ac61705: raises $0.12 to $0.22
cce2256c: folds
e0a2b2b6: calls $0.17
44c63f1d: raises $0.93 to $1.15
ac61705: raises $1.85 to $3
e0a2b2b6: folds
44c63f1d: folds
Uncalled bet ($1.85) returned to ac61705
*** SHOWDOWN ***
ac61705 collected $2.4 from pot
*** SUMMARY ***
Total pot $2.52 | Rake $0.12 | Jackpot $0 | Bingo $0 | Fortune $0
Seat 1: cce2256c (button) folded before Flop (didn't bet)
Seat 2: e0a2b2b6 (small blind) folded before Flop
Seat 3: 44c63f1d (big blind) folded before Flop
Seat 4: Hero folded before Flop (didn't bet)
Seat 5: 8205b559 folded before Flop (didn't bet)
Seat 6: ac61705 collected ($2.4)


Poker Hand #RC1450331573: Hold'em No Limit  ($0.05/$0.1) - 2023/04/04 14:32:36
Table 'RushAndCash1746833' 6-max Seat #1 is the button
Seat 1: 131cae3a ($5.75 in chips)
Seat 2: b1e4d625 ($13.33 in chips)
Seat 3: 25818059 ($10.23 in chips)
Seat 4: 8a33cfd3 ($10 in chips)
Seat 5: Hero ($23.96 in chips)
Seat 6: d619ac86 ($11.17 in chips)
b1e4d625: posts small blind $0.05
25818059: posts big blind $0.1
*** HOLE CARDS ***
Dealt to 131cae3a 
Dealt to b1e4d625 
Dealt to 25818059 
Dealt to 8a33cfd3 
Dealt to Hero [3c 8s]
Dealt to d619ac86 
8a33cfd3: raises $0.12 to $0.22
Hero: folds
d619ac86: folds
131cae3a: folds
b1e4d625: raises $0.72 to $0.94
25818059: folds
8a33cfd3: folds
Uncalled bet ($0.72) returned to b1e4d625
*** SHOWDOWN ***
b1e4d625 collected $0.52 from pot
*** SUMMARY ***
Total pot $0.54 | Rake $0.02 | Jackpot $0 | Bingo $0 | Fortune $0
Seat 1: 131cae3a (button) folded before Flop (didn't bet)
Seat 2: b1e4d625 (small blind) collected ($0.52)
Seat 3: 25818059 (big blind) folded before Flop
Seat 4: 8a33cfd3 folded before Flop
Seat 5: Hero folded before Flop (didn't bet)
Seat 6: d619ac86 folded before Flop (didn't bet)


Poker Hand #RC1450331536: Hold'em No Limit  ($0.05/$0.1) - 2023/04/04 14:32:29
Table 'RushAndCash1746796' 6-max Seat #1 is the button
Seat 1: 8b83eb8a ($22.15 in chips)
Seat 2: cee00378 ($13.13 in chips)
Seat 3: 11ae0d2a ($10.1 in chips)
Seat 4: b9523125 ($23.66 in chips)
Seat 5: 5a96fa16 ($1.67 in chips)
Seat 6: Hero ($23.96 in chips)
cee00378: posts small blind $0.05
11ae0d2a: posts big blind $0.1
*** HOLE CARDS ***
Dealt to 8b83eb8a 
Dealt to cee00378 
Dealt to 11ae0d2a 
Dealt to b9523125 
Dealt to 5a96fa16 
Dealt to Hero [Th 2c]
b9523125: folds
5a96fa16: folds
Hero: folds
8b83eb8a: folds
cee00378: folds
Uncalled bet ($0.05) returned to 11ae0d2a
*** SHOWDOWN ***
11ae0d2a collected $0.1 from pot
*** SUMMARY ***
Total pot $0.1 | Rake $0 | Jackpot $0 | Bingo $0 | Fortune $0
Seat 1: 8b83eb8a (button) folded before Flop (didn't bet)
Seat 2: cee00378 (small blind) folded before Flop
Seat 3: 11ae0d2a (big blind) collected ($0.1)
Seat 4: b9523125 folded before Flop (didn't bet)
Seat 5: 5a96fa16 folded before Flop (didn't bet)
Seat 6: Hero folded before Flop (didn't bet)


Poker Hand #RC1450331467: Hold'em No Limit  ($0.05/$0.1) - 2023/04/04 14:32:19
Table 'RushAndCash1746727' 6-max Seat #1 is the button
Seat 1: Hero ($23.96 in chips)
Seat 2: f3df658f ($11.6 in chips)
Seat 3: d38e0934 ($19.9 in chips)
Seat 4: 792837e4 ($10.88 in chips)
Seat 5: dac6c67b ($10 in chips)
Seat 6: df711b8c ($19.68 in chips)
f3df658f: posts small blind $0.05
d38e0934: posts big blind $0.1
*** HOLE CARDS ***
Dealt to Hero [3s 5s]
Dealt to f3df658f 
Dealt to d38e0934 
Dealt to 792837e4 
Dealt to dac6c67b 
Dealt to df711b8c 
792837e4: raises $0.12 to $0.22
dac6c67b: folds
df711b8c: folds
Hero: folds
f3df658f: raises $0.98 to $1.2
d38e0934: folds
792837e4: folds
Uncalled bet ($0.98) returned to f3df658f
*** SHOWDOWN ***
f3df658f collected $0.52 from pot
*** SUMMARY ***
Total pot $0.54 | Rake $0.02 | Jackpot $0 | Bingo $0 | Fortune $0
Seat 1: Hero (button) folded before Flop (didn't bet)
Seat 2: f3df658f (small blind) collected ($0.52)
Seat 3: d38e0934 (big blind) folded before Flop
Seat 4: 792837e4 folded before Flop
Seat 5: dac6c67b folded before Flop (didn't bet)
Seat 6: df711b8c folded before Flop (didn't bet)


Poker Hand #RC1450331283: Hold'em No Limit  ($0.05/$0.1) - 2023/04/04 14:31:53
Table 'RushAndCash1746543' 6-max Seat #1 is the button
Seat 1: e8f0a4f9 ($10 in chips)
Seat 2: Hero ($23.86 in chips)
Seat 3: 3a5173f3 ($7.53 in chips)
Seat 4: 77565b6d ($10.69 in chips)
Seat 5: 558f1813 ($10 in chips)
Seat 6: 51f3fe27 ($11.68 in chips)
Hero: posts small blind $0.05
3a5173f3: posts big blind $0.1
*** HOLE CARDS ***
Dealt to e8f0a4f9 
Dealt to Hero [Ad As]
Dealt to 3a5173f3 
Dealt to 77565b6d 
Dealt to 558f1813 
Dealt to 51f3fe27 
77565b6d: folds
558f1813: folds
51f3fe27: folds
e8f0a4f9: folds
Hero: raises $0.2 to $0.3
3a5173f3: folds
Uncalled bet ($0.2) returned to Hero
*** SHOWDOWN ***
Hero collected $0.2 from pot
*** SUMMARY ***
Total pot $0.2 | Rake $0 | Jackpot $0 | Bingo $0 | Fortune $0
Seat 1: e8f0a4f9 (button) folded before Flop (didn't bet)
Seat 2: Hero (small blind) collected ($0.2)
Seat 3: 3a5173f3 (big blind) folded before Flop
Seat 4: 77565b6d folded before Flop (didn't bet)
Seat 5: 558f1813 folded before Flop (didn't bet)
Seat 6: 51f3fe27 folded before Flop (didn't bet)


Poker Hand #RC1450331204: Hold'em No Limit  ($0.05/$0.1) - 2023/04/04 14:31:40
Table 'RushAndCash1746464' 6-max Seat #1 is the button
Seat 1: 2dd39616 ($10.97 in chips)
Seat 2: e0a2b2b6 ($11.61 in chips)
Seat 3: Hero ($23.96 in chips)
Seat 4: 669ca88b ($10.43 in chips)
Seat 5: 3edc0f41 ($10.94 in chips)
Seat 6: 7c80994c ($10 in chips)
e0a2b2b6: posts small blind $0.05
Hero: posts big blind $0.1
*** HOLE CARDS ***
Dealt to 2dd39616 
Dealt to e0a2b2b6 
Dealt to Hero [5s Th]
Dealt to 669ca88b 
Dealt to 3edc0f41 
Dealt to 7c80994c 
669ca88b: raises $0.1 to $0.2
3edc0f41: folds
7c80994c: folds
2dd39616: folds
e0a2b2b6: calls $0.15
Hero: folds
*** FLOP *** [6h Kd Kh]
e0a2b2b6: checks
669ca88b: bets $0.17
e0a2b2b6: folds
Uncalled bet ($0.17) returned to 669ca88b
*** SHOWDOWN ***
669ca88b collected $0.48 from pot
*** SUMMARY ***
Total pot $0.5 | Rake $0.02 | Jackpot $0 | Bingo $0 | Fortune $0
Board [6h Kd Kh]
Seat 1: 2dd39616 (button) folded before Flop (didn't bet)
Seat 2: e0a2b2b6 (small blind) folded on the Flop
Seat 3: Hero (big blind) folded before Flop
Seat 4: 669ca88b won ($0.48)
Seat 5: 3edc0f41 folded before Flop (didn't bet)
Seat 6: 7c80994c folded before Flop (didn't bet)


Poker Hand #RC1450331061: Hold'em No Limit  ($0.05/$0.1) - 2023/04/04 14:31:20
Table 'RushAndCash1746321' 6-max Seat #1 is the button
Seat 1: d3ae7171 ($10.8 in chips)
Seat 2: 4ce6673c ($10.92 in chips)
Seat 3: 983fb4cd ($10 in chips)
Seat 4: 80430b00 ($10.15 in chips)
Seat 5: 3ac485b0 ($8.42 in chips)
Seat 6: Hero ($23.96 in chips)
4ce6673c: posts small blind $0.05
983fb4cd: posts big blind $0.1
*** HOLE CARDS ***
Dealt to d3ae7171 
Dealt to 4ce6673c 
Dealt to 983fb4cd 
Dealt to 80430b00 
Dealt to 3ac485b0 
Dealt to Hero [Ah 5h]
80430b00: raises $0.1 to $0.2
3ac485b0: folds
Hero: folds
d3ae7171: folds
4ce6673c: folds
983fb4cd: folds
Uncalled bet ($0.1) returned to 80430b00
*** SHOWDOWN ***
80430b00 collected $0.25 from pot
*** SUMMARY ***
Total pot $0.25 | Rake $0 | Jackpot $0 | Bingo $0 | Fortune $0
Seat 1: d3ae7171 (button) folded before Flop (didn't bet)
Seat 2: 4ce6673c (small blind) folded before Flop
Seat 3: 983fb4cd (big blind) folded before Flop
Seat 4: 80430b00 collected ($0.25)
Seat 5: 3ac485b0 folded before Flop (didn't bet)
Seat 6: Hero folded before Flop (didn't bet)


Poker Hand #RC1450330922: Hold'em No Limit  ($0.05/$0.1) - 2023/04/04 14:30:59
Table 'RushAndCash1746182' 6-max Seat #1 is the button
Seat 1: Hero ($23.96 in chips)
Seat 2: c6454b6a ($23.94 in chips)
Seat 3: 5f84c35a ($13.36 in chips)
Seat 4: 337857b6 ($11.87 in chips)
Seat 5: a7887132 ($15.48 in chips)
Seat 6: 17b7e2db ($20.66 in chips)
c6454b6a: posts small blind $0.05
5f84c35a: posts big blind $0.1
*** HOLE CARDS ***
Dealt to Hero [9s Kc]
Dealt to c6454b6a 
Dealt to 5f84c35a 
Dealt to 337857b6 
Dealt to a7887132 
Dealt to 17b7e2db 
337857b6: folds
a7887132: raises $0.2 to $0.3
17b7e2db: raises $0.57 to $0.87
Hero: folds
c6454b6a: folds
5f84c35a: folds
a7887132: folds
Uncalled bet ($0.57) returned to 17b7e2db
*** SHOWDOWN ***
17b7e2db collected $0.72 from pot
*** SUMMARY ***
Total pot $0.75 | Rake $0.03 | Jackpot $0 | Bingo $0 | Fortune $0
Seat 1: Hero (button) folded before Flop (didn't bet)
Seat 2: c6454b6a (small blind) folded before Flop
Seat 3: 5f84c35a (big blind) folded before Flop
Seat 4: 337857b6 folded before Flop (didn't bet)
Seat 5: a7887132 folded before Flop
Seat 6: 17b7e2db collected ($0.72)


Poker Hand #RC1450330829: Hold'em No Limit  ($0.05/$0.1) - 2023/04/04 14:30:46
Table 'RushAndCash1746089' 6-max Seat #1 is the button
Seat 1: 2da1d878 ($10.66 in chips)
Seat 2: 4f7491f9 ($11.28 in chips)
Seat 3: 4d707336 ($12.12 in chips)
Seat 4: 58d0444f ($11.05 in chips)
Seat 5: Hero ($23.96 in chips)
Seat 6: fc2e2645 ($21.87 in chips)
4f7491f9: posts small blind $0.05
4d707336: posts big blind $0.1
*** HOLE CARDS ***
Dealt to 2da1d878 
Dealt to 4f7491f9 
Dealt to 4d707336 
Dealt to 58d0444f 
Dealt to Hero [7d Ks]
Dealt to fc2e2645 
58d0444f: folds
Hero: folds
fc2e2645: folds
2da1d878: raises $0.1 to $0.2
4f7491f9: folds
4d707336: folds
Uncalled bet ($0.1) returned to 2da1d878
*** SHOWDOWN ***
2da1d878 collected $0.25 from pot
*** SUMMARY ***
Total pot $0.25 | Rake $0 | Jackpot $0 | Bingo $0 | Fortune $0
Seat 1: 2da1d878 (button) collected ($0.25)
Seat 2: 4f7491f9 (small blind) folded before Flop
Seat 3: 4d707336 (big blind) folded before Flop
Seat 4: 58d0444f folded before Flop (didn't bet)
Seat 5: Hero folded before Flop (didn't bet)
Seat 6: fc2e2645 folded before Flop (didn't bet)


Poker Hand #RC1450330775: Hold'em No Limit  ($0.05/$0.1) - 2023/04/04 14:30:38
Table 'RushAndCash1746035' 6-max Seat #1 is the button
Seat 1: 8436bcc0 ($13.38 in chips)
Seat 2: 94a282a6 ($9.9 in chips)
Seat 3: 788e3116 ($11.93 in chips)
Seat 4: 27e10e53 ($19.8 in chips)
Seat 5: 44c63f1d ($10.42 in chips)
Seat 6: Hero ($23.96 in chips)
94a282a6: posts small blind $0.05
788e3116: posts big blind $0.1
*** HOLE CARDS ***
Dealt to 8436bcc0 
Dealt to 94a282a6 
Dealt to 788e3116 
Dealt to 27e10e53 
Dealt to 44c63f1d 
Dealt to Hero [6s Qh]
27e10e53: folds
44c63f1d: folds
Hero: folds
8436bcc0: folds
94a282a6: folds
Uncalled bet ($0.05) returned to 788e3116
*** SHOWDOWN ***
788e3116 collected $0.1 from pot
*** SUMMARY ***
Total pot $0.1 | Rake $0 | Jackpot $0 | Bingo $0 | Fortune $0
Seat 1: 8436bcc0 (button) folded before Flop (didn't bet)
Seat 2: 94a282a6 (small blind) folded before Flop
Seat 3: 788e3116 (big blind) collected ($0.1)
Seat 4: 27e10e53 folded before Flop (didn't bet)
Seat 5: 44c63f1d folded before Flop (didn't bet)
Seat 6: Hero folded before Flop (didn't bet)


Poker Hand #RC1450330644: Hold'em No Limit  ($0.05/$0.1) - 2023/04/04 14:30:18
Table 'RushAndCash1745904' 6-max Seat #1 is the button
Seat 1: 266138f2 ($10.33 in chips)
Seat 2: 133a9e69 ($10.15 in chips)
Seat 3: 97c1eee5 ($11.41 in chips)
Seat 4: Hero ($23.81 in chips)
Seat 5: e203b4c2 ($12.22 in chips)
Seat 6: de2fd60c ($10 in chips)
133a9e69: posts small blind $0.05
97c1eee5: posts big blind $0.1
*** HOLE CARDS ***
Dealt to 266138f2 
Dealt to 133a9e69 
Dealt to 97c1eee5 
Dealt to Hero [Td Jd]
Dealt to e203b4c2 
Dealt to de2fd60c 
Hero: raises $0.15 to $0.25
e203b4c2: folds
de2fd60c: folds
266138f2: folds
133a9e69: folds
97c1eee5: folds
Uncalled bet ($0.15) returned to Hero
*** SHOWDOWN ***
Hero collected $0.25 from pot
*** SUMMARY ***
Total pot $0.25 | Rake $0 | Jackpot $0 | Bingo $0 | Fortune $0
Seat 1: 266138f2 (button) folded before Flop (didn't bet)
Seat 2: 133a9e69 (small blind) folded before Flop
Seat 3: 97c1eee5 (big blind) folded before Flop
Seat 4: Hero collected ($0.25)
Seat 5: e203b4c2 folded before Flop (didn't bet)
Seat 6: de2fd60c folded before Flop (didn't bet)


Poker Hand #RC1450330602: Hold'em No Limit  ($0.05/$0.1) - 2023/04/04 14:30:12
Table 'RushAndCash1745862' 6-max Seat #1 is the button
Seat 1: Hero ($23.81 in chips)
Seat 2: 12260f7f ($9.69 in chips)
Seat 3: a2e80610 ($12.96 in chips)
Seat 4: e4ac1aec ($11.19 in chips)
Seat 5: 196c6ae9 ($12.32 in chips)
Seat 6: 9aaea041 ($23.97 in chips)
12260f7f: posts small blind $0.05
a2e80610: posts big blind $0.1
*** HOLE CARDS ***
Dealt to Hero [Td 3s]
Dealt to 12260f7f 
Dealt to a2e80610 
Dealt to e4ac1aec 
Dealt to 196c6ae9 
Dealt to 9aaea041 
e4ac1aec: raises $0.12 to $0.22
196c6ae9: folds
9aaea041: folds
Hero: folds
12260f7f: folds
a2e80610: folds
Uncalled bet ($0.12) returned to e4ac1aec
*** SHOWDOWN ***
e4ac1aec collected $0.25 from pot
*** SUMMARY ***
Total pot $0.25 | Rake $0 | Jackpot $0 | Bingo $0 | Fortune $0
Seat 1: Hero (button) folded before Flop (didn't bet)
Seat 2: 12260f7f (small blind) folded before Flop
Seat 3: a2e80610 (big blind) folded before Flop
Seat 4: e4ac1aec collected ($0.25)
Seat 5: 196c6ae9 folded before Flop (didn't bet)
Seat 6: 9aaea041 folded before Flop (didn't bet)


Poker Hand #RC1450291965: Hold'em No Limit  ($0.05/$0.1) - 2023/04/04 14:08:07
Table 'RushAndCash1737225' 6-max Seat #1 is the button
Seat 1: d1624a34 ($12.23 in chips)
Seat 2: 6fa93048 ($10.05 in chips)
Seat 3: 3c0f475b ($14.43 in chips)
Seat 4: 7bfb7ffe ($20.2 in chips)
Seat 5: 1b960b42 ($13.08 in chips)
Seat 6: Hero ($23.81 in chips)
6fa93048: posts small blind $0.05
3c0f475b: posts big blind $0.1
*** HOLE CARDS ***
Dealt to d1624a34 
Dealt to 6fa93048 
Dealt to 3c0f475b 
Dealt to 7bfb7ffe 
Dealt to 1b960b42 
Dealt to Hero [5d Jh]
7bfb7ffe: raises $0.15 to $0.25
1b960b42: folds
Hero: folds
d1624a34: folds
6fa93048: folds
3c0f475b: folds
Uncalled bet ($0.15) returned to 7bfb7ffe
*** SHOWDOWN ***
7bfb7ffe collected $0.25 from pot
*** SUMMARY ***
Total pot $0.25 | Rake $0 | Jackpot $0 | Bingo $0 | Fortune $0
Seat 1: d1624a34 (button) folded before Flop (didn't bet)
Seat 2: 6fa93048 (small blind) folded before Flop
Seat 3: 3c0f475b (big blind) folded before Flop
Seat 4: 7bfb7ffe collected ($0.25)
Seat 5: 1b960b42 folded before Flop (didn't bet)
Seat 6: Hero folded before Flop (didn't bet)


Poker Hand #RC1450291819: Hold'em No Limit  ($0.05/$0.1) - 2023/04/04 14:07:43
Table 'RushAndCash1737079' 6-max Seat #1 is the button
Seat 1: 4e0c6c2a ($10.74 in chips)
Seat 2: Hero ($23.86 in chips)
Seat 3: 44924120 ($12.57 in chips)
Seat 4: eaa0380b ($13.2 in chips)
Seat 5: eb101c52 ($13.51 in chips)
Seat 6: d023f4eb ($10.09 in chips)
Hero: posts small blind $0.05
44924120: posts big blind $0.1
*** HOLE CARDS ***
Dealt to 4e0c6c2a 
Dealt to Hero [Kh Qc]
Dealt to 44924120 
Dealt to eaa0380b 
Dealt to eb101c52 
Dealt to d023f4eb 
eaa0380b: raises $0.15 to $0.25
eb101c52: raises $0.55 to $0.8
d023f4eb: folds
4e0c6c2a: folds
Hero: folds
44924120: folds
eaa0380b: calls $0.55
*** FLOP *** [7c 8h 4d]
eaa0380b: checks
eb101c52: bets $0.6
eaa0380b: calls $0.6
*** TURN *** [7c 8h 4d] [As]
eaa0380b: checks
eb101c52: bets $1.85
eaa0380b: folds
Uncalled bet ($1.85) returned to eb101c52
*** SHOWDOWN ***
eb101c52 collected $2.81 from pot
*** SUMMARY ***
Total pot $2.95 | Rake $0.14 | Jackpot $0 | Bingo $0 | Fortune $0
Board [7c 8h 4d As]
Seat 1: 4e0c6c2a (button) folded before Flop (didn't bet)
Seat 2: Hero (small blind) folded before Flop
Seat 3: 44924120 (big blind) folded before Flop
Seat 4: eaa0380b folded on the Turn
Seat 5: eb101c52 won ($2.81)
Seat 6: d023f4eb folded before Flop (didn't bet)


Poker Hand #RC1450291248: Hold'em No Limit  ($0.05/$0.1) - 2023/04/04 14:06:13
Table 'RushAndCash1736508' 6-max Seat #1 is the button
Seat 1: 39e5b565 ($10.51 in chips)
Seat 2: c7ae08ec ($10.82 in chips)
Seat 3: Hero ($23.33 in chips)
Seat 4: cf70d3a9 ($10 in chips)
Seat 5: 835b78d9 ($10 in chips)
Seat 6: 227c75a ($32.86 in chips)
c7ae08ec: posts small blind $0.05
Hero: posts big blind $0.1
*** HOLE CARDS ***
Dealt to 39e5b565 
Dealt to c7ae08ec 
Dealt to Hero [6h 4h]
Dealt to cf70d3a9 
Dealt to 835b78d9 
Dealt to 227c75a 
cf70d3a9: folds
835b78d9: folds
227c75a: folds
39e5b565: raises $0.15 to $0.25
c7ae08ec: folds
Hero: calls $0.15
*** FLOP *** [8d 3d Tc]
Hero: bets $0.28
39e5b565: calls $0.28
*** TURN *** [8d 3d Tc] [4c]
Hero: checks
39e5b565: checks
*** RIVER *** [8d 3d Tc 4c] [2c]
Hero: checks
39e5b565: checks
Hero: shows [6h 4h] (Pair of Fours)
39e5b565: shows [3s As] (Pair of Treys)
*** SHOWDOWN ***
Hero collected $1.06 from pot
*** SUMMARY ***
Total pot $1.11 | Rake $0.05 | Jackpot $0 | Bingo $0 | Fortune $0
Board [8d 3d Tc 4c 2c]
Seat 1: 39e5b565 (button) showed [3s As] and lost with Pair of Treys
Seat 2: c7ae08ec (small blind) folded before Flop
Seat 3: Hero (big blind) showed [6h 4h] and won ($1.06) with Pair of Fours
Seat 4: cf70d3a9 folded before Flop (didn't bet)
Seat 5: 835b78d9 folded before Flop (didn't bet)
Seat 6: 227c75a folded before Flop (didn't bet)


Poker Hand #RC1450290771: Hold'em No Limit  ($0.05/$0.1) - 2023/04/04 14:04:55
Table 'RushAndCash1736031' 6-max Seat #1 is the button
Seat 1: 54291ee1 ($9.85 in chips)
Seat 2: 56f54f19 ($31.96 in chips)
Seat 3: 227c75a ($31.47 in chips)
Seat 4: Hero ($24.98 in chips)
Seat 5: 295eeaa4 ($10 in chips)
Seat 6: a4518a95 ($10.61 in chips)
56f54f19: posts small blind $0.05
227c75a: posts big blind $0.1
*** HOLE CARDS ***
Dealt to 54291ee1 
Dealt to 56f54f19 
Dealt to 227c75a 
Dealt to Hero [7c 7d]
Dealt to 295eeaa4 
Dealt to a4518a95 
Hero: raises $0.15 to $0.25
295eeaa4: folds
a4518a95: folds
54291ee1: folds
56f54f19: folds
227c75a: calls $0.15
*** FLOP *** [9s 6c 8d]
227c75a: checks
Hero: checks
*** TURN *** [9s 6c 8d] [6h]
227c75a: bets $0.4
Hero: calls $0.4
*** RIVER *** [9s 6c 8d 6h] [9c]
227c75a: bets $1
Hero: calls $1
227c75a: shows [6s 7s] (Sixes Full over Nines)
Hero: shows [7c 7d] (Pair of Nines and Pair of Sevens)
*** SHOWDOWN ***
227c75a collected $3.04 from pot
*** SUMMARY ***
Total pot $3.35 | Rake $0.16 | Jackpot $0.15 | Bingo $0 | Fortune $0
Board [9s 6c 8d 6h 9c]
Seat 1: 54291ee1 (button) folded before Flop (didn't bet)
Seat 2: 56f54f19 (small blind) folded before Flop
Seat 3: 227c75a (big blind) showed [6s 7s] and won ($3.04) with Sixes Full over Nines
Seat 4: Hero showed [7c 7d] and lost with Pair of Nines and Pair of Sevens
Seat 5: 295eeaa4 folded before Flop (didn't bet)
Seat 6: a4518a95 folded before Flop (didn't bet)


Poker Hand #RC1450290741: Hold'em No Limit  ($0.05/$0.1) - 2023/04/04 14:04:50
Table 'RushAndCash1736001' 6-max Seat #1 is the button
Seat 1: 4aca1dfa ($21.54 in chips)
Seat 2: 9b7ae8dd ($10.05 in chips)
Seat 3: 2c07de8a ($10.15 in chips)
Seat 4: Hero ($24.98 in chips)
Seat 5: 6c6fb8b0 ($10.05 in chips)
Seat 6: af50e261 ($10.75 in chips)
9b7ae8dd: posts small blind $0.05
2c07de8a: posts big blind $0.1
*** HOLE CARDS ***
Dealt to 4aca1dfa 
Dealt to 9b7ae8dd 
Dealt to 2c07de8a 
Dealt to Hero [9s Jh]
Dealt to 6c6fb8b0 
Dealt to af50e261 
Hero: folds
6c6fb8b0: folds
af50e261: folds
4aca1dfa: raises $0.15 to $0.25
9b7ae8dd: raises $0.75 to $1
2c07de8a: folds
4aca1dfa: calls $0.75
*** FLOP *** [Ts 5d Ad]
9b7ae8dd: bets $0.9
4aca1dfa: calls $0.9
*** TURN *** [Ts 5d Ad] [Tc]
9b7ae8dd: checks
4aca1dfa: checks
*** RIVER *** [Ts 5d Ad Tc] [Qh]
9b7ae8dd: bets $2.25
4aca1dfa: folds
Uncalled bet ($2.25) returned to 9b7ae8dd
*** SHOWDOWN ***
9b7ae8dd collected $3.57 from pot
*** SUMMARY ***
Total pot $3.9 | Rake $0.18 | Jackpot $0.15 | Bingo $0 | Fortune $0
Board [Ts 5d Ad Tc Qh]
Seat 1: 4aca1dfa (button) folded on the River
Seat 2: 9b7ae8dd (small blind) won ($3.57)
Seat 3: 2c07de8a (big blind) folded before Flop
Seat 4: Hero folded before Flop (didn't bet)
Seat 5: 6c6fb8b0 folded before Flop (didn't bet)
Seat 6: af50e261 folded before Flop (didn't bet)


Poker Hand #RC1450290713: Hold'em No Limit  ($0.05/$0.1) - 2023/04/04 14:04:46
Table 'RushAndCash1735973' 6-max Seat #1 is the button
Seat 1: 93d67df6 ($10.54 in chips)
Seat 2: Hero ($25.03 in chips)
Seat 3: 56f54f19 ($31.91 in chips)
Seat 4: 3a233d9d ($10.29 in chips)
Seat 5: bc88d1e3 ($10.47 in chips)
Seat 6: 7e3eec67 ($7.8 in chips)
Hero: posts small blind $0.05
56f54f19: posts big blind $0.1
*** HOLE CARDS ***
Dealt to 93d67df6 
Dealt to Hero [3d 6d]
Dealt to 56f54f19 
Dealt to 3a233d9d 
Dealt to bc88d1e3 
Dealt to 7e3eec67 
3a233d9d: folds
bc88d1e3: folds
7e3eec67: folds
93d67df6: folds
Hero: folds
Uncalled bet ($0.05) returned to 56f54f19
*** SHOWDOWN ***
56f54f19 collected $0.1 from pot
*** SUMMARY ***
Total pot $0.1 | Rake $0 | Jackpot $0 | Bingo $0 | Fortune $0
Seat 1: 93d67df6 (button) folded before Flop (didn't bet)
Seat 2: Hero (small blind) folded before Flop
Seat 3: 56f54f19 (big blind) collected ($0.1)
Seat 4: 3a233d9d folded before Flop (didn't bet)
Seat 5: bc88d1e3 folded before Flop (didn't bet)
Seat 6: 7e3eec67 folded before Flop (didn't bet)


Poker Hand #RC1450290464: Hold'em No Limit  ($0.05/$0.1) - 2023/04/04 14:04:04
Table 'RushAndCash1735724' 6-max Seat #1 is the button
Seat 1: 5e4c3740 ($16.61 in chips)
Seat 2: ca953875 ($10 in chips)
Seat 3: Hero ($25.33 in chips)
Seat 4: d8fb67b8 ($10.53 in chips)
Seat 5: 562dfc2e ($10.1 in chips)
Seat 6: bc88d1e3 ($10.15 in chips)
ca953875: posts small blind $0.05
Hero: posts big blind $0.1
*** HOLE CARDS ***
Dealt to 5e4c3740 
Dealt to ca953875 
Dealt to Hero [4c 5c]
Dealt to d8fb67b8 
Dealt to 562dfc2e 
Dealt to bc88d1e3 
d8fb67b8: folds
562dfc2e: folds
bc88d1e3: raises $0.2 to $0.3
5e4c3740: folds
ca953875: folds
Hero: calls $0.2
*** FLOP *** [Jd 3d Kd]
Hero: checks
bc88d1e3: bets $0.25
Hero: folds
Uncalled bet ($0.25) returned to bc88d1e3
*** SHOWDOWN ***
bc88d1e3 collected $0.62 from pot
*** SUMMARY ***
Total pot $0.65 | Rake $0.03 | Jackpot $0 | Bingo $0 | Fortune $0
Board [Jd 3d Kd]
Seat 1: 5e4c3740 (button) folded before Flop (didn't bet)
Seat 2: ca953875 (small blind) folded before Flop
Seat 3: Hero (big blind) folded on the Flop
Seat 4: d8fb67b8 folded before Flop (didn't bet)
Seat 5: 562dfc2e folded before Flop (didn't bet)
Seat 6: bc88d1e3 won ($0.62)


Poker Hand #RC1450290432: Hold'em No Limit  ($0.05/$0.1) - 2023/04/04 14:03:59
Table 'RushAndCash1735692' 6-max Seat #1 is the button
Seat 1: 7046c8f8 ($19.83 in chips)
Seat 2: b8fb2e35 ($25.66 in chips)
Seat 3: c99470e5 ($10.42 in chips)
Seat 4: 91786260 ($17.39 in chips)
Seat 5: b9e733ee ($24.68 in chips)
Seat 6: Hero ($25.33 in chips)
b8fb2e35: posts small blind $0.05
c99470e5: posts big blind $0.1
*** HOLE CARDS ***
Dealt to 7046c8f8 
Dealt to b8fb2e35 
Dealt to c99470e5 
Dealt to 91786260 
Dealt to b9e733ee 
Dealt to Hero [4h 3c]
91786260: folds
b9e733ee: raises $0.1 to $0.2
Hero: folds
7046c8f8: folds
b8fb2e35: folds
c99470e5: calls $0.1
*** FLOP *** [Td Ah 4s]
c99470e5: checks
b9e733ee: bets $0.2
c99470e5: folds
Uncalled bet ($0.2) returned to b9e733ee
*** SHOWDOWN ***
b9e733ee collected $0.43 from pot
*** SUMMARY ***
Total pot $0.45 | Rake $0.02 | Jackpot $0 | Bingo $0 | Fortune $0
Board [Td Ah 4s]
Seat 1: 7046c8f8 (button) folded before Flop (didn't bet)
Seat 2: b8fb2e35 (small blind) folded before Flop
Seat 3: c99470e5 (big blind) folded on the Flop
Seat 4: 91786260 folded before Flop (didn't bet)
Seat 5: b9e733ee won ($0.43)
Seat 6: Hero folded before Flop (didn't bet)


Poker Hand #RC1450290400: Hold'em No Limit  ($0.05/$0.1) - 2023/04/04 14:03:54
Table 'RushAndCash1735660' 6-max Seat #1 is the button
Seat 1: Hero ($25.33 in chips)
Seat 2: 7e925928 ($5 in chips)
Seat 3: bd9208e3 ($12.09 in chips)
Seat 4: 94531820 ($10.5 in chips)
Seat 5: c03d4f91 ($10.29 in chips)
Seat 6: f9b983f7 ($8.39 in chips)
7e925928: posts small blind $0.05
bd9208e3: posts big blind $0.1
*** HOLE CARDS ***
Dealt to Hero [6h 8c]
Dealt to 7e925928 
Dealt to bd9208e3 
Dealt to 94531820 
Dealt to c03d4f91 
Dealt to f9b983f7 
94531820: folds
c03d4f91: folds
f9b983f7: folds
Hero: folds
7e925928: calls $0.05
bd9208e3: checks
*** FLOP *** [Ad Qc Js]
7e925928: bets $0.1
bd9208e3: folds
Uncalled bet ($0.1) returned to 7e925928
*** SHOWDOWN ***
7e925928 collected $0.19 from pot
*** SUMMARY ***
Total pot $0.2 | Rake $0.01 | Jackpot $0 | Bingo $0 | Fortune $0
Board [Ad Qc Js]
Seat 1: Hero (button) folded before Flop (didn't bet)
Seat 2: 7e925928 (small blind) won ($0.19)
Seat 3: bd9208e3 (big blind) folded on the Flop
Seat 4: 94531820 folded before Flop (didn't bet)
Seat 5: c03d4f91 folded before Flop (didn't bet)
Seat 6: f9b983f7 folded before Flop (didn't bet)


Poker Hand #RC1450290359: Hold'em No Limit  ($0.05/$0.1) - 2023/04/04 14:03:47
Table 'RushAndCash1735619' 6-max Seat #1 is the button
Seat 1: 926afae ($11.85 in chips)
Seat 2: 580ebf6e ($9.14 in chips)
Seat 3: 131cae3a ($6.65 in chips)
Seat 4: a4e7cb4a ($11.33 in chips)
Seat 5: Hero ($25.33 in chips)
Seat 6: 6dadd287 ($3.28 in chips)
580ebf6e: posts small blind $0.05
131cae3a: posts big blind $0.1
*** HOLE CARDS ***
Dealt to 926afae 
Dealt to 580ebf6e 
Dealt to 131cae3a 
Dealt to a4e7cb4a 
Dealt to Hero [4s 7s]
Dealt to 6dadd287 
a4e7cb4a: raises $0.12 to $0.22
Hero: folds
6dadd287: folds
926afae: folds
580ebf6e: calls $0.17
131cae3a: folds
*** FLOP *** [5c Ad 8c]
580ebf6e: bets $0.27
a4e7cb4a: raises $0.83 to $1.1
580ebf6e: calls $0.83
*** TURN *** [5c Ad 8c] [Jd]
580ebf6e: checks
a4e7cb4a: bets $2.4
580ebf6e: calls $2.4
*** RIVER *** [5c Ad 8c Jd] [2h]
580ebf6e: checks
a4e7cb4a: bets $7.61 and is all-in
580ebf6e: folds
Uncalled bet ($7.61) returned to a4e7cb4a
*** SHOWDOWN ***
a4e7cb4a collected $7.09 from pot
*** SUMMARY ***
Total pot $7.54 | Rake $0.3 | Jackpot $0.15 | Bingo $0 | Fortune $0
Board [5c Ad 8c Jd 2h]
Seat 1: 926afae (button) folded before Flop (didn't bet)
Seat 2: 580ebf6e (small blind) folded on the River
Seat 3: 131cae3a (big blind) folded before Flop
Seat 4: a4e7cb4a won ($7.09)
Seat 5: Hero folded before Flop (didn't bet)
Seat 6: 6dadd287 folded before Flop (didn't bet)


Poker Hand #RC1450289415: Hold'em No Limit  ($0.05/$0.1) - 2023/04/04 14:01:16
Table 'RushAndCash1734675' 6-max Seat #1 is the button
Seat 1: 2659bcc ($13.45 in chips)
Seat 2: cdd88429 ($11.86 in chips)
Seat 3: 7f126f89 ($15.37 in chips)
Seat 4: 47ba2001 ($11.96 in chips)
Seat 5: 48e8cf66 ($11.83 in chips)
Seat 6: Hero ($24.03 in chips)
cdd88429: posts small blind $0.05
7f126f89: posts big blind $0.1
*** HOLE CARDS ***
Dealt to 2659bcc 
Dealt to cdd88429 
Dealt to 7f126f89 
Dealt to 47ba2001 
Dealt to 48e8cf66 
Dealt to Hero [9d 9s]
47ba2001: folds
48e8cf66: folds
Hero: raises $0.15 to $0.25
2659bcc: raises $0.49 to $0.74
cdd88429: folds
7f126f89: folds
Hero: calls $0.49
*** FLOP *** [Ad 2s 9c]
Hero: checks
2659bcc: bets $0.54
Hero: calls $0.54
*** TURN *** [Ad 2s 9c] [Qc]
Hero: checks
2659bcc: checks
*** RIVER *** [Ad 2s 9c Qc] [4h]
Hero: bets $2
2659bcc: folds
Uncalled bet ($2) returned to Hero
*** SHOWDOWN ***
Hero collected $2.58 from pot
*** SUMMARY ***
Total pot $2.71 | Rake $0.13 | Jackpot $0 | Bingo $0 | Fortune $0
Board [Ad 2s 9c Qc 4h]
Seat 1: 2659bcc (button) folded on the River
Seat 2: cdd88429 (small blind) folded before Flop
Seat 3: 7f126f89 (big blind) folded before Flop
Seat 4: 47ba2001 folded before Flop (didn't bet)
Seat 5: 48e8cf66 folded before Flop (didn't bet)
Seat 6: Hero won ($2.58)


Poker Hand #RC1450289315: Hold'em No Limit  ($0.05/$0.1) - 2023/04/04 14:01:00
Table 'RushAndCash1734575' 6-max Seat #1 is the button
Seat 1: Hero ($24.03 in chips)
Seat 2: 42313935 ($17.77 in chips)
Seat 3: c5c19f04 ($10.15 in chips)
Seat 4: 2e2c5de2 ($10.23 in chips)
Seat 5: d9305c7b ($10.2 in chips)
Seat 6: 4e0c6c2a ($10 in chips)
42313935: posts small blind $0.05
c5c19f04: posts big blind $0.1
*** HOLE CARDS ***
Dealt to Hero [8s 2c]
Dealt to 42313935 
Dealt to c5c19f04 
Dealt to 2e2c5de2 
Dealt to d9305c7b 
Dealt to 4e0c6c2a 
2e2c5de2: folds
d9305c7b: raises $0.2 to $0.3
4e0c6c2a: folds
Hero: folds
42313935: folds
c5c19f04: folds
Uncalled bet ($0.2) returned to d9305c7b
*** SHOWDOWN ***
d9305c7b collected $0.25 from pot
*** SUMMARY ***
Total pot $0.25 | Rake $0 | Jackpot $0 | Bingo $0 | Fortune $0
Seat 1: Hero (button) folded before Flop (didn't bet)
Seat 2: 42313935 (small blind) folded before Flop
Seat 3: c5c19f04 (big blind) folded before Flop
Seat 4: 2e2c5de2 folded before Flop (didn't bet)
Seat 5: d9305c7b collected ($0.25)
Seat 6: 4e0c6c2a folded before Flop (didn't bet)


Poker Hand #RC1450289251: Hold'em No Limit  ($0.05/$0.1) - 2023/04/04 14:00:49
Table 'RushAndCash1734511' 6-max Seat #1 is the button
Seat 1: 967b5491 ($12.4 in chips)
Seat 2: 5d0602f ($55.43 in chips)
Seat 3: Hero ($24.13 in chips)
Seat 4: e35428b6 ($10 in chips)
Seat 5: 5f84c35a ($18.32 in chips)
Seat 6: 4fce061d ($10.45 in chips)
5d0602f: posts small blind $0.05
Hero: posts big blind $0.1
*** HOLE CARDS ***
Dealt to 967b5491 
Dealt to 5d0602f 
Dealt to Hero [3s 5h]
Dealt to e35428b6 
Dealt to 5f84c35a 
Dealt to 4fce061d 
e35428b6: folds
5f84c35a: folds
4fce061d: folds
967b5491: folds
5d0602f: raises $0.2 to $0.3
Hero: folds
Uncalled bet ($0.2) returned to 5d0602f
*** SHOWDOWN ***
5d0602f collected $0.2 from pot
*** SUMMARY ***
Total pot $0.2 | Rake $0 | Jackpot $0 | Bingo $0 | Fortune $0
Seat 1: 967b5491 (button) folded before Flop (didn't bet)
Seat 2: 5d0602f (small blind) collected ($0.2)
Seat 3: Hero (big blind) folded before Flop
Seat 4: e35428b6 folded before Flop (didn't bet)
Seat 5: 5f84c35a folded before Flop (didn't bet)
Seat 6: 4fce061d folded before Flop (didn't bet)


Poker Hand #RC1450289190: Hold'em No Limit  ($0.05/$0.1) - 2023/04/04 14:00:41
Table 'RushAndCash1734450' 6-max Seat #1 is the button
Seat 1: 2a14239b ($132.77 in chips)
Seat 2: Hero ($24.18 in chips)
Seat 3: d9305c7b ($10.15 in chips)
Seat 4: 7c3a0ea8 ($11.75 in chips)
Seat 5: 5513bfa4 ($11.63 in chips)
Seat 6: 580ebf6e ($9.49 in chips)
Hero: posts small blind $0.05
d9305c7b: posts big blind $0.1
*** HOLE CARDS ***
Dealt to 2a14239b 
Dealt to Hero [9d 2s]
Dealt to d9305c7b 
Dealt to 7c3a0ea8 
Dealt to 5513bfa4 
Dealt to 580ebf6e 
7c3a0ea8: folds
5513bfa4: folds
580ebf6e: folds
2a14239b: folds
Hero: folds
Uncalled bet ($0.05) returned to d9305c7b
*** SHOWDOWN ***
d9305c7b collected $0.1 from pot
*** SUMMARY ***
Total pot $0.1 | Rake $0 | Jackpot $0 | Bingo $0 | Fortune $0
Seat 1: 2a14239b (button) folded before Flop (didn't bet)
Seat 2: Hero (small blind) folded before Flop
Seat 3: d9305c7b (big blind) collected ($0.1)
Seat 4: 7c3a0ea8 folded before Flop (didn't bet)
Seat 5: 5513bfa4 folded before Flop (didn't bet)
Seat 6: 580ebf6e folded before Flop (didn't bet)


Poker Hand #RC1450289029: Hold'em No Limit  ($0.05/$0.1) - 2023/04/04 14:00:14
Table 'RushAndCash1734289' 6-max Seat #1 is the button
Seat 1: 7046c8f8 ($10 in chips)
Seat 2: 22fc2efd ($24.05 in chips)
Seat 3: 967b5491 ($12.55 in chips)
Seat 4: 2a14239b ($133.02 in chips)
Seat 5: 6048193f ($11.56 in chips)
Seat 6: Hero ($23.81 in chips)
22fc2efd: posts small blind $0.05
967b5491: posts big blind $0.1
*** HOLE CARDS ***
Dealt to 7046c8f8 
Dealt to 22fc2efd 
Dealt to 967b5491 
Dealt to 2a14239b 
Dealt to 6048193f 
Dealt to Hero [Ks Kh]
2a14239b: raises $0.15 to $0.25
6048193f: folds
Hero: raises $0.54 to $0.79
7046c8f8: folds
22fc2efd: folds
967b5491: folds
2a14239b: folds
Uncalled bet ($0.54) returned to Hero
*** SHOWDOWN ***
Hero collected $0.62 from pot
*** SUMMARY ***
Total pot $0.65 | Rake $0.03 | Jackpot $0 | Bingo $0 | Fortune $0
Seat 1: 7046c8f8 (button) folded before Flop (didn't bet)
Seat 2: 22fc2efd (small blind) folded before Flop
Seat 3: 967b5491 (big blind) folded before Flop
Seat 4: 2a14239b folded before Flop
Seat 5: 6048193f folded before Flop (didn't bet)
Seat 6: Hero collected ($0.62)


Poker Hand #RC1450289000: Hold'em No Limit  ($0.05/$0.1) - 2023/04/04 14:00:09
Table 'RushAndCash1734260' 6-max Seat #1 is the button
Seat 1: a64a1b05 ($10.2 in chips)
Seat 2: 375a5192 ($12.6 in chips)
Seat 3: e755990e ($13.05 in chips)
Seat 4: 1c152682 ($10.58 in chips)
Seat 5: e4337282 ($26.7 in chips)
Seat 6: Hero ($23.81 in chips)
375a5192: posts small blind $0.05
e755990e: posts big blind $0.1
*** HOLE CARDS ***
Dealt to a64a1b05 
Dealt to 375a5192 
Dealt to e755990e 
Dealt to 1c152682 
Dealt to e4337282 
Dealt to Hero [6d 3s]
1c152682: folds
e4337282: folds
Hero: folds
a64a1b05: folds
375a5192: folds
Uncalled bet ($0.05) returned to e755990e
*** SHOWDOWN ***
e755990e collected $0.1 from pot
*** SUMMARY ***
Total pot $0.1 | Rake $0 | Jackpot $0 | Bingo $0 | Fortune $0
Seat 1: a64a1b05 (button) folded before Flop (didn't bet)
Seat 2: 375a5192 (small blind) folded before Flop
Seat 3: e755990e (big blind) collected ($0.1)
Seat 4: 1c152682 folded before Flop (didn't bet)
Seat 5: e4337282 folded before Flop (didn't bet)
Seat 6: Hero folded before Flop (didn't bet)


Poker Hand #RC1450288975: Hold'em No Limit  ($0.05/$0.1) - 2023/04/04 14:00:05
Table 'RushAndCash1734235' 6-max Seat #1 is the button
Seat 1: 1ef3fbaf ($12.36 in chips)
Seat 2: Hero ($23.86 in chips)
Seat 3: 29a621d6 ($10.8 in chips)
Seat 4: 56d5375c ($10 in chips)
Seat 5: 3ac485b0 ($4.35 in chips)
Seat 6: 4cf04597 ($10 in chips)
Hero: posts small blind $0.05
29a621d6: posts big blind $0.1
*** HOLE CARDS ***
Dealt to 1ef3fbaf 
Dealt to Hero [6d 3c]
Dealt to 29a621d6 
Dealt to 56d5375c 
Dealt to 3ac485b0 
Dealt to 4cf04597 
56d5375c: folds
3ac485b0: folds
4cf04597: folds
1ef3fbaf: raises $0.1 to $0.2
Hero: folds
29a621d6: folds
Uncalled bet ($0.1) returned to 1ef3fbaf
*** SHOWDOWN ***
1ef3fbaf collected $0.25 from pot
*** SUMMARY ***
Total pot $0.25 | Rake $0 | Jackpot $0 | Bingo $0 | Fortune $0
Seat 1: 1ef3fbaf (button) collected ($0.25)
Seat 2: Hero (small blind) folded before Flop
Seat 3: 29a621d6 (big blind) folded before Flop
Seat 4: 56d5375c folded before Flop (didn't bet)
Seat 5: 3ac485b0 folded before Flop (didn't bet)
Seat 6: 4cf04597 folded before Flop (didn't bet)


Poker Hand #RC1450288875: Hold'em No Limit  ($0.05/$0.1) - 2023/04/04 13:59:49
Table 'RushAndCash1734135' 6-max Seat #1 is the button
Seat 1: ead27665 ($9.45 in chips)
Seat 2: fbe91f05 ($14.88 in chips)
Seat 3: Hero ($23.96 in chips)
Seat 4: 90ba0857 ($26.48 in chips)
Seat 5: 7046c8f8 ($10 in chips)
Seat 6: d95430be ($10 in chips)
fbe91f05: posts small blind $0.05
Hero: posts big blind $0.1
*** HOLE CARDS ***
Dealt to ead27665 
Dealt to fbe91f05 
Dealt to Hero [2h 3s]
Dealt to 90ba0857 
Dealt to 7046c8f8 
Dealt to d95430be 
90ba0857: folds
7046c8f8: folds
d95430be: raises $0.15 to $0.25
ead27665: raises $0.49 to $0.74
fbe91f05: folds
Hero: folds
d95430be: folds
Uncalled bet ($0.49) returned to ead27665
*** SHOWDOWN ***
ead27665 collected $0.62 from pot
*** SUMMARY ***
Total pot $0.65 | Rake $0.03 | Jackpot $0 | Bingo $0 | Fortune $0
Seat 1: ead27665 (button) collected ($0.62)
Seat 2: fbe91f05 (small blind) folded before Flop
Seat 3: Hero (big blind) folded before Flop
Seat 4: 90ba0857 folded before Flop (didn't bet)
Seat 5: 7046c8f8 folded before Flop (didn't bet)
Seat 6: d95430be folded before Flop


Poker Hand #RC1450288844: Hold'em No Limit  ($0.05/$0.1) - 2023/04/04 13:59:43
Table 'RushAndCash1734104' 6-max Seat #1 is the button
Seat 1: Hero ($23.96 in chips)
Seat 2: 1dd104a3 ($10.45 in chips)
Seat 3: 68c8bbb ($9.95 in chips)
Seat 4: 89c555d3 ($13.38 in chips)
Seat 5: c74ff8d7 ($12.43 in chips)
Seat 6: 741f86e ($37.85 in chips)
1dd104a3: posts small blind $0.05
68c8bbb: posts big blind $0.1
*** HOLE CARDS ***
Dealt to Hero [3s 4h]
Dealt to 1dd104a3 
Dealt to 68c8bbb 
Dealt to 89c555d3 
Dealt to c74ff8d7 
Dealt to 741f86e 
89c555d3: raises $0.12 to $0.22
c74ff8d7: folds
741f86e: folds
Hero: folds
1dd104a3: raises $0.88 to $1.1
68c8bbb: folds
89c555d3: folds
Uncalled bet ($0.88) returned to 1dd104a3
*** SHOWDOWN ***
1dd104a3 collected $0.52 from pot
*** SUMMARY ***
Total pot $0.54 | Rake $0.02 | Jackpot $0 | Bingo $0 | Fortune $0
Seat 1: Hero (button) folded before Flop (didn't bet)
Seat 2: 1dd104a3 (small blind) collected ($0.52)
Seat 3: 68c8bbb (big blind) folded before Flop
Seat 4: 89c555d3 folded before Flop
Seat 5: c74ff8d7 folded before Flop (didn't bet)
Seat 6: 741f86e folded before Flop (didn't bet)


Poker Hand #RC1450288815: Hold'em No Limit  ($0.05/$0.1) - 2023/04/04 13:59:38
Table 'RushAndCash1734075' 6-max Seat #1 is the button
Seat 1: dc1b263b ($10.66 in chips)
Seat 2: 835b78d9 ($10.2 in chips)
Seat 3: 7d168d46 ($10.15 in chips)
Seat 4: Hero ($23.96 in chips)
Seat 5: 275dd1a1 ($10.27 in chips)
Seat 6: 903f94a9 ($5.14 in chips)
835b78d9: posts small blind $0.05
7d168d46: posts big blind $0.1
*** HOLE CARDS ***
Dealt to dc1b263b 
Dealt to 835b78d9 
Dealt to 7d168d46 
Dealt to Hero [8c Jd]
Dealt to 275dd1a1 
Dealt to 903f94a9 
Hero: folds
275dd1a1: folds
903f94a9: folds
dc1b263b: folds
835b78d9: folds
Uncalled bet ($0.05) returned to 7d168d46
*** SHOWDOWN ***
7d168d46 collected $0.1 from pot
*** SUMMARY ***
Total pot $0.1 | Rake $0 | Jackpot $0 | Bingo $0 | Fortune $0
Seat 1: dc1b263b (button) folded before Flop (didn't bet)
Seat 2: 835b78d9 (small blind) folded before Flop
Seat 3: 7d168d46 (big blind) collected ($0.1)
Seat 4: Hero folded before Flop (didn't bet)
Seat 5: 275dd1a1 folded before Flop (didn't bet)
Seat 6: 903f94a9 folded before Flop (didn't bet)


Poker Hand #RC1450288726: Hold'em No Limit  ($0.05/$0.1) - 2023/04/04 13:59:25
Table 'RushAndCash1733986' 6-max Seat #1 is the button
Seat 1: 56f54f19 ($31.77 in chips)
Seat 2: badfb4bf ($17.83 in chips)
Seat 3: 9052a998 ($14.89 in chips)
Seat 4: Hero ($23.81 in chips)
Seat 5: fcc0cf9c ($26.44 in chips)
Seat 6: a8919337 ($10.15 in chips)
badfb4bf: posts small blind $0.05
9052a998: posts big blind $0.1
*** HOLE CARDS ***
Dealt to 56f54f19 
Dealt to badfb4bf 
Dealt to 9052a998 
Dealt to Hero [As Jd]
Dealt to fcc0cf9c 
Dealt to a8919337 
Hero: raises $0.15 to $0.25
fcc0cf9c: folds
a8919337: folds
56f54f19: folds
badfb4bf: folds
9052a998: folds
Uncalled bet ($0.15) returned to Hero
*** SHOWDOWN ***
Hero collected $0.25 from pot
*** SUMMARY ***
Total pot $0.25 | Rake $0 | Jackpot $0 | Bingo $0 | Fortune $0
Seat 1: 56f54f19 (button) folded before Flop (didn't bet)
Seat 2: badfb4bf (small blind) folded before Flop
Seat 3: 9052a998 (big blind) folded before Flop
Seat 4: Hero collected ($0.25)
Seat 5: fcc0cf9c folded before Flop (didn't bet)
Seat 6: a8919337 folded before Flop (didn't bet)


Poker Hand #RC1450288661: Hold'em No Limit  ($0.05/$0.1) - 2023/04/04 13:59:14
Table 'RushAndCash1733921' 6-max Seat #1 is the button
Seat 1: ec6bfae0 ($10 in chips)
Seat 2: Hero ($23.86 in chips)
Seat 3: 969f2365 ($12.43 in chips)
Seat 4: 99569be ($10.1 in chips)
Seat 5: 93344214 ($66.46 in chips)
Seat 6: 56f54f19 ($31.77 in chips)
Hero: posts small blind $0.05
969f2365: posts big blind $0.1
*** HOLE CARDS ***
Dealt to ec6bfae0 
Dealt to Hero [Jc 2h]
Dealt to 969f2365 
Dealt to 99569be 
Dealt to 93344214 
Dealt to 56f54f19 
99569be: folds
93344214: folds
56f54f19: folds
ec6bfae0: folds
Hero: folds
Uncalled bet ($0.05) returned to 969f2365
*** SHOWDOWN ***
969f2365 collected $0.1 from pot
*** SUMMARY ***
Total pot $0.1 | Rake $0 | Jackpot $0 | Bingo $0 | Fortune $0
Seat 1: ec6bfae0 (button) folded before Flop (didn't bet)
Seat 2: Hero (small blind) folded before Flop
Seat 3: 969f2365 (big blind) collected ($0.1)
Seat 4: 99569be folded before Flop (didn't bet)
Seat 5: 93344214 folded before Flop (didn't bet)
Seat 6: 56f54f19 folded before Flop (didn't bet)


Poker Hand #RC1450288616: Hold'em No Limit  ($0.05/$0.1) - 2023/04/04 13:59:07
Table 'RushAndCash1733876' 6-max Seat #1 is the button
Seat 1: 664b025e ($10.94 in chips)
Seat 2: 4dc1749 ($10.05 in chips)
Seat 3: Hero ($23.96 in chips)
Seat 4: cab54030 ($9.88 in chips)
Seat 5: d7a988df ($10 in chips)
Seat 6: 5352f853 ($10.82 in chips)
4dc1749: posts small blind $0.05
Hero: posts big blind $0.1
*** HOLE CARDS ***
Dealt to 664b025e 
Dealt to 4dc1749 
Dealt to Hero [2h 5c]
Dealt to cab54030 
Dealt to d7a988df 
Dealt to 5352f853 
cab54030: raises $0.1 to $0.2
d7a988df: folds
5352f853: folds
664b025e: folds
4dc1749: folds
Hero: folds
Uncalled bet ($0.1) returned to cab54030
*** SHOWDOWN ***
cab54030 collected $0.25 from pot
*** SUMMARY ***
Total pot $0.25 | Rake $0 | Jackpot $0 | Bingo $0 | Fortune $0
Seat 1: 664b025e (button) folded before Flop (didn't bet)
Seat 2: 4dc1749 (small blind) folded before Flop
Seat 3: Hero (big blind) folded before Flop
Seat 4: cab54030 collected ($0.25)
Seat 5: d7a988df folded before Flop (didn't bet)
Seat 6: 5352f853 folded before Flop (didn't bet)


Poker Hand #RC1450288572: Hold'em No Limit  ($0.05/$0.1) - 2023/04/04 13:59:00
Table 'RushAndCash1733832' 6-max Seat #1 is the button
Seat 1: 892df41c ($11.61 in chips)
Seat 2: 3c627a6a ($4.13 in chips)
Seat 3: 46808144 ($10.59 in chips)
Seat 4: b18aa276 ($7.86 in chips)
Seat 5: 83b59100 ($12.37 in chips)
Seat 6: Hero ($23.96 in chips)
3c627a6a: posts small blind $0.05
46808144: posts big blind $0.1
*** HOLE CARDS ***
Dealt to 892df41c 
Dealt to 3c627a6a 
Dealt to 46808144 
Dealt to b18aa276 
Dealt to 83b59100 
Dealt to Hero [Tc 8s]
b18aa276: folds
83b59100: folds
Hero: folds
892df41c: folds
3c627a6a: raises $0.2 to $0.3
46808144: folds
Uncalled bet ($0.2) returned to 3c627a6a
*** SHOWDOWN ***
3c627a6a collected $0.2 from pot
*** SUMMARY ***
Total pot $0.2 | Rake $0 | Jackpot $0 | Bingo $0 | Fortune $0
Seat 1: 892df41c (button) folded before Flop (didn't bet)
Seat 2: 3c627a6a (small blind) collected ($0.2)
Seat 3: 46808144 (big blind) folded before Flop
Seat 4: b18aa276 folded before Flop (didn't bet)
Seat 5: 83b59100 folded before Flop (didn't bet)
Seat 6: Hero folded before Flop (didn't bet)


Poker Hand #RC1450288457: Hold'em No Limit  ($0.05/$0.1) - 2023/04/04 13:58:42
Table 'RushAndCash1733717' 6-max Seat #1 is the button
Seat 1: e4337282 ($26.65 in chips)
Seat 2: fe2ac48a ($13.59 in chips)
Seat 3: cb150ed4 ($14.06 in chips)
Seat 4: Hero ($23.96 in chips)
Seat 5: 8d482961 ($25.49 in chips)
Seat 6: a541cdb8 ($21.27 in chips)
fe2ac48a: posts small blind $0.05
cb150ed4: posts big blind $0.1
*** HOLE CARDS ***
Dealt to e4337282 
Dealt to fe2ac48a 
Dealt to cb150ed4 
Dealt to Hero [2c 5d]
Dealt to 8d482961 
Dealt to a541cdb8 
Hero: folds
8d482961: raises $0.1 to $0.2
a541cdb8: folds
e4337282: folds
fe2ac48a: raises $0.8 to $1
cb150ed4: folds
8d482961: calls $0.8
*** FLOP *** [7d 9s Ah]
fe2ac48a: bets $1.05
8d482961: folds
Uncalled bet ($1.05) returned to fe2ac48a
*** SHOWDOWN ***
fe2ac48a collected $2 from pot
*** SUMMARY ***
Total pot $2.1 | Rake $0.1 | Jackpot $0 | Bingo $0 | Fortune $0
Board [7d 9s Ah]
Seat 1: e4337282 (button) folded before Flop (didn't bet)
Seat 2: fe2ac48a (small blind) won ($2)
Seat 3: cb150ed4 (big blind) folded before Flop
Seat 4: Hero folded before Flop (didn't bet)
Seat 5: 8d482961 folded on the Flop
Seat 6: a541cdb8 folded before Flop (didn't bet)


Poker Hand #RC1450288361: Hold'em No Limit  ($0.05/$0.1) - 2023/04/04 13:58:28
Table 'RushAndCash1733621' 6-max Seat #1 is the button
Seat 1: Hero ($23.96 in chips)
Seat 2: 3eae412f ($18.07 in chips)
Seat 3: 3491822 ($9.77 in chips)
Seat 4: 6cf55711 ($17.34 in chips)
Seat 5: 4498df0d ($11.31 in chips)
Seat 6: 6dadd287 ($5.82 in chips)
3eae412f: posts small blind $0.05
3491822: posts big blind $0.1
*** HOLE CARDS ***
Dealt to Hero [2c As]
Dealt to 3eae412f 
Dealt to 3491822 
Dealt to 6cf55711 
Dealt to 4498df0d 
Dealt to 6dadd287 
6cf55711: folds
4498df0d: raises $0.1 to $0.2
6dadd287: folds
Hero: folds
3eae412f: raises $0.6 to $0.8
3491822: folds
4498df0d: calls $0.6
*** FLOP *** [3d Qd 4s]
3eae412f: bets $0.57
4498df0d: calls $0.57
*** TURN *** [3d Qd 4s] [8d]
3eae412f: bets $2.13
4498df0d: calls $2.13
*** RIVER *** [3d Qd 4s 8d] [2h]
3eae412f: bets $8
4498df0d: calls $7.81 and is all-in
Uncalled bet ($0.19) returned to 3eae412f
3eae412f: shows [Kh Kc] (Pair of Kings)
4498df0d: shows [6d 7d] (Queen High Flush)
*** SHOWDOWN ***
4498df0d collected $22.27 from pot
*** SUMMARY ***
Total pot $22.72 | Rake $0.3 | Jackpot $0.15 | Bingo $0 | Fortune $0
Board [3d Qd 4s 8d 2h]
Seat 1: Hero (button) folded before Flop (didn't bet)
Seat 2: 3eae412f (small blind) showed [Kh Kc] and lost with Pair of Kings
Seat 3: 3491822 (big blind) folded before Flop
Seat 4: 6cf55711 folded before Flop (didn't bet)
Seat 5: 4498df0d showed [6d 7d] and won ($22.27) with Queen High Flush
Seat 6: 6dadd287 folded before Flop (didn't bet)


Poker Hand #RC1450288278: Hold'em No Limit  ($0.05/$0.1) - 2023/04/04 13:58:15
Table 'RushAndCash1733538' 6-max Seat #1 is the button
Seat 1: 4a2da5d7 ($11.14 in chips)
Seat 2: db76e222 ($20.82 in chips)
Seat 3: b600de42 ($11.01 in chips)
Seat 4: 99569be ($10.25 in chips)
Seat 5: 48e8cf66 ($9.88 in chips)
Seat 6: Hero ($23.96 in chips)
db76e222: posts small blind $0.05
b600de42: posts big blind $0.1
*** HOLE CARDS ***
Dealt to 4a2da5d7 
Dealt to db76e222 
Dealt to b600de42 
Dealt to 99569be 
Dealt to 48e8cf66 
Dealt to Hero [Qs 8d]
99569be: folds
48e8cf66: folds
Hero: folds
4a2da5d7: folds
db76e222: folds
Uncalled bet ($0.05) returned to b600de42
*** SHOWDOWN ***
b600de42 collected $0.1 from pot
*** SUMMARY ***
Total pot $0.1 | Rake $0 | Jackpot $0 | Bingo $0 | Fortune $0
Seat 1: 4a2da5d7 (button) folded before Flop (didn't bet)
Seat 2: db76e222 (small blind) folded before Flop
Seat 3: b600de42 (big blind) collected ($0.1)
Seat 4: 99569be folded before Flop (didn't bet)
Seat 5: 48e8cf66 folded before Flop (didn't bet)
Seat 6: Hero folded before Flop (didn't bet)


Poker Hand #RC1450288038: Hold'em No Limit  ($0.05/$0.1) - 2023/04/04 13:57:35
Table 'RushAndCash1733298' 6-max Seat #1 is the button
Seat 1: 235c6019 ($10.05 in chips)
Seat 2: b600de42 ($10 in chips)
Seat 3: aade7c9a ($14.98 in chips)
Seat 4: Hero ($24.21 in chips)
Seat 5: 7520f7cc ($10.34 in chips)
Seat 6: 99569be ($11 in chips)
b600de42: posts small blind $0.05
aade7c9a: posts big blind $0.1
*** HOLE CARDS ***
Dealt to 235c6019 
Dealt to b600de42 
Dealt to aade7c9a 
Dealt to Hero [Ac Ts]
Dealt to 7520f7cc 
Dealt to 99569be 
Hero: raises $0.15 to $0.25
7520f7cc: folds
99569be: raises $0.5 to $0.75
235c6019: folds
b600de42: raises $1.85 to $2.6
aade7c9a: folds
Hero: folds
99569be: folds
Uncalled bet ($1.85) returned to b600de42
*** SHOWDOWN ***
b600de42 collected $1.76 from pot
*** SUMMARY ***
Total pot $1.85 | Rake $0.09 | Jackpot $0 | Bingo $0 | Fortune $0
Seat 1: 235c6019 (button) folded before Flop (didn't bet)
Seat 2: b600de42 (small blind) collected ($1.76)
Seat 3: aade7c9a (big blind) folded before Flop
Seat 4: Hero folded before Flop
Seat 5: 7520f7cc folded before Flop (didn't bet)
Seat 6: 99569be folded before Flop


Poker Hand #RC1450287914: Hold'em No Limit  ($0.05/$0.1) - 2023/04/04 13:57:16
Table 'RushAndCash1733174' 6-max Seat #1 is the button
Seat 1: Hero ($24.21 in chips)
Seat 2: 967782aa ($22.56 in chips)
Seat 3: afd9a8a4 ($44.54 in chips)
Seat 4: 5085fd5 ($13.64 in chips)
Seat 5: 911c0ea5 ($16.82 in chips)
Seat 6: 5c6d2a05 ($21.49 in chips)
967782aa: posts small blind $0.05
afd9a8a4: posts big blind $0.1
*** HOLE CARDS ***
Dealt to Hero [6c Qs]
Dealt to 967782aa 
Dealt to afd9a8a4 
Dealt to 5085fd5 
Dealt to 911c0ea5 
Dealt to 5c6d2a05 
5085fd5: raises $0.15 to $0.25
911c0ea5: folds
5c6d2a05: folds
Hero: folds
967782aa: calls $0.2
afd9a8a4: calls $0.15
*** FLOP *** [7d 9h Qc]
967782aa: checks
afd9a8a4: checks
5085fd5: bets $0.5
967782aa: folds
afd9a8a4: calls $0.5
*** TURN *** [7d 9h Qc] [Qh]
afd9a8a4: checks
5085fd5: bets $1.16
afd9a8a4: folds
Uncalled bet ($1.16) returned to 5085fd5
*** SHOWDOWN ***
5085fd5 collected $1.67 from pot
*** SUMMARY ***
Total pot $1.75 | Rake $0.08 | Jackpot $0 | Bingo $0 | Fortune $0
Board [7d 9h Qc Qh]
Seat 1: Hero (button) folded before Flop (didn't bet)
Seat 2: 967782aa (small blind) folded on the Flop
Seat 3: afd9a8a4 (big blind) folded on the Turn
Seat 4: 5085fd5 won ($1.67)
Seat 5: 911c0ea5 folded before Flop (didn't bet)
Seat 6: 5c6d2a05 folded before Flop (didn't bet)


Poker Hand #RC1450287844: Hold'em No Limit  ($0.05/$0.1) - 2023/04/04 13:57:05
Table 'RushAndCash1733104' 6-max Seat #1 is the button
Seat 1: a8594abd ($43.53 in chips)
Seat 2: Hero ($24.26 in chips)
Seat 3: 2736a486 ($13.71 in chips)
Seat 4: 1c9fa39e ($25.78 in chips)
Seat 5: 5439745c ($9.65 in chips)
Seat 6: 831f6c59 ($8.72 in chips)
Hero: posts small blind $0.05
2736a486: posts big blind $0.1
*** HOLE CARDS ***
Dealt to a8594abd 
Dealt to Hero [4c 6h]
Dealt to 2736a486 
Dealt to 1c9fa39e 
Dealt to 5439745c 
Dealt to 831f6c59 
1c9fa39e: folds
5439745c: folds
831f6c59: raises $0.25 to $0.35
a8594abd: folds
Hero: folds
2736a486: calls $0.25
*** FLOP *** [Js 6d 8s]
2736a486: checks
831f6c59: bets $0.38
2736a486: calls $0.38
*** TURN *** [Js 6d 8s] [Qh]
2736a486: checks
831f6c59: bets $1.14
2736a486: calls $1.14
*** RIVER *** [Js 6d 8s Qh] [5c]
2736a486: checks
831f6c59: checks
2736a486: shows [Kd Ts] (King-High)
831f6c59: shows [Ks Jh] (Pair of Jacks)
*** SHOWDOWN ***
831f6c59 collected $3.46 from pot
*** SUMMARY ***
Total pot $3.79 | Rake $0.18 | Jackpot $0.15 | Bingo $0 | Fortune $0
Board [Js 6d 8s Qh 5c]
Seat 1: a8594abd (button) folded before Flop (didn't bet)
Seat 2: Hero (small blind) folded before Flop
Seat 3: 2736a486 (big blind) showed [Kd Ts] and lost with King-High
Seat 4: 1c9fa39e folded before Flop (didn't bet)
Seat 5: 5439745c folded before Flop (didn't bet)
Seat 6: 831f6c59 showed [Ks Jh] and won ($3.46) with Pair of Jacks


Poker Hand #RC1450287818: Hold'em No Limit  ($0.05/$0.1) - 2023/04/04 13:57:01
Table 'RushAndCash1733078' 6-max Seat #1 is the button
Seat 1: 6048193f ($10 in chips)
Seat 2: e170b23c ($13.3 in chips)
Seat 3: 5d0602f ($57.58 in chips)
Seat 4: Hero ($24.26 in chips)
Seat 5: e6b1c36a ($11.51 in chips)
Seat 6: be3ff53c ($13.12 in chips)
e170b23c: posts small blind $0.05
5d0602f: posts big blind $0.1
*** HOLE CARDS ***
Dealt to 6048193f 
Dealt to e170b23c 
Dealt to 5d0602f 
Dealt to Hero [2h 5h]
Dealt to e6b1c36a 
Dealt to be3ff53c 
Hero: folds
e6b1c36a: folds
be3ff53c: folds
6048193f: raises $0.2 to $0.3
e170b23c: folds
5d0602f: folds
Uncalled bet ($0.2) returned to 6048193f
*** SHOWDOWN ***
6048193f collected $0.25 from pot
*** SUMMARY ***
Total pot $0.25 | Rake $0 | Jackpot $0 | Bingo $0 | Fortune $0
Seat 1: 6048193f (button) collected ($0.25)
Seat 2: e170b23c (small blind) folded before Flop
Seat 3: 5d0602f (big blind) folded before Flop
Seat 4: Hero folded before Flop (didn't bet)
Seat 5: e6b1c36a folded before Flop (didn't bet)
Seat 6: be3ff53c folded before Flop (didn't bet)


Poker Hand #RC1450287752: Hold'em No Limit  ($0.05/$0.1) - 2023/04/04 13:56:51
Table 'RushAndCash1733012' 6-max Seat #1 is the button
Seat 1: 1a522963 ($10 in chips)
Seat 2: d95430be ($11.55 in chips)
Seat 3: Hero ($24.36 in chips)
Seat 4: 969f2365 ($12.06 in chips)
Seat 5: 811b8e96 ($13 in chips)
Seat 6: 4f20efc4 ($8.44 in chips)
d95430be: posts small blind $0.05
Hero: posts big blind $0.1
*** HOLE CARDS ***
Dealt to 1a522963 
Dealt to d95430be 
Dealt to Hero [Jh 2s]
Dealt to 969f2365 
Dealt to 811b8e96 
Dealt to 4f20efc4 
969f2365: raises $0.1 to $0.2
811b8e96: folds
4f20efc4: folds
1a522963: folds
d95430be: folds
Hero: folds
Uncalled bet ($0.1) returned to 969f2365
*** SHOWDOWN ***
969f2365 collected $0.25 from pot
*** SUMMARY ***
Total pot $0.25 | Rake $0 | Jackpot $0 | Bingo $0 | Fortune $0
Seat 1: 1a522963 (button) folded before Flop (didn't bet)
Seat 2: d95430be (small blind) folded before Flop
Seat 3: Hero (big blind) folded before Flop
Seat 4: 969f2365 collected ($0.25)
Seat 5: 811b8e96 folded before Flop (didn't bet)
Seat 6: 4f20efc4 folded before Flop (didn't bet)


Poker Hand #RC1450287720: Hold'em No Limit  ($0.05/$0.1) - 2023/04/04 13:56:46
Table 'RushAndCash1732980' 6-max Seat #1 is the button
Seat 1: d4c3b568 ($7.44 in chips)
Seat 2: 5dcb2cf7 ($12.95 in chips)
Seat 3: 2a8e40f7 ($23.07 in chips)
Seat 4: 5e4c3740 ($18.21 in chips)
Seat 5: Hero ($24.36 in chips)
Seat 6: 2fe76621 ($10 in chips)
5dcb2cf7: posts small blind $0.05
2a8e40f7: posts big blind $0.1
*** HOLE CARDS ***
Dealt to d4c3b568 
Dealt to 5dcb2cf7 
Dealt to 2a8e40f7 
Dealt to 5e4c3740 
Dealt to Hero [4d 5s]
Dealt to 2fe76621 
5e4c3740: folds
Hero: folds
2fe76621: folds
d4c3b568: raises $0.15 to $0.25
5dcb2cf7: folds
2a8e40f7: raises $0.75 to $1
d4c3b568: calls $0.75
*** FLOP *** [Ts 6h 3s]
2a8e40f7: bets $2.05
d4c3b568: calls $2.05
*** TURN *** [Ts 6h 3s] [Kd]
2a8e40f7: bets $20.02 and is all-in
d4c3b568: calls $4.39 and is all-in
Uncalled bet ($15.63) returned to 2a8e40f7
2a8e40f7: shows [Qh Qd] (Pair of Queens)
d4c3b568: shows [Ks Js] (Pair of Kings)
*** RIVER *** [Ts 6h 3s Kd] [Qc]
*** SHOWDOWN ***
2a8e40f7 collected $14.48 from pot
*** SUMMARY ***
Total pot $14.93 | Rake $0.3 | Jackpot $0.15 | Bingo $0 | Fortune $0
Board [Ts 6h 3s Kd Qc]
Seat 1: d4c3b568 (button) showed [Ks Js] and lost with Pair of Kings
Seat 2: 5dcb2cf7 (small blind) folded before Flop
Seat 3: 2a8e40f7 (big blind) showed [Qh Qd] and won ($14.48) with Three Queens
Seat 4: 5e4c3740 folded before Flop (didn't bet)
Seat 5: Hero folded before Flop (didn't bet)
Seat 6: 2fe76621 folded before Flop (didn't bet)


Poker Hand #RC1450287685: Hold'em No Limit  ($0.05/$0.1) - 2023/04/04 13:56:40
Table 'RushAndCash1732945' 6-max Seat #1 is the button
Seat 1: d42d5cb1 ($19.38 in chips)
Seat 2: 6b7032c7 ($10.28 in chips)
Seat 3: b789b917 ($20.1 in chips)
Seat 4: 9da7089d ($10.1 in chips)
Seat 5: Hero ($24.36 in chips)
Seat 6: cdd88429 ($10 in chips)
6b7032c7: posts small blind $0.05
b789b917: posts big blind $0.1
*** HOLE CARDS ***
Dealt to d42d5cb1 
Dealt to 6b7032c7 
Dealt to b789b917 
Dealt to 9da7089d 
Dealt to Hero [Jh 2d]
Dealt to cdd88429 
9da7089d: raises $0.15 to $0.25
Hero: folds
cdd88429: folds
d42d5cb1: raises $0.49 to $0.74
6b7032c7: folds
b789b917: folds
9da7089d: raises $1.43 to $2.17
d42d5cb1: folds
Uncalled bet ($1.43) returned to 9da7089d
*** SHOWDOWN ***
9da7089d collected $1.55 from pot
*** SUMMARY ***
Total pot $1.63 | Rake $0.08 | Jackpot $0 | Bingo $0 | Fortune $0
Seat 1: d42d5cb1 (button) folded before Flop
Seat 2: 6b7032c7 (small blind) folded before Flop
Seat 3: b789b917 (big blind) folded before Flop
Seat 4: 9da7089d collected ($1.55)
Seat 5: Hero folded before Flop (didn't bet)
Seat 6: cdd88429 folded before Flop (didn't bet)


Poker Hand #RC1450287597: Hold'em No Limit  ($0.05/$0.1) - 2023/04/04 13:56:24
Table 'RushAndCash1732857' 6-max Seat #1 is the button
Seat 1: ab1c16ad ($13.3 in chips)
Seat 2: 3da0105d ($2.55 in chips)
Seat 3: ff000f72 ($10.92 in chips)
Seat 4: 54d88467 ($10.15 in chips)
Seat 5: 31d951c2 ($9.88 in chips)
Seat 6: Hero ($24.36 in chips)
3da0105d: posts small blind $0.05
ff000f72: posts big blind $0.1
*** HOLE CARDS ***
Dealt to ab1c16ad 
Dealt to 3da0105d 
Dealt to ff000f72 
Dealt to 54d88467 
Dealt to 31d951c2 
Dealt to Hero [5c Ad]
54d88467: raises $0.12 to $0.22
31d951c2: folds
Hero: folds
ab1c16ad: folds
3da0105d: folds
ff000f72: folds
Uncalled bet ($0.12) returned to 54d88467
*** SHOWDOWN ***
54d88467 collected $0.25 from pot
*** SUMMARY ***
Total pot $0.25 | Rake $0 | Jackpot $0 | Bingo $0 | Fortune $0
Seat 1: ab1c16ad (button) folded before Flop (didn't bet)
Seat 2: 3da0105d (small blind) folded before Flop
Seat 3: ff000f72 (big blind) folded before Flop
Seat 4: 54d88467 collected ($0.25)
Seat 5: 31d951c2 folded before Flop (didn't bet)
Seat 6: Hero folded before Flop (didn't bet)


Poker Hand #RC1450287422: Hold'em No Limit  ($0.05/$0.1) - 2023/04/04 13:55:57
Table 'RushAndCash1732682' 6-max Seat #1 is the button
Seat 1: 52909264 ($11.31 in chips)
Seat 2: cf70d3a9 ($10.33 in chips)
Seat 3: Hero ($24.46 in chips)
Seat 4: d08c8e7d ($23.7 in chips)
Seat 5: f05bb1e1 ($10.32 in chips)
Seat 6: 24bb211c ($23.39 in chips)
cf70d3a9: posts small blind $0.05
Hero: posts big blind $0.1
*** HOLE CARDS ***
Dealt to 52909264 
Dealt to cf70d3a9 
Dealt to Hero [Ks Th]
Dealt to d08c8e7d 
Dealt to f05bb1e1 
Dealt to 24bb211c 
d08c8e7d: folds
f05bb1e1: folds
24bb211c: raises $0.2 to $0.3
52909264: folds
cf70d3a9: folds
Hero: folds
Uncalled bet ($0.2) returned to 24bb211c
*** SHOWDOWN ***
24bb211c collected $0.25 from pot
*** SUMMARY ***
Total pot $0.25 | Rake $0 | Jackpot $0 | Bingo $0 | Fortune $0
Seat 1: 52909264 (button) folded before Flop (didn't bet)
Seat 2: cf70d3a9 (small blind) folded before Flop
Seat 3: Hero (big blind) folded before Flop
Seat 4: d08c8e7d folded before Flop (didn't bet)
Seat 5: f05bb1e1 folded before Flop (didn't bet)
Seat 6: 24bb211c collected ($0.25)


Poker Hand #RC1450287342: Hold'em No Limit  ($0.05/$0.1) - 2023/04/04 13:55:44
Table 'RushAndCash1732602' 6-max Seat #1 is the button
Seat 1: Hero ($24.46 in chips)
Seat 2: e755990e ($12.95 in chips)
Seat 3: 592b6d74 ($10.52 in chips)
Seat 4: 1c9fa39e ($25.51 in chips)
Seat 5: a56b2bd0 ($5.61 in chips)
Seat 6: 1c152682 ($10.7 in chips)
e755990e: posts small blind $0.05
592b6d74: posts big blind $0.1
*** HOLE CARDS ***
Dealt to Hero [9c 8s]
Dealt to e755990e 
Dealt to 592b6d74 
Dealt to 1c9fa39e 
Dealt to a56b2bd0 
Dealt to 1c152682 
1c9fa39e: folds
a56b2bd0: folds
1c152682: folds
Hero: folds
e755990e: folds
Uncalled bet ($0.05) returned to 592b6d74
*** SHOWDOWN ***
592b6d74 collected $0.1 from pot
*** SUMMARY ***
Total pot $0.1 | Rake $0 | Jackpot $0 | Bingo $0 | Fortune $0
Seat 1: Hero (button) folded before Flop (didn't bet)
Seat 2: e755990e (small blind) folded before Flop
Seat 3: 592b6d74 (big blind) collected ($0.1)
Seat 4: 1c9fa39e folded before Flop (didn't bet)
Seat 5: a56b2bd0 folded before Flop (didn't bet)
Seat 6: 1c152682 folded before Flop (didn't bet)


Poker Hand #RC1450287263: Hold'em No Limit  ($0.05/$0.1) - 2023/04/04 13:55:31
Table 'RushAndCash1732523' 6-max Seat #1 is the button
Seat 1: 290a9499 ($18.65 in chips)
Seat 2: Hero ($24.51 in chips)
Seat 3: 9e48a9d4 ($32.61 in chips)
Seat 4: 9da7089d ($10 in chips)
Seat 5: 50f01c6e ($12.34 in chips)
Seat 6: 5c4b1a56 ($11.41 in chips)
Hero: posts small blind $0.05
9e48a9d4: posts big blind $0.1
*** HOLE CARDS ***
Dealt to 290a9499 
Dealt to Hero [3c Qh]
Dealt to 9e48a9d4 
Dealt to 9da7089d 
Dealt to 50f01c6e 
Dealt to 5c4b1a56 
9da7089d: folds
50f01c6e: folds
5c4b1a56: folds
290a9499: folds
Hero: folds
Uncalled bet ($0.05) returned to 9e48a9d4
*** SHOWDOWN ***
9e48a9d4 collected $0.1 from pot
*** SUMMARY ***
Total pot $0.1 | Rake $0 | Jackpot $0 | Bingo $0 | Fortune $0
Seat 1: 290a9499 (button) folded before Flop (didn't bet)
Seat 2: Hero (small blind) folded before Flop
Seat 3: 9e48a9d4 (big blind) collected ($0.1)
Seat 4: 9da7089d folded before Flop (didn't bet)
Seat 5: 50f01c6e folded before Flop (didn't bet)
Seat 6: 5c4b1a56 folded before Flop (didn't bet)


Poker Hand #RC1450286793: Hold'em No Limit  ($0.05/$0.1) - 2023/04/04 13:54:17
Table 'RushAndCash1732053' 6-max Seat #1 is the button
Seat 1: d5088eab ($7.85 in chips)
Seat 2: f337c440 ($19.8 in chips)
Seat 3: 305aa8ba ($6.74 in chips)
Seat 4: Hero ($16.96 in chips)
Seat 5: 433114a5 ($10.37 in chips)
Seat 6: 5dcb2cf7 ($11.49 in chips)
f337c440: posts small blind $0.05
305aa8ba: posts big blind $0.1
*** HOLE CARDS ***
Dealt to d5088eab 
Dealt to f337c440 
Dealt to 305aa8ba 
Dealt to Hero [Kc Kh]
Dealt to 433114a5 
Dealt to 5dcb2cf7 
Hero: raises $0.15 to $0.25
433114a5: folds
5dcb2cf7: folds
d5088eab: raises $0.65 to $0.9
f337c440: folds
305aa8ba: folds
Hero: raises $1.52 to $2.42
d5088eab: calls $1.52
*** FLOP *** [Ks 5d Qd]
Hero: checks
d5088eab: bets $2.5
Hero: raises $3.65 to $6.15
d5088eab: calls $2.93 and is all-in
Uncalled bet ($0.72) returned to Hero
Hero: shows [Kc Kh] (Three Kings)
d5088eab: shows [Jd As] (Ace-High)
*** TURN *** [Ks 5d Qd] [Kd]
*** RIVER *** [Ks 5d Qd Kd] [4h]
*** SHOWDOWN ***
Hero collected $15.4 from pot
*** SUMMARY ***
Total pot $15.85 | Rake $0.3 | Jackpot $0.15 | Bingo $0 | Fortune $0
Board [Ks 5d Qd Kd 4h]
Seat 1: d5088eab (button) showed [Jd As] and lost with Pair of Kings
Seat 2: f337c440 (small blind) folded before Flop
Seat 3: 305aa8ba (big blind) folded before Flop
Seat 4: Hero showed [Kc Kh] and won ($15.4) with Four Kings
Seat 5: 433114a5 folded before Flop (didn't bet)
Seat 6: 5dcb2cf7 folded before Flop (didn't bet)


Poker Hand #RC1450286634: Hold'em No Limit  ($0.05/$0.1) - 2023/04/04 13:53:52
Table 'RushAndCash1731894' 6-max Seat #1 is the button
Seat 1: 6129dfa5 ($20.55 in chips)
Seat 2: 56f54f19 ($31.67 in chips)
Seat 3: 12260f7f ($14.29 in chips)
Seat 4: a2e80610 ($10.79 in chips)
Seat 5: Hero ($17.21 in chips)
Seat 6: 433114a5 ($10 in chips)
56f54f19: posts small blind $0.05
12260f7f: posts big blind $0.1
*** HOLE CARDS ***
Dealt to 6129dfa5 
Dealt to 56f54f19 
Dealt to 12260f7f 
Dealt to a2e80610 
Dealt to Hero [Kd Jc]
Dealt to 433114a5 
a2e80610: folds
Hero: raises $0.15 to $0.25
433114a5: raises $0.55 to $0.8
6129dfa5: folds
56f54f19: folds
12260f7f: folds
Hero: folds
Uncalled bet ($0.55) returned to 433114a5
*** SHOWDOWN ***
433114a5 collected $0.62 from pot
*** SUMMARY ***
Total pot $0.65 | Rake $0.03 | Jackpot $0 | Bingo $0 | Fortune $0
Seat 1: 6129dfa5 (button) folded before Flop (didn't bet)
Seat 2: 56f54f19 (small blind) folded before Flop
Seat 3: 12260f7f (big blind) folded before Flop
Seat 4: a2e80610 folded before Flop (didn't bet)
Seat 5: Hero folded before Flop
Seat 6: 433114a5 collected ($0.62)


Poker Hand #RC1450286107: Hold'em No Limit  ($0.05/$0.1) - 2023/04/04 13:52:34
Table 'RushAndCash1731367' 6-max Seat #1 is the button
Seat 1: a0aeb849 ($10.89 in chips)
Seat 2: Hero ($16.04 in chips)
Seat 3: 15c14e7a ($10.76 in chips)
Seat 4: b185bb94 ($13.43 in chips)
Seat 5: 5ea75956 ($20.04 in chips)
Seat 6: 617903 ($10.29 in chips)
Hero: posts small blind $0.05
15c14e7a: posts big blind $0.1
*** HOLE CARDS ***
Dealt to a0aeb849 
Dealt to Hero [9c Jc]
Dealt to 15c14e7a 
Dealt to b185bb94 
Dealt to 5ea75956 
Dealt to 617903 
b185bb94: folds
5ea75956: folds
617903: folds
a0aeb849: folds
Hero: raises $0.2 to $0.3
15c14e7a: calls $0.2
*** FLOP *** [5h Jh 5c]
Hero: checks
15c14e7a: bets $0.3
Hero: calls $0.3
*** TURN *** [5h Jh 5c] [7h]
Hero: checks
15c14e7a: bets $0.7
Hero: calls $0.7
*** RIVER *** [5h Jh 5c 7h] [9h]
Hero: bets $0.86
15c14e7a: folds
Uncalled bet ($0.86) returned to Hero
*** SHOWDOWN ***
Hero collected $2.47 from pot
*** SUMMARY ***
Total pot $2.6 | Rake $0.13 | Jackpot $0 | Bingo $0 | Fortune $0
Board [5h Jh 5c 7h 9h]
Seat 1: a0aeb849 (button) folded before Flop (didn't bet)
Seat 2: Hero (small blind) won ($2.47)
Seat 3: 15c14e7a (big blind) folded on the River
Seat 4: b185bb94 folded before Flop (didn't bet)
Seat 5: 5ea75956 folded before Flop (didn't bet)
Seat 6: 617903 folded before Flop (didn't bet)


Poker Hand #RC1450286069: Hold'em No Limit  ($0.05/$0.1) - 2023/04/04 13:52:29
Table 'RushAndCash1731329' 6-max Seat #1 is the button
Seat 1: Hero ($16.04 in chips)
Seat 2: 14dfaed ($18.47 in chips)
Seat 3: 892bbc0a ($9.85 in chips)
Seat 4: fa4f19f7 ($13 in chips)
Seat 5: dd558106 ($12.44 in chips)
Seat 6: 9962b694 ($16.58 in chips)
14dfaed: posts small blind $0.05
892bbc0a: posts big blind $0.1
*** HOLE CARDS ***
Dealt to Hero [5s 3d]
Dealt to 14dfaed 
Dealt to 892bbc0a 
Dealt to fa4f19f7 
Dealt to dd558106 
Dealt to 9962b694 
fa4f19f7: folds
dd558106: folds
9962b694: folds
Hero: folds
14dfaed: folds
Uncalled bet ($0.05) returned to 892bbc0a
*** SHOWDOWN ***
892bbc0a collected $0.1 from pot
*** SUMMARY ***
Total pot $0.1 | Rake $0 | Jackpot $0 | Bingo $0 | Fortune $0
Seat 1: Hero (button) folded before Flop (didn't bet)
Seat 2: 14dfaed (small blind) folded before Flop
Seat 3: 892bbc0a (big blind) collected ($0.1)
Seat 4: fa4f19f7 folded before Flop (didn't bet)
Seat 5: dd558106 folded before Flop (didn't bet)
Seat 6: 9962b694 folded before Flop (didn't bet)


Poker Hand #RC1450285933: Hold'em No Limit  ($0.05/$0.1) - 2023/04/04 13:52:09
Table 'RushAndCash1731193' 6-max Seat #1 is the button
Seat 1: d8f47e5a ($23.26 in chips)
Seat 2: 6129dfa5 ($23.05 in chips)
Seat 3: Hero ($16.14 in chips)
Seat 4: d08c8e7d ($22.43 in chips)
Seat 5: 3d4ef984 ($6.3 in chips)
Seat 6: 6b7032c7 ($10 in chips)
6129dfa5: posts small blind $0.05
Hero: posts big blind $0.1
*** HOLE CARDS ***
Dealt to d8f47e5a 
Dealt to 6129dfa5 
Dealt to Hero [9c 9s]
Dealt to d08c8e7d 
Dealt to 3d4ef984 
Dealt to 6b7032c7 
d08c8e7d: folds
3d4ef984: raises $0.15 to $0.25
6b7032c7: folds
d8f47e5a: folds
6129dfa5: raises $0.75 to $1
Hero: folds
3d4ef984: calls $0.75
*** FLOP *** [3c 8c 5h]
6129dfa5: checks
3d4ef984: checks
*** TURN *** [3c 8c 5h] [9d]
6129dfa5: bets $1.5
3d4ef984: calls $1.5
*** RIVER *** [3c 8c 5h 9d] [9h]
6129dfa5: checks
3d4ef984: checks
6129dfa5: shows [Jh Th] (Pair of Nines)
3d4ef984: shows [7s 8s] (Pair of Nines and Pair of Eights)
*** SHOWDOWN ***
3d4ef984 collected $4.71 from pot
*** SUMMARY ***
Total pot $5.1 | Rake $0.24 | Jackpot $0.15 | Bingo $0 | Fortune $0
Board [3c 8c 5h 9d 9h]
Seat 1: d8f47e5a (button) folded before Flop (didn't bet)
Seat 2: 6129dfa5 (small blind) showed [Jh Th] and lost with Pair of Nines
Seat 3: Hero (big blind) folded before Flop
Seat 4: d08c8e7d folded before Flop (didn't bet)
Seat 5: 3d4ef984 showed [7s 8s] and won ($4.71) with Pair of Nines and Pair of Eights
Seat 6: 6b7032c7 folded before Flop (didn't bet)


Poker Hand #RC1450285844: Hold'em No Limit  ($0.05/$0.1) - 2023/04/04 13:51:56
Table 'RushAndCash1731104' 6-max Seat #1 is the button
Seat 1: 6048193f ($10 in chips)
Seat 2: 521c5f6e ($10.3 in chips)
Seat 3: b789b917 ($19.82 in chips)
Seat 4: 27b5706e ($7.63 in chips)
Seat 5: 25f3ce37 ($8.53 in chips)
Seat 6: Hero ($15.99 in chips)
521c5f6e: posts small blind $0.05
b789b917: posts big blind $0.1
*** HOLE CARDS ***
Dealt to 6048193f 
Dealt to 521c5f6e 
Dealt to b789b917 
Dealt to 27b5706e 
Dealt to 25f3ce37 
Dealt to Hero [Qd Kh]
27b5706e: folds
25f3ce37: folds
Hero: raises $0.15 to $0.25
6048193f: folds
521c5f6e: folds
b789b917: folds
Uncalled bet ($0.15) returned to Hero
*** SHOWDOWN ***
Hero collected $0.25 from pot
*** SUMMARY ***
Total pot $0.25 | Rake $0 | Jackpot $0 | Bingo $0 | Fortune $0
Seat 1: 6048193f (button) folded before Flop (didn't bet)
Seat 2: 521c5f6e (small blind) folded before Flop
Seat 3: b789b917 (big blind) folded before Flop
Seat 4: 27b5706e folded before Flop (didn't bet)
Seat 5: 25f3ce37 folded before Flop (didn't bet)
Seat 6: Hero collected ($0.25)


Poker Hand #RC1450284885: Hold'em No Limit  ($0.05/$0.1) - 2023/04/04 13:49:36
Table 'RushAndCash1730145' 6-max Seat #1 is the button
Seat 1: cdd88429 ($10.15 in chips)
Seat 2: a20fbe3d ($19.01 in chips)
Seat 3: 6e3f2442 ($15.91 in chips)
Seat 4: Hero ($17.09 in chips)
Seat 5: ac3f5819 ($19.72 in chips)
Seat 6: 130a8c91 ($14.27 in chips)
a20fbe3d: posts small blind $0.05
6e3f2442: posts big blind $0.1
*** HOLE CARDS ***
Dealt to cdd88429 
Dealt to a20fbe3d 
Dealt to 6e3f2442 
Dealt to Hero [Jd Ad]
Dealt to ac3f5819 
Dealt to 130a8c91 
Hero: raises $0.15 to $0.25
ac3f5819: raises $0.85 to $1.1
130a8c91: folds
cdd88429: folds
a20fbe3d: calls $1.05
6e3f2442: folds
Hero: calls $0.85
*** FLOP *** [7s 5c 8s]
a20fbe3d: checks
Hero: checks
ac3f5819: bets $1.7
a20fbe3d: calls $1.7
Hero: folds
*** TURN *** [7s 5c 8s] [2h]
a20fbe3d: bets $3.4
ac3f5819: raises $13.52 to $16.92 and is all-in
a20fbe3d: calls $12.81 and is all-in
Uncalled bet ($0.71) returned to ac3f5819
ac3f5819: shows [Qd Qs] (Pair of Queens)
a20fbe3d: shows [6c 6h] (Pair of Sixes)
*** FIRST RIVER *** [7s 5c 8s 2h] [Th]
*** SECOND RIVER *** [7s 5c 8s 2h] [4s]
*** FIRST SHOWDOWN ***
ac3f5819 collected $19.38 from pot
*** SECOND SHOWDOWN ***
a20fbe3d collected $19.39 from pot
*** SUMMARY ***
Total pot $39.22 | Rake $0.3 | Jackpot $0.15 | Bingo $0 | Fortune $0
Hand was run two times
FIRST Board [7s 5c 8s 2h Th]
SECOND Board [4s]
Seat 1: cdd88429 (button) folded before Flop (didn't bet)
Seat 2: a20fbe3d (small blind) showed [6c 6h] and lost with Pair of Sixes, and won ($19.39)
Seat 3: 6e3f2442 (big blind) folded before Flop
Seat 4: Hero folded on the Flop
Seat 5: ac3f5819 showed [Qd Qs] and won ($19.38) with Pair of Queens, and lost
Seat 6: 130a8c91 folded before Flop (didn't bet)


Poker Hand #RC1450284761: Hold'em No Limit  ($0.05/$0.1) - 2023/04/04 13:49:19
Table 'RushAndCash1730021' 6-max Seat #1 is the button
Seat 1: eb62523c ($10.76 in chips)
Seat 2: fcc0cf9c ($10.48 in chips)
Seat 3: fec26545 ($10.72 in chips)
Seat 4: 821397f2 ($10.06 in chips)
Seat 5: Hero ($16.94 in chips)
Seat 6: 4f850b7f ($16.77 in chips)
fcc0cf9c: posts small blind $0.05
fec26545: posts big blind $0.1
*** HOLE CARDS ***
Dealt to eb62523c 
Dealt to fcc0cf9c 
Dealt to fec26545 
Dealt to 821397f2 
Dealt to Hero [7c Ac]
Dealt to 4f850b7f 
821397f2: folds
Hero: raises $0.15 to $0.25
4f850b7f: folds
eb62523c: folds
fcc0cf9c: folds
fec26545: folds
Uncalled bet ($0.15) returned to Hero
*** SHOWDOWN ***
Hero collected $0.25 from pot
*** SUMMARY ***
Total pot $0.25 | Rake $0 | Jackpot $0 | Bingo $0 | Fortune $0
Seat 1: eb62523c (button) folded before Flop (didn't bet)
Seat 2: fcc0cf9c (small blind) folded before Flop
Seat 3: fec26545 (big blind) folded before Flop
Seat 4: 821397f2 folded before Flop (didn't bet)
Seat 5: Hero collected ($0.25)
Seat 6: 4f850b7f folded before Flop (didn't bet)


Poker Hand #RC1450244633: Hold'em No Limit  ($0.05/$0.1) - 2023/04/04 13:49:00
Table 'RushAndCash1729893' 6-max Seat #1 is the button
Seat 1: fc2e2645 ($16.7 in chips)
Seat 2: d3e0fbdc ($12.7 in chips)
Seat 3: f1d1196d ($32.48 in chips)
Seat 4: f9672df ($10 in chips)
Seat 5: d9305c7b ($10 in chips)
Seat 6: Hero ($16.94 in chips)
d3e0fbdc: posts small blind $0.05
f1d1196d: posts big blind $0.1
*** HOLE CARDS ***
Dealt to fc2e2645 
Dealt to d3e0fbdc 
Dealt to f1d1196d 
Dealt to f9672df 
Dealt to d9305c7b 
Dealt to Hero [As 5d]
f9672df: folds
d9305c7b: folds
Hero: folds
fc2e2645: folds
d3e0fbdc: folds
Uncalled bet ($0.05) returned to f1d1196d
*** SHOWDOWN ***
f1d1196d collected $0.1 from pot
*** SUMMARY ***
Total pot $0.1 | Rake $0 | Jackpot $0 | Bingo $0 | Fortune $0
Seat 1: fc2e2645 (button) folded before Flop (didn't bet)
Seat 2: d3e0fbdc (small blind) folded before Flop
Seat 3: f1d1196d (big blind) collected ($0.1)
Seat 4: f9672df folded before Flop (didn't bet)
Seat 5: d9305c7b folded before Flop (didn't bet)
Seat 6: Hero folded before Flop (didn't bet)


Poker Hand #RC1450244538: Hold'em No Limit  ($0.05/$0.1) - 2023/04/04 13:48:46
Table 'RushAndCash1729798' 6-max Seat #1 is the button
Seat 1: 9671cabc ($12.06 in chips)
Seat 2: Hero ($16.99 in chips)
Seat 3: d6e72fe2 ($14.94 in chips)
Seat 4: 403f45d7 ($10.86 in chips)
Seat 5: 12c8e6a6 ($17.78 in chips)
Seat 6: d42d5cb1 ($19.86 in chips)
Hero: posts small blind $0.05
d6e72fe2: posts big blind $0.1
*** HOLE CARDS ***
Dealt to 9671cabc 
Dealt to Hero [3s 5d]
Dealt to d6e72fe2 
Dealt to 403f45d7 
Dealt to 12c8e6a6 
Dealt to d42d5cb1 
403f45d7: folds
12c8e6a6: folds
d42d5cb1: folds
9671cabc: raises $0.15 to $0.25
Hero: folds
d6e72fe2: calls $0.15
*** FLOP *** [Ah Jd Kh]
d6e72fe2: checks
9671cabc: bets $0.19
d6e72fe2: calls $0.19
*** TURN *** [Ah Jd Kh] [2c]
d6e72fe2: checks
9671cabc: checks
*** RIVER *** [Ah Jd Kh 2c] [8s]
d6e72fe2: bets $0.7
9671cabc: folds
Uncalled bet ($0.7) returned to d6e72fe2
*** SHOWDOWN ***
d6e72fe2 collected $0.89 from pot
*** SUMMARY ***
Total pot $0.93 | Rake $0.04 | Jackpot $0 | Bingo $0 | Fortune $0
Board [Ah Jd Kh 2c 8s]
Seat 1: 9671cabc (button) folded on the River
Seat 2: Hero (small blind) folded before Flop
Seat 3: d6e72fe2 (big blind) won ($0.89)
Seat 4: 403f45d7 folded before Flop (didn't bet)
Seat 5: 12c8e6a6 folded before Flop (didn't bet)
Seat 6: d42d5cb1 folded before Flop (didn't bet)


Poker Hand #RC1450244476: Hold'em No Limit  ($0.05/$0.1) - 2023/04/04 13:48:37
Table 'RushAndCash1729736' 6-max Seat #1 is the button
Seat 1: d995b8c0 ($10.85 in chips)
Seat 2: a3a9b8cf ($10.95 in chips)
Seat 3: Hero ($17.09 in chips)
Seat 4: 5fcfce38 ($10.87 in chips)
Seat 5: 1663aa47 ($10 in chips)
Seat 6: b1e4d625 ($6.85 in chips)
a3a9b8cf: posts small blind $0.05
Hero: posts big blind $0.1
*** HOLE CARDS ***
Dealt to d995b8c0 
Dealt to a3a9b8cf 
Dealt to Hero [Th Qd]
Dealt to 5fcfce38 
Dealt to 1663aa47 
Dealt to b1e4d625 
5fcfce38: folds
1663aa47: folds
b1e4d625: raises $0.13 to $0.23
d995b8c0: folds
a3a9b8cf: folds
Hero: folds
Uncalled bet ($0.13) returned to b1e4d625
*** SHOWDOWN ***
b1e4d625 collected $0.25 from pot
*** SUMMARY ***
Total pot $0.25 | Rake $0 | Jackpot $0 | Bingo $0 | Fortune $0
Seat 1: d995b8c0 (button) folded before Flop (didn't bet)
Seat 2: a3a9b8cf (small blind) folded before Flop
Seat 3: Hero (big blind) folded before Flop
Seat 4: 5fcfce38 folded before Flop (didn't bet)
Seat 5: 1663aa47 folded before Flop (didn't bet)
Seat 6: b1e4d625 collected ($0.25)


Poker Hand #RC1450244378: Hold'em No Limit  ($0.05/$0.1) - 2023/04/04 13:48:23
Table 'RushAndCash1729638' 6-max Seat #1 is the button
Seat 1: 4d66519d ($12.06 in chips)
Seat 2: 8f6afbfd ($10 in chips)
Seat 3: 758c4283 ($10 in chips)
Seat 4: df99ba43 ($12.88 in chips)
Seat 5: 950fbf58 ($8.41 in chips)
Seat 6: Hero ($17.09 in chips)
8f6afbfd: posts small blind $0.05
758c4283: posts big blind $0.1
*** HOLE CARDS ***
Dealt to 4d66519d 
Dealt to 8f6afbfd 
Dealt to 758c4283 
Dealt to df99ba43 
Dealt to 950fbf58 
Dealt to Hero [Th 5c]
df99ba43: folds
950fbf58: folds
Hero: folds
4d66519d: raises $0.15 to $0.25
8f6afbfd: folds
758c4283: folds
Uncalled bet ($0.15) returned to 4d66519d
*** SHOWDOWN ***
4d66519d collected $0.25 from pot
*** SUMMARY ***
Total pot $0.25 | Rake $0 | Jackpot $0 | Bingo $0 | Fortune $0
Seat 1: 4d66519d (button) collected ($0.25)
Seat 2: 8f6afbfd (small blind) folded before Flop
Seat 3: 758c4283 (big blind) folded before Flop
Seat 4: df99ba43 folded before Flop (didn't bet)
Seat 5: 950fbf58 folded before Flop (didn't bet)
Seat 6: Hero folded before Flop (didn't bet)


Poker Hand #RC1450244312: Hold'em No Limit  ($0.05/$0.1) - 2023/04/04 13:48:13
Table 'RushAndCash1729572' 6-max Seat #1 is the button
Seat 1: Hero ($17.09 in chips)
Seat 2: 73cd0574 ($10.87 in chips)
Seat 3: 3f0847dd ($10.65 in chips)
Seat 4: 459424a6 ($24.01 in chips)
Seat 5: a898c2c3 ($10.34 in chips)
Seat 6: 1e73e09e ($11 in chips)
73cd0574: posts small blind $0.05
3f0847dd: posts big blind $0.1
*** HOLE CARDS ***
Dealt to Hero [Qh 6h]
Dealt to 73cd0574 
Dealt to 3f0847dd 
Dealt to 459424a6 
Dealt to a898c2c3 
Dealt to 1e73e09e 
459424a6: folds
a898c2c3: folds
1e73e09e: folds
Hero: folds
73cd0574: folds
Uncalled bet ($0.05) returned to 3f0847dd
*** SHOWDOWN ***
3f0847dd collected $0.1 from pot
*** SUMMARY ***
Total pot $0.1 | Rake $0 | Jackpot $0 | Bingo $0 | Fortune $0
Seat 1: Hero (button) folded before Flop (didn't bet)
Seat 2: 73cd0574 (small blind) folded before Flop
Seat 3: 3f0847dd (big blind) collected ($0.1)
Seat 4: 459424a6 folded before Flop (didn't bet)
Seat 5: a898c2c3 folded before Flop (didn't bet)
Seat 6: 1e73e09e folded before Flop (didn't bet)


Poker Hand #RC1450244285: Hold'em No Limit  ($0.05/$0.1) - 2023/04/04 13:48:08
Table 'RushAndCash1729545' 6-max Seat #1 is the button
Seat 1: 3197db6f ($17.58 in chips)
Seat 2: 108e58ff ($12.01 in chips)
Seat 3: ede9df4 ($14.23 in chips)
Seat 4: Hero ($17.09 in chips)
Seat 5: c7ae08ec ($11.75 in chips)
Seat 6: 67cb34ff ($10 in chips)
108e58ff: posts small blind $0.05
ede9df4: posts big blind $0.1
*** HOLE CARDS ***
Dealt to 3197db6f 
Dealt to 108e58ff 
Dealt to ede9df4 
Dealt to Hero [6h 7h]
Dealt to c7ae08ec 
Dealt to 67cb34ff 
Hero: folds
c7ae08ec: raises $0.15 to $0.25
67cb34ff: folds
3197db6f: folds
108e58ff: folds
ede9df4: raises $0.52 to $0.77
c7ae08ec: calls $0.52
*** FLOP *** [Th 7s 9s]
ede9df4: checks
c7ae08ec: checks
*** TURN *** [Th 7s 9s] [4d]
ede9df4: checks
c7ae08ec: bets $1.2
ede9df4: folds
Uncalled bet ($1.2) returned to c7ae08ec
*** SHOWDOWN ***
c7ae08ec collected $1.51 from pot
*** SUMMARY ***
Total pot $1.59 | Rake $0.08 | Jackpot $0 | Bingo $0 | Fortune $0
Board [Th 7s 9s 4d]
Seat 1: 3197db6f (button) folded before Flop (didn't bet)
Seat 2: 108e58ff (small blind) folded before Flop
Seat 3: ede9df4 (big blind) folded on the Turn
Seat 4: Hero folded before Flop (didn't bet)
Seat 5: c7ae08ec won ($1.51)
Seat 6: 67cb34ff folded before Flop (didn't bet)


Poker Hand #RC1450244197: Hold'em No Limit  ($0.05/$0.1) - 2023/04/04 13:47:55
Table 'RushAndCash1729457' 6-max Seat #1 is the button
Seat 1: 5e4c3740 ($21.24 in chips)
Seat 2: Hero ($16.99 in chips)
Seat 3: 11ae0d2a ($12.63 in chips)
Seat 4: 7bfb7ffe ($17.43 in chips)
Seat 5: 403f45d7 ($10.86 in chips)
Seat 6: dc1b263b ($10.07 in chips)
Hero: posts small blind $0.05
11ae0d2a: posts big blind $0.1
*** HOLE CARDS ***
Dealt to 5e4c3740 
Dealt to Hero [8d As]
Dealt to 11ae0d2a 
Dealt to 7bfb7ffe 
Dealt to 403f45d7 
Dealt to dc1b263b 
7bfb7ffe: folds
403f45d7: folds
dc1b263b: folds
5e4c3740: folds
Hero: raises $0.2 to $0.3
11ae0d2a: folds
Uncalled bet ($0.2) returned to Hero
*** SHOWDOWN ***
Hero collected $0.2 from pot
*** SUMMARY ***
Total pot $0.2 | Rake $0 | Jackpot $0 | Bingo $0 | Fortune $0
Seat 1: 5e4c3740 (button) folded before Flop (didn't bet)
Seat 2: Hero (small blind) collected ($0.2)
Seat 3: 11ae0d2a (big blind) folded before Flop
Seat 4: 7bfb7ffe folded before Flop (didn't bet)
Seat 5: 403f45d7 folded before Flop (didn't bet)
Seat 6: dc1b263b folded before Flop (didn't bet)


Poker Hand #RC1450244161: Hold'em No Limit  ($0.05/$0.1) - 2023/04/04 13:47:50
Table 'RushAndCash1729421' 6-max Seat #1 is the button
Seat 1: 911c0ea5 ($11.65 in chips)
Seat 2: 39e5b565 ($6.89 in chips)
Seat 3: 42313935 ($13.48 in chips)
Seat 4: Hero ($16.99 in chips)
Seat 5: df99ba43 ($12.98 in chips)
Seat 6: f88322b2 ($10 in chips)
39e5b565: posts small blind $0.05
42313935: posts big blind $0.1
*** HOLE CARDS ***
Dealt to 911c0ea5 
Dealt to 39e5b565 
Dealt to 42313935 
Dealt to Hero [3d Kc]
Dealt to df99ba43 
Dealt to f88322b2 
Hero: folds
df99ba43: folds
f88322b2: raises $0.13 to $0.23
911c0ea5: folds
39e5b565: folds
42313935: folds
Uncalled bet ($0.13) returned to f88322b2
*** SHOWDOWN ***
f88322b2 collected $0.25 from pot
*** SUMMARY ***
Total pot $0.25 | Rake $0 | Jackpot $0 | Bingo $0 | Fortune $0
Seat 1: 911c0ea5 (button) folded before Flop (didn't bet)
Seat 2: 39e5b565 (small blind) folded before Flop
Seat 3: 42313935 (big blind) folded before Flop
Seat 4: Hero folded before Flop (didn't bet)
Seat 5: df99ba43 folded before Flop (didn't bet)
Seat 6: f88322b2 collected ($0.25)


Poker Hand #RC1450244031: Hold'em No Limit  ($0.05/$0.1) - 2023/04/04 13:47:30
Table 'RushAndCash1729291' 6-max Seat #1 is the button
Seat 1: 6cf55711 ($15.98 in chips)
Seat 2: 5055f8d5 ($10.92 in chips)
Seat 3: Hero ($17.09 in chips)
Seat 4: b9523125 ($14.16 in chips)
Seat 5: d0a1549 ($14.19 in chips)
Seat 6: 8f841224 ($10 in chips)
5055f8d5: posts small blind $0.05
Hero: posts big blind $0.1
*** HOLE CARDS ***
Dealt to 6cf55711 
Dealt to 5055f8d5 
Dealt to Hero [3h 7d]
Dealt to b9523125 
Dealt to d0a1549 
Dealt to 8f841224 
b9523125: folds
d0a1549: folds
8f841224: folds
6cf55711: folds
5055f8d5: raises $0.2 to $0.3
Hero: folds
Uncalled bet ($0.2) returned to 5055f8d5
*** SHOWDOWN ***
5055f8d5 collected $0.2 from pot
*** SUMMARY ***
Total pot $0.2 | Rake $0 | Jackpot $0 | Bingo $0 | Fortune $0
Seat 1: 6cf55711 (button) folded before Flop (didn't bet)
Seat 2: 5055f8d5 (small blind) collected ($0.2)
Seat 3: Hero (big blind) folded before Flop
Seat 4: b9523125 folded before Flop (didn't bet)
Seat 5: d0a1549 folded before Flop (didn't bet)
Seat 6: 8f841224 folded before Flop (didn't bet)


Poker Hand #RC1450243546: Hold'em No Limit  ($0.05/$0.1) - 2023/04/04 13:46:11
Table 'RushAndCash1728806' 6-max Seat #1 is the button
Seat 1: Hero ($18.07 in chips)
Seat 2: 3eae412f ($19.67 in chips)
Seat 3: 53b5407e ($8.59 in chips)
Seat 4: d9bc9171 ($31.77 in chips)
Seat 5: b8905b12 ($12.28 in chips)
Seat 6: d936146d ($17.39 in chips)
3eae412f: posts small blind $0.05
53b5407e: posts big blind $0.1
*** HOLE CARDS ***
Dealt to Hero [Td Th]
Dealt to 3eae412f 
Dealt to 53b5407e 
Dealt to d9bc9171 
Dealt to b8905b12 
Dealt to d936146d 
d9bc9171: folds
b8905b12: raises $0.15 to $0.25
d936146d: calls $0.25
Hero: raises $0.73 to $0.98
3eae412f: folds
53b5407e: raises $7.61 to $8.59 and is all-in
b8905b12: folds
d936146d: folds
Hero: folds
Uncalled bet ($7.61) returned to 53b5407e
*** SHOWDOWN ***
53b5407e collected $2.39 from pot
*** SUMMARY ***
Total pot $2.51 | Rake $0.12 | Jackpot $0 | Bingo $0 | Fortune $0
Seat 1: Hero (button) folded before Flop
Seat 2: 3eae412f (small blind) folded before Flop
Seat 3: 53b5407e (big blind) collected ($2.39)
Seat 4: d9bc9171 folded before Flop (didn't bet)
Seat 5: b8905b12 folded before Flop
Seat 6: d936146d folded before Flop


Poker Hand #RC1450243470: Hold'em No Limit  ($0.05/$0.1) - 2023/04/04 13:45:59
Table 'RushAndCash1728730' 6-max Seat #1 is the button
Seat 1: c891daba ($21.81 in chips)
Seat 2: 4ca43baa ($9.7 in chips)
Seat 3: 12c8e6a6 ($15.09 in chips)
Seat 4: 233e44ca ($5.15 in chips)
Seat 5: fc2e2645 ($16.55 in chips)
Seat 6: Hero ($18.07 in chips)
4ca43baa: posts small blind $0.05
12c8e6a6: posts big blind $0.1
*** HOLE CARDS ***
Dealt to c891daba 
Dealt to 4ca43baa 
Dealt to 12c8e6a6 
Dealt to 233e44ca 
Dealt to fc2e2645 
Dealt to Hero [8c Qh]
233e44ca: folds
fc2e2645: folds
Hero: folds
c891daba: raises $0.15 to $0.25
4ca43baa: calls $0.2
12c8e6a6: raises $0.4 to $0.65
c891daba: calls $0.4
4ca43baa: calls $0.4
*** FLOP *** [Qs Th Jh]
4ca43baa: checks
12c8e6a6: checks
c891daba: checks
*** TURN *** [Qs Th Jh] [6c]
4ca43baa: checks
12c8e6a6: bets $1.04
c891daba: calls $1.04
4ca43baa: calls $1.04
*** RIVER *** [Qs Th Jh 6c] [Tc]
4ca43baa: checks
12c8e6a6: checks
c891daba: checks
4ca43baa: shows [6h 7h] (Pair of Tens and Pair of Sixes)
12c8e6a6: shows [Kc Ah] (Aces-High Straight)
c891daba: shows [4c Qc] (Pair of Queens and Pair of Tens)
*** SHOWDOWN ***
12c8e6a6 collected $4.68 from pot
*** SUMMARY ***
Total pot $5.07 | Rake $0.24 | Jackpot $0.15 | Bingo $0 | Fortune $0
Board [Qs Th Jh 6c Tc]
Seat 1: c891daba (button) showed [4c Qc] and lost with Pair of Queens and Pair of Tens
Seat 2: 4ca43baa (small blind) showed [6h 7h] and lost with Pair of Tens and Pair of Sixes
Seat 3: 12c8e6a6 (big blind) showed [Kc Ah] and won ($4.68) with Aces-High Straight
Seat 4: 233e44ca folded before Flop (didn't bet)
Seat 5: fc2e2645 folded before Flop (didn't bet)
Seat 6: Hero folded before Flop (didn't bet)


Poker Hand #RC1450243043: Hold'em No Limit  ($0.05/$0.1) - 2023/04/04 13:44:51
Table 'RushAndCash1728303' 6-max Seat #1 is the button
Seat 1: 46d4ff79 ($12.77 in chips)
Seat 2: a898c2c3 ($9.75 in chips)
Seat 3: ae376ced ($10.28 in chips)
Seat 4: 892df41c ($11.54 in chips)
Seat 5: Hero ($16.79 in chips)
Seat 6: b7483169 ($18.9 in chips)
a898c2c3: posts small blind $0.05
ae376ced: posts big blind $0.1
*** HOLE CARDS ***
Dealt to 46d4ff79 
Dealt to a898c2c3 
Dealt to ae376ced 
Dealt to 892df41c 
Dealt to Hero [3h Ah]
Dealt to b7483169 
892df41c: folds
Hero: raises $0.15 to $0.25
b7483169: folds
46d4ff79: folds
a898c2c3: folds
ae376ced: calls $0.15
*** FLOP *** [Th 4h 6c]
ae376ced: checks
Hero: bets $0.42
ae376ced: raises $0.7 to $1.12
Hero: raises $15.42 to $16.54 and is all-in
ae376ced: folds
Uncalled bet ($15.42) returned to Hero
*** SHOWDOWN ***
Hero collected $2.65 from pot
*** SUMMARY ***
Total pot $2.79 | Rake $0.14 | Jackpot $0 | Bingo $0 | Fortune $0
Board [Th 4h 6c]
Seat 1: 46d4ff79 (button) folded before Flop (didn't bet)
Seat 2: a898c2c3 (small blind) folded before Flop
Seat 3: ae376ced (big blind) folded on the Flop
Seat 4: 892df41c folded before Flop (didn't bet)
Seat 5: Hero won ($2.65)
Seat 6: b7483169 folded before Flop (didn't bet)


Poker Hand #RC1450242656: Hold'em No Limit  ($0.05/$0.1) - 2023/04/04 13:43:49
Table 'RushAndCash1727916' 6-max Seat #1 is the button
Seat 1: a108bebb ($8.31 in chips)
Seat 2: a4e7cb4a ($12.13 in chips)
Seat 3: 337857b6 ($10.05 in chips)
Seat 4: fcc0cf9c ($11.49 in chips)
Seat 5: fa2b7532 ($5.37 in chips)
Seat 6: Hero ($17.26 in chips)
a4e7cb4a: posts small blind $0.05
337857b6: posts big blind $0.1
*** HOLE CARDS ***
Dealt to a108bebb 
Dealt to a4e7cb4a 
Dealt to 337857b6 
Dealt to fcc0cf9c 
Dealt to fa2b7532 
Dealt to Hero [8h Jh]
fcc0cf9c: folds
fa2b7532: folds
Hero: raises $0.15 to $0.25
a108bebb: calls $0.25
a4e7cb4a: folds
337857b6: folds
*** FLOP *** [3d 2c 4s]
Hero: bets $0.22
a108bebb: calls $0.22
*** TURN *** [3d 2c 4s] [As]
Hero: checks
a108bebb: bets $0.25
Hero: folds
Uncalled bet ($0.25) returned to a108bebb
*** SHOWDOWN ***
a108bebb collected $1.04 from pot
*** SUMMARY ***
Total pot $1.09 | Rake $0.05 | Jackpot $0 | Bingo $0 | Fortune $0
Board [3d 2c 4s As]
Seat 1: a108bebb (button) won ($1.04)
Seat 2: a4e7cb4a (small blind) folded before Flop
Seat 3: 337857b6 (big blind) folded before Flop
Seat 4: fcc0cf9c folded before Flop (didn't bet)
Seat 5: fa2b7532 folded before Flop (didn't bet)
Seat 6: Hero folded on the Turn


Poker Hand #RC1450242579: Hold'em No Limit  ($0.05/$0.1) - 2023/04/04 13:43:36
Table 'RushAndCash1727839' 6-max Seat #1 is the button
Seat 1: b582423a ($10.1 in chips)
Seat 2: Hero ($17.17 in chips)
Seat 3: f4b2a196 ($9.95 in chips)
Seat 4: ae928856 ($11.15 in chips)
Seat 5: 68908a6c ($10.37 in chips)
Seat 6: a3a9b8cf ($11.22 in chips)
Hero: posts small blind $0.05
f4b2a196: posts big blind $0.1
*** HOLE CARDS ***
Dealt to b582423a 
Dealt to Hero [Jh 2h]
Dealt to f4b2a196 
Dealt to ae928856 
Dealt to 68908a6c 
Dealt to a3a9b8cf 
ae928856: folds
68908a6c: folds
a3a9b8cf: folds
b582423a: folds
Hero: calls $0.05
f4b2a196: checks
*** FLOP *** [Qd 5s Qh]
Hero: bets $0.1
f4b2a196: folds
Uncalled bet ($0.1) returned to Hero
*** SHOWDOWN ***
Hero collected $0.19 from pot
*** SUMMARY ***
Total pot $0.2 | Rake $0.01 | Jackpot $0 | Bingo $0 | Fortune $0
Board [Qd 5s Qh]
Seat 1: b582423a (button) folded before Flop (didn't bet)
Seat 2: Hero (small blind) won ($0.19)
Seat 3: f4b2a196 (big blind) folded on the Flop
Seat 4: ae928856 folded before Flop (didn't bet)
Seat 5: 68908a6c folded before Flop (didn't bet)
Seat 6: a3a9b8cf folded before Flop (didn't bet)


Poker Hand #RC1450242516: Hold'em No Limit  ($0.05/$0.1) - 2023/04/04 13:43:26
Table 'RushAndCash1727776' 6-max Seat #1 is the button
Seat 1: 88635321 ($10.15 in chips)
Seat 2: e176fa2a ($10.01 in chips)
Seat 3: Hero ($17.12 in chips)
Seat 4: 5213468c ($12.16 in chips)
Seat 5: 4f850b7f ($11.16 in chips)
Seat 6: 53d12cbb ($10.55 in chips)
e176fa2a: posts small blind $0.05
Hero: posts big blind $0.1
*** HOLE CARDS ***
Dealt to 88635321 
Dealt to e176fa2a 
Dealt to Hero [7s Kc]
Dealt to 5213468c 
Dealt to 4f850b7f 
Dealt to 53d12cbb 
5213468c: folds
4f850b7f: folds
53d12cbb: folds
88635321: folds
e176fa2a: folds
Uncalled bet ($0.05) returned to Hero
*** SHOWDOWN ***
Hero collected $0.1 from pot
*** SUMMARY ***
Total pot $0.1 | Rake $0 | Jackpot $0 | Bingo $0 | Fortune $0
Seat 1: 88635321 (button) folded before Flop (didn't bet)
Seat 2: e176fa2a (small blind) folded before Flop
Seat 3: Hero (big blind) collected ($0.1)
Seat 4: 5213468c folded before Flop (didn't bet)
Seat 5: 4f850b7f folded before Flop (didn't bet)
Seat 6: 53d12cbb folded before Flop (didn't bet)


Poker Hand #RC1450242478: Hold'em No Limit  ($0.05/$0.1) - 2023/04/04 13:43:20
Table 'RushAndCash1727738' 6-max Seat #1 is the button
Seat 1: Hero ($17.12 in chips)
Seat 2: 73cb4d62 ($9.95 in chips)
Seat 3: c9823ad ($8.27 in chips)
Seat 4: bd5c997f ($10.25 in chips)
Seat 5: 9dc36458 ($10 in chips)
Seat 6: b0cd54bf ($13.32 in chips)
73cb4d62: posts small blind $0.05
c9823ad: posts big blind $0.1
*** HOLE CARDS ***
Dealt to Hero [Kh 6c]
Dealt to 73cb4d62 
Dealt to c9823ad 
Dealt to bd5c997f 
Dealt to 9dc36458 
Dealt to b0cd54bf 
bd5c997f: folds
9dc36458: folds
b0cd54bf: folds
Hero: folds
73cb4d62: raises $0.2 to $0.3
c9823ad: calls $0.2
*** FLOP *** [6h Ad 5c]
73cb4d62: bets $0.45
c9823ad: calls $0.45
*** TURN *** [6h Ad 5c] [8d]
73cb4d62: bets $1.13
c9823ad: calls $1.13
*** RIVER *** [6h Ad 5c 8d] [Kc]
73cb4d62: bets $8.07 and is all-in
c9823ad: calls $6.39 and is all-in
Uncalled bet ($1.68) returned to 73cb4d62
73cb4d62: shows [Ac Ks] (Pair of Aces and Pair of Kings)
c9823ad: shows [9h As] (Pair of Aces)
*** SHOWDOWN ***
73cb4d62 collected $16.09 from pot
*** SUMMARY ***
Total pot $16.54 | Rake $0.3 | Jackpot $0.15 | Bingo $0 | Fortune $0
Board [6h Ad 5c 8d Kc]
Seat 1: Hero (button) folded before Flop (didn't bet)
Seat 2: 73cb4d62 (small blind) showed [Ac Ks] and won ($16.09) with Pair of Aces and Pair of Kings
Seat 3: c9823ad (big blind) showed [9h As] and lost with Pair of Aces
Seat 4: bd5c997f folded before Flop (didn't bet)
Seat 5: 9dc36458 folded before Flop (didn't bet)
Seat 6: b0cd54bf folded before Flop (didn't bet)


Poker Hand #RC1450242406: Hold'em No Limit  ($0.05/$0.1) - 2023/04/04 13:43:07
Table 'RushAndCash1727666' 6-max Seat #1 is the button
Seat 1: ebee9f36 ($11.23 in chips)
Seat 2: 6939957c ($13.17 in chips)
Seat 3: 241d0a7e ($27.38 in chips)
Seat 4: bdbb2152 ($10 in chips)
Seat 5: 933edc39 ($7.76 in chips)
Seat 6: Hero ($17.12 in chips)
6939957c: posts small blind $0.05
241d0a7e: posts big blind $0.1
*** HOLE CARDS ***
Dealt to ebee9f36 
Dealt to 6939957c 
Dealt to 241d0a7e 
Dealt to bdbb2152 
Dealt to 933edc39 
Dealt to Hero [Kd 5c]
bdbb2152: raises $0.12 to $0.22
933edc39: calls $0.22
Hero: folds
ebee9f36: folds
6939957c: folds
241d0a7e: folds
*** FLOP *** [2s 4s 8d]
bdbb2152: bets $0.3
933edc39: calls $0.3
*** TURN *** [2s 4s 8d] [8s]
bdbb2152: checks
933edc39: bets $0.59
bdbb2152: folds
Uncalled bet ($0.59) returned to 933edc39
*** SHOWDOWN ***
933edc39 collected $1.13 from pot
*** SUMMARY ***
Total pot $1.19 | Rake $0.06 | Jackpot $0 | Bingo $0 | Fortune $0
Board [2s 4s 8d 8s]
Seat 1: ebee9f36 (button) folded before Flop (didn't bet)
Seat 2: 6939957c (small blind) folded before Flop
Seat 3: 241d0a7e (big blind) folded before Flop
Seat 4: bdbb2152 folded on the Turn
Seat 5: 933edc39 won ($1.13)
Seat 6: Hero folded before Flop (didn't bet)


Poker Hand #RC1450241928: Hold'em No Limit  ($0.05/$0.1) - 2023/04/04 13:41:45
Table 'RushAndCash1727188' 6-max Seat #1 is the button
Seat 1: 4d66519d ($10.14 in chips)
Seat 2: Hero ($17.17 in chips)
Seat 3: f94e5167 ($10.77 in chips)
Seat 4: ebc8af65 ($10 in chips)
Seat 5: 5e4c3740 ($20.72 in chips)
Seat 6: b04199b5 ($9.45 in chips)
Hero: posts small blind $0.05
f94e5167: posts big blind $0.1
*** HOLE CARDS ***
Dealt to 4d66519d 
Dealt to Hero [Kh 5d]
Dealt to f94e5167 
Dealt to ebc8af65 
Dealt to 5e4c3740 
Dealt to b04199b5 
ebc8af65: folds
5e4c3740: folds
b04199b5: folds
4d66519d: raises $0.15 to $0.25
Hero: folds
f94e5167: calls $0.15
*** FLOP *** [9h As Kd]
f94e5167: checks
4d66519d: bets $0.19
f94e5167: calls $0.19
*** TURN *** [9h As Kd] [Td]
f94e5167: checks
4d66519d: bets $0.71
f94e5167: calls $0.71
*** RIVER *** [9h As Kd Td] [9s]
f94e5167: checks
4d66519d: checks
f94e5167: shows [7s Qs] (Pair of Nines)
4d66519d: shows [Ks Tc] (Pair of Kings and Pair of Tens)
*** SHOWDOWN ***
4d66519d collected $2.24 from pot
*** SUMMARY ***
Total pot $2.35 | Rake $0.11 | Jackpot $0 | Bingo $0 | Fortune $0
Board [9h As Kd Td 9s]
Seat 1: 4d66519d (button) showed [Ks Tc] and won ($2.24) with Pair of Kings and Pair of Tens
Seat 2: Hero (small blind) folded before Flop
Seat 3: f94e5167 (big blind) showed [7s Qs] and lost with Pair of Nines
Seat 4: ebc8af65 folded before Flop (didn't bet)
Seat 5: 5e4c3740 folded before Flop (didn't bet)
Seat 6: b04199b5 folded before Flop (didn't bet)


Poker Hand #RC1450241873: Hold'em No Limit  ($0.05/$0.1) - 2023/04/04 13:41:37
Table 'RushAndCash1727133' 6-max Seat #1 is the button
Seat 1: 67af583a ($8.5 in chips)
Seat 2: 2736a486 ($10.27 in chips)
Seat 3: eb62523c ($10 in chips)
Seat 4: Hero ($17.17 in chips)
Seat 5: ede9df4 ($10.49 in chips)
Seat 6: 857e53eb ($10.94 in chips)
2736a486: posts small blind $0.05
eb62523c: posts big blind $0.1
*** HOLE CARDS ***
Dealt to 67af583a 
Dealt to 2736a486 
Dealt to eb62523c 
Dealt to Hero [Th 9d]
Dealt to ede9df4 
Dealt to 857e53eb 
Hero: folds
ede9df4: folds
857e53eb: folds
67af583a: folds
2736a486: folds
Uncalled bet ($0.05) returned to eb62523c
*** SHOWDOWN ***
eb62523c collected $0.1 from pot
*** SUMMARY ***
Total pot $0.1 | Rake $0 | Jackpot $0 | Bingo $0 | Fortune $0
Seat 1: 67af583a (button) folded before Flop (didn't bet)
Seat 2: 2736a486 (small blind) folded before Flop
Seat 3: eb62523c (big blind) collected ($0.1)
Seat 4: Hero folded before Flop (didn't bet)
Seat 5: ede9df4 folded before Flop (didn't bet)
Seat 6: 857e53eb folded before Flop (didn't bet)


Poker Hand #RC1450241700: Hold'em No Limit  ($0.05/$0.1) - 2023/04/04 13:41:07
Table 'RushAndCash1726960' 6-max Seat #1 is the button
Seat 1: Hero ($17.17 in chips)
Seat 2: c8faaf9d ($9.9 in chips)
Seat 3: 459424a6 ($29.57 in chips)
Seat 4: 6b7032c7 ($10.2 in chips)
Seat 5: 1f97bafa ($16.59 in chips)
Seat 6: be3ff53c ($10.18 in chips)
c8faaf9d: posts small blind $0.05
459424a6: posts big blind $0.1
*** HOLE CARDS ***
Dealt to Hero [Qc Qs]
Dealt to c8faaf9d 
Dealt to 459424a6 
Dealt to 6b7032c7 
Dealt to 1f97bafa 
Dealt to be3ff53c 
6b7032c7: folds
1f97bafa: raises $0.13 to $0.23
be3ff53c: folds
Hero: folds
c8faaf9d: raises $0.77 to $1
459424a6: folds
1f97bafa: calls $0.77
*** FLOP *** [6c Kd Jd]
c8faaf9d: bets $1.05
1f97bafa: calls $1.05
*** TURN *** [6c Kd Jd] [6s]
c8faaf9d: bets $2.1
1f97bafa: raises $12.44 to $14.54 and is all-in
c8faaf9d: calls $5.75 and is all-in
Uncalled bet ($6.69) returned to 1f97bafa
1f97bafa: shows [Ac Kc] (Pair of Kings and Pair of Sixes)
c8faaf9d: shows [Kh Ah] (Pair of Kings and Pair of Sixes)
*** RIVER *** [6c Kd Jd 6s] [7s]
*** SHOWDOWN ***
c8faaf9d collected $9.73 from pot
1f97bafa collected $9.72 from pot
*** SUMMARY ***
Total pot $19.9 | Rake $0.3 | Jackpot $0.15 | Bingo $0 | Fortune $0
Board [6c Kd Jd 6s 7s]
Seat 1: Hero (button) folded before Flop (didn't bet)
Seat 2: c8faaf9d (small blind) showed [Kh Ah] and won ($9.73) with Pair of Kings and Pair of Sixes
Seat 3: 459424a6 (big blind) folded before Flop
Seat 4: 6b7032c7 folded before Flop (didn't bet)
Seat 5: 1f97bafa showed [Ac Kc] and won ($9.72) with Pair of Kings and Pair of Sixes
Seat 6: be3ff53c folded before Flop (didn't bet)


Poker Hand #RC1450234764: Hold'em No Limit  ($0.05/$0.1) - 2023/04/04 13:22:30
Table 'RushAndCash1720024' 6-max Seat #1 is the button
Seat 1: d5e97e90 ($15.9 in chips)
Seat 2: c9823ad ($11.85 in chips)
Seat 3: 83dee427 ($13.95 in chips)
Seat 4: 459424a6 ($27.61 in chips)
Seat 5: 9052a998 ($11.29 in chips)
Seat 6: Hero ($14.07 in chips)
c9823ad: posts small blind $0.05
83dee427: posts big blind $0.1
*** HOLE CARDS ***
Dealt to d5e97e90 
Dealt to c9823ad 
Dealt to 83dee427 
Dealt to 459424a6 
Dealt to 9052a998 
Dealt to Hero [Js Jd]
459424a6: folds
9052a998: folds
Hero: raises $0.15 to $0.25
d5e97e90: calls $0.25
c9823ad: folds
83dee427: folds
*** FLOP *** [3h 9s Qc]
Hero: checks
d5e97e90: bets $0.17
Hero: calls $0.17
*** TURN *** [3h 9s Qc] [6d]
Hero: checks
d5e97e90: bets $0.87
Hero: calls $0.87
*** RIVER *** [3h 9s Qc 6d] [5s]
Hero: checks
d5e97e90: bets $2.11
Hero: calls $2.11
d5e97e90: shows [2c Ac] (Ace-High)
Hero: shows [Js Jd] (Pair of Jacks)
*** SHOWDOWN ***
Hero collected $6.5 from pot
*** SUMMARY ***
Total pot $6.95 | Rake $0.3 | Jackpot $0.15 | Bingo $0 | Fortune $0
Board [3h 9s Qc 6d 5s]
Seat 1: d5e97e90 (button) showed [2c Ac] and lost with Ace-High
Seat 2: c9823ad (small blind) folded before Flop
Seat 3: 83dee427 (big blind) folded before Flop
Seat 4: 459424a6 folded before Flop (didn't bet)
Seat 5: 9052a998 folded before Flop (didn't bet)
Seat 6: Hero showed [Js Jd] and won ($6.5) with Pair of Jacks


Poker Hand #RC1450204689: Hold'em No Limit  ($0.05/$0.1) - 2023/04/04 13:22:19
Table 'RushAndCash1719949' 6-max Seat #1 is the button
Seat 1: 27f72cf8 ($10.28 in chips)
Seat 2: f4bdb874 ($22.51 in chips)
Seat 3: Hero ($14.02 in chips)
Seat 4: 3d2a9541 ($10.1 in chips)
Seat 5: 5354b045 ($17.7 in chips)
Seat 6: ccf24fd1 ($14.08 in chips)
f4bdb874: posts small blind $0.05
Hero: posts big blind $0.1
*** HOLE CARDS ***
Dealt to 27f72cf8 
Dealt to f4bdb874 
Dealt to Hero [3c 2c]
Dealt to 3d2a9541 
Dealt to 5354b045 
Dealt to ccf24fd1 
3d2a9541: folds
5354b045: folds
ccf24fd1: folds
27f72cf8: folds
f4bdb874: folds
Uncalled bet ($0.05) returned to Hero
*** SHOWDOWN ***
Hero collected $0.1 from pot
*** SUMMARY ***
Total pot $0.1 | Rake $0 | Jackpot $0 | Bingo $0 | Fortune $0
Seat 1: 27f72cf8 (button) folded before Flop (didn't bet)
Seat 2: f4bdb874 (small blind) folded before Flop
Seat 3: Hero (big blind) collected ($0.1)
Seat 4: 3d2a9541 folded before Flop (didn't bet)
Seat 5: 5354b045 folded before Flop (didn't bet)
Seat 6: ccf24fd1 folded before Flop (didn't bet)


Poker Hand #RC1450204597: Hold'em No Limit  ($0.05/$0.1) - 2023/04/04 13:22:05
Table 'RushAndCash1719857' 6-max Seat #1 is the button
Seat 1: 7a9f3eab ($18.26 in chips)
Seat 2: 435fe64d ($17.86 in chips)
Seat 3: 6142aa82 ($12.31 in chips)
Seat 4: 2e4160d3 ($4.86 in chips)
Seat 5: 5ca63c56 ($6.23 in chips)
Seat 6: Hero ($13.87 in chips)
435fe64d: posts small blind $0.05
6142aa82: posts big blind $0.1
*** HOLE CARDS ***
Dealt to 7a9f3eab 
Dealt to 435fe64d 
Dealt to 6142aa82 
Dealt to 2e4160d3 
Dealt to 5ca63c56 
Dealt to Hero [Th Kh]
2e4160d3: folds
5ca63c56: folds
Hero: raises $0.15 to $0.25
7a9f3eab: folds
435fe64d: folds
6142aa82: folds
Uncalled bet ($0.15) returned to Hero
*** SHOWDOWN ***
Hero collected $0.25 from pot
*** SUMMARY ***
Total pot $0.25 | Rake $0 | Jackpot $0 | Bingo $0 | Fortune $0
Seat 1: 7a9f3eab (button) folded before Flop (didn't bet)
Seat 2: 435fe64d (small blind) folded before Flop
Seat 3: 6142aa82 (big blind) folded before Flop
Seat 4: 2e4160d3 folded before Flop (didn't bet)
Seat 5: 5ca63c56 folded before Flop (didn't bet)
Seat 6: Hero collected ($0.25)


Poker Hand #RC1450204528: Hold'em No Limit  ($0.05/$0.1) - 2023/04/04 13:21:55
Table 'RushAndCash1719788' 6-max Seat #1 is the button
Seat 1: ea20233a ($10 in chips)
Seat 2: d26a5350 ($11.78 in chips)
Seat 3: 2fc15672 ($9.32 in chips)
Seat 4: 31925ca0 ($13.84 in chips)
Seat 5: 911a46b3 ($10 in chips)
Seat 6: Hero ($13.87 in chips)
d26a5350: posts small blind $0.05
2fc15672: posts big blind $0.1
*** HOLE CARDS ***
Dealt to ea20233a 
Dealt to d26a5350 
Dealt to 2fc15672 
Dealt to 31925ca0 
Dealt to 911a46b3 
Dealt to Hero [2d As]
31925ca0: folds
911a46b3: folds
Hero: folds
ea20233a: folds
d26a5350: folds
Uncalled bet ($0.05) returned to 2fc15672
*** SHOWDOWN ***
2fc15672 collected $0.1 from pot
*** SUMMARY ***
Total pot $0.1 | Rake $0 | Jackpot $0 | Bingo $0 | Fortune $0
Seat 1: ea20233a (button) folded before Flop (didn't bet)
Seat 2: d26a5350 (small blind) folded before Flop
Seat 3: 2fc15672 (big blind) collected ($0.1)
Seat 4: 31925ca0 folded before Flop (didn't bet)
Seat 5: 911a46b3 folded before Flop (didn't bet)
Seat 6: Hero folded before Flop (didn't bet)


Poker Hand #RC1450204437: Hold'em No Limit  ($0.05/$0.1) - 2023/04/04 13:21:39
Table 'RushAndCash1719697' 6-max Seat #1 is the button
Seat 1: 8c8a4356 ($19.72 in chips)
Seat 2: cf381112 ($3.27 in chips)
Seat 3: 3b6d9aa0 ($11.77 in chips)
Seat 4: Hero ($13.72 in chips)
Seat 5: 3037958b ($10 in chips)
Seat 6: 8278e2d5 ($12.06 in chips)
cf381112: posts small blind $0.05
3b6d9aa0: posts big blind $0.1
*** HOLE CARDS ***
Dealt to 8c8a4356 
Dealt to cf381112 
Dealt to 3b6d9aa0 
Dealt to Hero [As 8s]
Dealt to 3037958b 
Dealt to 8278e2d5 
Hero: raises $0.15 to $0.25
3037958b: folds
8278e2d5: folds
8c8a4356: folds
cf381112: folds
3b6d9aa0: folds
Uncalled bet ($0.15) returned to Hero
*** SHOWDOWN ***
Hero collected $0.25 from pot
*** SUMMARY ***
Total pot $0.25 | Rake $0 | Jackpot $0 | Bingo $0 | Fortune $0
Seat 1: 8c8a4356 (button) folded before Flop (didn't bet)
Seat 2: cf381112 (small blind) folded before Flop
Seat 3: 3b6d9aa0 (big blind) folded before Flop
Seat 4: Hero collected ($0.25)
Seat 5: 3037958b folded before Flop (didn't bet)
Seat 6: 8278e2d5 folded before Flop (didn't bet)


Poker Hand #RC1450204405: Hold'em No Limit  ($0.05/$0.1) - 2023/04/04 13:21:35
Table 'RushAndCash1719665' 6-max Seat #1 is the button
Seat 1: Hero ($13.72 in chips)
Seat 2: bebc21d4 ($10.05 in chips)
Seat 3: 3eae412f ($11.02 in chips)
Seat 4: d0a02003 ($10 in chips)
Seat 5: 337857b6 ($22.78 in chips)
Seat 6: 5e4c3740 ($21.72 in chips)
bebc21d4: posts small blind $0.05
3eae412f: posts big blind $0.1
*** HOLE CARDS ***
Dealt to Hero [7s Tc]
Dealt to bebc21d4 
Dealt to 3eae412f 
Dealt to d0a02003 
Dealt to 337857b6 
Dealt to 5e4c3740 
d0a02003: folds
337857b6: folds
5e4c3740: folds
Hero: folds
bebc21d4: folds
Uncalled bet ($0.05) returned to 3eae412f
*** SHOWDOWN ***
3eae412f collected $0.1 from pot
*** SUMMARY ***
Total pot $0.1 | Rake $0 | Jackpot $0 | Bingo $0 | Fortune $0
Seat 1: Hero (button) folded before Flop (didn't bet)
Seat 2: bebc21d4 (small blind) folded before Flop
Seat 3: 3eae412f (big blind) collected ($0.1)
Seat 4: d0a02003 folded before Flop (didn't bet)
Seat 5: 337857b6 folded before Flop (didn't bet)
Seat 6: 5e4c3740 folded before Flop (didn't bet)


Poker Hand #RC1450204358: Hold'em No Limit  ($0.05/$0.1) - 2023/04/04 13:21:26
Table 'RushAndCash1719618' 6-max Seat #1 is the button
Seat 1: e61d7625 ($10.65 in chips)
Seat 2: Hero ($13.77 in chips)
Seat 3: 21f27f8f ($10.05 in chips)
Seat 4: ec0f9625 ($10.94 in chips)
Seat 5: 337857b6 ($22.78 in chips)
Seat 6: 87faaa15 ($10 in chips)
Hero: posts small blind $0.05
21f27f8f: posts big blind $0.1
*** HOLE CARDS ***
Dealt to e61d7625 
Dealt to Hero [4c Qd]
Dealt to 21f27f8f 
Dealt to ec0f9625 
Dealt to 337857b6 
Dealt to 87faaa15 
ec0f9625: folds
337857b6: folds
87faaa15: folds
e61d7625: folds
Hero: folds
Uncalled bet ($0.05) returned to 21f27f8f
*** SHOWDOWN ***
21f27f8f collected $0.1 from pot
*** SUMMARY ***
Total pot $0.1 | Rake $0 | Jackpot $0 | Bingo $0 | Fortune $0
Seat 1: e61d7625 (button) folded before Flop (didn't bet)
Seat 2: Hero (small blind) folded before Flop
Seat 3: 21f27f8f (big blind) collected ($0.1)
Seat 4: ec0f9625 folded before Flop (didn't bet)
Seat 5: 337857b6 folded before Flop (didn't bet)
Seat 6: 87faaa15 folded before Flop (didn't bet)


Poker Hand #RC1450204130: Hold'em No Limit  ($0.05/$0.1) - 2023/04/04 13:20:50
Table 'RushAndCash1719390' 6-max Seat #1 is the button
Seat 1: c4688014 ($10.26 in chips)
Seat 2: 6aabbe8 ($9.75 in chips)
Seat 3: Hero ($14.02 in chips)
Seat 4: 84d74cfb ($14.31 in chips)
Seat 5: 4f8a129d ($11.07 in chips)
Seat 6: ec0f9625 ($10.66 in chips)
6aabbe8: posts small blind $0.05
Hero: posts big blind $0.1
*** HOLE CARDS ***
Dealt to c4688014 
Dealt to 6aabbe8 
Dealt to Hero [As 9s]
Dealt to 84d74cfb 
Dealt to 4f8a129d 
Dealt to ec0f9625 
84d74cfb: folds
4f8a129d: folds
ec0f9625: raises $0.15 to $0.25
c4688014: folds
6aabbe8: folds
Hero: calls $0.15
*** FLOP *** [Kd 4h Js]
Hero: checks
ec0f9625: bets $0.4
Hero: folds
Uncalled bet ($0.4) returned to ec0f9625
*** SHOWDOWN ***
ec0f9625 collected $0.53 from pot
*** SUMMARY ***
Total pot $0.55 | Rake $0.02 | Jackpot $0 | Bingo $0 | Fortune $0
Board [Kd 4h Js]
Seat 1: c4688014 (button) folded before Flop (didn't bet)
Seat 2: 6aabbe8 (small blind) folded before Flop
Seat 3: Hero (big blind) folded on the Flop
Seat 4: 84d74cfb folded before Flop (didn't bet)
Seat 5: 4f8a129d folded before Flop (didn't bet)
Seat 6: ec0f9625 won ($0.53)


Poker Hand #RC1450204090: Hold'em No Limit  ($0.05/$0.1) - 2023/04/04 13:20:43
Table 'RushAndCash1719350' 6-max Seat #1 is the button
Seat 1: 2752c843 ($5.8 in chips)
Seat 2: 353041b5 ($13.12 in chips)
Seat 3: d48d3fc5 ($10.99 in chips)
Seat 4: 571dc346 ($16.72 in chips)
Seat 5: Hero ($14.02 in chips)
Seat 6: 8278e2d5 ($11.68 in chips)
353041b5: posts small blind $0.05
d48d3fc5: posts big blind $0.1
*** HOLE CARDS ***
Dealt to 2752c843 
Dealt to 353041b5 
Dealt to d48d3fc5 
Dealt to 571dc346 
Dealt to Hero [Js 4h]
Dealt to 8278e2d5 
571dc346: raises $0.1 to $0.2
Hero: folds
8278e2d5: folds
2752c843: folds
353041b5: folds
d48d3fc5: folds
Uncalled bet ($0.1) returned to 571dc346
*** SHOWDOWN ***
571dc346 collected $0.25 from pot
*** SUMMARY ***
Total pot $0.25 | Rake $0 | Jackpot $0 | Bingo $0 | Fortune $0
Seat 1: 2752c843 (button) folded before Flop (didn't bet)
Seat 2: 353041b5 (small blind) folded before Flop
Seat 3: d48d3fc5 (big blind) folded before Flop
Seat 4: 571dc346 collected ($0.25)
Seat 5: Hero folded before Flop (didn't bet)
Seat 6: 8278e2d5 folded before Flop (didn't bet)


Poker Hand #RC1450204055: Hold'em No Limit  ($0.05/$0.1) - 2023/04/04 13:20:38
Table 'RushAndCash1719315' 6-max Seat #1 is the button
Seat 1: 93d67df6 ($16.68 in chips)
Seat 2: 1c355ec7 ($20.79 in chips)
Seat 3: 660f16de ($8.78 in chips)
Seat 4: Hero ($14.02 in chips)
Seat 5: e8e68652 ($17.58 in chips)
Seat 6: 44b47173 ($10.03 in chips)
1c355ec7: posts small blind $0.05
660f16de: posts big blind $0.1
*** HOLE CARDS ***
Dealt to 93d67df6 
Dealt to 1c355ec7 
Dealt to 660f16de 
Dealt to Hero [7h Qh]
Dealt to e8e68652 
Dealt to 44b47173 
Hero: folds
e8e68652: folds
44b47173: raises $0.15 to $0.25
93d67df6: folds
1c355ec7: calls $0.2
660f16de: folds
*** FLOP *** [9s 3d 3h]
1c355ec7: checks
44b47173: checks
*** TURN *** [9s 3d 3h] [5s]
1c355ec7: bets $0.45
44b47173: folds
Uncalled bet ($0.45) returned to 1c355ec7
*** SHOWDOWN ***
1c355ec7 collected $0.57 from pot
*** SUMMARY ***
Total pot $0.6 | Rake $0.03 | Jackpot $0 | Bingo $0 | Fortune $0
Board [9s 3d 3h 5s]
Seat 1: 93d67df6 (button) folded before Flop (didn't bet)
Seat 2: 1c355ec7 (small blind) won ($0.57)
Seat 3: 660f16de (big blind) folded before Flop
Seat 4: Hero folded before Flop (didn't bet)
Seat 5: e8e68652 folded before Flop (didn't bet)
Seat 6: 44b47173 folded on the Turn


Poker Hand #RC1450204008: Hold'em No Limit  ($0.05/$0.1) - 2023/04/04 13:20:31
Table 'RushAndCash1719268' 6-max Seat #1 is the button
Seat 1: 3d68c9d7 ($16.05 in chips)
Seat 2: a02d6ca1 ($18.59 in chips)
Seat 3: be5b99f9 ($12.54 in chips)
Seat 4: Hero ($14.02 in chips)
Seat 5: 337857b6 ($23.23 in chips)
Seat 6: ccf24fd1 ($12.72 in chips)
a02d6ca1: posts small blind $0.05
be5b99f9: posts big blind $0.1
*** HOLE CARDS ***
Dealt to 3d68c9d7 
Dealt to a02d6ca1 
Dealt to be5b99f9 
Dealt to Hero [5s 9c]
Dealt to 337857b6 
Dealt to ccf24fd1 
Hero: folds
337857b6: folds
ccf24fd1: folds
3d68c9d7: folds
a02d6ca1: folds
Uncalled bet ($0.05) returned to be5b99f9
*** SHOWDOWN ***
be5b99f9 collected $0.1 from pot
*** SUMMARY ***
Total pot $0.1 | Rake $0 | Jackpot $0 | Bingo $0 | Fortune $0
Seat 1: 3d68c9d7 (button) folded before Flop (didn't bet)
Seat 2: a02d6ca1 (small blind) folded before Flop
Seat 3: be5b99f9 (big blind) collected ($0.1)
Seat 4: Hero folded before Flop (didn't bet)
Seat 5: 337857b6 folded before Flop (didn't bet)
Seat 6: ccf24fd1 folded before Flop (didn't bet)


Poker Hand #RC1450203864: Hold'em No Limit  ($0.05/$0.1) - 2023/04/04 13:20:09
Table 'RushAndCash1719124' 6-max Seat #1 is the button
Seat 1: 29c40505 ($5.26 in chips)
Seat 2: Hero ($13.92 in chips)
Seat 3: 1c152682 ($10.34 in chips)
Seat 4: 7464cedc ($23.06 in chips)
Seat 5: ee225d5b ($17.19 in chips)
Seat 6: a95ce0e2 ($17.02 in chips)
Hero: posts small blind $0.05
1c152682: posts big blind $0.1
*** HOLE CARDS ***
Dealt to 29c40505 
Dealt to Hero [Kd Kh]
Dealt to 1c152682 
Dealt to 7464cedc 
Dealt to ee225d5b 
Dealt to a95ce0e2 
7464cedc: folds
ee225d5b: folds
a95ce0e2: folds
29c40505: folds
Hero: raises $0.2 to $0.3
1c152682: folds
Uncalled bet ($0.2) returned to Hero
*** SHOWDOWN ***
Hero collected $0.2 from pot
*** SUMMARY ***
Total pot $0.2 | Rake $0 | Jackpot $0 | Bingo $0 | Fortune $0
Seat 1: 29c40505 (button) folded before Flop (didn't bet)
Seat 2: Hero (small blind) collected ($0.2)
Seat 3: 1c152682 (big blind) folded before Flop
Seat 4: 7464cedc folded before Flop (didn't bet)
Seat 5: ee225d5b folded before Flop (didn't bet)
Seat 6: a95ce0e2 folded before Flop (didn't bet)


Poker Hand #RC1450203787: Hold'em No Limit  ($0.05/$0.1) - 2023/04/04 13:19:57
Table 'RushAndCash1719047' 6-max Seat #1 is the button
Seat 1: bebc21d4 ($10 in chips)
Seat 2: 26771a59 ($9.53 in chips)
Seat 3: Hero ($14.02 in chips)
Seat 4: 660f16de ($8.78 in chips)
Seat 5: 70a170d5 ($10.17 in chips)
Seat 6: c10d70f9 ($11.69 in chips)
26771a59: posts small blind $0.05
Hero: posts big blind $0.1
*** HOLE CARDS ***
Dealt to bebc21d4 
Dealt to 26771a59 
Dealt to Hero [9s Qc]
Dealt to 660f16de 
Dealt to 70a170d5 
Dealt to c10d70f9 
660f16de: folds
70a170d5: folds
c10d70f9: folds
bebc21d4: raises $0.2 to $0.3
26771a59: calls $0.25
Hero: folds
*** FLOP *** [Qd 9c Jh]
26771a59: checks
bebc21d4: checks
*** TURN *** [Qd 9c Jh] [Tc]
26771a59: bets $0.35
bebc21d4: folds
Uncalled bet ($0.35) returned to 26771a59
*** SHOWDOWN ***
26771a59 collected $0.67 from pot
*** SUMMARY ***
Total pot $0.7 | Rake $0.03 | Jackpot $0 | Bingo $0 | Fortune $0
Board [Qd 9c Jh Tc]
Seat 1: bebc21d4 (button) folded on the Turn
Seat 2: 26771a59 (small blind) won ($0.67)
Seat 3: Hero (big blind) folded before Flop
Seat 4: 660f16de folded before Flop (didn't bet)
Seat 5: 70a170d5 folded before Flop (didn't bet)
Seat 6: c10d70f9 folded before Flop (didn't bet)


Poker Hand #RC1450203701: Hold'em No Limit  ($0.05/$0.1) - 2023/04/04 13:19:44
Table 'RushAndCash1718961' 6-max Seat #1 is the button
Seat 1: Hero ($14.02 in chips)
Seat 2: d60f8e2d ($9.6 in chips)
Seat 3: 5055f8d5 ($11.16 in chips)
Seat 4: cf381112 ($4.37 in chips)
Seat 5: f054a803 ($5.7 in chips)
Seat 6: 4f06df97 ($10 in chips)
d60f8e2d: posts small blind $0.05
5055f8d5: posts big blind $0.1
*** HOLE CARDS ***
Dealt to Hero [4d 5h]
Dealt to d60f8e2d 
Dealt to 5055f8d5 
Dealt to cf381112 
Dealt to f054a803 
Dealt to 4f06df97 
cf381112: folds
f054a803: raises $0.15 to $0.25
4f06df97: folds
Hero: folds
d60f8e2d: folds
5055f8d5: folds
Uncalled bet ($0.15) returned to f054a803
*** SHOWDOWN ***
f054a803 collected $0.25 from pot
*** SUMMARY ***
Total pot $0.25 | Rake $0 | Jackpot $0 | Bingo $0 | Fortune $0
Seat 1: Hero (button) folded before Flop (didn't bet)
Seat 2: d60f8e2d (small blind) folded before Flop
Seat 3: 5055f8d5 (big blind) folded before Flop
Seat 4: cf381112 folded before Flop (didn't bet)
Seat 5: f054a803 collected ($0.25)
Seat 6: 4f06df97 folded before Flop (didn't bet)


Poker Hand #RC1450203605: Hold'em No Limit  ($0.05/$0.1) - 2023/04/04 13:19:30
Table 'RushAndCash1718865' 6-max Seat #1 is the button
Seat 1: cf14bf6c ($9.61 in chips)
Seat 2: 1ef67c60 ($6.08 in chips)
Seat 3: 831f6c59 ($14.2 in chips)
Seat 4: 5a2a25e4 ($13.46 in chips)
Seat 5: 4498df0d ($11.77 in chips)
Seat 6: Hero ($14.02 in chips)
1ef67c60: posts small blind $0.05
831f6c59: posts big blind $0.1
*** HOLE CARDS ***
Dealt to cf14bf6c 
Dealt to 1ef67c60 
Dealt to 831f6c59 
Dealt to 5a2a25e4 
Dealt to 4498df0d 
Dealt to Hero [8h Ts]
5a2a25e4: raises $0.2 to $0.3
4498df0d: folds
Hero: folds
cf14bf6c: folds
1ef67c60: folds
831f6c59: folds
Uncalled bet ($0.2) returned to 5a2a25e4
*** SHOWDOWN ***
5a2a25e4 collected $0.25 from pot
*** SUMMARY ***
Total pot $0.25 | Rake $0 | Jackpot $0 | Bingo $0 | Fortune $0
Seat 1: cf14bf6c (button) folded before Flop (didn't bet)
Seat 2: 1ef67c60 (small blind) folded before Flop
Seat 3: 831f6c59 (big blind) folded before Flop
Seat 4: 5a2a25e4 collected ($0.25)
Seat 5: 4498df0d folded before Flop (didn't bet)
Seat 6: Hero folded before Flop (didn't bet)


Poker Hand #RC1450203561: Hold'em No Limit  ($0.05/$0.1) - 2023/04/04 13:19:24
Table 'RushAndCash1718821' 6-max Seat #1 is the button
Seat 1: 931ea47c ($10.81 in chips)
Seat 2: 403f45d7 ($13.58 in chips)
Seat 3: b36fb082 ($10 in chips)
Seat 4: Hero ($14.02 in chips)
Seat 5: 93f94e7 ($10.07 in chips)
Seat 6: a7c9e27d ($29.21 in chips)
403f45d7: posts small blind $0.05
b36fb082: posts big blind $0.1
*** HOLE CARDS ***
Dealt to 931ea47c 
Dealt to 403f45d7 
Dealt to b36fb082 
Dealt to Hero [8c 6d]
Dealt to 93f94e7 
Dealt to a7c9e27d 
Hero: folds
93f94e7: raises $0.12 to $0.22
a7c9e27d: calls $0.22
931ea47c: folds
403f45d7: folds
b36fb082: folds
*** FLOP *** [7s Td 4s]
93f94e7: checks
a7c9e27d: bets $0.32
93f94e7: calls $0.32
*** TURN *** [7s Td 4s] [Qh]
93f94e7: checks
a7c9e27d: bets $0.93
93f94e7: folds
Uncalled bet ($0.93) returned to a7c9e27d
*** SHOWDOWN ***
a7c9e27d collected $1.17 from pot
*** SUMMARY ***
Total pot $1.23 | Rake $0.06 | Jackpot $0 | Bingo $0 | Fortune $0
Board [7s Td 4s Qh]
Seat 1: 931ea47c (button) folded before Flop (didn't bet)
Seat 2: 403f45d7 (small blind) folded before Flop
Seat 3: b36fb082 (big blind) folded before Flop
Seat 4: Hero folded before Flop (didn't bet)
Seat 5: 93f94e7 folded on the Turn
Seat 6: a7c9e27d won ($1.17)


Poker Hand #RC1450203498: Hold'em No Limit  ($0.05/$0.1) - 2023/04/04 13:19:15
Table 'RushAndCash1718758' 6-max Seat #1 is the button
Seat 1: 31d951c2 ($9.9 in chips)
Seat 2: 189e1226 ($10.18 in chips)
Seat 3: 521c5f6e ($10.14 in chips)
Seat 4: d0ced2eb ($13.73 in chips)
Seat 5: 89c31dc5 ($12.32 in chips)
Seat 6: Hero ($14.02 in chips)
189e1226: posts small blind $0.05
521c5f6e: posts big blind $0.1
*** HOLE CARDS ***
Dealt to 31d951c2 
Dealt to 189e1226 
Dealt to 521c5f6e 
Dealt to d0ced2eb 
Dealt to 89c31dc5 
Dealt to Hero [6h Ac]
d0ced2eb: folds
89c31dc5: raises $0.15 to $0.25
Hero: folds
31d951c2: folds
189e1226: folds
521c5f6e: folds
Uncalled bet ($0.15) returned to 89c31dc5
*** SHOWDOWN ***
89c31dc5 collected $0.25 from pot
*** SUMMARY ***
Total pot $0.25 | Rake $0 | Jackpot $0 | Bingo $0 | Fortune $0
Seat 1: 31d951c2 (button) folded before Flop (didn't bet)
Seat 2: 189e1226 (small blind) folded before Flop
Seat 3: 521c5f6e (big blind) folded before Flop
Seat 4: d0ced2eb folded before Flop (didn't bet)
Seat 5: 89c31dc5 collected ($0.25)
Seat 6: Hero folded before Flop (didn't bet)


Poker Hand #RC1450203454: Hold'em No Limit  ($0.05/$0.1) - 2023/04/04 13:19:08
Table 'RushAndCash1718714' 6-max Seat #1 is the button
Seat 1: 44b47173 ($10 in chips)
Seat 2: Hero ($14.07 in chips)
Seat 3: 93f04da5 ($27.67 in chips)
Seat 4: a68ddb6d ($13.85 in chips)
Seat 5: 6dd0850b ($11.03 in chips)
Seat 6: 7b5d549c ($21.69 in chips)
Hero: posts small blind $0.05
93f04da5: posts big blind $0.1
*** HOLE CARDS ***
Dealt to 44b47173 
Dealt to Hero [8d 5s]
Dealt to 93f04da5 
Dealt to a68ddb6d 
Dealt to 6dd0850b 
Dealt to 7b5d549c 
a68ddb6d: folds
6dd0850b: raises $0.2 to $0.3
7b5d549c: folds
44b47173: folds
Hero: folds
93f04da5: calls $0.2
*** FLOP *** [Th 2h 9s]
93f04da5: checks
6dd0850b: bets $0.33
93f04da5: calls $0.33
*** TURN *** [Th 2h 9s] [4c]
93f04da5: checks
6dd0850b: bets $0.66
93f04da5: folds
Uncalled bet ($0.66) returned to 6dd0850b
*** SHOWDOWN ***
6dd0850b collected $1.25 from pot
*** SUMMARY ***
Total pot $1.31 | Rake $0.06 | Jackpot $0 | Bingo $0 | Fortune $0
Board [Th 2h 9s 4c]
Seat 1: 44b47173 (button) folded before Flop (didn't bet)
Seat 2: Hero (small blind) folded before Flop
Seat 3: 93f04da5 (big blind) folded on the Turn
Seat 4: a68ddb6d folded before Flop (didn't bet)
Seat 5: 6dd0850b won ($1.25)
Seat 6: 7b5d549c folded before Flop (didn't bet)


Poker Hand #RC1450203381: Hold'em No Limit  ($0.05/$0.1) - 2023/04/04 13:18:56
Table 'RushAndCash1718641' 6-max Seat #1 is the button
Seat 1: 7a9f3eab ($17.86 in chips)
Seat 2: a38a0f53 ($10 in chips)
Seat 3: Hero ($14.17 in chips)
Seat 4: e439ecaf ($9.25 in chips)
Seat 5: 67239530 ($21.5 in chips)
Seat 6: 95917217 ($10.69 in chips)
a38a0f53: posts small blind $0.05
Hero: posts big blind $0.1
*** HOLE CARDS ***
Dealt to 7a9f3eab 
Dealt to a38a0f53 
Dealt to Hero [4s Qs]
Dealt to e439ecaf 
Dealt to 67239530 
Dealt to 95917217 
e439ecaf: folds
67239530: folds
95917217: folds
7a9f3eab: raises $0.15 to $0.25
a38a0f53: folds
Hero: folds
Uncalled bet ($0.15) returned to 7a9f3eab
*** SHOWDOWN ***
7a9f3eab collected $0.25 from pot
*** SUMMARY ***
Total pot $0.25 | Rake $0 | Jackpot $0 | Bingo $0 | Fortune $0
Seat 1: 7a9f3eab (button) collected ($0.25)
Seat 2: a38a0f53 (small blind) folded before Flop
Seat 3: Hero (big blind) folded before Flop
Seat 4: e439ecaf folded before Flop (didn't bet)
Seat 5: 67239530 folded before Flop (didn't bet)
Seat 6: 95917217 folded before Flop (didn't bet)


Poker Hand #RC1450203354: Hold'em No Limit  ($0.05/$0.1) - 2023/04/04 13:18:52
Table 'RushAndCash1718614' 6-max Seat #1 is the button
Seat 1: Hero ($14.17 in chips)
Seat 2: d81a9783 ($13.36 in chips)
Seat 3: c6e3e6b3 ($44.81 in chips)
Seat 4: 1ebd7102 ($16.76 in chips)
Seat 5: 2652e5d3 ($9.31 in chips)
Seat 6: 57e952c2 ($14.26 in chips)
d81a9783: posts small blind $0.05
c6e3e6b3: posts big blind $0.1
*** HOLE CARDS ***
Dealt to Hero [Qd 2h]
Dealt to d81a9783 
Dealt to c6e3e6b3 
Dealt to 1ebd7102 
Dealt to 2652e5d3 
Dealt to 57e952c2 
1ebd7102: folds
2652e5d3: folds
57e952c2: folds
Hero: folds
d81a9783: folds
Uncalled bet ($0.05) returned to c6e3e6b3
*** SHOWDOWN ***
c6e3e6b3 collected $0.1 from pot
*** SUMMARY ***
Total pot $0.1 | Rake $0 | Jackpot $0 | Bingo $0 | Fortune $0
Seat 1: Hero (button) folded before Flop (didn't bet)
Seat 2: d81a9783 (small blind) folded before Flop
Seat 3: c6e3e6b3 (big blind) collected ($0.1)
Seat 4: 1ebd7102 folded before Flop (didn't bet)
Seat 5: 2652e5d3 folded before Flop (didn't bet)
Seat 6: 57e952c2 folded before Flop (didn't bet)


Poker Hand #RC1450203322: Hold'em No Limit  ($0.05/$0.1) - 2023/04/04 13:18:46
Table 'RushAndCash1718582' 6-max Seat #1 is the button
Seat 1: 132cbcc2 ($10.13 in chips)
Seat 2: 83dee427 ($13.09 in chips)
Seat 3: a1ef0696 ($10.15 in chips)
Seat 4: 8271b321 ($10.12 in chips)
Seat 5: d52b3937 ($24.38 in chips)
Seat 6: Hero ($14.17 in chips)
83dee427: posts small blind $0.05
a1ef0696: posts big blind $0.1
*** HOLE CARDS ***
Dealt to 132cbcc2 
Dealt to 83dee427 
Dealt to a1ef0696 
Dealt to 8271b321 
Dealt to d52b3937 
Dealt to Hero [4d 6s]
8271b321: folds
d52b3937: folds
Hero: folds
132cbcc2: folds
83dee427: folds
Uncalled bet ($0.05) returned to a1ef0696
*** SHOWDOWN ***
a1ef0696 collected $0.1 from pot
*** SUMMARY ***
Total pot $0.1 | Rake $0 | Jackpot $0 | Bingo $0 | Fortune $0
Seat 1: 132cbcc2 (button) folded before Flop (didn't bet)
Seat 2: 83dee427 (small blind) folded before Flop
Seat 3: a1ef0696 (big blind) collected ($0.1)
Seat 4: 8271b321 folded before Flop (didn't bet)
Seat 5: d52b3937 folded before Flop (didn't bet)
Seat 6: Hero folded before Flop (didn't bet)


Poker Hand #RC1450203295: Hold'em No Limit  ($0.05/$0.1) - 2023/04/04 13:18:42
Table 'RushAndCash1718555' 6-max Seat #1 is the button
Seat 1: 2652e5d3 ($9.16 in chips)
Seat 2: 93d67df6 ($14.97 in chips)
Seat 3: a99ea745 ($14.51 in chips)
Seat 4: 10ca4c7f ($4.49 in chips)
Seat 5: 1d5dc9a9 ($11.06 in chips)
Seat 6: Hero ($14.17 in chips)
93d67df6: posts small blind $0.05
a99ea745: posts big blind $0.1
*** HOLE CARDS ***
Dealt to 2652e5d3 
Dealt to 93d67df6 
Dealt to a99ea745 
Dealt to 10ca4c7f 
Dealt to 1d5dc9a9 
Dealt to Hero [8s Ts]
10ca4c7f: folds
1d5dc9a9: folds
Hero: folds
2652e5d3: folds
93d67df6: folds
Uncalled bet ($0.05) returned to a99ea745
*** SHOWDOWN ***
a99ea745 collected $0.1 from pot
*** SUMMARY ***
Total pot $0.1 | Rake $0 | Jackpot $0 | Bingo $0 | Fortune $0
Seat 1: 2652e5d3 (button) folded before Flop (didn't bet)
Seat 2: 93d67df6 (small blind) folded before Flop
Seat 3: a99ea745 (big blind) collected ($0.1)
Seat 4: 10ca4c7f folded before Flop (didn't bet)
Seat 5: 1d5dc9a9 folded before Flop (didn't bet)
Seat 6: Hero folded before Flop (didn't bet)


Poker Hand #RC1450203156: Hold'em No Limit  ($0.05/$0.1) - 2023/04/04 13:18:23
Table 'RushAndCash1718416' 6-max Seat #1 is the button
Seat 1: bb59ca08 ($12.9 in chips)
Seat 2: Hero ($14.22 in chips)
Seat 3: dd558106 ($12.07 in chips)
Seat 4: 158312ec ($7.57 in chips)
Seat 5: 8e403005 ($14.55 in chips)
Seat 6: f3d07c6d ($10.76 in chips)
Hero: posts small blind $0.05
dd558106: posts big blind $0.1
*** HOLE CARDS ***
Dealt to bb59ca08 
Dealt to Hero [As Qc]
Dealt to dd558106 
Dealt to 158312ec 
Dealt to 8e403005 
Dealt to f3d07c6d 
158312ec: folds
8e403005: raises $0.2 to $0.3
f3d07c6d: raises $0.6 to $0.9
bb59ca08: folds
Hero: folds
dd558106: folds
8e403005: calls $0.6
*** FLOP *** [Ks 5s 8d]
8e403005: checks
f3d07c6d: bets $0.88
8e403005: calls $0.88
*** TURN *** [Ks 5s 8d] [7h]
8e403005: checks
f3d07c6d: checks
*** RIVER *** [Ks 5s 8d 7h] [4d]
8e403005: checks
f3d07c6d: checks
8e403005: shows [Td Jd] (King-High)
f3d07c6d: shows [Jh Ah] (Ace-High)
*** SHOWDOWN ***
f3d07c6d collected $3.39 from pot
*** SUMMARY ***
Total pot $3.71 | Rake $0.17 | Jackpot $0.15 | Bingo $0 | Fortune $0
Board [Ks 5s 8d 7h 4d]
Seat 1: bb59ca08 (button) folded before Flop (didn't bet)
Seat 2: Hero (small blind) folded before Flop
Seat 3: dd558106 (big blind) folded before Flop
Seat 4: 158312ec folded before Flop (didn't bet)
Seat 5: 8e403005 showed [Td Jd] and lost with King-High
Seat 6: f3d07c6d showed [Jh Ah] and won ($3.39) with Ace-High


Poker Hand #RC1450203078: Hold'em No Limit  ($0.05/$0.1) - 2023/04/04 13:18:12
Table 'RushAndCash1718338' 6-max Seat #1 is the button
Seat 1: efab3a0e ($12.74 in chips)
Seat 2: 5daf4032 ($10.93 in chips)
Seat 3: Hero ($14.32 in chips)
Seat 4: 660f16de ($8.93 in chips)
Seat 5: 10ca4c7f ($4.49 in chips)
Seat 6: 1852367 ($8.73 in chips)
5daf4032: posts small blind $0.05
Hero: posts big blind $0.1
*** HOLE CARDS ***
Dealt to efab3a0e 
Dealt to 5daf4032 
Dealt to Hero [7d 4c]
Dealt to 660f16de 
Dealt to 10ca4c7f 
Dealt to 1852367 
660f16de: raises $0.1 to $0.2
10ca4c7f: folds
1852367: folds
efab3a0e: folds
5daf4032: folds
Hero: folds
Uncalled bet ($0.1) returned to 660f16de
*** SHOWDOWN ***
660f16de collected $0.25 from pot
*** SUMMARY ***
Total pot $0.25 | Rake $0 | Jackpot $0 | Bingo $0 | Fortune $0
Seat 1: efab3a0e (button) folded before Flop (didn't bet)
Seat 2: 5daf4032 (small blind) folded before Flop
Seat 3: Hero (big blind) folded before Flop
Seat 4: 660f16de collected ($0.25)
Seat 5: 10ca4c7f folded before Flop (didn't bet)
Seat 6: 1852367 folded before Flop (didn't bet)


Poker Hand #RC1450203021: Hold'em No Limit  ($0.05/$0.1) - 2023/04/04 13:18:03
Table 'RushAndCash1718281' 6-max Seat #1 is the button
Seat 1: Hero ($14.32 in chips)
Seat 2: bebc21d4 ($10.15 in chips)
Seat 3: e773a95d ($12.28 in chips)
Seat 4: 892df41c ($10 in chips)
Seat 5: 42313935 ($9.9 in chips)
Seat 6: e3047465 ($22.71 in chips)
bebc21d4: posts small blind $0.05
e773a95d: posts big blind $0.1
*** HOLE CARDS ***
Dealt to Hero [3d 6h]
Dealt to bebc21d4 
Dealt to e773a95d 
Dealt to 892df41c 
Dealt to 42313935 
Dealt to e3047465 
892df41c: folds
42313935: raises $0.2 to $0.3
e3047465: folds
Hero: folds
bebc21d4: calls $0.25
e773a95d: calls $0.2
*** FLOP *** [Qs 3h 3c]
bebc21d4: checks
e773a95d: checks
42313935: checks
*** TURN *** [Qs 3h 3c] [2s]
bebc21d4: checks
e773a95d: checks
42313935: checks
*** RIVER *** [Qs 3h 3c 2s] [Ks]
bebc21d4: bets $0.45
e773a95d: folds
42313935: folds
Uncalled bet ($0.45) returned to bebc21d4
*** SHOWDOWN ***
bebc21d4 collected $0.85 from pot
*** SUMMARY ***
Total pot $0.9 | Rake $0.05 | Jackpot $0 | Bingo $0 | Fortune $0
Board [Qs 3h 3c 2s Ks]
Seat 1: Hero (button) folded before Flop (didn't bet)
Seat 2: bebc21d4 (small blind) won ($0.85)
Seat 3: e773a95d (big blind) folded on the River
Seat 4: 892df41c folded before Flop (didn't bet)
Seat 5: 42313935 folded on the River
Seat 6: e3047465 folded before Flop (didn't bet)


Poker Hand #RC1450201533: Hold'em No Limit  ($0.05/$0.1) - 2023/04/04 13:14:24
Table 'RushAndCash1716793' 6-max Seat #1 is the button
Seat 1: 96996b73 ($10 in chips)
Seat 2: c5a640a ($29.61 in chips)
Seat 3: 67239530 ($25.51 in chips)
Seat 4: 1aba88ac ($10 in chips)
Seat 5: Hero ($10.49 in chips)
Seat 6: d4a191bb ($11.08 in chips)
c5a640a: posts small blind $0.05
67239530: posts big blind $0.1
*** HOLE CARDS ***
Dealt to 96996b73 
Dealt to c5a640a 
Dealt to 67239530 
Dealt to 1aba88ac 
Dealt to Hero [Ad Qs]
Dealt to d4a191bb 
1aba88ac: folds
Hero: raises $0.15 to $0.25
d4a191bb: folds
96996b73: folds
c5a640a: folds
67239530: raises $1 to $1.25
Hero: calls $1
*** FLOP *** [8d As 9c]
67239530: bets $0.85
Hero: calls $0.85
*** TURN *** [8d As 9c] [5s]
67239530: bets $2.13
Hero: calls $2.13
*** RIVER *** [8d As 9c 5s] [4s]
67239530: checks
Hero: bets $2.5
67239530: folds
Uncalled bet ($2.5) returned to Hero
*** SHOWDOWN ***
Hero collected $8.06 from pot
*** SUMMARY ***
Total pot $8.51 | Rake $0.3 | Jackpot $0.15 | Bingo $0 | Fortune $0
Board [8d As 9c 5s 4s]
Seat 1: 96996b73 (button) folded before Flop (didn't bet)
Seat 2: c5a640a (small blind) folded before Flop
Seat 3: 67239530 (big blind) folded on the River
Seat 4: 1aba88ac folded before Flop (didn't bet)
Seat 5: Hero won ($8.06)
Seat 6: d4a191bb folded before Flop (didn't bet)


Poker Hand #RC1450201493: Hold'em No Limit  ($0.05/$0.1) - 2023/04/04 13:14:18
Table 'RushAndCash1716753' 6-max Seat #1 is the button
Seat 1: Hero ($10.49 in chips)
Seat 2: 265bb427 ($4.98 in chips)
Seat 3: ca953875 ($10.47 in chips)
Seat 4: de5bd074 ($19.24 in chips)
Seat 5: 7b5d549c ($21.11 in chips)
Seat 6: f996b3d ($8.19 in chips)
265bb427: posts small blind $0.05
ca953875: posts big blind $0.1
*** HOLE CARDS ***
Dealt to Hero [Kh 6d]
Dealt to 265bb427 
Dealt to ca953875 
Dealt to de5bd074 
Dealt to 7b5d549c 
Dealt to f996b3d 
de5bd074: raises $0.2 to $0.3
7b5d549c: folds
f996b3d: folds
Hero: folds
265bb427: folds
ca953875: folds
Uncalled bet ($0.2) returned to de5bd074
*** SHOWDOWN ***
de5bd074 collected $0.25 from pot
*** SUMMARY ***
Total pot $0.25 | Rake $0 | Jackpot $0 | Bingo $0 | Fortune $0
Seat 1: Hero (button) folded before Flop (didn't bet)
Seat 2: 265bb427 (small blind) folded before Flop
Seat 3: ca953875 (big blind) folded before Flop
Seat 4: de5bd074 collected ($0.25)
Seat 5: 7b5d549c folded before Flop (didn't bet)
Seat 6: f996b3d folded before Flop (didn't bet)


Poker Hand #RC1450201465: Hold'em No Limit  ($0.05/$0.1) - 2023/04/04 13:14:14
Table 'RushAndCash1716725' 6-max Seat #1 is the button
Seat 1: 44b47173 ($10.55 in chips)
Seat 2: b6e4a9b6 ($25.41 in chips)
Seat 3: 9ce5799b ($28.31 in chips)
Seat 4: 9b6a8260 ($18.56 in chips)
Seat 5: Hero ($10.49 in chips)
Seat 6: f054a803 ($4.98 in chips)
b6e4a9b6: posts small blind $0.05
9ce5799b: posts big blind $0.1
*** HOLE CARDS ***
Dealt to 44b47173 
Dealt to b6e4a9b6 
Dealt to 9ce5799b 
Dealt to 9b6a8260 
Dealt to Hero [5c 6s]
Dealt to f054a803 
9b6a8260: folds
Hero: folds
f054a803: folds
44b47173: folds
b6e4a9b6: raises $0.12 to $0.22
9ce5799b: calls $0.12
*** FLOP *** [Kh 4d 2d]
b6e4a9b6: bets $0.16
9ce5799b: raises $0.38 to $0.54
b6e4a9b6: folds
Uncalled bet ($0.38) returned to 9ce5799b
*** SHOWDOWN ***
9ce5799b collected $0.73 from pot
*** SUMMARY ***
Total pot $0.76 | Rake $0.03 | Jackpot $0 | Bingo $0 | Fortune $0
Board [Kh 4d 2d]
Seat 1: 44b47173 (button) folded before Flop (didn't bet)
Seat 2: b6e4a9b6 (small blind) folded on the Flop
Seat 3: 9ce5799b (big blind) won ($0.73)
Seat 4: 9b6a8260 folded before Flop (didn't bet)
Seat 5: Hero folded before Flop (didn't bet)
Seat 6: f054a803 folded before Flop (didn't bet)


Poker Hand #RC1450201029: Hold'em No Limit  ($0.05/$0.1) - 2023/04/04 13:13:07
Table 'RushAndCash1716289' 6-max Seat #1 is the button
Seat 1: 9b6a8260 ($17 in chips)
Seat 2: Hero ($12.27 in chips)
Seat 3: a56d63c6 ($11.96 in chips)
Seat 4: bebc21d4 ($10 in chips)
Seat 5: a7a71095 ($10 in chips)
Seat 6: 40d1ac0e ($20.79 in chips)
Hero: posts small blind $0.05
a56d63c6: posts big blind $0.1
*** HOLE CARDS ***
Dealt to 9b6a8260 
Dealt to Hero [Ah Qh]
Dealt to a56d63c6 
Dealt to bebc21d4 
Dealt to a7a71095 
Dealt to 40d1ac0e 
bebc21d4: folds
a7a71095: folds
40d1ac0e: folds
9b6a8260: raises $0.15 to $0.25
Hero: raises $0.8 to $1.05
a56d63c6: folds
9b6a8260: calls $0.8
*** FLOP *** [8d 4h 8c]
Hero: bets $0.73
9b6a8260: calls $0.73
*** TURN *** [8d 4h 8c] [7c]
Hero: checks
9b6a8260: bets $2.75
Hero: folds
Uncalled bet ($2.75) returned to 9b6a8260
*** SHOWDOWN ***
9b6a8260 collected $3.34 from pot
*** SUMMARY ***
Total pot $3.66 | Rake $0.17 | Jackpot $0.15 | Bingo $0 | Fortune $0
Board [8d 4h 8c 7c]
Seat 1: 9b6a8260 (button) won ($3.34)
Seat 2: Hero (small blind) folded on the Turn
Seat 3: a56d63c6 (big blind) folded before Flop
Seat 4: bebc21d4 folded before Flop (didn't bet)
Seat 5: a7a71095 folded before Flop (didn't bet)
Seat 6: 40d1ac0e folded before Flop (didn't bet)


Poker Hand #RC1450200966: Hold'em No Limit  ($0.05/$0.1) - 2023/04/04 13:12:58
Table 'RushAndCash1716226' 6-max Seat #1 is the button
Seat 1: 4b6302ea ($9.3 in chips)
Seat 2: c10d70f9 ($11.63 in chips)
Seat 3: Hero ($12.37 in chips)
Seat 4: 42d998fa ($12.79 in chips)
Seat 5: 2591eae4 ($13.13 in chips)
Seat 6: 8c62e299 ($10.11 in chips)
c10d70f9: posts small blind $0.05
Hero: posts big blind $0.1
*** HOLE CARDS ***
Dealt to 4b6302ea 
Dealt to c10d70f9 
Dealt to Hero [2s Jd]
Dealt to 42d998fa 
Dealt to 2591eae4 
Dealt to 8c62e299 
42d998fa: folds
2591eae4: folds
8c62e299: folds
4b6302ea: folds
c10d70f9: raises $0.2 to $0.3
Hero: folds
Uncalled bet ($0.2) returned to c10d70f9
*** SHOWDOWN ***
c10d70f9 collected $0.2 from pot
*** SUMMARY ***
Total pot $0.2 | Rake $0 | Jackpot $0 | Bingo $0 | Fortune $0
Seat 1: 4b6302ea (button) folded before Flop (didn't bet)
Seat 2: c10d70f9 (small blind) collected ($0.2)
Seat 3: Hero (big blind) folded before Flop
Seat 4: 42d998fa folded before Flop (didn't bet)
Seat 5: 2591eae4 folded before Flop (didn't bet)
Seat 6: 8c62e299 folded before Flop (didn't bet)


Poker Hand #RC1450200417: Hold'em No Limit  ($0.05/$0.1) - 2023/04/04 13:11:39
Table 'RushAndCash1715677' 6-max Seat #1 is the button
Seat 1: 975b0144 ($10.89 in chips)
Seat 2: bd5ad169 ($13.95 in chips)
Seat 3: 4b6302ea ($7.65 in chips)
Seat 4: Hero ($14.3 in chips)
Seat 5: d62a71a7 ($35.46 in chips)
Seat 6: 563140a8 ($11.23 in chips)
bd5ad169: posts small blind $0.05
4b6302ea: posts big blind $0.1
*** HOLE CARDS ***
Dealt to 975b0144 
Dealt to bd5ad169 
Dealt to 4b6302ea 
Dealt to Hero [Kh Jc]
Dealt to d62a71a7 
Dealt to 563140a8 
Hero: raises $0.15 to $0.25
d62a71a7: folds
563140a8: folds
975b0144: folds
bd5ad169: folds
4b6302ea: calls $0.15
*** FLOP *** [7c Kd 3h]
4b6302ea: checks
Hero: bets $0.28
4b6302ea: calls $0.28
*** TURN *** [7c Kd 3h] [8h]
4b6302ea: checks
Hero: bets $0.37
4b6302ea: raises $1.03 to $1.4
Hero: calls $1.03
*** RIVER *** [7c Kd 3h 8h] [5s]
4b6302ea: bets $5.72 and is all-in
Hero: folds
Uncalled bet ($5.72) returned to 4b6302ea
*** SHOWDOWN ***
4b6302ea collected $3.58 from pot
*** SUMMARY ***
Total pot $3.91 | Rake $0.18 | Jackpot $0.15 | Bingo $0 | Fortune $0
Board [7c Kd 3h 8h 5s]
Seat 1: 975b0144 (button) folded before Flop (didn't bet)
Seat 2: bd5ad169 (small blind) folded before Flop
Seat 3: 4b6302ea (big blind) won ($3.58)
Seat 4: Hero folded on the River
Seat 5: d62a71a7 folded before Flop (didn't bet)
Seat 6: 563140a8 folded before Flop (didn't bet)


Poker Hand #RC1450199848: Hold'em No Limit  ($0.05/$0.1) - 2023/04/04 13:10:12
Table 'RushAndCash1715108' 6-max Seat #1 is the button
Seat 1: 3614f6af ($10.63 in chips)
Seat 2: d81a9783 ($10.05 in chips)
Seat 3: bd5ad169 ($12.92 in chips)
Seat 4: 772b0ce1 ($10 in chips)
Seat 5: Hero ($15.39 in chips)
Seat 6: d0ced2eb ($11.53 in chips)
d81a9783: posts small blind $0.05
bd5ad169: posts big blind $0.1
*** HOLE CARDS ***
Dealt to 3614f6af 
Dealt to d81a9783 
Dealt to bd5ad169 
Dealt to 772b0ce1 
Dealt to Hero [Kc Kh]
Dealt to d0ced2eb 
772b0ce1: folds
Hero: raises $0.15 to $0.25
d0ced2eb: folds
3614f6af: folds
d81a9783: folds
bd5ad169: calls $0.15
*** FLOP *** [Jc 9d 8c]
bd5ad169: checks
Hero: bets $0.28
bd5ad169: calls $0.28
*** TURN *** [Jc 9d 8c] [3d]
bd5ad169: checks
Hero: bets $0.56
bd5ad169: calls $0.56
*** RIVER *** [Jc 9d 8c 3d] [7s]
bd5ad169: bets $1.79
Hero: folds
Uncalled bet ($1.79) returned to bd5ad169
*** SHOWDOWN ***
bd5ad169 collected $2.12 from pot
*** SUMMARY ***
Total pot $2.23 | Rake $0.11 | Jackpot $0 | Bingo $0 | Fortune $0
Board [Jc 9d 8c 3d 7s]
Seat 1: 3614f6af (button) folded before Flop (didn't bet)
Seat 2: d81a9783 (small blind) folded before Flop
Seat 3: bd5ad169 (big blind) won ($2.12)
Seat 4: 772b0ce1 folded before Flop (didn't bet)
Seat 5: Hero folded on the River
Seat 6: d0ced2eb folded before Flop (didn't bet)


Poker Hand #RC1450199778: Hold'em No Limit  ($0.05/$0.1) - 2023/04/04 13:10:00
Table 'RushAndCash1715038' 6-max Seat #1 is the button
Seat 1: 8b2916d3 ($10.15 in chips)
Seat 2: 83b3d916 ($11.3 in chips)
Seat 3: 5296da72 ($4.6 in chips)
Seat 4: 7b5d549c ($21.28 in chips)
Seat 5: Hero ($15.39 in chips)
Seat 6: b2a74498 ($21.43 in chips)
83b3d916: posts small blind $0.05
5296da72: posts big blind $0.1
*** HOLE CARDS ***
Dealt to 8b2916d3 
Dealt to 83b3d916 
Dealt to 5296da72 
Dealt to 7b5d549c 
Dealt to Hero [9d Kc]
Dealt to b2a74498 
7b5d549c: folds
Hero: folds
b2a74498: folds
8b2916d3: raises $0.15 to $0.25
83b3d916: folds
5296da72: calls $0.15
*** FLOP *** [2d Ah Js]
5296da72: checks
8b2916d3: bets $0.28
5296da72: folds
Uncalled bet ($0.28) returned to 8b2916d3
*** SHOWDOWN ***
8b2916d3 collected $0.53 from pot
*** SUMMARY ***
Total pot $0.55 | Rake $0.02 | Jackpot $0 | Bingo $0 | Fortune $0
Board [2d Ah Js]
Seat 1: 8b2916d3 (button) won ($0.53)
Seat 2: 83b3d916 (small blind) folded before Flop
Seat 3: 5296da72 (big blind) folded on the Flop
Seat 4: 7b5d549c folded before Flop (didn't bet)
Seat 5: Hero folded before Flop (didn't bet)
Seat 6: b2a74498 folded before Flop (didn't bet)


Poker Hand #RC1450199753: Hold'em No Limit  ($0.05/$0.1) - 2023/04/04 13:09:56
Table 'RushAndCash1715013' 6-max Seat #1 is the button
Seat 1: 851526cc ($9.32 in chips)
Seat 2: 505ae137 ($10 in chips)
Seat 3: ee225d5b ($17.18 in chips)
Seat 4: adf2c4c ($16.11 in chips)
Seat 5: 422942d ($12.67 in chips)
Seat 6: Hero ($15.39 in chips)
505ae137: posts small blind $0.05
ee225d5b: posts big blind $0.1
*** HOLE CARDS ***
Dealt to 851526cc 
Dealt to 505ae137 
Dealt to ee225d5b 
Dealt to adf2c4c 
Dealt to 422942d 
Dealt to Hero [3d Qd]
adf2c4c: folds
422942d: folds
Hero: folds
851526cc: folds
505ae137: folds
Uncalled bet ($0.05) returned to ee225d5b
*** SHOWDOWN ***
ee225d5b collected $0.1 from pot
*** SUMMARY ***
Total pot $0.1 | Rake $0 | Jackpot $0 | Bingo $0 | Fortune $0
Seat 1: 851526cc (button) folded before Flop (didn't bet)
Seat 2: 505ae137 (small blind) folded before Flop
Seat 3: ee225d5b (big blind) collected ($0.1)
Seat 4: adf2c4c folded before Flop (didn't bet)
Seat 5: 422942d folded before Flop (didn't bet)
Seat 6: Hero folded before Flop (didn't bet)


Poker Hand #RC1450199726: Hold'em No Limit  ($0.05/$0.1) - 2023/04/04 13:09:51
Table 'RushAndCash1714986' 6-max Seat #1 is the button
Seat 1: 9c60e565 ($16.29 in chips)
Seat 2: d62ff668 ($10.51 in chips)
Seat 3: b8fb2e35 ($23.96 in chips)
Seat 4: efab3a0e ($10.64 in chips)
Seat 5: 8b2916d3 ($10.15 in chips)
Seat 6: Hero ($15.39 in chips)
d62ff668: posts small blind $0.05
b8fb2e35: posts big blind $0.1
*** HOLE CARDS ***
Dealt to 9c60e565 
Dealt to d62ff668 
Dealt to b8fb2e35 
Dealt to efab3a0e 
Dealt to 8b2916d3 
Dealt to Hero [4s Kc]
efab3a0e: folds
8b2916d3: folds
Hero: folds
9c60e565: folds
d62ff668: folds
Uncalled bet ($0.05) returned to b8fb2e35
*** SHOWDOWN ***
b8fb2e35 collected $0.1 from pot
*** SUMMARY ***
Total pot $0.1 | Rake $0 | Jackpot $0 | Bingo $0 | Fortune $0
Seat 1: 9c60e565 (button) folded before Flop (didn't bet)
Seat 2: d62ff668 (small blind) folded before Flop
Seat 3: b8fb2e35 (big blind) collected ($0.1)
Seat 4: efab3a0e folded before Flop (didn't bet)
Seat 5: 8b2916d3 folded before Flop (didn't bet)
Seat 6: Hero folded before Flop (didn't bet)


Poker Hand #RC1450199690: Hold'em No Limit  ($0.05/$0.1) - 2023/04/04 13:09:46
Table 'RushAndCash1714950' 6-max Seat #1 is the button
Seat 1: 9ce9afa0 ($10.26 in chips)
Seat 2: a242fb49 ($11.73 in chips)
Seat 3: abb6ebf4 ($10 in chips)
Seat 4: 99c2d5e0 ($11.09 in chips)
Seat 5: Hero ($15.39 in chips)
Seat 6: 1d39a56c ($11.53 in chips)
a242fb49: posts small blind $0.05
abb6ebf4: posts big blind $0.1
*** HOLE CARDS ***
Dealt to 9ce9afa0 
Dealt to a242fb49 
Dealt to abb6ebf4 
Dealt to 99c2d5e0 
Dealt to Hero [7d 5h]
Dealt to 1d39a56c 
99c2d5e0: raises $0.2 to $0.3
Hero: folds
1d39a56c: calls $0.3
9ce9afa0: folds
a242fb49: folds
abb6ebf4: calls $0.2
*** FLOP *** [8c 6h 3d]
abb6ebf4: bets $0.46
99c2d5e0: folds
1d39a56c: folds
Uncalled bet ($0.46) returned to abb6ebf4
*** SHOWDOWN ***
abb6ebf4 collected $0.9 from pot
*** SUMMARY ***
Total pot $0.95 | Rake $0.05 | Jackpot $0 | Bingo $0 | Fortune $0
Board [8c 6h 3d]
Seat 1: 9ce9afa0 (button) folded before Flop (didn't bet)
Seat 2: a242fb49 (small blind) folded before Flop
Seat 3: abb6ebf4 (big blind) won ($0.9)
Seat 4: 99c2d5e0 folded on the Flop
Seat 5: Hero folded before Flop (didn't bet)
Seat 6: 1d39a56c folded on the Flop


Poker Hand #RC1450199657: Hold'em No Limit  ($0.05/$0.1) - 2023/04/04 13:09:41
Table 'RushAndCash1714917' 6-max Seat #1 is the button
Seat 1: 1361f9b6 ($19.57 in chips)
Seat 2: c62e3e4d ($16.49 in chips)
Seat 3: Hero ($15.49 in chips)
Seat 4: 2e09a268 ($4.9 in chips)
Seat 5: 3614f6af ($10.78 in chips)
Seat 6: a89e8ad5 ($11.05 in chips)
c62e3e4d: posts small blind $0.05
Hero: posts big blind $0.1
*** HOLE CARDS ***
Dealt to 1361f9b6 
Dealt to c62e3e4d 
Dealt to Hero [2d 6h]
Dealt to 2e09a268 
Dealt to 3614f6af 
Dealt to a89e8ad5 
2e09a268: folds
3614f6af: folds
a89e8ad5: raises $0.15 to $0.25
1361f9b6: calls $0.25
c62e3e4d: folds
Hero: folds
*** FLOP *** [5d 6d 7c]
a89e8ad5: bets $0.51
1361f9b6: calls $0.51
*** TURN *** [5d 6d 7c] [Td]
a89e8ad5: bets $2.34
1361f9b6: folds
Uncalled bet ($2.34) returned to a89e8ad5
*** SHOWDOWN ***
a89e8ad5 collected $1.59 from pot
*** SUMMARY ***
Total pot $1.67 | Rake $0.08 | Jackpot $0 | Bingo $0 | Fortune $0
Board [5d 6d 7c Td]
Seat 1: 1361f9b6 (button) folded on the Turn
Seat 2: c62e3e4d (small blind) folded before Flop
Seat 3: Hero (big blind) folded before Flop
Seat 4: 2e09a268 folded before Flop (didn't bet)
Seat 5: 3614f6af folded before Flop (didn't bet)
Seat 6: a89e8ad5 won ($1.59)


Poker Hand #RC1450199603: Hold'em No Limit  ($0.05/$0.1) - 2023/04/04 13:09:32
Table 'RushAndCash1714863' 6-max Seat #1 is the button
Seat 1: Hero ($15.49 in chips)
Seat 2: 772b0ce1 ($10.92 in chips)
Seat 3: fc2e2645 ($12.51 in chips)
Seat 4: 4b4fac94 ($12.07 in chips)
Seat 5: 9052a998 ($11.99 in chips)
Seat 6: a7c9e27d ($25.34 in chips)
772b0ce1: posts small blind $0.05
fc2e2645: posts big blind $0.1
*** HOLE CARDS ***
Dealt to Hero [Ac 6d]
Dealt to 772b0ce1 
Dealt to fc2e2645 
Dealt to 4b4fac94 
Dealt to 9052a998 
Dealt to a7c9e27d 
4b4fac94: folds
9052a998: folds
a7c9e27d: raises $0.15 to $0.25
Hero: folds
772b0ce1: raises $0.85 to $1.1
fc2e2645: folds
a7c9e27d: calls $0.85
*** FLOP *** [7h 2d Th]
772b0ce1: checks
a7c9e27d: bets $1.25
772b0ce1: folds
Uncalled bet ($1.25) returned to a7c9e27d
*** SHOWDOWN ***
a7c9e27d collected $2.19 from pot
*** SUMMARY ***
Total pot $2.3 | Rake $0.11 | Jackpot $0 | Bingo $0 | Fortune $0
Board [7h 2d Th]
Seat 1: Hero (button) folded before Flop (didn't bet)
Seat 2: 772b0ce1 (small blind) folded on the Flop
Seat 3: fc2e2645 (big blind) folded before Flop
Seat 4: 4b4fac94 folded before Flop (didn't bet)
Seat 5: 9052a998 folded before Flop (didn't bet)
Seat 6: a7c9e27d won ($2.19)


Poker Hand #RC1450199555: Hold'em No Limit  ($0.05/$0.1) - 2023/04/04 13:09:25
Table 'RushAndCash1714815' 6-max Seat #1 is the button
Seat 1: 4177aafc ($11.9 in chips)
Seat 2: Hero ($15.54 in chips)
Seat 3: a32c2431 ($11.35 in chips)
Seat 4: e27ee34e ($10 in chips)
Seat 5: 37387541 ($18.38 in chips)
Seat 6: 7e38a471 ($2.82 in chips)
Hero: posts small blind $0.05
a32c2431: posts big blind $0.1
*** HOLE CARDS ***
Dealt to 4177aafc 
Dealt to Hero [5h 2h]
Dealt to a32c2431 
Dealt to e27ee34e 
Dealt to 37387541 
Dealt to 7e38a471 
e27ee34e: folds
37387541: folds
7e38a471: folds
4177aafc: raises $0.15 to $0.25
Hero: folds
a32c2431: calls $0.15
*** FLOP *** [Kc 8h Jc]
a32c2431: checks
4177aafc: bets $0.19
a32c2431: calls $0.19
*** TURN *** [Kc 8h Jc] [5c]
a32c2431: checks
4177aafc: checks
*** RIVER *** [Kc 8h Jc 5c] [7c]
a32c2431: checks
4177aafc: bets $1.4
a32c2431: folds
Uncalled bet ($1.4) returned to 4177aafc
*** SHOWDOWN ***
4177aafc collected $0.89 from pot
*** SUMMARY ***
Total pot $0.93 | Rake $0.04 | Jackpot $0 | Bingo $0 | Fortune $0
Board [Kc 8h Jc 5c 7c]
Seat 1: 4177aafc (button) won ($0.89)
Seat 2: Hero (small blind) folded before Flop
Seat 3: a32c2431 (big blind) folded on the River
Seat 4: e27ee34e folded before Flop (didn't bet)
Seat 5: 37387541 folded before Flop (didn't bet)
Seat 6: 7e38a471 folded before Flop (didn't bet)


Poker Hand #RC1450199492: Hold'em No Limit  ($0.05/$0.1) - 2023/04/04 13:09:14
Table 'RushAndCash1714752' 6-max Seat #1 is the button
Seat 1: cf381112 ($5.16 in chips)
Seat 2: 7adb2a2b ($23.29 in chips)
Seat 3: c5aaea23 ($13.14 in chips)
Seat 4: e2540526 ($10.89 in chips)
Seat 5: Hero ($15.54 in chips)
Seat 6: 4312a339 ($10.25 in chips)
7adb2a2b: posts small blind $0.05
c5aaea23: posts big blind $0.1
*** HOLE CARDS ***
Dealt to cf381112 
Dealt to 7adb2a2b 
Dealt to c5aaea23 
Dealt to e2540526 
Dealt to Hero [2d 3s]
Dealt to 4312a339 
e2540526: folds
Hero: folds
4312a339: raises $0.15 to $0.25
cf381112: folds
7adb2a2b: folds
c5aaea23: folds
Uncalled bet ($0.15) returned to 4312a339
*** SHOWDOWN ***
4312a339 collected $0.25 from pot
*** SUMMARY ***
Total pot $0.25 | Rake $0 | Jackpot $0 | Bingo $0 | Fortune $0
Seat 1: cf381112 (button) folded before Flop (didn't bet)
Seat 2: 7adb2a2b (small blind) folded before Flop
Seat 3: c5aaea23 (big blind) folded before Flop
Seat 4: e2540526 folded before Flop (didn't bet)
Seat 5: Hero folded before Flop (didn't bet)
Seat 6: 4312a339 collected ($0.25)


Poker Hand #RC1450199444: Hold'em No Limit  ($0.05/$0.1) - 2023/04/04 13:09:07
Table 'RushAndCash1714704' 6-max Seat #1 is the button
Seat 1: f0d77ceb ($12.47 in chips)
Seat 2: cbd10165 ($5.04 in chips)
Seat 3: 4b6302ea ($5.59 in chips)
Seat 4: 2a84deda ($17.08 in chips)
Seat 5: Hero ($15.54 in chips)
Seat 6: 7b5d549c ($20.85 in chips)
cbd10165: posts small blind $0.05
4b6302ea: posts big blind $0.1
*** HOLE CARDS ***
Dealt to f0d77ceb 
Dealt to cbd10165 
Dealt to 4b6302ea 
Dealt to 2a84deda 
Dealt to Hero [Qh 3c]
Dealt to 7b5d549c 
2a84deda: folds
Hero: folds
7b5d549c: raises $0.13 to $0.23
f0d77ceb: folds
cbd10165: folds
4b6302ea: folds
Uncalled bet ($0.13) returned to 7b5d549c
*** SHOWDOWN ***
7b5d549c collected $0.25 from pot
*** SUMMARY ***
Total pot $0.25 | Rake $0 | Jackpot $0 | Bingo $0 | Fortune $0
Seat 1: f0d77ceb (button) folded before Flop (didn't bet)
Seat 2: cbd10165 (small blind) folded before Flop
Seat 3: 4b6302ea (big blind) folded before Flop
Seat 4: 2a84deda folded before Flop (didn't bet)
Seat 5: Hero folded before Flop (didn't bet)
Seat 6: 7b5d549c collected ($0.25)


Poker Hand #RC1450199337: Hold'em No Limit  ($0.05/$0.1) - 2023/04/04 13:08:51
Table 'RushAndCash1714597' 6-max Seat #1 is the button
Seat 1: 851526cc ($9.17 in chips)
Seat 2: 9b63d394 ($11.21 in chips)
Seat 3: 772b0ce1 ($11.07 in chips)
Seat 4: 9c6a7b48 ($18.29 in chips)
Seat 5: Hero ($15.39 in chips)
Seat 6: 6bfcffcd ($11.39 in chips)
9b63d394: posts small blind $0.05
772b0ce1: posts big blind $0.1
*** HOLE CARDS ***
Dealt to 851526cc 
Dealt to 9b63d394 
Dealt to 772b0ce1 
Dealt to 9c6a7b48 
Dealt to Hero [Td Ad]
Dealt to 6bfcffcd 
9c6a7b48: folds
Hero: raises $0.15 to $0.25
6bfcffcd: folds
851526cc: folds
9b63d394: folds
772b0ce1: folds
Uncalled bet ($0.15) returned to Hero
*** SHOWDOWN ***
Hero collected $0.25 from pot
*** SUMMARY ***
Total pot $0.25 | Rake $0 | Jackpot $0 | Bingo $0 | Fortune $0
Seat 1: 851526cc (button) folded before Flop (didn't bet)
Seat 2: 9b63d394 (small blind) folded before Flop
Seat 3: 772b0ce1 (big blind) folded before Flop
Seat 4: 9c6a7b48 folded before Flop (didn't bet)
Seat 5: Hero collected ($0.25)
Seat 6: 6bfcffcd folded before Flop (didn't bet)


Poker Hand #RC1450199307: Hold'em No Limit  ($0.05/$0.1) - 2023/04/04 13:08:46
Table 'RushAndCash1714567' 6-max Seat #1 is the button
Seat 1: Hero ($15.39 in chips)
Seat 2: 8aeb7ce4 ($10.05 in chips)
Seat 3: 34362433 ($14.22 in chips)
Seat 4: ff2ca10c ($10.05 in chips)
Seat 5: d52b3937 ($16.46 in chips)
Seat 6: 6044cf04 ($24.59 in chips)
8aeb7ce4: posts small blind $0.05
34362433: posts big blind $0.1
*** HOLE CARDS ***
Dealt to Hero [5h 2d]
Dealt to 8aeb7ce4 
Dealt to 34362433 
Dealt to ff2ca10c 
Dealt to d52b3937 
Dealt to 6044cf04 
ff2ca10c: raises $0.2 to $0.3
d52b3937: folds
6044cf04: folds
Hero: folds
8aeb7ce4: folds
34362433: folds
Uncalled bet ($0.2) returned to ff2ca10c
*** SHOWDOWN ***
ff2ca10c collected $0.25 from pot
*** SUMMARY ***
Total pot $0.25 | Rake $0 | Jackpot $0 | Bingo $0 | Fortune $0
Seat 1: Hero (button) folded before Flop (didn't bet)
Seat 2: 8aeb7ce4 (small blind) folded before Flop
Seat 3: 34362433 (big blind) folded before Flop
Seat 4: ff2ca10c collected ($0.25)
Seat 5: d52b3937 folded before Flop (didn't bet)
Seat 6: 6044cf04 folded before Flop (didn't bet)


Poker Hand #RC1450199214: Hold'em No Limit  ($0.05/$0.1) - 2023/04/04 13:08:32
Table 'RushAndCash1714474' 6-max Seat #1 is the button
Seat 1: 8131709 ($10 in chips)
Seat 2: Hero ($15.44 in chips)
Seat 3: 99c2d5e0 ($19.52 in chips)
Seat 4: adfb7a38 ($11.16 in chips)
Seat 5: ad1cc215 ($25.54 in chips)
Seat 6: a1c62f27 ($9.69 in chips)
Hero: posts small blind $0.05
99c2d5e0: posts big blind $0.1
*** HOLE CARDS ***
Dealt to 8131709 
Dealt to Hero [3d 2c]
Dealt to 99c2d5e0 
Dealt to adfb7a38 
Dealt to ad1cc215 
Dealt to a1c62f27 
adfb7a38: raises $0.15 to $0.25
ad1cc215: folds
a1c62f27: folds
8131709: folds
Hero: folds
99c2d5e0: folds
Uncalled bet ($0.15) returned to adfb7a38
*** SHOWDOWN ***
adfb7a38 collected $0.25 from pot
*** SUMMARY ***
Total pot $0.25 | Rake $0 | Jackpot $0 | Bingo $0 | Fortune $0
Seat 1: 8131709 (button) folded before Flop (didn't bet)
Seat 2: Hero (small blind) folded before Flop
Seat 3: 99c2d5e0 (big blind) folded before Flop
Seat 4: adfb7a38 collected ($0.25)
Seat 5: ad1cc215 folded before Flop (didn't bet)
Seat 6: a1c62f27 folded before Flop (didn't bet)


Poker Hand #RC1450198990: Hold'em No Limit  ($0.05/$0.1) - 2023/04/04 13:07:59
Table 'RushAndCash1714250' 6-max Seat #1 is the button
Seat 1: b243336c ($10.59 in chips)
Seat 2: adfb7a38 ($11.71 in chips)
Seat 3: Hero ($14.94 in chips)
Seat 4: c5aaea23 ($12.92 in chips)
Seat 5: a200a7df ($12.69 in chips)
Seat 6: bad9fca9 ($10 in chips)
adfb7a38: posts small blind $0.05
Hero: posts big blind $0.1
*** HOLE CARDS ***
Dealt to b243336c 
Dealt to adfb7a38 
Dealt to Hero [Js Jh]
Dealt to c5aaea23 
Dealt to a200a7df 
Dealt to bad9fca9 
c5aaea23: folds
a200a7df: folds
bad9fca9: folds
b243336c: folds
adfb7a38: raises $0.1 to $0.2
Hero: raises $0.35 to $0.55
adfb7a38: calls $0.35
*** FLOP *** [Jc 9c Qc]
adfb7a38: checks
Hero: bets $0.55
adfb7a38: folds
Uncalled bet ($0.55) returned to Hero
*** SHOWDOWN ***
Hero collected $1.05 from pot
*** SUMMARY ***
Total pot $1.1 | Rake $0.05 | Jackpot $0 | Bingo $0 | Fortune $0
Board [Jc 9c Qc]
Seat 1: b243336c (button) folded before Flop (didn't bet)
Seat 2: adfb7a38 (small blind) folded on the Flop
Seat 3: Hero (big blind) won ($1.05)
Seat 4: c5aaea23 folded before Flop (didn't bet)
Seat 5: a200a7df folded before Flop (didn't bet)
Seat 6: bad9fca9 folded before Flop (didn't bet)


Poker Hand #RC1450198721: Hold'em No Limit  ($0.05/$0.1) - 2023/04/04 13:07:19
Table 'RushAndCash1713981' 6-max Seat #1 is the button
Seat 1: 185c5581 ($11.49 in chips)
Seat 2: b243336c ($10.27 in chips)
Seat 3: ca953875 ($10 in chips)
Seat 4: 6d5351e3 ($15.4 in chips)
Seat 5: 8c20be0f ($14.42 in chips)
Seat 6: Hero ($15.19 in chips)
b243336c: posts small blind $0.05
ca953875: posts big blind $0.1
*** HOLE CARDS ***
Dealt to 185c5581 
Dealt to b243336c 
Dealt to ca953875 
Dealt to 6d5351e3 
Dealt to 8c20be0f 
Dealt to Hero [5c Ah]
6d5351e3: folds
8c20be0f: folds
Hero: raises $0.15 to $0.25
185c5581: folds
b243336c: raises $0.65 to $0.9
ca953875: folds
Hero: folds
Uncalled bet ($0.65) returned to b243336c
*** SHOWDOWN ***
b243336c collected $0.57 from pot
*** SUMMARY ***
Total pot $0.6 | Rake $0.03 | Jackpot $0 | Bingo $0 | Fortune $0
Seat 1: 185c5581 (button) folded before Flop (didn't bet)
Seat 2: b243336c (small blind) collected ($0.57)
Seat 3: ca953875 (big blind) folded before Flop
Seat 4: 6d5351e3 folded before Flop (didn't bet)
Seat 5: 8c20be0f folded before Flop (didn't bet)
Seat 6: Hero folded before Flop


Poker Hand #RC1450198692: Hold'em No Limit  ($0.05/$0.1) - 2023/04/04 13:07:14
Table 'RushAndCash1713952' 6-max Seat #1 is the button
Seat 1: 7e38a471 ($3.78 in chips)
Seat 2: 37d69c98 ($10 in chips)
Seat 3: b6e4a9b6 ($24.95 in chips)
Seat 4: Hero ($15.19 in chips)
Seat 5: c7ae08ec ($10.46 in chips)
Seat 6: 741f86e ($10.1 in chips)
37d69c98: posts small blind $0.05
b6e4a9b6: posts big blind $0.1
*** HOLE CARDS ***
Dealt to 7e38a471 
Dealt to 37d69c98 
Dealt to b6e4a9b6 
Dealt to Hero [2h 8c]
Dealt to c7ae08ec 
Dealt to 741f86e 
Hero: folds
c7ae08ec: folds
741f86e: folds
7e38a471: folds
37d69c98: folds
Uncalled bet ($0.05) returned to b6e4a9b6
*** SHOWDOWN ***
b6e4a9b6 collected $0.1 from pot
*** SUMMARY ***
Total pot $0.1 | Rake $0 | Jackpot $0 | Bingo $0 | Fortune $0
Seat 1: 7e38a471 (button) folded before Flop (didn't bet)
Seat 2: 37d69c98 (small blind) folded before Flop
Seat 3: b6e4a9b6 (big blind) collected ($0.1)
Seat 4: Hero folded before Flop (didn't bet)
Seat 5: c7ae08ec folded before Flop (didn't bet)
Seat 6: 741f86e folded before Flop (didn't bet)


Poker Hand #RC1450197969: Hold'em No Limit  ($0.05/$0.1) - 2023/04/04 13:05:24
Table 'RushAndCash1713229' 6-max Seat #1 is the button
Seat 1: Hero ($20.79 in chips)
Seat 2: 88e6cfdf ($9.75 in chips)
Seat 3: e61d7625 ($10.45 in chips)
Seat 4: ee225d5b ($13.56 in chips)
Seat 5: dbb873be ($5.6 in chips)
Seat 6: 2196134a ($20.76 in chips)
88e6cfdf: posts small blind $0.05
e61d7625: posts big blind $0.1
*** HOLE CARDS ***
Dealt to Hero [Jc Jh]
Dealt to 88e6cfdf 
Dealt to e61d7625 
Dealt to ee225d5b 
Dealt to dbb873be 
Dealt to 2196134a 
ee225d5b: folds
dbb873be: raises $0.15 to $0.25
2196134a: folds
Hero: raises $0.54 to $0.79
88e6cfdf: folds
e61d7625: folds
dbb873be: calls $0.54
*** FLOP *** [Kh 5h 8s]
dbb873be: bets $0.87
Hero: calls $0.87
*** TURN *** [Kh 5h 8s] [3s]
dbb873be: bets $1.15
Hero: calls $1.15
*** RIVER *** [Kh 5h 8s 3s] [6c]
dbb873be: bets $2.79 and is all-in
Hero: calls $2.79
dbb873be: shows [Ac Ks] (Pair of Kings)
Hero: shows [Jc Jh] (Pair of Jacks)
*** SHOWDOWN ***
dbb873be collected $10.7 from pot
*** SUMMARY ***
Total pot $11.35 | Rake $0.5 | Jackpot $0.15 | Bingo $0 | Fortune $0
Board [Kh 5h 8s 3s 6c]
Seat 1: Hero (button) showed [Jc Jh] and lost with Pair of Jacks
Seat 2: 88e6cfdf (small blind) folded before Flop
Seat 3: e61d7625 (big blind) folded before Flop
Seat 4: ee225d5b folded before Flop (didn't bet)
Seat 5: dbb873be showed [Ac Ks] and won ($10.7) with Pair of Kings
Seat 6: 2196134a folded before Flop (didn't bet)


Poker Hand #RC1450197913: Hold'em No Limit  ($0.05/$0.1) - 2023/04/04 13:05:15
Table 'RushAndCash1713173' 6-max Seat #1 is the button
Seat 1: 263d3da ($10.21 in chips)
Seat 2: Hero ($20.84 in chips)
Seat 3: 45bd0d17 ($12.2 in chips)
Seat 4: f0b3102e ($10.38 in chips)
Seat 5: d8f47e5a ($10 in chips)
Seat 6: ee225d5b ($13.56 in chips)
Hero: posts small blind $0.05
45bd0d17: posts big blind $0.1
*** HOLE CARDS ***
Dealt to 263d3da 
Dealt to Hero [6c 8h]
Dealt to 45bd0d17 
Dealt to f0b3102e 
Dealt to d8f47e5a 
Dealt to ee225d5b 
f0b3102e: folds
d8f47e5a: raises $0.2 to $0.3
ee225d5b: folds
263d3da: folds
Hero: folds
45bd0d17: folds
Uncalled bet ($0.2) returned to d8f47e5a
*** SHOWDOWN ***
d8f47e5a collected $0.25 from pot
*** SUMMARY ***
Total pot $0.25 | Rake $0 | Jackpot $0 | Bingo $0 | Fortune $0
Seat 1: 263d3da (button) folded before Flop (didn't bet)
Seat 2: Hero (small blind) folded before Flop
Seat 3: 45bd0d17 (big blind) folded before Flop
Seat 4: f0b3102e folded before Flop (didn't bet)
Seat 5: d8f47e5a collected ($0.25)
Seat 6: ee225d5b folded before Flop (didn't bet)


Poker Hand #RC1450197176: Hold'em No Limit  ($0.05/$0.1) - 2023/04/04 13:03:21
Table 'RushAndCash1712436' 6-max Seat #1 is the button
Seat 1: ea20233a ($13.52 in chips)
Seat 2: 975b0144 ($10.07 in chips)
Seat 3: Hero ($20.39 in chips)
Seat 4: c708262 ($14.74 in chips)
Seat 5: 69ba4194 ($10.18 in chips)
Seat 6: 72641a64 ($13.21 in chips)
975b0144: posts small blind $0.05
Hero: posts big blind $0.1
*** HOLE CARDS ***
Dealt to ea20233a 
Dealt to 975b0144 
Dealt to Hero [3s Ks]
Dealt to c708262 
Dealt to 69ba4194 
Dealt to 72641a64 
c708262: folds
69ba4194: folds
72641a64: folds
ea20233a: raises $0.15 to $0.25
975b0144: folds
Hero: calls $0.15
*** FLOP *** [Kc 5c 9d]
Hero: checks
ea20233a: bets $0.19
Hero: calls $0.19
*** TURN *** [Kc 5c 9d] [Td]
Hero: checks
ea20233a: checks
*** RIVER *** [Kc 5c 9d Td] [Qs]
Hero: bets $0.3
ea20233a: folds
Uncalled bet ($0.3) returned to Hero
*** SHOWDOWN ***
Hero collected $0.89 from pot
*** SUMMARY ***
Total pot $0.93 | Rake $0.04 | Jackpot $0 | Bingo $0 | Fortune $0
Board [Kc 5c 9d Td Qs]
Seat 1: ea20233a (button) folded on the River
Seat 2: 975b0144 (small blind) folded before Flop
Seat 3: Hero (big blind) won ($0.89)
Seat 4: c708262 folded before Flop (didn't bet)
Seat 5: 69ba4194 folded before Flop (didn't bet)
Seat 6: 72641a64 folded before Flop (didn't bet)


Poker Hand #RC1450197140: Hold'em No Limit  ($0.05/$0.1) - 2023/04/04 13:03:17
Table 'RushAndCash1712400' 6-max Seat #1 is the button
Seat 1: b047d1a3 ($9.92 in chips)
Seat 2: 521c5f6e ($14.9 in chips)
Seat 3: 5632af2 ($19.77 in chips)
Seat 4: Hero ($20.39 in chips)
Seat 5: eacb4d2c ($10.36 in chips)
Seat 6: cffc1ea3 ($16.07 in chips)
521c5f6e: posts small blind $0.05
5632af2: posts big blind $0.1
*** HOLE CARDS ***
Dealt to b047d1a3 
Dealt to 521c5f6e 
Dealt to 5632af2 
Dealt to Hero [8d 9c]
Dealt to eacb4d2c 
Dealt to cffc1ea3 
Hero: folds
eacb4d2c: folds
cffc1ea3: folds
b047d1a3: folds
521c5f6e: folds
Uncalled bet ($0.05) returned to 5632af2
*** SHOWDOWN ***
5632af2 collected $0.1 from pot
*** SUMMARY ***
Total pot $0.1 | Rake $0 | Jackpot $0 | Bingo $0 | Fortune $0
Seat 1: b047d1a3 (button) folded before Flop (didn't bet)
Seat 2: 521c5f6e (small blind) folded before Flop
Seat 3: 5632af2 (big blind) collected ($0.1)
Seat 4: Hero folded before Flop (didn't bet)
Seat 5: eacb4d2c folded before Flop (didn't bet)
Seat 6: cffc1ea3 folded before Flop (didn't bet)


Poker Hand #RC1450197070: Hold'em No Limit  ($0.05/$0.1) - 2023/04/04 13:03:07
Table 'RushAndCash1712330' 6-max Seat #1 is the button
Seat 1: 88adc2bd ($14.15 in chips)
Seat 2: 6d5351e3 ($10 in chips)
Seat 3: b89f42f0 ($23.47 in chips)
Seat 4: Hero ($20.24 in chips)
Seat 5: f054a803 ($8.02 in chips)
Seat 6: 1ed91dc7 ($11.62 in chips)
6d5351e3: posts small blind $0.05
b89f42f0: posts big blind $0.1
*** HOLE CARDS ***
Dealt to 88adc2bd 
Dealt to 6d5351e3 
Dealt to b89f42f0 
Dealt to Hero [Jd Kd]
Dealt to f054a803 
Dealt to 1ed91dc7 
Hero: raises $0.15 to $0.25
f054a803: folds
1ed91dc7: folds
88adc2bd: folds
6d5351e3: folds
b89f42f0: folds
Uncalled bet ($0.15) returned to Hero
*** SHOWDOWN ***
Hero collected $0.25 from pot
*** SUMMARY ***
Total pot $0.25 | Rake $0 | Jackpot $0 | Bingo $0 | Fortune $0
Seat 1: 88adc2bd (button) folded before Flop (didn't bet)
Seat 2: 6d5351e3 (small blind) folded before Flop
Seat 3: b89f42f0 (big blind) folded before Flop
Seat 4: Hero collected ($0.25)
Seat 5: f054a803 folded before Flop (didn't bet)
Seat 6: 1ed91dc7 folded before Flop (didn't bet)


Poker Hand #RC1450197038: Hold'em No Limit  ($0.05/$0.1) - 2023/04/04 13:03:02
Table 'RushAndCash1712298' 6-max Seat #1 is the button
Seat 1: ec6db2f6 ($9.45 in chips)
Seat 2: a1c62f27 ($10.15 in chips)
Seat 3: c740e135 ($10.15 in chips)
Seat 4: Hero ($20.24 in chips)
Seat 5: f5da36f8 ($10.05 in chips)
Seat 6: af1da715 ($3.54 in chips)
a1c62f27: posts small blind $0.05
c740e135: posts big blind $0.1
*** HOLE CARDS ***
Dealt to ec6db2f6 
Dealt to a1c62f27 
Dealt to c740e135 
Dealt to Hero [Kh 6c]
Dealt to f5da36f8 
Dealt to af1da715 
Hero: folds
f5da36f8: folds
af1da715: folds
ec6db2f6: folds
a1c62f27: raises $0.15 to $0.25
c740e135: raises $0.65 to $0.9
a1c62f27: calls $0.65
*** FLOP *** [7h Qs 2h]
a1c62f27: checks
c740e135: bets $0.6
a1c62f27: calls $0.6
*** TURN *** [7h Qs 2h] [4h]
a1c62f27: bets $0.99
c740e135: folds
Uncalled bet ($0.99) returned to a1c62f27
*** SHOWDOWN ***
a1c62f27 collected $2.71 from pot
*** SUMMARY ***
Total pot $3 | Rake $0.14 | Jackpot $0.15 | Bingo $0 | Fortune $0
Board [7h Qs 2h 4h]
Seat 1: ec6db2f6 (button) folded before Flop (didn't bet)
Seat 2: a1c62f27 (small blind) won ($2.71)
Seat 3: c740e135 (big blind) folded on the Turn
Seat 4: Hero folded before Flop (didn't bet)
Seat 5: f5da36f8 folded before Flop (didn't bet)
Seat 6: af1da715 folded before Flop (didn't bet)


Poker Hand #RC1450196945: Hold'em No Limit  ($0.05/$0.1) - 2023/04/04 13:02:48
Table 'RushAndCash1712205' 6-max Seat #1 is the button
Seat 1: Hero ($20.24 in chips)
Seat 2: 26a822e ($10.07 in chips)
Seat 3: 1b71b36f ($16.96 in chips)
Seat 4: 6dd0850b ($7.18 in chips)
Seat 5: 1970d66f ($28.1 in chips)
Seat 6: 3dee9af0 ($52.8 in chips)
26a822e: posts small blind $0.05
1b71b36f: posts big blind $0.1
*** HOLE CARDS ***
Dealt to Hero [9d 2s]
Dealt to 26a822e 
Dealt to 1b71b36f 
Dealt to 6dd0850b 
Dealt to 1970d66f 
Dealt to 3dee9af0 
6dd0850b: folds
1970d66f: folds
3dee9af0: folds
Hero: folds
26a822e: folds
Uncalled bet ($0.05) returned to 1b71b36f
*** SHOWDOWN ***
1b71b36f collected $0.1 from pot
*** SUMMARY ***
Total pot $0.1 | Rake $0 | Jackpot $0 | Bingo $0 | Fortune $0
Seat 1: Hero (button) folded before Flop (didn't bet)
Seat 2: 26a822e (small blind) folded before Flop
Seat 3: 1b71b36f (big blind) collected ($0.1)
Seat 4: 6dd0850b folded before Flop (didn't bet)
Seat 5: 1970d66f folded before Flop (didn't bet)
Seat 6: 3dee9af0 folded before Flop (didn't bet)


Poker Hand #RC1450196836: Hold'em No Limit  ($0.05/$0.1) - 2023/04/04 13:02:32
Table 'RushAndCash1712096' 6-max Seat #1 is the button
Seat 1: e3d8e5bc ($10.23 in chips)
Seat 2: Hero ($20.29 in chips)
Seat 3: 915bd5fc ($21.72 in chips)
Seat 4: 20ee6254 ($48.67 in chips)
Seat 5: f7396c1a ($11.69 in chips)
Seat 6: a48939a2 ($14.29 in chips)
Hero: posts small blind $0.05
915bd5fc: posts big blind $0.1
*** HOLE CARDS ***
Dealt to e3d8e5bc 
Dealt to Hero [7h Jd]
Dealt to 915bd5fc 
Dealt to 20ee6254 
Dealt to f7396c1a 
Dealt to a48939a2 
20ee6254: folds
f7396c1a: folds
a48939a2: folds
e3d8e5bc: raises $0.15 to $0.25
Hero: folds
915bd5fc: folds
Uncalled bet ($0.15) returned to e3d8e5bc
*** SHOWDOWN ***
e3d8e5bc collected $0.25 from pot
*** SUMMARY ***
Total pot $0.25 | Rake $0 | Jackpot $0 | Bingo $0 | Fortune $0
Seat 1: e3d8e5bc (button) collected ($0.25)
Seat 2: Hero (small blind) folded before Flop
Seat 3: 915bd5fc (big blind) folded before Flop
Seat 4: 20ee6254 folded before Flop (didn't bet)
Seat 5: f7396c1a folded before Flop (didn't bet)
Seat 6: a48939a2 folded before Flop (didn't bet)


Poker Hand #RC1450196724: Hold'em No Limit  ($0.05/$0.1) - 2023/04/04 13:02:15
Table 'RushAndCash1711984' 6-max Seat #1 is the button
Seat 1: d8baf4f7 ($29.49 in chips)
Seat 2: b5a47269 ($14.09 in chips)
Seat 3: Hero ($20.39 in chips)
Seat 4: a99ea745 ($14.66 in chips)
Seat 5: 9c074679 ($9.55 in chips)
Seat 6: 363fe4a ($16.5 in chips)
b5a47269: posts small blind $0.05
Hero: posts big blind $0.1
*** HOLE CARDS ***
Dealt to d8baf4f7 
Dealt to b5a47269 
Dealt to Hero [2h 4c]
Dealt to a99ea745 
Dealt to 9c074679 
Dealt to 363fe4a 
a99ea745: folds
9c074679: folds
363fe4a: raises $0.15 to $0.25
d8baf4f7: calls $0.25
b5a47269: folds
Hero: folds
*** FLOP *** [2d 6c As]
363fe4a: checks
d8baf4f7: checks
*** TURN *** [2d 6c As] [7s]
363fe4a: bets $0.49
d8baf4f7: folds
Uncalled bet ($0.49) returned to 363fe4a
*** SHOWDOWN ***
363fe4a collected $0.62 from pot
*** SUMMARY ***
Total pot $0.65 | Rake $0.03 | Jackpot $0 | Bingo $0 | Fortune $0
Board [2d 6c As 7s]
Seat 1: d8baf4f7 (button) folded on the Turn
Seat 2: b5a47269 (small blind) folded before Flop
Seat 3: Hero (big blind) folded before Flop
Seat 4: a99ea745 folded before Flop (didn't bet)
Seat 5: 9c074679 folded before Flop (didn't bet)
Seat 6: 363fe4a won ($0.62)


Poker Hand #RC1450196646: Hold'em No Limit  ($0.05/$0.1) - 2023/04/04 13:02:05
Table 'RushAndCash1711906' 6-max Seat #1 is the button
Seat 1: ec6db2f6 ($9.7 in chips)
Seat 2: a4e7cb4a ($12.88 in chips)
Seat 3: cb575242 ($16.06 in chips)
Seat 4: dcb1db62 ($10.32 in chips)
Seat 5: 286203f7 ($14 in chips)
Seat 6: Hero ($20.39 in chips)
a4e7cb4a: posts small blind $0.05
cb575242: posts big blind $0.1
*** HOLE CARDS ***
Dealt to ec6db2f6 
Dealt to a4e7cb4a 
Dealt to cb575242 
Dealt to dcb1db62 
Dealt to 286203f7 
Dealt to Hero [5d 5s]
dcb1db62: folds
286203f7: raises $0.15 to $0.25
Hero: folds
ec6db2f6: folds
a4e7cb4a: folds
cb575242: folds
Uncalled bet ($0.15) returned to 286203f7
*** SHOWDOWN ***
286203f7 collected $0.25 from pot
*** SUMMARY ***
Total pot $0.25 | Rake $0 | Jackpot $0 | Bingo $0 | Fortune $0
Seat 1: ec6db2f6 (button) folded before Flop (didn't bet)
Seat 2: a4e7cb4a (small blind) folded before Flop
Seat 3: cb575242 (big blind) folded before Flop
Seat 4: dcb1db62 folded before Flop (didn't bet)
Seat 5: 286203f7 collected ($0.25)
Seat 6: Hero folded before Flop (didn't bet)


Poker Hand #RC1450196315: Hold'em No Limit  ($0.05/$0.1) - 2023/04/04 13:01:10
Table 'RushAndCash1711575' 6-max Seat #1 is the button
Seat 1: d9bc9171 ($22.52 in chips)
Seat 2: 1f3e887a ($10.43 in chips)
Seat 3: ec6db2f6 ($9.95 in chips)
Seat 4: Hero ($20.64 in chips)
Seat 5: 40d1ac0e ($10.85 in chips)
Seat 6: 394f483c ($9.26 in chips)
1f3e887a: posts small blind $0.05
ec6db2f6: posts big blind $0.1
*** HOLE CARDS ***
Dealt to d9bc9171 
Dealt to 1f3e887a 
Dealt to ec6db2f6 
Dealt to Hero [Ad 2d]
Dealt to 40d1ac0e 
Dealt to 394f483c 
Hero: raises $0.15 to $0.25
40d1ac0e: folds
394f483c: calls $0.25
d9bc9171: folds
1f3e887a: folds
ec6db2f6: calls $0.15
*** FLOP *** [6h 9s 5d]
ec6db2f6: checks
Hero: checks
394f483c: checks
*** TURN *** [6h 9s 5d] [2c]
ec6db2f6: checks
Hero: checks
394f483c: checks
*** RIVER *** [6h 9s 5d 2c] [Ks]
ec6db2f6: checks
Hero: checks
394f483c: bets $0.75
ec6db2f6: folds
Hero: folds
Uncalled bet ($0.75) returned to 394f483c
*** SHOWDOWN ***
394f483c collected $0.76 from pot
*** SUMMARY ***
Total pot $0.8 | Rake $0.04 | Jackpot $0 | Bingo $0 | Fortune $0
Board [6h 9s 5d 2c Ks]
Seat 1: d9bc9171 (button) folded before Flop (didn't bet)
Seat 2: 1f3e887a (small blind) folded before Flop
Seat 3: ec6db2f6 (big blind) folded on the River
Seat 4: Hero folded on the River
Seat 5: 40d1ac0e folded before Flop (didn't bet)
Seat 6: 394f483c won ($0.76)


Poker Hand #RC1450196283: Hold'em No Limit  ($0.05/$0.1) - 2023/04/04 13:01:04
Table 'RushAndCash1711543' 6-max Seat #1 is the button
Seat 1: 9b63d394 ($10.05 in chips)
Seat 2: 263d3da ($10 in chips)
Seat 3: 963611e5 ($13.32 in chips)
Seat 4: Hero ($20.64 in chips)
Seat 5: 831f6c59 ($12.94 in chips)
Seat 6: 4a140c5 ($10 in chips)
263d3da: posts small blind $0.05
963611e5: posts big blind $0.1
*** HOLE CARDS ***
Dealt to 9b63d394 
Dealt to 263d3da 
Dealt to 963611e5 
Dealt to Hero [Js 9d]
Dealt to 831f6c59 
Dealt to 4a140c5 
Hero: folds
831f6c59: folds
4a140c5: folds
9b63d394: raises $0.15 to $0.25
263d3da: folds
963611e5: folds
Uncalled bet ($0.15) returned to 9b63d394
*** SHOWDOWN ***
9b63d394 collected $0.25 from pot
*** SUMMARY ***
Total pot $0.25 | Rake $0 | Jackpot $0 | Bingo $0 | Fortune $0
Seat 1: 9b63d394 (button) collected ($0.25)
Seat 2: 263d3da (small blind) folded before Flop
Seat 3: 963611e5 (big blind) folded before Flop
Seat 4: Hero folded before Flop (didn't bet)
Seat 5: 831f6c59 folded before Flop (didn't bet)
Seat 6: 4a140c5 folded before Flop (didn't bet)


Poker Hand #RC1450196244: Hold'em No Limit  ($0.05/$0.1) - 2023/04/04 13:00:59
Table 'RushAndCash1711504' 6-max Seat #1 is the button
Seat 1: a12d4131 ($7.44 in chips)
Seat 2: c5a640a ($19.27 in chips)
Seat 3: aa8cc67c ($24.61 in chips)
Seat 4: Hero ($20.64 in chips)
Seat 5: 744860a2 ($9.6 in chips)
Seat 6: 433114a5 ($10.1 in chips)
c5a640a: posts small blind $0.05
aa8cc67c: posts big blind $0.1
*** HOLE CARDS ***
Dealt to a12d4131 
Dealt to c5a640a 
Dealt to aa8cc67c 
Dealt to Hero [Ks 2c]
Dealt to 744860a2 
Dealt to 433114a5 
Hero: folds
744860a2: folds
433114a5: folds
a12d4131: folds
c5a640a: folds
Uncalled bet ($0.05) returned to aa8cc67c
*** SHOWDOWN ***
aa8cc67c collected $0.1 from pot
*** SUMMARY ***
Total pot $0.1 | Rake $0 | Jackpot $0 | Bingo $0 | Fortune $0
Seat 1: a12d4131 (button) folded before Flop (didn't bet)
Seat 2: c5a640a (small blind) folded before Flop
Seat 3: aa8cc67c (big blind) collected ($0.1)
Seat 4: Hero folded before Flop (didn't bet)
Seat 5: 744860a2 folded before Flop (didn't bet)
Seat 6: 433114a5 folded before Flop (didn't bet)


Poker Hand #RC1450196209: Hold'em No Limit  ($0.05/$0.1) - 2023/04/04 13:00:54
Table 'RushAndCash1711469' 6-max Seat #1 is the button
Seat 1: Hero ($20.64 in chips)
Seat 2: 2a14239b ($105.12 in chips)
Seat 3: 7a0d25df ($18.47 in chips)
Seat 4: ea20233a ($13.36 in chips)
Seat 5: 586c9bbd ($14.07 in chips)
Seat 6: 67239530 ($10.91 in chips)
2a14239b: posts small blind $0.05
7a0d25df: posts big blind $0.1
*** HOLE CARDS ***
Dealt to Hero [8s 4d]
Dealt to 2a14239b 
Dealt to 7a0d25df 
Dealt to ea20233a 
Dealt to 586c9bbd 
Dealt to 67239530 
ea20233a: folds
586c9bbd: folds
67239530: folds
Hero: folds
2a14239b: folds
Uncalled bet ($0.05) returned to 7a0d25df
*** SHOWDOWN ***
7a0d25df collected $0.1 from pot
*** SUMMARY ***
Total pot $0.1 | Rake $0 | Jackpot $0 | Bingo $0 | Fortune $0
Seat 1: Hero (button) folded before Flop (didn't bet)
Seat 2: 2a14239b (small blind) folded before Flop
Seat 3: 7a0d25df (big blind) collected ($0.1)
Seat 4: ea20233a folded before Flop (didn't bet)
Seat 5: 586c9bbd folded before Flop (didn't bet)
Seat 6: 67239530 folded before Flop (didn't bet)


Poker Hand #RC1450196070: Hold'em No Limit  ($0.05/$0.1) - 2023/04/04 13:00:33
Table 'RushAndCash1711330' 6-max Seat #1 is the button
Seat 1: d26a5350 ($11.15 in chips)
Seat 2: 571dc346 ($11.14 in chips)
Seat 3: Hero ($20.74 in chips)
Seat 4: c62e3e4d ($15.29 in chips)
Seat 5: b91f7451 ($10.23 in chips)
Seat 6: 3614f6af ($10 in chips)
571dc346: posts small blind $0.05
Hero: posts big blind $0.1
*** HOLE CARDS ***
Dealt to d26a5350 
Dealt to 571dc346 
Dealt to Hero [7d Ks]
Dealt to c62e3e4d 
Dealt to b91f7451 
Dealt to 3614f6af 
c62e3e4d: raises $0.15 to $0.25
b91f7451: folds
3614f6af: folds
d26a5350: folds
571dc346: raises $0.75 to $1
Hero: folds
c62e3e4d: calls $0.75
*** FLOP *** [Qc 8d 6h]
571dc346: bets $1
c62e3e4d: calls $1
*** TURN *** [Qc 8d 6h] [Ts]
571dc346: checks
c62e3e4d: checks
*** RIVER *** [Qc 8d 6h Ts] [Jh]
571dc346: bets $1.2
c62e3e4d: folds
Uncalled bet ($1.2) returned to 571dc346
c62e3e4d: shows [Ac Jc] (Pair of Jacks)
*** SHOWDOWN ***
571dc346 collected $3.76 from pot
*** SUMMARY ***
Total pot $4.1 | Rake $0.19 | Jackpot $0.15 | Bingo $0 | Fortune $0
Board [Qc 8d 6h Ts Jh]
Seat 1: d26a5350 (button) folded before Flop (didn't bet)
Seat 2: 571dc346 (small blind) won ($3.76)
Seat 3: Hero (big blind) folded before Flop
Seat 4: c62e3e4d folded on the River
Seat 5: b91f7451 folded before Flop (didn't bet)
Seat 6: 3614f6af folded before Flop (didn't bet)


Poker Hand #RC1450196046: Hold'em No Limit  ($0.05/$0.1) - 2023/04/04 13:00:29
Table 'RushAndCash1711306' 6-max Seat #1 is the button
Seat 1: 6c913bd4 ($7.83 in chips)
Seat 2: Hero ($20.79 in chips)
Seat 3: 8c20be0f ($13.55 in chips)
Seat 4: 5ca63c56 ($4.4 in chips)
Seat 5: adfb7a38 ($12.56 in chips)
Seat 6: b36fb082 ($22.68 in chips)
Hero: posts small blind $0.05
8c20be0f: posts big blind $0.1
*** HOLE CARDS ***
Dealt to 6c913bd4 
Dealt to Hero [2h 4s]
Dealt to 8c20be0f 
Dealt to 5ca63c56 
Dealt to adfb7a38 
Dealt to b36fb082 
5ca63c56: folds
adfb7a38: folds
b36fb082: folds
6c913bd4: folds
Hero: folds
Uncalled bet ($0.05) returned to 8c20be0f
*** SHOWDOWN ***
8c20be0f collected $0.1 from pot
*** SUMMARY ***
Total pot $0.1 | Rake $0 | Jackpot $0 | Bingo $0 | Fortune $0
Seat 1: 6c913bd4 (button) folded before Flop (didn't bet)
Seat 2: Hero (small blind) folded before Flop
Seat 3: 8c20be0f (big blind) collected ($0.1)
Seat 4: 5ca63c56 folded before Flop (didn't bet)
Seat 5: adfb7a38 folded before Flop (didn't bet)
Seat 6: b36fb082 folded before Flop (didn't bet)


Poker Hand #RC1450195882: Hold'em No Limit  ($0.05/$0.1) - 2023/04/04 13:00:03
Table 'RushAndCash1711142' 6-max Seat #1 is the button
Seat 1: Hero ($20.64 in chips)
Seat 2: c44eb047 ($25.56 in chips)
Seat 3: 1ad7b59d ($10.1 in chips)
Seat 4: 5638115c ($24.06 in chips)
Seat 5: af1da715 ($3.94 in chips)
Seat 6: b0cd54bf ($14.25 in chips)
c44eb047: posts small blind $0.05
1ad7b59d: posts big blind $0.1
*** HOLE CARDS ***
Dealt to Hero [7c Jc]
Dealt to c44eb047 
Dealt to 1ad7b59d 
Dealt to 5638115c 
Dealt to af1da715 
Dealt to b0cd54bf 
5638115c: folds
af1da715: folds
b0cd54bf: folds
Hero: raises $0.15 to $0.25
c44eb047: folds
1ad7b59d: folds
Uncalled bet ($0.15) returned to Hero
*** SHOWDOWN ***
Hero collected $0.25 from pot
*** SUMMARY ***
Total pot $0.25 | Rake $0 | Jackpot $0 | Bingo $0 | Fortune $0
Seat 1: Hero (button) collected ($0.25)
Seat 2: c44eb047 (small blind) folded before Flop
Seat 3: 1ad7b59d (big blind) folded before Flop
Seat 4: 5638115c folded before Flop (didn't bet)
Seat 5: af1da715 folded before Flop (didn't bet)
Seat 6: b0cd54bf folded before Flop (didn't bet)


Poker Hand #RC1450195832: Hold'em No Limit  ($0.05/$0.1) - 2023/04/04 12:59:55
Table 'RushAndCash1711092' 6-max Seat #1 is the button
Seat 1: c7ae08ec ($10 in chips)
Seat 2: d3a4ef5c ($11.96 in chips)
Seat 3: d08c8e7d ($14.69 in chips)
Seat 4: 2652e5d3 ($9.19 in chips)
Seat 5: Hero ($20.64 in chips)
Seat 6: c4688014 ($10 in chips)
d3a4ef5c: posts small blind $0.05
d08c8e7d: posts big blind $0.1
*** HOLE CARDS ***
Dealt to c7ae08ec 
Dealt to d3a4ef5c 
Dealt to d08c8e7d 
Dealt to 2652e5d3 
Dealt to Hero [2c 6c]
Dealt to c4688014 
2652e5d3: folds
Hero: folds
c4688014: folds
c7ae08ec: folds
d3a4ef5c: raises $0.15 to $0.25
d08c8e7d: folds
Uncalled bet ($0.15) returned to d3a4ef5c
*** SHOWDOWN ***
d3a4ef5c collected $0.2 from pot
*** SUMMARY ***
Total pot $0.2 | Rake $0 | Jackpot $0 | Bingo $0 | Fortune $0
Seat 1: c7ae08ec (button) folded before Flop (didn't bet)
Seat 2: d3a4ef5c (small blind) collected ($0.2)
Seat 3: d08c8e7d (big blind) folded before Flop
Seat 4: 2652e5d3 folded before Flop (didn't bet)
Seat 5: Hero folded before Flop (didn't bet)
Seat 6: c4688014 folded before Flop (didn't bet)


Poker Hand #RC1450195767: Hold'em No Limit  ($0.05/$0.1) - 2023/04/04 12:59:44
Table 'RushAndCash1711027' 6-max Seat #1 is the button
Seat 1: 5a2a25e4 ($12.18 in chips)
Seat 2: 5074637 ($10.59 in chips)
Seat 3: Hero ($20.74 in chips)
Seat 4: 6e303da0 ($9.72 in chips)
Seat 5: 6dd0850b ($6.6 in chips)
Seat 6: f9236c56 ($7.7 in chips)
5074637: posts small blind $0.05
Hero: posts big blind $0.1
*** HOLE CARDS ***
Dealt to 5a2a25e4 
Dealt to 5074637 
Dealt to Hero [7s 7c]
Dealt to 6e303da0 
Dealt to 6dd0850b 
Dealt to f9236c56 
6e303da0: raises $0.15 to $0.25
6dd0850b: raises $0.51 to $0.76
f9236c56: folds
5a2a25e4: folds
5074637: folds
Hero: folds
6e303da0: calls $0.51
*** FLOP *** [9h Ah Js]
6e303da0: checks
6dd0850b: bets $0.61
6e303da0: folds
Uncalled bet ($0.61) returned to 6dd0850b
*** SHOWDOWN ***
6dd0850b collected $1.59 from pot
*** SUMMARY ***
Total pot $1.67 | Rake $0.08 | Jackpot $0 | Bingo $0 | Fortune $0
Board [9h Ah Js]
Seat 1: 5a2a25e4 (button) folded before Flop (didn't bet)
Seat 2: 5074637 (small blind) folded before Flop
Seat 3: Hero (big blind) folded before Flop
Seat 4: 6e303da0 folded on the Flop
Seat 5: 6dd0850b won ($1.59)
Seat 6: f9236c56 folded before Flop (didn't bet)


Poker Hand #RC1450195688: Hold'em No Limit  ($0.05/$0.1) - 2023/04/04 12:59:32
Table 'RushAndCash1710948' 6-max Seat #1 is the button
Seat 1: 3c64327c ($3.19 in chips)
Seat 2: 9be0077c ($12.27 in chips)
Seat 3: 6ad92dd7 ($10 in chips)
Seat 4: f3f405f ($10 in chips)
Seat 5: Hero ($20.74 in chips)
Seat 6: e5250fe ($7.67 in chips)
9be0077c: posts small blind $0.05
6ad92dd7: posts big blind $0.1
*** HOLE CARDS ***
Dealt to 3c64327c 
Dealt to 9be0077c 
Dealt to 6ad92dd7 
Dealt to f3f405f 
Dealt to Hero [Js Kh]
Dealt to e5250fe 
f3f405f: raises $0.15 to $0.25
Hero: folds
e5250fe: folds
3c64327c: folds
9be0077c: folds
6ad92dd7: calls $0.15
*** FLOP *** [Jh 3c Ks]
6ad92dd7: checks
f3f405f: checks
*** TURN *** [Jh 3c Ks] [3s]
6ad92dd7: checks
f3f405f: bets $0.36
6ad92dd7: calls $0.36
*** RIVER *** [Jh 3c Ks 3s] [3h]
6ad92dd7: checks
f3f405f: bets $0.82
6ad92dd7: raises $8.57 to $9.39 and is all-in
f3f405f: folds
Uncalled bet ($8.57) returned to 6ad92dd7
*** SHOWDOWN ***
6ad92dd7 collected $2.77 from pot
*** SUMMARY ***
Total pot $2.91 | Rake $0.14 | Jackpot $0 | Bingo $0 | Fortune $0
Board [Jh 3c Ks 3s 3h]
Seat 1: 3c64327c (button) folded before Flop (didn't bet)
Seat 2: 9be0077c (small blind) folded before Flop
Seat 3: 6ad92dd7 (big blind) won ($2.77)
Seat 4: f3f405f folded on the River
Seat 5: Hero folded before Flop (didn't bet)
Seat 6: e5250fe folded before Flop (didn't bet)


Poker Hand #RC1450195612: Hold'em No Limit  ($0.05/$0.1) - 2023/04/04 12:59:20
Table 'RushAndCash1710872' 6-max Seat #1 is the button
Seat 1: 2c3c77 ($20.17 in chips)
Seat 2: Hero ($20.79 in chips)
Seat 3: c7ae08ec ($10 in chips)
Seat 4: 8416c485 ($10.11 in chips)
Seat 5: f903ac9 ($10.38 in chips)
Seat 6: e3bc8979 ($18.91 in chips)
Hero: posts small blind $0.05
c7ae08ec: posts big blind $0.1
*** HOLE CARDS ***
Dealt to 2c3c77 
Dealt to Hero [9h 5c]
Dealt to c7ae08ec 
Dealt to 8416c485 
Dealt to f903ac9 
Dealt to e3bc8979 
8416c485: raises $0.2 to $0.3
f903ac9: folds
e3bc8979: folds
2c3c77: folds
Hero: folds
c7ae08ec: folds
Uncalled bet ($0.2) returned to 8416c485
*** SHOWDOWN ***
8416c485 collected $0.25 from pot
*** SUMMARY ***
Total pot $0.25 | Rake $0 | Jackpot $0 | Bingo $0 | Fortune $0
Seat 1: 2c3c77 (button) folded before Flop (didn't bet)
Seat 2: Hero (small blind) folded before Flop
Seat 3: c7ae08ec (big blind) folded before Flop
Seat 4: 8416c485 collected ($0.25)
Seat 5: f903ac9 folded before Flop (didn't bet)
Seat 6: e3bc8979 folded before Flop (didn't bet)


Poker Hand #RC1450143503: Hold'em No Limit  ($0.05/$0.1) - 2023/04/04 12:53:48
Table 'RushAndCash1708763' 6-max Seat #1 is the button
Seat 1: 2c8b1380 ($10 in chips)
Seat 2: c891daba ($11.61 in chips)
Seat 3: 21f27f8f ($11.71 in chips)
Seat 4: 185c5581 ($12.82 in chips)
Seat 5: e6b1c36a ($13.13 in chips)
Seat 6: Hero ($17.55 in chips)
c891daba: posts small blind $0.05
21f27f8f: posts big blind $0.1
*** HOLE CARDS ***
Dealt to 2c8b1380 
Dealt to c891daba 
Dealt to 21f27f8f 
Dealt to 185c5581 
Dealt to e6b1c36a 
Dealt to Hero [Ts 9s]
185c5581: folds
e6b1c36a: raises $0.12 to $0.22
Hero: calls $0.22
2c8b1380: folds
c891daba: folds
21f27f8f: folds
*** FLOP *** [Kc 7d 9c]
e6b1c36a: bets $0.2
Hero: calls $0.2
*** TURN *** [Kc 7d 9c] [6h]
e6b1c36a: bets $0.81
Hero: calls $0.81
*** RIVER *** [Kc 7d 9c 6h] [8s]
e6b1c36a: bets $0.87
Hero: raises $1.44 to $2.31
e6b1c36a: calls $1.44
Hero: shows [Ts 9s] (Tens-High Straight)
e6b1c36a: shows [5c Ac] (Nines-High Straight)
*** SHOWDOWN ***
Hero collected $6.78 from pot
*** SUMMARY ***
Total pot $7.23 | Rake $0.3 | Jackpot $0.15 | Bingo $0 | Fortune $0
Board [Kc 7d 9c 6h 8s]
Seat 1: 2c8b1380 (button) folded before Flop (didn't bet)
Seat 2: c891daba (small blind) folded before Flop
Seat 3: 21f27f8f (big blind) folded before Flop
Seat 4: 185c5581 folded before Flop (didn't bet)
Seat 5: e6b1c36a showed [5c Ac] and lost with Nines-High Straight
Seat 6: Hero showed [Ts 9s] and won ($6.78) with Tens-High Straight


Poker Hand #RC1450143317: Hold'em No Limit  ($0.05/$0.1) - 2023/04/04 12:53:20
Table 'RushAndCash1708577' 6-max Seat #1 is the button
Seat 1: cb150ed4 ($6.97 in chips)
Seat 2: 618c3b1e ($10.92 in chips)
Seat 3: 24bd690a ($10.78 in chips)
Seat 4: dbd998b4 ($12.32 in chips)
Seat 5: Hero ($17.8 in chips)
Seat 6: 21f27f8f ($11.34 in chips)
618c3b1e: posts small blind $0.05
24bd690a: posts big blind $0.1
*** HOLE CARDS ***
Dealt to cb150ed4 
Dealt to 618c3b1e 
Dealt to 24bd690a 
Dealt to dbd998b4 
Dealt to Hero [As 8s]
Dealt to 21f27f8f 
dbd998b4: folds
Hero: raises $0.15 to $0.25
21f27f8f: raises $0.5 to $0.75
cb150ed4: folds
618c3b1e: folds
24bd690a: folds
Hero: folds
Uncalled bet ($0.5) returned to 21f27f8f
*** SHOWDOWN ***
21f27f8f collected $0.62 from pot
*** SUMMARY ***
Total pot $0.65 | Rake $0.03 | Jackpot $0 | Bingo $0 | Fortune $0
Seat 1: cb150ed4 (button) folded before Flop (didn't bet)
Seat 2: 618c3b1e (small blind) folded before Flop
Seat 3: 24bd690a (big blind) folded before Flop
Seat 4: dbd998b4 folded before Flop (didn't bet)
Seat 5: Hero folded before Flop
Seat 6: 21f27f8f collected ($0.62)


Poker Hand #RC1450143203: Hold'em No Limit  ($0.05/$0.1) - 2023/04/04 12:53:02
Table 'RushAndCash1708463' 6-max Seat #1 is the button
Seat 1: 5a2a25e4 ($13.13 in chips)
Seat 2: 7ad1b406 ($10.66 in chips)
Seat 3: 74cbb44a ($12.23 in chips)
Seat 4: 221740eb ($28.22 in chips)
Seat 5: d4a191bb ($10.97 in chips)
Seat 6: Hero ($17.8 in chips)
7ad1b406: posts small blind $0.05
74cbb44a: posts big blind $0.1
*** HOLE CARDS ***
Dealt to 5a2a25e4 
Dealt to 7ad1b406 
Dealt to 74cbb44a 
Dealt to 221740eb 
Dealt to d4a191bb 
Dealt to Hero [9s 2s]
221740eb: folds
d4a191bb: folds
Hero: folds
5a2a25e4: folds
7ad1b406: raises $0.15 to $0.25
74cbb44a: folds
Uncalled bet ($0.15) returned to 7ad1b406
*** SHOWDOWN ***
7ad1b406 collected $0.2 from pot
*** SUMMARY ***
Total pot $0.2 | Rake $0 | Jackpot $0 | Bingo $0 | Fortune $0
Seat 1: 5a2a25e4 (button) folded before Flop (didn't bet)
Seat 2: 7ad1b406 (small blind) collected ($0.2)
Seat 3: 74cbb44a (big blind) folded before Flop
Seat 4: 221740eb folded before Flop (didn't bet)
Seat 5: d4a191bb folded before Flop (didn't bet)
Seat 6: Hero folded before Flop (didn't bet)


Poker Hand #RC1450143171: Hold'em No Limit  ($0.05/$0.1) - 2023/04/04 12:52:57
Table 'RushAndCash1708431' 6-max Seat #1 is the button
Seat 1: 21f27f8f ($11.34 in chips)
Seat 2: 2be6d799 ($10.2 in chips)
Seat 3: cbd10165 ($16.13 in chips)
Seat 4: 37d69c98 ($10 in chips)
Seat 5: b2a74498 ($23.53 in chips)
Seat 6: Hero ($17.8 in chips)
2be6d799: posts small blind $0.05
cbd10165: posts big blind $0.1
*** HOLE CARDS ***
Dealt to 21f27f8f 
Dealt to 2be6d799 
Dealt to cbd10165 
Dealt to 37d69c98 
Dealt to b2a74498 
Dealt to Hero [3c 8d]
37d69c98: raises $0.15 to $0.25
b2a74498: folds
Hero: folds
21f27f8f: folds
2be6d799: folds
cbd10165: folds
Uncalled bet ($0.15) returned to 37d69c98
*** SHOWDOWN ***
37d69c98 collected $0.25 from pot
*** SUMMARY ***
Total pot $0.25 | Rake $0 | Jackpot $0 | Bingo $0 | Fortune $0
Seat 1: 21f27f8f (button) folded before Flop (didn't bet)
Seat 2: 2be6d799 (small blind) folded before Flop
Seat 3: cbd10165 (big blind) folded before Flop
Seat 4: 37d69c98 collected ($0.25)
Seat 5: b2a74498 folded before Flop (didn't bet)
Seat 6: Hero folded before Flop (didn't bet)


Poker Hand #RC1450143136: Hold'em No Limit  ($0.05/$0.1) - 2023/04/04 12:52:51
Table 'RushAndCash1708396' 6-max Seat #1 is the button
Seat 1: Hero ($17.8 in chips)
Seat 2: 2652e5d3 ($13.01 in chips)
Seat 3: 4f23201d ($22.57 in chips)
Seat 4: 29a069c0 ($10 in chips)
Seat 5: 91f4af6a ($6.98 in chips)
Seat 6: 951dbf1d ($12.66 in chips)
2652e5d3: posts small blind $0.05
4f23201d: posts big blind $0.1
*** HOLE CARDS ***
Dealt to Hero [2d 7d]
Dealt to 2652e5d3 
Dealt to 4f23201d 
Dealt to 29a069c0 
Dealt to 91f4af6a 
Dealt to 951dbf1d 
29a069c0: folds
91f4af6a: folds
951dbf1d: folds
Hero: folds
2652e5d3: folds
Uncalled bet ($0.05) returned to 4f23201d
*** SHOWDOWN ***
4f23201d collected $0.1 from pot
*** SUMMARY ***
Total pot $0.1 | Rake $0 | Jackpot $0 | Bingo $0 | Fortune $0
Seat 1: Hero (button) folded before Flop (didn't bet)
Seat 2: 2652e5d3 (small blind) folded before Flop
Seat 3: 4f23201d (big blind) collected ($0.1)
Seat 4: 29a069c0 folded before Flop (didn't bet)
Seat 5: 91f4af6a folded before Flop (didn't bet)
Seat 6: 951dbf1d folded before Flop (didn't bet)


Poker Hand #RC1450143071: Hold'em No Limit  ($0.05/$0.1) - 2023/04/04 12:52:42
Table 'RushAndCash1708331' 6-max Seat #1 is the button
Seat 1: 7a0d25df ($18.01 in chips)
Seat 2: f095207d ($4.81 in chips)
Seat 3: Hero ($17.9 in chips)
Seat 4: 2e956c6 ($14.85 in chips)
Seat 5: c708262 ($15.25 in chips)
Seat 6: 34362433 ($16.66 in chips)
f095207d: posts small blind $0.05
Hero: posts big blind $0.1
*** HOLE CARDS ***
Dealt to 7a0d25df 
Dealt to f095207d 
Dealt to Hero [8c 4c]
Dealt to 2e956c6 
Dealt to c708262 
Dealt to 34362433 
2e956c6: folds
c708262: folds
34362433: raises $0.13 to $0.23
7a0d25df: folds
f095207d: folds
Hero: folds
Uncalled bet ($0.13) returned to 34362433
*** SHOWDOWN ***
34362433 collected $0.25 from pot
*** SUMMARY ***
Total pot $0.25 | Rake $0 | Jackpot $0 | Bingo $0 | Fortune $0
Seat 1: 7a0d25df (button) folded before Flop (didn't bet)
Seat 2: f095207d (small blind) folded before Flop
Seat 3: Hero (big blind) folded before Flop
Seat 4: 2e956c6 folded before Flop (didn't bet)
Seat 5: c708262 folded before Flop (didn't bet)
Seat 6: 34362433 collected ($0.25)


Poker Hand #RC1450142959: Hold'em No Limit  ($0.05/$0.1) - 2023/04/04 12:52:24
Table 'RushAndCash1708219' 6-max Seat #1 is the button
Seat 1: 950fbf58 ($12.34 in chips)
Seat 2: Hero ($17.8 in chips)
Seat 3: bb59ca08 ($12.47 in chips)
Seat 4: 53acf7fa ($7.63 in chips)
Seat 5: 333f8cef ($11.4 in chips)
Seat 6: e363c3b ($11.39 in chips)
Hero: posts small blind $0.05
bb59ca08: posts big blind $0.1
*** HOLE CARDS ***
Dealt to 950fbf58 
Dealt to Hero [2h Kh]
Dealt to bb59ca08 
Dealt to 53acf7fa 
Dealt to 333f8cef 
Dealt to e363c3b 
53acf7fa: folds
333f8cef: folds
e363c3b: folds
950fbf58: folds
Hero: raises $0.2 to $0.3
bb59ca08: folds
Uncalled bet ($0.2) returned to Hero
*** SHOWDOWN ***
Hero collected $0.2 from pot
*** SUMMARY ***
Total pot $0.2 | Rake $0 | Jackpot $0 | Bingo $0 | Fortune $0
Seat 1: 950fbf58 (button) folded before Flop (didn't bet)
Seat 2: Hero (small blind) collected ($0.2)
Seat 3: bb59ca08 (big blind) folded before Flop
Seat 4: 53acf7fa folded before Flop (didn't bet)
Seat 5: 333f8cef folded before Flop (didn't bet)
Seat 6: e363c3b folded before Flop (didn't bet)


Poker Hand #RC1450142913: Hold'em No Limit  ($0.05/$0.1) - 2023/04/04 12:52:17
Table 'RushAndCash1708173' 6-max Seat #1 is the button
Seat 1: e88df375 ($11.64 in chips)
Seat 2: bb59ca08 ($12.52 in chips)
Seat 3: 9eaf11f9 ($8.92 in chips)
Seat 4: 3cc84dc ($7.89 in chips)
Seat 5: ecc107b9 ($11.99 in chips)
Seat 6: Hero ($17.8 in chips)
bb59ca08: posts small blind $0.05
9eaf11f9: posts big blind $0.1
*** HOLE CARDS ***
Dealt to e88df375 
Dealt to bb59ca08 
Dealt to 9eaf11f9 
Dealt to 3cc84dc 
Dealt to ecc107b9 
Dealt to Hero [8d Ac]
3cc84dc: folds
ecc107b9: raises $0.2 to $0.3
Hero: folds
e88df375: folds
bb59ca08: folds
9eaf11f9: folds
Uncalled bet ($0.2) returned to ecc107b9
*** SHOWDOWN ***
ecc107b9 collected $0.25 from pot
*** SUMMARY ***
Total pot $0.25 | Rake $0 | Jackpot $0 | Bingo $0 | Fortune $0
Seat 1: e88df375 (button) folded before Flop (didn't bet)
Seat 2: bb59ca08 (small blind) folded before Flop
Seat 3: 9eaf11f9 (big blind) folded before Flop
Seat 4: 3cc84dc folded before Flop (didn't bet)
Seat 5: ecc107b9 collected ($0.25)
Seat 6: Hero folded before Flop (didn't bet)


Poker Hand #RC1450142287: Hold'em No Limit  ($0.05/$0.1) - 2023/04/04 12:50:41
Table 'RushAndCash1707547' 6-max Seat #1 is the button
Seat 1: 8fdfed0 ($9.85 in chips)
Seat 2: 3824108b ($10 in chips)
Seat 3: 1970d66f ($27.38 in chips)
Seat 4: Hero ($20.05 in chips)
Seat 5: 3b6d9aa0 ($7.2 in chips)
Seat 6: ff2ca10c ($10.9 in chips)
3824108b: posts small blind $0.05
1970d66f: posts big blind $0.1
*** HOLE CARDS ***
Dealt to 8fdfed0 
Dealt to 3824108b 
Dealt to 1970d66f 
Dealt to Hero [Tc Ac]
Dealt to 3b6d9aa0 
Dealt to ff2ca10c 
Hero: raises $0.15 to $0.25
3b6d9aa0: folds
ff2ca10c: calls $0.25
8fdfed0: folds
3824108b: folds
1970d66f: calls $0.15
*** FLOP *** [3s Ts 8s]
1970d66f: checks
Hero: bets $0.4
ff2ca10c: folds
1970d66f: calls $0.4
*** TURN *** [3s Ts 8s] [7d]
1970d66f: checks
Hero: checks
*** RIVER *** [3s Ts 8s 7d] [Jc]
1970d66f: bets $1.6
Hero: calls $1.6
1970d66f: shows [As 9h] (Jacks-High Straight)
Hero: shows [Tc Ac] (Pair of Tens)
*** SHOWDOWN ***
1970d66f collected $4.42 from pot
*** SUMMARY ***
Total pot $4.8 | Rake $0.23 | Jackpot $0.15 | Bingo $0 | Fortune $0
Board [3s Ts 8s 7d Jc]
Seat 1: 8fdfed0 (button) folded before Flop (didn't bet)
Seat 2: 3824108b (small blind) folded before Flop
Seat 3: 1970d66f (big blind) showed [As 9h] and won ($4.42) with Jacks-High Straight
Seat 4: Hero showed [Tc Ac] and lost with Pair of Tens
Seat 5: 3b6d9aa0 folded before Flop (didn't bet)
Seat 6: ff2ca10c folded on the Flop


Poker Hand #RC1450142245: Hold'em No Limit  ($0.05/$0.1) - 2023/04/04 12:50:34
Table 'RushAndCash1707505' 6-max Seat #1 is the button
Seat 1: Hero ($20.05 in chips)
Seat 2: b2ef8623 ($10 in chips)
Seat 3: 83c76ae ($8.66 in chips)
Seat 4: d00add5a ($8.73 in chips)
Seat 5: 4e2c146f ($10.17 in chips)
Seat 6: 8b0f2680 ($11.89 in chips)
b2ef8623: posts small blind $0.05
83c76ae: posts big blind $0.1
*** HOLE CARDS ***
Dealt to Hero [Qs 6d]
Dealt to b2ef8623 
Dealt to 83c76ae 
Dealt to d00add5a 
Dealt to 4e2c146f 
Dealt to 8b0f2680 
d00add5a: folds
4e2c146f: raises $0.15 to $0.25
8b0f2680: folds
Hero: folds
b2ef8623: folds
83c76ae: calls $0.15
*** FLOP *** [5d Ad 6h]
83c76ae: checks
4e2c146f: bets $0.4
83c76ae: calls $0.4
*** TURN *** [5d Ad 6h] [6c]
83c76ae: bets $0.9
4e2c146f: folds
Uncalled bet ($0.9) returned to 83c76ae
*** SHOWDOWN ***
83c76ae collected $1.29 from pot
*** SUMMARY ***
Total pot $1.35 | Rake $0.06 | Jackpot $0 | Bingo $0 | Fortune $0
Board [5d Ad 6h 6c]
Seat 1: Hero (button) folded before Flop (didn't bet)
Seat 2: b2ef8623 (small blind) folded before Flop
Seat 3: 83c76ae (big blind) won ($1.29)
Seat 4: d00add5a folded before Flop (didn't bet)
Seat 5: 4e2c146f folded on the Turn
Seat 6: 8b0f2680 folded before Flop (didn't bet)


Poker Hand #RC1450142145: Hold'em No Limit  ($0.05/$0.1) - 2023/04/04 12:50:19
Table 'RushAndCash1707405' 6-max Seat #1 is the button
Seat 1: 95bf822 ($11.96 in chips)
Seat 2: Hero ($20.1 in chips)
Seat 3: b0cd54bf ($15.58 in chips)
Seat 4: 89aba73b ($14.59 in chips)
Seat 5: d6e72fe2 ($17.31 in chips)
Seat 6: aa7481c3 ($10 in chips)
Hero: posts small blind $0.05
b0cd54bf: posts big blind $0.1
*** HOLE CARDS ***
Dealt to 95bf822 
Dealt to Hero [4c Ts]
Dealt to b0cd54bf 
Dealt to 89aba73b 
Dealt to d6e72fe2 
Dealt to aa7481c3 
89aba73b: folds
d6e72fe2: folds
aa7481c3: folds
95bf822: raises $0.2 to $0.3
Hero: folds
b0cd54bf: folds
Uncalled bet ($0.2) returned to 95bf822
*** SHOWDOWN ***
95bf822 collected $0.25 from pot
*** SUMMARY ***
Total pot $0.25 | Rake $0 | Jackpot $0 | Bingo $0 | Fortune $0
Seat 1: 95bf822 (button) collected ($0.25)
Seat 2: Hero (small blind) folded before Flop
Seat 3: b0cd54bf (big blind) folded before Flop
Seat 4: 89aba73b folded before Flop (didn't bet)
Seat 5: d6e72fe2 folded before Flop (didn't bet)
Seat 6: aa7481c3 folded before Flop (didn't bet)


Poker Hand #RC1450140676: Hold'em No Limit  ($0.05/$0.1) - 2023/04/04 12:46:17
Table 'RushAndCash1705936' 6-max Seat #1 is the button
Seat 1: f33b127b ($10 in chips)
Seat 2: 67e21d4e ($26.86 in chips)
Seat 3: Hero ($10.15 in chips)
Seat 4: 7624ff2 ($9.35 in chips)
Seat 5: c7ec547a ($10 in chips)
Seat 6: 78737dab ($24.32 in chips)
67e21d4e: posts small blind $0.05
Hero: posts big blind $0.1
*** HOLE CARDS ***
Dealt to f33b127b 
Dealt to 67e21d4e 
Dealt to Hero [Js Jc]
Dealt to 7624ff2 
Dealt to c7ec547a 
Dealt to 78737dab 
7624ff2: folds
c7ec547a: folds
78737dab: raises $0.15 to $0.25
f33b127b: folds
67e21d4e: raises $0.65 to $0.9
Hero: raises $1.03 to $1.93
78737dab: folds
67e21d4e: calls $1.03
*** FLOP *** [Jh 9s Qs]
67e21d4e: checks
Hero: bets $1.31
67e21d4e: calls $1.31
*** TURN *** [Jh 9s Qs] [5h]
67e21d4e: checks
Hero: bets $2.23
67e21d4e: calls $2.23
*** RIVER *** [Jh 9s Qs 5h] [7s]
67e21d4e: checks
Hero: bets $4.68 and is all-in
67e21d4e: calls $4.68
Hero: shows [Js Jc] (Three Jacks)
67e21d4e: shows [Tc 9c] (Pair of Nines)
*** SHOWDOWN ***
Hero collected $20.1 from pot
*** SUMMARY ***
Total pot $20.55 | Rake $0.3 | Jackpot $0.15 | Bingo $0 | Fortune $0
Board [Jh 9s Qs 5h 7s]
Seat 1: f33b127b (button) folded before Flop (didn't bet)
Seat 2: 67e21d4e (small blind) showed [Tc 9c] and lost with Pair of Nines
Seat 3: Hero (big blind) showed [Js Jc] and won ($20.1) with Three Jacks
Seat 4: 7624ff2 folded before Flop (didn't bet)
Seat 5: c7ec547a folded before Flop (didn't bet)
Seat 6: 78737dab folded before Flop


Poker Hand #RC1450140621: Hold'em No Limit  ($0.05/$0.1) - 2023/04/04 12:46:07
Table 'RushAndCash1705881' 6-max Seat #1 is the button
Seat 1: fc6c7ad3 ($8.92 in chips)
Seat 2: e8e99fb0 ($11.68 in chips)
Seat 3: 337857b6 ($10 in chips)
Seat 4: f71adb86 ($10.37 in chips)
Seat 5: f2767a9f ($10 in chips)
Seat 6: Hero ($10.15 in chips)
e8e99fb0: posts small blind $0.05
337857b6: posts big blind $0.1
*** HOLE CARDS ***
Dealt to fc6c7ad3 
Dealt to e8e99fb0 
Dealt to 337857b6 
Dealt to f71adb86 
Dealt to f2767a9f 
Dealt to Hero [5s Tc]
f71adb86: folds
f2767a9f: raises $0.1 to $0.2
Hero: folds
fc6c7ad3: folds
e8e99fb0: folds
337857b6: folds
Uncalled bet ($0.1) returned to f2767a9f
*** SHOWDOWN ***
f2767a9f collected $0.25 from pot
*** SUMMARY ***
Total pot $0.25 | Rake $0 | Jackpot $0 | Bingo $0 | Fortune $0
Seat 1: fc6c7ad3 (button) folded before Flop (didn't bet)
Seat 2: e8e99fb0 (small blind) folded before Flop
Seat 3: 337857b6 (big blind) folded before Flop
Seat 4: f71adb86 folded before Flop (didn't bet)
Seat 5: f2767a9f collected ($0.25)
Seat 6: Hero folded before Flop (didn't bet)


Poker Hand #RC1450140483: Hold'em No Limit  ($0.05/$0.1) - 2023/04/04 12:45:43
Table 'RushAndCash1705743' 6-max Seat #1 is the button
Seat 1: 563140a8 ($10 in chips)
Seat 2: 3cc84dc ($6.62 in chips)
Seat 3: e21a8f8b ($12.8 in chips)
Seat 4: 4fc49830 ($12.54 in chips)
Seat 5: 9be0077c ($11.5 in chips)
Seat 6: Hero ($10 in chips)
3cc84dc: posts small blind $0.05
e21a8f8b: posts big blind $0.1
*** HOLE CARDS ***
Dealt to 563140a8 
Dealt to 3cc84dc 
Dealt to e21a8f8b 
Dealt to 4fc49830 
Dealt to 9be0077c 
Dealt to Hero [Ah Js]
4fc49830: folds
9be0077c: folds
Hero: raises $0.15 to $0.25
563140a8: folds
3cc84dc: folds
e21a8f8b: folds
Uncalled bet ($0.15) returned to Hero
*** SHOWDOWN ***
Hero collected $0.25 from pot
*** SUMMARY ***
Total pot $0.25 | Rake $0 | Jackpot $0 | Bingo $0 | Fortune $0
Seat 1: 563140a8 (button) folded before Flop (didn't bet)
Seat 2: 3cc84dc (small blind) folded before Flop
Seat 3: e21a8f8b (big blind) folded before Flop
Seat 4: 4fc49830 folded before Flop (didn't bet)
Seat 5: 9be0077c folded before Flop (didn't bet)
Seat 6: Hero collected ($0.25)


Poker Hand #RC1450140456: Hold'em No Limit  ($0.05/$0.1) - 2023/04/04 12:45:39
Table 'RushAndCash1705716' 6-max Seat #1 is the button
Seat 1: f1d1196d ($20.23 in chips)
Seat 2: ece737ea ($8.91 in chips)
Seat 3: 4b076e2f ($9.66 in chips)
Seat 4: 294b07d6 ($13.95 in chips)
Seat 5: 6dd0850b ($12.31 in chips)
Seat 6: Hero ($10 in chips)
ece737ea: posts small blind $0.05
4b076e2f: posts big blind $0.1
*** HOLE CARDS ***
Dealt to f1d1196d 
Dealt to ece737ea 
Dealt to 4b076e2f 
Dealt to 294b07d6 
Dealt to 6dd0850b 
Dealt to Hero [2c Ts]
294b07d6: folds
6dd0850b: folds
Hero: folds
f1d1196d: raises $0.15 to $0.25
ece737ea: folds
4b076e2f: calls $0.15
*** FLOP *** [9d 2h Jc]
4b076e2f: checks
f1d1196d: checks
*** TURN *** [9d 2h Jc] [Jh]
4b076e2f: bets $0.28
f1d1196d: folds
Uncalled bet ($0.28) returned to 4b076e2f
*** SHOWDOWN ***
4b076e2f collected $0.53 from pot
*** SUMMARY ***
Total pot $0.55 | Rake $0.02 | Jackpot $0 | Bingo $0 | Fortune $0
Board [9d 2h Jc Jh]
Seat 1: f1d1196d (button) folded on the Turn
Seat 2: ece737ea (small blind) folded before Flop
Seat 3: 4b076e2f (big blind) won ($0.53)
Seat 4: 294b07d6 folded before Flop (didn't bet)
Seat 5: 6dd0850b folded before Flop (didn't bet)
Seat 6: Hero folded before Flop (didn't bet)


Poker Hand #RC1450140414: Hold'em No Limit  ($0.05/$0.1) - 2023/04/04 12:45:32
Table 'RushAndCash1705674' 6-max Seat #1 is the button
Seat 1: cbd10165 ($15.94 in chips)
Seat 2: d980e3d ($25.72 in chips)
Seat 3: e4b521a5 ($4 in chips)
Seat 4: 626c83b5 ($11.86 in chips)
Seat 5: Hero ($10 in chips)
Seat 6: 5632af2 ($11.33 in chips)
d980e3d: posts small blind $0.05
e4b521a5: posts big blind $0.1
*** HOLE CARDS ***
Dealt to cbd10165 
Dealt to d980e3d 
Dealt to e4b521a5 
Dealt to 626c83b5 
Dealt to Hero [9s 8d]
Dealt to 5632af2 
626c83b5: raises $0.15 to $0.25
Hero: folds
5632af2: folds
cbd10165: folds
d980e3d: folds
e4b521a5: folds
Uncalled bet ($0.15) returned to 626c83b5
*** SHOWDOWN ***
626c83b5 collected $0.25 from pot
*** SUMMARY ***
Total pot $0.25 | Rake $0 | Jackpot $0 | Bingo $0 | Fortune $0
Seat 1: cbd10165 (button) folded before Flop (didn't bet)
Seat 2: d980e3d (small blind) folded before Flop
Seat 3: e4b521a5 (big blind) folded before Flop
Seat 4: 626c83b5 collected ($0.25)
Seat 5: Hero folded before Flop (didn't bet)
Seat 6: 5632af2 folded before Flop (didn't bet)


Poker Hand #RC1450140353: Hold'em No Limit  ($0.05/$0.1) - 2023/04/04 12:45:24
Table 'RushAndCash1705613' 6-max Seat #1 is the button
Seat 1: 3fae6cbf ($13.35 in chips)
Seat 2: Hero ($10.05 in chips)
Seat 3: d81641b8 ($10.47 in chips)
Seat 4: 4c0b413c ($11.92 in chips)
Seat 5: d9bc9171 ($19.71 in chips)
Seat 6: 87d04c7d ($14.5 in chips)
Hero: posts small blind $0.05
d81641b8: posts big blind $0.1
*** HOLE CARDS ***
Dealt to 3fae6cbf 
Dealt to Hero [Ts 8s]
Dealt to d81641b8 
Dealt to 4c0b413c 
Dealt to d9bc9171 
Dealt to 87d04c7d 
4c0b413c: folds
d9bc9171: raises $0.1 to $0.2
87d04c7d: folds
3fae6cbf: folds
Hero: folds
d81641b8: folds
Uncalled bet ($0.1) returned to d9bc9171
*** SHOWDOWN ***
d9bc9171 collected $0.25 from pot
*** SUMMARY ***
Total pot $0.25 | Rake $0 | Jackpot $0 | Bingo $0 | Fortune $0
Seat 1: 3fae6cbf (button) folded before Flop (didn't bet)
Seat 2: Hero (small blind) folded before Flop
Seat 3: d81641b8 (big blind) folded before Flop
Seat 4: 4c0b413c folded before Flop (didn't bet)
Seat 5: d9bc9171 collected ($0.25)
Seat 6: 87d04c7d folded before Flop (didn't bet)


Poker Hand #RC1450140324: Hold'em No Limit  ($0.05/$0.1) - 2023/04/04 12:45:19
Table 'RushAndCash1705584' 6-max Seat #1 is the button
Seat 1: ba9ba03f ($10.07 in chips)
Seat 2: 6872b58e ($12.39 in chips)
Seat 3: Hero ($10.15 in chips)
Seat 4: 7c22c86 ($10.05 in chips)
Seat 5: a0461986 ($9.2 in chips)
Seat 6: f678d2c5 ($7.65 in chips)
6872b58e: posts small blind $0.05
Hero: posts big blind $0.1
*** HOLE CARDS ***
Dealt to ba9ba03f 
Dealt to 6872b58e 
Dealt to Hero [7s Qh]
Dealt to 7c22c86 
Dealt to a0461986 
Dealt to f678d2c5 
7c22c86: raises $0.2 to $0.3
a0461986: folds
f678d2c5: folds
ba9ba03f: folds
6872b58e: folds
Hero: folds
Uncalled bet ($0.2) returned to 7c22c86
*** SHOWDOWN ***
7c22c86 collected $0.25 from pot
*** SUMMARY ***
Total pot $0.25 | Rake $0 | Jackpot $0 | Bingo $0 | Fortune $0
Seat 1: ba9ba03f (button) folded before Flop (didn't bet)
Seat 2: 6872b58e (small blind) folded before Flop
Seat 3: Hero (big blind) folded before Flop
Seat 4: 7c22c86 collected ($0.25)
Seat 5: a0461986 folded before Flop (didn't bet)
Seat 6: f678d2c5 folded before Flop (didn't bet)


Poker Hand #RC1450140295: Hold'em No Limit  ($0.05/$0.1) - 2023/04/04 12:45:14
Table 'RushAndCash1705555' 6-max Seat #1 is the button
Seat 1: Hero ($10.15 in chips)
Seat 2: 150fdfe6 ($10.13 in chips)
Seat 3: 345248f6 ($8.31 in chips)
Seat 4: 1c781bb3 ($1.97 in chips)
Seat 5: 1970d66f ($22.51 in chips)
Seat 6: e86a4b58 ($10 in chips)
150fdfe6: posts small blind $0.05
345248f6: posts big blind $0.1
*** HOLE CARDS ***
Dealt to Hero [5c Js]
Dealt to 150fdfe6 
Dealt to 345248f6 
Dealt to 1c781bb3 
Dealt to 1970d66f 
Dealt to e86a4b58 
1c781bb3: raises $0.1 to $0.2
1970d66f: folds
e86a4b58: folds
Hero: folds
150fdfe6: folds
345248f6: folds
Uncalled bet ($0.1) returned to 1c781bb3
*** SHOWDOWN ***
1c781bb3 collected $0.25 from pot
*** SUMMARY ***
Total pot $0.25 | Rake $0 | Jackpot $0 | Bingo $0 | Fortune $0
Seat 1: Hero (button) folded before Flop (didn't bet)
Seat 2: 150fdfe6 (small blind) folded before Flop
Seat 3: 345248f6 (big blind) folded before Flop
Seat 4: 1c781bb3 collected ($0.25)
Seat 5: 1970d66f folded before Flop (didn't bet)
Seat 6: e86a4b58 folded before Flop (didn't bet)


Poker Hand #RC1450140247: Hold'em No Limit  ($0.05/$0.1) - 2023/04/04 12:45:06
Table 'RushAndCash1705507' 6-max Seat #1 is the button
Seat 1: cd8a3ecf ($12.51 in chips)
Seat 2: c7e9d3b5 ($10 in chips)
Seat 3: a7f4f38 ($23.1 in chips)
Seat 4: a4e7cb4a ($15.37 in chips)
Seat 5: Hero ($10.15 in chips)
Seat 6: 1c781bb3 ($1.97 in chips)
c7e9d3b5: posts small blind $0.05
a7f4f38: posts big blind $0.1
*** HOLE CARDS ***
Dealt to cd8a3ecf 
Dealt to c7e9d3b5 
Dealt to a7f4f38 
Dealt to a4e7cb4a 
Dealt to Hero [Qc 3c]
Dealt to 1c781bb3 
a4e7cb4a: folds
Hero: folds
1c781bb3: folds
cd8a3ecf: folds
c7e9d3b5: folds
Uncalled bet ($0.05) returned to a7f4f38
*** SHOWDOWN ***
a7f4f38 collected $0.1 from pot
*** SUMMARY ***
Total pot $0.1 | Rake $0 | Jackpot $0 | Bingo $0 | Fortune $0
Seat 1: cd8a3ecf (button) folded before Flop (didn't bet)
Seat 2: c7e9d3b5 (small blind) folded before Flop
Seat 3: a7f4f38 (big blind) collected ($0.1)
Seat 4: a4e7cb4a folded before Flop (didn't bet)
Seat 5: Hero folded before Flop (didn't bet)
Seat 6: 1c781bb3 folded before Flop (didn't bet)


Poker Hand #RC1450140218: Hold'em No Limit  ($0.05/$0.1) - 2023/04/04 12:45:01
Table 'RushAndCash1705478' 6-max Seat #1 is the button
Seat 1: cb150ed4 ($7.96 in chips)
Seat 2: 9be0077c ($11.13 in chips)
Seat 3: a5090f03 ($10.15 in chips)
Seat 4: b28beae6 ($11.89 in chips)
Seat 5: 4925bcb3 ($10 in chips)
Seat 6: Hero ($10.15 in chips)
9be0077c: posts small blind $0.05
a5090f03: posts big blind $0.1
*** HOLE CARDS ***
Dealt to cb150ed4 
Dealt to 9be0077c 
Dealt to a5090f03 
Dealt to b28beae6 
Dealt to 4925bcb3 
Dealt to Hero [3c 6h]
b28beae6: folds
4925bcb3: folds
Hero: folds
cb150ed4: folds
9be0077c: raises $0.2 to $0.3
a5090f03: folds
Uncalled bet ($0.2) returned to 9be0077c
*** SHOWDOWN ***
9be0077c collected $0.2 from pot
*** SUMMARY ***
Total pot $0.2 | Rake $0 | Jackpot $0 | Bingo $0 | Fortune $0
Seat 1: cb150ed4 (button) folded before Flop (didn't bet)
Seat 2: 9be0077c (small blind) collected ($0.2)
Seat 3: a5090f03 (big blind) folded before Flop
Seat 4: b28beae6 folded before Flop (didn't bet)
Seat 5: 4925bcb3 folded before Flop (didn't bet)
Seat 6: Hero folded before Flop (didn't bet)


Poker Hand #RC1450140121: Hold'em No Limit  ($0.05/$0.1) - 2023/04/04 12:44:46
Table 'RushAndCash1705381' 6-max Seat #1 is the button
Seat 1: f8a35af7 ($2.07 in chips)
Seat 2: e3fed5ef ($12.05 in chips)
Seat 3: e3bc8979 ($10.13 in chips)
Seat 4: bbbbf5ea ($12.47 in chips)
Seat 5: fdca7c21 ($22.83 in chips)
Seat 6: Hero ($10.15 in chips)
e3fed5ef: posts small blind $0.05
e3bc8979: posts big blind $0.1
*** HOLE CARDS ***
Dealt to f8a35af7 
Dealt to e3fed5ef 
Dealt to e3bc8979 
Dealt to bbbbf5ea 
Dealt to fdca7c21 
Dealt to Hero [Qh 5h]
bbbbf5ea: folds
fdca7c21: folds
Hero: folds
f8a35af7: folds
e3fed5ef: raises $0.2 to $0.3
e3bc8979: raises $0.6 to $0.9
e3fed5ef: folds
Uncalled bet ($0.6) returned to e3bc8979
*** SHOWDOWN ***
e3bc8979 collected $0.57 from pot
*** SUMMARY ***
Total pot $0.6 | Rake $0.03 | Jackpot $0 | Bingo $0 | Fortune $0
Seat 1: f8a35af7 (button) folded before Flop (didn't bet)
Seat 2: e3fed5ef (small blind) folded before Flop
Seat 3: e3bc8979 (big blind) collected ($0.57)
Seat 4: bbbbf5ea folded before Flop (didn't bet)
Seat 5: fdca7c21 folded before Flop (didn't bet)
Seat 6: Hero folded before Flop (didn't bet)


Poker Hand #RC1450140046: Hold'em No Limit  ($0.05/$0.1) - 2023/04/04 12:44:34
Table 'RushAndCash1705306' 6-max Seat #1 is the button
Seat 1: Hero ($10 in chips)
Seat 2: adf2c4c ($10.11 in chips)
Seat 3: 7b5d549c ($20.13 in chips)
Seat 4: 7df2fab2 ($11.03 in chips)
Seat 5: c7e9d3b5 ($10.05 in chips)
Seat 6: 195361f3 ($10.38 in chips)
adf2c4c: posts small blind $0.05
7b5d549c: posts big blind $0.1
*** HOLE CARDS ***
Dealt to Hero [Kc 5c]
Dealt to adf2c4c 
Dealt to 7b5d549c 
Dealt to 7df2fab2 
Dealt to c7e9d3b5 
Dealt to 195361f3 
7df2fab2: folds
c7e9d3b5: folds
195361f3: folds
Hero: raises $0.15 to $0.25
adf2c4c: folds
7b5d549c: folds
Uncalled bet ($0.15) returned to Hero
*** SHOWDOWN ***
Hero collected $0.25 from pot
*** SUMMARY ***
Total pot $0.25 | Rake $0 | Jackpot $0 | Bingo $0 | Fortune $0
Seat 1: Hero (button) collected ($0.25)
Seat 2: adf2c4c (small blind) folded before Flop
Seat 3: 7b5d549c (big blind) folded before Flop
Seat 4: 7df2fab2 folded before Flop (didn't bet)
Seat 5: c7e9d3b5 folded before Flop (didn't bet)
Seat 6: 195361f3 folded before Flop (didn't bet)


Poker Hand #RC1450140013: Hold'em No Limit  ($0.05/$0.1) - 2023/04/04 12:44:28
Table 'RushAndCash1705273' 6-max Seat #1 is the button
Seat 1: 54836f75 ($21.1 in chips)
Seat 2: Hero ($10.05 in chips)
Seat 3: 7adb2a2b ($20.62 in chips)
Seat 4: 93d67df6 ($13.85 in chips)
Seat 5: 3dee9af0 ($25.26 in chips)
Seat 6: 1361f9b6 ($7.99 in chips)
Hero: posts small blind $0.05
7adb2a2b: posts big blind $0.1
*** HOLE CARDS ***
Dealt to 54836f75 
Dealt to Hero [Th 6s]
Dealt to 7adb2a2b 
Dealt to 93d67df6 
Dealt to 3dee9af0 
Dealt to 1361f9b6 
93d67df6: folds
3dee9af0: raises $0.15 to $0.25
1361f9b6: folds
54836f75: folds
Hero: folds
7adb2a2b: folds
Uncalled bet ($0.15) returned to 3dee9af0
*** SHOWDOWN ***
3dee9af0 collected $0.25 from pot
*** SUMMARY ***
Total pot $0.25 | Rake $0 | Jackpot $0 | Bingo $0 | Fortune $0
Seat 1: 54836f75 (button) folded before Flop (didn't bet)
Seat 2: Hero (small blind) folded before Flop
Seat 3: 7adb2a2b (big blind) folded before Flop
Seat 4: 93d67df6 folded before Flop (didn't bet)
Seat 5: 3dee9af0 collected ($0.25)
Seat 6: 1361f9b6 folded before Flop (didn't bet)


Poker Hand #RC1450139935: Hold'em No Limit  ($0.05/$0.1) - 2023/04/04 12:44:14
Table 'RushAndCash1705195' 6-max Seat #1 is the button
Seat 1: bb8a2c0 ($10 in chips)
Seat 2: 45d961d2 ($10 in chips)
Seat 3: Hero ($10 in chips)
Seat 4: 333f8cef ($11.12 in chips)
Seat 5: 9c8dc365 ($10 in chips)
Seat 6: c165ca07 ($5.14 in chips)
45d961d2: posts small blind $0.05
Hero: posts big blind $0.1
*** HOLE CARDS ***
Dealt to bb8a2c0 
Dealt to 45d961d2 
Dealt to Hero [9d Jc]
Dealt to 333f8cef 
Dealt to 9c8dc365 
Dealt to c165ca07 
333f8cef: folds
9c8dc365: folds
c165ca07: folds
bb8a2c0: folds
45d961d2: folds
Uncalled bet ($0.05) returned to Hero
*** SHOWDOWN ***
Hero collected $0.1 from pot
*** SUMMARY ***
Total pot $0.1 | Rake $0 | Jackpot $0 | Bingo $0 | Fortune $0
Seat 1: bb8a2c0 (button) folded before Flop (didn't bet)
Seat 2: 45d961d2 (small blind) folded before Flop
Seat 3: Hero (big blind) collected ($0.1)
Seat 4: 333f8cef folded before Flop (didn't bet)
Seat 5: 9c8dc365 folded before Flop (didn't bet)
Seat 6: c165ca07 folded before Flop (didn't bet)


