Poker Hand #RC1433462906: Hold'em No Limit  ($0.05/$0.1) - 2023/03/27 20:26:22
Table 'RushAndCash28198166' 6-max Seat #1 is the button
Seat 1: Hero ($27.68 in chips)
Seat 2: 10742e07 ($10.05 in chips)
Seat 3: 834fe7f8 ($12.3 in chips)
Seat 4: 3e9aa64b ($10 in chips)
Seat 5: ed9b3fa5 ($3 in chips)
Seat 6: bfc6618d ($22.52 in chips)
10742e07: posts small blind $0.05
834fe7f8: posts big blind $0.1
*** HOLE CARDS ***
Dealt to Hero [Td 2s]
Dealt to 10742e07 
Dealt to 834fe7f8 
Dealt to 3e9aa64b 
Dealt to ed9b3fa5 
Dealt to bfc6618d 
3e9aa64b: folds
ed9b3fa5: calls $0.1
bfc6618d: folds
Hero: folds
10742e07: folds
834fe7f8: checks
*** FLOP *** [Ah Jh 4d]
834fe7f8: checks
ed9b3fa5: checks
*** TURN *** [Ah Jh 4d] [Jd]
834fe7f8: checks
ed9b3fa5: bets $0.19
834fe7f8: folds
Uncalled bet ($0.19) returned to ed9b3fa5
*** SHOWDOWN ***
ed9b3fa5 collected $0.24 from pot
*** SUMMARY ***
Total pot $0.25 | Rake $0.01 | Jackpot $0 | Bingo $0 | Fortune $0
Board [Ah Jh 4d Jd]
Seat 1: Hero (button) folded before Flop (didn't bet)
Seat 2: 10742e07 (small blind) folded before Flop
Seat 3: 834fe7f8 (big blind) folded on the Turn
Seat 4: 3e9aa64b folded before Flop (didn't bet)
Seat 5: ed9b3fa5 won ($0.24)
Seat 6: bfc6618d folded before Flop (didn't bet)


Poker Hand #RC1433462814: Hold'em No Limit  ($0.05/$0.1) - 2023/03/27 20:26:09
Table 'RushAndCash28198074' 6-max Seat #1 is the button
Seat 1: c019c248 ($2.01 in chips)
Seat 2: Hero ($27.73 in chips)
Seat 3: 17e7697a ($46.08 in chips)
Seat 4: 583541e8 ($10.96 in chips)
Seat 5: 5b794c0c ($19.33 in chips)
Seat 6: 1085b481 ($13.27 in chips)
Hero: posts small blind $0.05
17e7697a: posts big blind $0.1
*** HOLE CARDS ***
Dealt to c019c248 
Dealt to Hero [6s 9h]
Dealt to 17e7697a 
Dealt to 583541e8 
Dealt to 5b794c0c 
Dealt to 1085b481 
583541e8: folds
5b794c0c: folds
1085b481: folds
c019c248: folds
Hero: folds
Uncalled bet ($0.05) returned to 17e7697a
*** SHOWDOWN ***
17e7697a collected $0.1 from pot
*** SUMMARY ***
Total pot $0.1 | Rake $0 | Jackpot $0 | Bingo $0 | Fortune $0
Seat 1: c019c248 (button) folded before Flop (didn't bet)
Seat 2: Hero (small blind) folded before Flop
Seat 3: 17e7697a (big blind) collected ($0.1)
Seat 4: 583541e8 folded before Flop (didn't bet)
Seat 5: 5b794c0c folded before Flop (didn't bet)
Seat 6: 1085b481 folded before Flop (didn't bet)


Poker Hand #RC1433462779: Hold'em No Limit  ($0.05/$0.1) - 2023/03/27 20:26:04
Table 'RushAndCash28198039' 6-max Seat #1 is the button
Seat 1: 3e9aa64b ($10 in chips)
Seat 2: 39f76252 ($10.71 in chips)
Seat 3: 5cd5006b ($6.25 in chips)
Seat 4: Hero ($27.73 in chips)
Seat 5: 6c4b3569 ($21.12 in chips)
Seat 6: 3129b917 ($24.73 in chips)
39f76252: posts small blind $0.05
5cd5006b: posts big blind $0.1
*** HOLE CARDS ***
Dealt to 3e9aa64b 
Dealt to 39f76252 
Dealt to 5cd5006b 
Dealt to Hero [6d 3h]
Dealt to 6c4b3569 
Dealt to 3129b917 
Hero: folds
6c4b3569: folds
3129b917: folds
3e9aa64b: folds
39f76252: raises $0.2 to $0.3
5cd5006b: folds
Uncalled bet ($0.2) returned to 39f76252
*** SHOWDOWN ***
39f76252 collected $0.2 from pot
*** SUMMARY ***
Total pot $0.2 | Rake $0 | Jackpot $0 | Bingo $0 | Fortune $0
Seat 1: 3e9aa64b (button) folded before Flop (didn't bet)
Seat 2: 39f76252 (small blind) collected ($0.2)
Seat 3: 5cd5006b (big blind) folded before Flop
Seat 4: Hero folded before Flop (didn't bet)
Seat 5: 6c4b3569 folded before Flop (didn't bet)
Seat 6: 3129b917 folded before Flop (didn't bet)


Poker Hand #RC1433462700: Hold'em No Limit  ($0.05/$0.1) - 2023/03/27 20:25:52
Table 'RushAndCash28197960' 6-max Seat #1 is the button
Seat 1: a862b43b ($15.7 in chips)
Seat 2: 880f1c43 ($45.1 in chips)
Seat 3: Hero ($27.83 in chips)
Seat 4: ccf6ba4d ($10 in chips)
Seat 5: 956b04ef ($13.48 in chips)
Seat 6: 25ac5c74 ($12.54 in chips)
880f1c43: posts small blind $0.05
Hero: posts big blind $0.1
*** HOLE CARDS ***
Dealt to a862b43b 
Dealt to 880f1c43 
Dealt to Hero [2d 4h]
Dealt to ccf6ba4d 
Dealt to 956b04ef 
Dealt to 25ac5c74 
ccf6ba4d: folds
956b04ef: folds
25ac5c74: raises $0.1 to $0.2
a862b43b: folds
880f1c43: raises $0.8 to $1
Hero: folds
25ac5c74: folds
Uncalled bet ($0.8) returned to 880f1c43
*** SHOWDOWN ***
880f1c43 collected $0.48 from pot
*** SUMMARY ***
Total pot $0.5 | Rake $0.02 | Jackpot $0 | Bingo $0 | Fortune $0
Seat 1: a862b43b (button) folded before Flop (didn't bet)
Seat 2: 880f1c43 (small blind) collected ($0.48)
Seat 3: Hero (big blind) folded before Flop
Seat 4: ccf6ba4d folded before Flop (didn't bet)
Seat 5: 956b04ef folded before Flop (didn't bet)
Seat 6: 25ac5c74 folded before Flop


Poker Hand #RC1433462511: Hold'em No Limit  ($0.05/$0.1) - 2023/03/27 20:25:23
Table 'RushAndCash28197771' 6-max Seat #1 is the button
Seat 1: Hero ($28.08 in chips)
Seat 2: 8c326938 ($11.45 in chips)
Seat 3: 506e0653 ($5.65 in chips)
Seat 4: 35a4c5a5 ($12.32 in chips)
Seat 5: a5b76d7b ($10.37 in chips)
Seat 6: 5a6c8cee ($15.5 in chips)
8c326938: posts small blind $0.05
506e0653: posts big blind $0.1
*** HOLE CARDS ***
Dealt to Hero [4s 3s]
Dealt to 8c326938 
Dealt to 506e0653 
Dealt to 35a4c5a5 
Dealt to a5b76d7b 
Dealt to 5a6c8cee 
35a4c5a5: folds
a5b76d7b: folds
5a6c8cee: folds
Hero: raises $0.15 to $0.25
8c326938: folds
506e0653: raises $0.5 to $0.75
Hero: folds
Uncalled bet ($0.5) returned to 506e0653
*** SHOWDOWN ***
506e0653 collected $0.53 from pot
*** SUMMARY ***
Total pot $0.55 | Rake $0.02 | Jackpot $0 | Bingo $0 | Fortune $0
Seat 1: Hero (button) folded before Flop
Seat 2: 8c326938 (small blind) folded before Flop
Seat 3: 506e0653 (big blind) collected ($0.53)
Seat 4: 35a4c5a5 folded before Flop (didn't bet)
Seat 5: a5b76d7b folded before Flop (didn't bet)
Seat 6: 5a6c8cee folded before Flop (didn't bet)


Poker Hand #RC1433462481: Hold'em No Limit  ($0.05/$0.1) - 2023/03/27 20:25:20
Table 'RushAndCash28197741' 6-max Seat #1 is the button
Seat 1: 254be459 ($10.37 in chips)
Seat 2: 506e0653 ($5.7 in chips)
Seat 3: eaf6fbbc ($10.15 in chips)
Seat 4: Hero ($28.08 in chips)
Seat 5: 3f48a6c1 ($9.32 in chips)
Seat 6: 840413b2 ($9.81 in chips)
506e0653: posts small blind $0.05
eaf6fbbc: posts big blind $0.1
*** HOLE CARDS ***
Dealt to 254be459 
Dealt to 506e0653 
Dealt to eaf6fbbc 
Dealt to Hero [5h 2h]
Dealt to 3f48a6c1 
Dealt to 840413b2 
Hero: folds
3f48a6c1: folds
840413b2: raises $0.1 to $0.2
254be459: folds
506e0653: folds
eaf6fbbc: folds
Uncalled bet ($0.1) returned to 840413b2
*** SHOWDOWN ***
840413b2 collected $0.25 from pot
*** SUMMARY ***
Total pot $0.25 | Rake $0 | Jackpot $0 | Bingo $0 | Fortune $0
Seat 1: 254be459 (button) folded before Flop (didn't bet)
Seat 2: 506e0653 (small blind) folded before Flop
Seat 3: eaf6fbbc (big blind) folded before Flop
Seat 4: Hero folded before Flop (didn't bet)
Seat 5: 3f48a6c1 folded before Flop (didn't bet)
Seat 6: 840413b2 collected ($0.25)


Poker Hand #RC1433462428: Hold'em No Limit  ($0.05/$0.1) - 2023/03/27 20:25:12
Table 'RushAndCash28197688' 6-max Seat #1 is the button
Seat 1: 840413b2 ($9.86 in chips)
Seat 2: ccab9584 ($18.41 in chips)
Seat 3: 4fbef5f9 ($11.03 in chips)
Seat 4: 4c3a2197 ($12.96 in chips)
Seat 5: 828d8dcf ($13.01 in chips)
Seat 6: Hero ($28.08 in chips)
ccab9584: posts small blind $0.05
4fbef5f9: posts big blind $0.1
*** HOLE CARDS ***
Dealt to 840413b2 
Dealt to ccab9584 
Dealt to 4fbef5f9 
Dealt to 4c3a2197 
Dealt to 828d8dcf 
Dealt to Hero [5s 7c]
4c3a2197: folds
828d8dcf: raises $0.1 to $0.2
Hero: folds
840413b2: folds
ccab9584: folds
4fbef5f9: folds
Uncalled bet ($0.1) returned to 828d8dcf
*** SHOWDOWN ***
828d8dcf collected $0.25 from pot
*** SUMMARY ***
Total pot $0.25 | Rake $0 | Jackpot $0 | Bingo $0 | Fortune $0
Seat 1: 840413b2 (button) folded before Flop (didn't bet)
Seat 2: ccab9584 (small blind) folded before Flop
Seat 3: 4fbef5f9 (big blind) folded before Flop
Seat 4: 4c3a2197 folded before Flop (didn't bet)
Seat 5: 828d8dcf collected ($0.25)
Seat 6: Hero folded before Flop (didn't bet)


Poker Hand #RC1433462396: Hold'em No Limit  ($0.05/$0.1) - 2023/03/27 20:25:08
Table 'RushAndCash28197656' 6-max Seat #1 is the button
Seat 1: d5571ce8 ($12.14 in chips)
Seat 2: bf6ad4c2 ($10.86 in chips)
Seat 3: b0948eea ($10.61 in chips)
Seat 4: Hero ($28.08 in chips)
Seat 5: 89290180 ($14.83 in chips)
Seat 6: c019c248 ($2.31 in chips)
bf6ad4c2: posts small blind $0.05
b0948eea: posts big blind $0.1
*** HOLE CARDS ***
Dealt to d5571ce8 
Dealt to bf6ad4c2 
Dealt to b0948eea 
Dealt to Hero [4s 8h]
Dealt to 89290180 
Dealt to c019c248 
Hero: folds
89290180: folds
c019c248: folds
d5571ce8: folds
bf6ad4c2: folds
Uncalled bet ($0.05) returned to b0948eea
*** SHOWDOWN ***
b0948eea collected $0.1 from pot
*** SUMMARY ***
Total pot $0.1 | Rake $0 | Jackpot $0 | Bingo $0 | Fortune $0
Seat 1: d5571ce8 (button) folded before Flop (didn't bet)
Seat 2: bf6ad4c2 (small blind) folded before Flop
Seat 3: b0948eea (big blind) collected ($0.1)
Seat 4: Hero folded before Flop (didn't bet)
Seat 5: 89290180 folded before Flop (didn't bet)
Seat 6: c019c248 folded before Flop (didn't bet)


Poker Hand #RC1433462276: Hold'em No Limit  ($0.05/$0.1) - 2023/03/27 20:24:51
Table 'RushAndCash28197536' 6-max Seat #1 is the button
Seat 1: 6d71942c ($12.21 in chips)
Seat 2: 7cc63046 ($10.05 in chips)
Seat 3: 2c7e7c9a ($29.8 in chips)
Seat 4: 947b43c2 ($39.78 in chips)
Seat 5: 20609e19 ($10.22 in chips)
Seat 6: Hero ($27.93 in chips)
7cc63046: posts small blind $0.05
2c7e7c9a: posts big blind $0.1
*** HOLE CARDS ***
Dealt to 6d71942c 
Dealt to 7cc63046 
Dealt to 2c7e7c9a 
Dealt to 947b43c2 
Dealt to 20609e19 
Dealt to Hero [Jd Ks]
947b43c2: folds
20609e19: folds
Hero: raises $0.15 to $0.25
6d71942c: folds
7cc63046: folds
2c7e7c9a: folds
Uncalled bet ($0.15) returned to Hero
*** SHOWDOWN ***
Hero collected $0.25 from pot
*** SUMMARY ***
Total pot $0.25 | Rake $0 | Jackpot $0 | Bingo $0 | Fortune $0
Seat 1: 6d71942c (button) folded before Flop (didn't bet)
Seat 2: 7cc63046 (small blind) folded before Flop
Seat 3: 2c7e7c9a (big blind) folded before Flop
Seat 4: 947b43c2 folded before Flop (didn't bet)
Seat 5: 20609e19 folded before Flop (didn't bet)
Seat 6: Hero collected ($0.25)


Poker Hand #RC1433462181: Hold'em No Limit  ($0.05/$0.1) - 2023/03/27 20:24:37
Table 'RushAndCash28197441' 6-max Seat #1 is the button
Seat 1: c7bcdfdb ($2.8 in chips)
Seat 2: Hero ($27.98 in chips)
Seat 3: 8a0160a1 ($25.89 in chips)
Seat 4: 23e44a77 ($10.1 in chips)
Seat 5: 16bfecec ($18.4 in chips)
Seat 6: 498dfc60 ($20.15 in chips)
Hero: posts small blind $0.05
8a0160a1: posts big blind $0.1
*** HOLE CARDS ***
Dealt to c7bcdfdb 
Dealt to Hero [Jd 7c]
Dealt to 8a0160a1 
Dealt to 23e44a77 
Dealt to 16bfecec 
Dealt to 498dfc60 
23e44a77: folds
16bfecec: folds
498dfc60: folds
c7bcdfdb: raises $0.1 to $0.2
Hero: folds
8a0160a1: calls $0.1
*** FLOP *** [3h 7s Qh]
8a0160a1: checks
c7bcdfdb: bets $0.15
8a0160a1: folds
Uncalled bet ($0.15) returned to c7bcdfdb
*** SHOWDOWN ***
c7bcdfdb collected $0.43 from pot
*** SUMMARY ***
Total pot $0.45 | Rake $0.02 | Jackpot $0 | Bingo $0 | Fortune $0
Board [3h 7s Qh]
Seat 1: c7bcdfdb (button) won ($0.43)
Seat 2: Hero (small blind) folded before Flop
Seat 3: 8a0160a1 (big blind) folded on the Flop
Seat 4: 23e44a77 folded before Flop (didn't bet)
Seat 5: 16bfecec folded before Flop (didn't bet)
Seat 6: 498dfc60 folded before Flop (didn't bet)


Poker Hand #RC1433462133: Hold'em No Limit  ($0.05/$0.1) - 2023/03/27 20:24:29
Table 'RushAndCash28197393' 6-max Seat #1 is the button
Seat 1: 93f4b839 ($13.26 in chips)
Seat 2: a3f62a8c ($15.14 in chips)
Seat 3: 5f51d405 ($4.22 in chips)
Seat 4: 6d71942c ($12.31 in chips)
Seat 5: c2f3c95e ($9.54 in chips)
Seat 6: Hero ($27.98 in chips)
a3f62a8c: posts small blind $0.05
5f51d405: posts big blind $0.1
*** HOLE CARDS ***
Dealt to 93f4b839 
Dealt to a3f62a8c 
Dealt to 5f51d405 
Dealt to 6d71942c 
Dealt to c2f3c95e 
Dealt to Hero [6d 9h]
6d71942c: folds
c2f3c95e: folds
Hero: folds
93f4b839: folds
a3f62a8c: raises $0.2 to $0.3
5f51d405: folds
Uncalled bet ($0.2) returned to a3f62a8c
*** SHOWDOWN ***
a3f62a8c collected $0.2 from pot
*** SUMMARY ***
Total pot $0.2 | Rake $0 | Jackpot $0 | Bingo $0 | Fortune $0
Seat 1: 93f4b839 (button) folded before Flop (didn't bet)
Seat 2: a3f62a8c (small blind) collected ($0.2)
Seat 3: 5f51d405 (big blind) folded before Flop
Seat 4: 6d71942c folded before Flop (didn't bet)
Seat 5: c2f3c95e folded before Flop (didn't bet)
Seat 6: Hero folded before Flop (didn't bet)


Poker Hand #RC1433462059: Hold'em No Limit  ($0.05/$0.1) - 2023/03/27 20:24:17
Table 'RushAndCash28197319' 6-max Seat #1 is the button
Seat 1: 75500428 ($9.75 in chips)
Seat 2: 47503c44 ($39.09 in chips)
Seat 3: Hero ($28.08 in chips)
Seat 4: 246e3643 ($10 in chips)
Seat 5: f137d313 ($15.36 in chips)
Seat 6: c373ffff ($13.29 in chips)
47503c44: posts small blind $0.05
Hero: posts big blind $0.1
*** HOLE CARDS ***
Dealt to 75500428 
Dealt to 47503c44 
Dealt to Hero [4c 8h]
Dealt to 246e3643 
Dealt to f137d313 
Dealt to c373ffff 
246e3643: folds
f137d313: raises $0.15 to $0.25
c373ffff: folds
75500428: folds
47503c44: folds
Hero: folds
Uncalled bet ($0.15) returned to f137d313
*** SHOWDOWN ***
f137d313 collected $0.25 from pot
*** SUMMARY ***
Total pot $0.25 | Rake $0 | Jackpot $0 | Bingo $0 | Fortune $0
Seat 1: 75500428 (button) folded before Flop (didn't bet)
Seat 2: 47503c44 (small blind) folded before Flop
Seat 3: Hero (big blind) folded before Flop
Seat 4: 246e3643 folded before Flop (didn't bet)
Seat 5: f137d313 collected ($0.25)
Seat 6: c373ffff folded before Flop (didn't bet)


Poker Hand #RC1433462029: Hold'em No Limit  ($0.05/$0.1) - 2023/03/27 20:24:12
Table 'RushAndCash28197289' 6-max Seat #1 is the button
Seat 1: 7cd65afb ($43.49 in chips)
Seat 2: Hero ($28.13 in chips)
Seat 3: 6b714094 ($27.77 in chips)
Seat 4: 230aa3ae ($13.75 in chips)
Seat 5: da2a9228 ($14.94 in chips)
Seat 6: c1afae07 ($17.72 in chips)
Hero: posts small blind $0.05
6b714094: posts big blind $0.1
*** HOLE CARDS ***
Dealt to 7cd65afb 
Dealt to Hero [2c 3c]
Dealt to 6b714094 
Dealt to 230aa3ae 
Dealt to da2a9228 
Dealt to c1afae07 
230aa3ae: raises $0.15 to $0.25
da2a9228: folds
c1afae07: folds
7cd65afb: folds
Hero: folds
6b714094: folds
Uncalled bet ($0.15) returned to 230aa3ae
*** SHOWDOWN ***
230aa3ae collected $0.25 from pot
*** SUMMARY ***
Total pot $0.25 | Rake $0 | Jackpot $0 | Bingo $0 | Fortune $0
Seat 1: 7cd65afb (button) folded before Flop (didn't bet)
Seat 2: Hero (small blind) folded before Flop
Seat 3: 6b714094 (big blind) folded before Flop
Seat 4: 230aa3ae collected ($0.25)
Seat 5: da2a9228 folded before Flop (didn't bet)
Seat 6: c1afae07 folded before Flop (didn't bet)


Poker Hand #RC1433461916: Hold'em No Limit  ($0.05/$0.1) - 2023/03/27 20:23:55
Table 'RushAndCash28197176' 6-max Seat #1 is the button
Seat 1: 5e9aefc6 ($16.29 in chips)
Seat 2: Hero ($28.18 in chips)
Seat 3: 7e0e949 ($10.13 in chips)
Seat 4: f770dcf2 ($11.56 in chips)
Seat 5: bb4b1d3f ($6.92 in chips)
Seat 6: fe2e3116 ($12.45 in chips)
Hero: posts small blind $0.05
7e0e949: posts big blind $0.1
*** HOLE CARDS ***
Dealt to 5e9aefc6 
Dealt to Hero [3d 2d]
Dealt to 7e0e949 
Dealt to f770dcf2 
Dealt to bb4b1d3f 
Dealt to fe2e3116 
f770dcf2: raises $0.15 to $0.25
bb4b1d3f: folds
fe2e3116: folds
5e9aefc6: folds
Hero: folds
7e0e949: folds
Uncalled bet ($0.15) returned to f770dcf2
*** SHOWDOWN ***
f770dcf2 collected $0.25 from pot
*** SUMMARY ***
Total pot $0.25 | Rake $0 | Jackpot $0 | Bingo $0 | Fortune $0
Seat 1: 5e9aefc6 (button) folded before Flop (didn't bet)
Seat 2: Hero (small blind) folded before Flop
Seat 3: 7e0e949 (big blind) folded before Flop
Seat 4: f770dcf2 collected ($0.25)
Seat 5: bb4b1d3f folded before Flop (didn't bet)
Seat 6: fe2e3116 folded before Flop (didn't bet)


Poker Hand #RC1433461795: Hold'em No Limit  ($0.05/$0.1) - 2023/03/27 20:23:38
Table 'RushAndCash28197055' 6-max Seat #1 is the button
Seat 1: Hero ($28.18 in chips)
Seat 2: 17936f02 ($10.05 in chips)
Seat 3: 9f599caa ($4.06 in chips)
Seat 4: e90061bc ($10.18 in chips)
Seat 5: c373ffff ($13.44 in chips)
Seat 6: 8c7035ae ($11.08 in chips)
17936f02: posts small blind $0.05
9f599caa: posts big blind $0.1
*** HOLE CARDS ***
Dealt to Hero [Ah 3d]
Dealt to 17936f02 
Dealt to 9f599caa 
Dealt to e90061bc 
Dealt to c373ffff 
Dealt to 8c7035ae 
e90061bc: raises $0.2 to $0.3
c373ffff: folds
8c7035ae: folds
Hero: folds
17936f02: folds
9f599caa: folds
Uncalled bet ($0.2) returned to e90061bc
*** SHOWDOWN ***
e90061bc collected $0.25 from pot
*** SUMMARY ***
Total pot $0.25 | Rake $0 | Jackpot $0 | Bingo $0 | Fortune $0
Seat 1: Hero (button) folded before Flop (didn't bet)
Seat 2: 17936f02 (small blind) folded before Flop
Seat 3: 9f599caa (big blind) folded before Flop
Seat 4: e90061bc collected ($0.25)
Seat 5: c373ffff folded before Flop (didn't bet)
Seat 6: 8c7035ae folded before Flop (didn't bet)


Poker Hand #RC1433461767: Hold'em No Limit  ($0.05/$0.1) - 2023/03/27 20:23:34
Table 'RushAndCash28197027' 6-max Seat #1 is the button
Seat 1: 27d009 ($10.78 in chips)
Seat 2: 21a2f42e ($26.68 in chips)
Seat 3: 399c1775 ($14.36 in chips)
Seat 4: Hero ($28.18 in chips)
Seat 5: 88fd491c ($14.33 in chips)
Seat 6: 2c7e7c9a ($19.32 in chips)
21a2f42e: posts small blind $0.05
399c1775: posts big blind $0.1
*** HOLE CARDS ***
Dealt to 27d009 
Dealt to 21a2f42e 
Dealt to 399c1775 
Dealt to Hero [6c Kd]
Dealt to 88fd491c 
Dealt to 2c7e7c9a 
Hero: folds
88fd491c: folds
2c7e7c9a: raises $0.14 to $0.24
27d009: raises $0.63 to $0.87
21a2f42e: folds
399c1775: folds
2c7e7c9a: calls $0.63
*** FLOP *** [8s Qs 6d]
2c7e7c9a: checks
27d009: bets $0.63
2c7e7c9a: raises $1.04 to $1.67
27d009: calls $1.04
*** TURN *** [8s Qs 6d] [Qc]
2c7e7c9a: bets $1.73
27d009: calls $1.73
*** RIVER *** [8s Qs 6d Qc] [5s]
2c7e7c9a: bets $15.05 and is all-in
27d009: calls $6.51 and is all-in
Uncalled bet ($8.54) returned to 2c7e7c9a
2c7e7c9a: shows [8h 8c] (Eights Full over Queens)
27d009: shows [As Qh] (Three Queens)
*** SHOWDOWN ***
2c7e7c9a collected $21.26 from pot
*** SUMMARY ***
Total pot $21.71 | Rake $0.3 | Jackpot $0.15 | Bingo $0 | Fortune $0
Board [8s Qs 6d Qc 5s]
Seat 1: 27d009 (button) showed [As Qh] and lost with Three Queens
Seat 2: 21a2f42e (small blind) folded before Flop
Seat 3: 399c1775 (big blind) folded before Flop
Seat 4: Hero folded before Flop (didn't bet)
Seat 5: 88fd491c folded before Flop (didn't bet)
Seat 6: 2c7e7c9a showed [8h 8c] and won ($21.26) with Eights Full over Queens


Poker Hand #RC1433461227: Hold'em No Limit  ($0.05/$0.1) - 2023/03/27 20:22:11
Table 'RushAndCash28196487' 6-max Seat #1 is the button
Seat 1: e02a8a20 ($5.79 in chips)
Seat 2: 82455445 ($9.28 in chips)
Seat 3: 21a2f42e ($28.23 in chips)
Seat 4: 8077ec64 ($10.5 in chips)
Seat 5: e4e5aa04 ($24.77 in chips)
Seat 6: Hero ($26.88 in chips)
82455445: posts small blind $0.05
21a2f42e: posts big blind $0.1
*** HOLE CARDS ***
Dealt to e02a8a20 
Dealt to 82455445 
Dealt to 21a2f42e 
Dealt to 8077ec64 
Dealt to e4e5aa04 
Dealt to Hero [4h Kh]
8077ec64: folds
e4e5aa04: folds
Hero: raises $0.15 to $0.25
e02a8a20: folds
82455445: folds
21a2f42e: calls $0.15
*** FLOP *** [4c 9s 4s]
21a2f42e: checks
Hero: bets $0.28
21a2f42e: raises $1.02 to $1.3
Hero: calls $1.02
*** TURN *** [4c 9s 4s] [Kc]
21a2f42e: checks
Hero: bets $2.42
21a2f42e: folds
Uncalled bet ($2.42) returned to Hero
*** SHOWDOWN ***
Hero collected $2.85 from pot
*** SUMMARY ***
Total pot $3.15 | Rake $0.15 | Jackpot $0.15 | Bingo $0 | Fortune $0
Board [4c 9s 4s Kc]
Seat 1: e02a8a20 (button) folded before Flop (didn't bet)
Seat 2: 82455445 (small blind) folded before Flop
Seat 3: 21a2f42e (big blind) folded on the Turn
Seat 4: 8077ec64 folded before Flop (didn't bet)
Seat 5: e4e5aa04 folded before Flop (didn't bet)
Seat 6: Hero won ($2.85)


Poker Hand #RC1433461090: Hold'em No Limit  ($0.05/$0.1) - 2023/03/27 20:21:51
Table 'RushAndCash28196350' 6-max Seat #1 is the button
Seat 1: 270d5a00 ($8.64 in chips)
Seat 2: 8639b271 ($12.53 in chips)
Seat 3: Hero ($26.98 in chips)
Seat 4: 2ef94abd ($8.07 in chips)
Seat 5: 2ef01b49 ($11.3 in chips)
Seat 6: baed1bcd ($16.5 in chips)
8639b271: posts small blind $0.05
Hero: posts big blind $0.1
*** HOLE CARDS ***
Dealt to 270d5a00 
Dealt to 8639b271 
Dealt to Hero [Jd 2s]
Dealt to 2ef94abd 
Dealt to 2ef01b49 
Dealt to baed1bcd 
2ef94abd: folds
2ef01b49: folds
baed1bcd: folds
270d5a00: folds
8639b271: raises $0.2 to $0.3
Hero: folds
Uncalled bet ($0.2) returned to 8639b271
*** SHOWDOWN ***
8639b271 collected $0.2 from pot
*** SUMMARY ***
Total pot $0.2 | Rake $0 | Jackpot $0 | Bingo $0 | Fortune $0
Seat 1: 270d5a00 (button) folded before Flop (didn't bet)
Seat 2: 8639b271 (small blind) collected ($0.2)
Seat 3: Hero (big blind) folded before Flop
Seat 4: 2ef94abd folded before Flop (didn't bet)
Seat 5: 2ef01b49 folded before Flop (didn't bet)
Seat 6: baed1bcd folded before Flop (didn't bet)


Poker Hand #RC1433461007: Hold'em No Limit  ($0.05/$0.1) - 2023/03/27 20:21:38
Table 'RushAndCash28196267' 6-max Seat #1 is the button
Seat 1: Hero ($26.98 in chips)
Seat 2: 8c7035ae ($12.53 in chips)
Seat 3: e9307344 ($9.77 in chips)
Seat 4: be87df52 ($16.67 in chips)
Seat 5: 79fb68ad ($22.02 in chips)
Seat 6: 4aed5ffa ($22.77 in chips)
8c7035ae: posts small blind $0.05
e9307344: posts big blind $0.1
*** HOLE CARDS ***
Dealt to Hero [2h Tc]
Dealt to 8c7035ae 
Dealt to e9307344 
Dealt to be87df52 
Dealt to 79fb68ad 
Dealt to 4aed5ffa 
be87df52: folds
79fb68ad: folds
4aed5ffa: folds
Hero: folds
8c7035ae: folds
Uncalled bet ($0.05) returned to e9307344
*** SHOWDOWN ***
e9307344 collected $0.1 from pot
*** SUMMARY ***
Total pot $0.1 | Rake $0 | Jackpot $0 | Bingo $0 | Fortune $0
Seat 1: Hero (button) folded before Flop (didn't bet)
Seat 2: 8c7035ae (small blind) folded before Flop
Seat 3: e9307344 (big blind) collected ($0.1)
Seat 4: be87df52 folded before Flop (didn't bet)
Seat 5: 79fb68ad folded before Flop (didn't bet)
Seat 6: 4aed5ffa folded before Flop (didn't bet)


Poker Hand #RC1433460861: Hold'em No Limit  ($0.05/$0.1) - 2023/03/27 20:21:17
Table 'RushAndCash28196121' 6-max Seat #1 is the button
Seat 1: 79fb68ad ($21.65 in chips)
Seat 2: e9307344 ($9.82 in chips)
Seat 3: 9dcd0fe9 ($17.71 in chips)
Seat 4: 3253ee1d ($20.66 in chips)
Seat 5: 4fccbb97 ($21.56 in chips)
Seat 6: Hero ($27.23 in chips)
e9307344: posts small blind $0.05
9dcd0fe9: posts big blind $0.1
*** HOLE CARDS ***
Dealt to 79fb68ad 
Dealt to e9307344 
Dealt to 9dcd0fe9 
Dealt to 3253ee1d 
Dealt to 4fccbb97 
Dealt to Hero [Ac 9h]
3253ee1d: folds
4fccbb97: folds
Hero: raises $0.15 to $0.25
79fb68ad: raises $0.59 to $0.84
e9307344: folds
9dcd0fe9: folds
Hero: folds
Uncalled bet ($0.59) returned to 79fb68ad
*** SHOWDOWN ***
79fb68ad collected $0.62 from pot
*** SUMMARY ***
Total pot $0.65 | Rake $0.03 | Jackpot $0 | Bingo $0 | Fortune $0
Seat 1: 79fb68ad (button) collected ($0.62)
Seat 2: e9307344 (small blind) folded before Flop
Seat 3: 9dcd0fe9 (big blind) folded before Flop
Seat 4: 3253ee1d folded before Flop (didn't bet)
Seat 5: 4fccbb97 folded before Flop (didn't bet)
Seat 6: Hero folded before Flop


Poker Hand #RC1433460388: Hold'em No Limit  ($0.05/$0.1) - 2023/03/27 20:20:11
Table 'RushAndCash28195648' 6-max Seat #1 is the button
Seat 1: Hero ($26.3 in chips)
Seat 2: 79fb68ad ($22.15 in chips)
Seat 3: f1e92832 ($6.1 in chips)
Seat 4: b5c2a326 ($12.35 in chips)
Seat 5: 5767ae8f ($15.47 in chips)
Seat 6: f7cc0300 ($11.13 in chips)
79fb68ad: posts small blind $0.05
f1e92832: posts big blind $0.1
*** HOLE CARDS ***
Dealt to Hero [3c As]
Dealt to 79fb68ad 
Dealt to f1e92832 
Dealt to b5c2a326 
Dealt to 5767ae8f 
Dealt to f7cc0300 
b5c2a326: folds
5767ae8f: folds
f7cc0300: folds
Hero: raises $0.15 to $0.25
79fb68ad: calls $0.2
f1e92832: calls $0.15
*** FLOP *** [Ac 4c 2d]
79fb68ad: checks
f1e92832: checks
Hero: bets $0.25
79fb68ad: calls $0.25
f1e92832: calls $0.25
*** TURN *** [Ac 4c 2d] [8h]
79fb68ad: checks
f1e92832: checks
Hero: checks
*** RIVER *** [Ac 4c 2d 8h] [4s]
79fb68ad: checks
f1e92832: checks
Hero: bets $0.35
79fb68ad: folds
f1e92832: folds
Uncalled bet ($0.35) returned to Hero
*** SHOWDOWN ***
Hero collected $1.43 from pot
*** SUMMARY ***
Total pot $1.5 | Rake $0.07 | Jackpot $0 | Bingo $0 | Fortune $0
Board [Ac 4c 2d 8h 4s]
Seat 1: Hero (button) won ($1.43)
Seat 2: 79fb68ad (small blind) folded on the River
Seat 3: f1e92832 (big blind) folded on the River
Seat 4: b5c2a326 folded before Flop (didn't bet)
Seat 5: 5767ae8f folded before Flop (didn't bet)
Seat 6: f7cc0300 folded before Flop (didn't bet)


Poker Hand #RC1433460172: Hold'em No Limit  ($0.05/$0.1) - 2023/03/27 20:19:42
Table 'RushAndCash28195432' 6-max Seat #1 is the button
Seat 1: 763a399f ($12.17 in chips)
Seat 2: b4bad238 ($10.11 in chips)
Seat 3: Hero ($26.4 in chips)
Seat 4: 6a0a729e ($10.7 in chips)
Seat 5: 5a7aae45 ($10.16 in chips)
Seat 6: 583c101c ($10 in chips)
b4bad238: posts small blind $0.05
Hero: posts big blind $0.1
*** HOLE CARDS ***
Dealt to 763a399f 
Dealt to b4bad238 
Dealt to Hero [5h 8d]
Dealt to 6a0a729e 
Dealt to 5a7aae45 
Dealt to 583c101c 
6a0a729e: raises $0.12 to $0.22
5a7aae45: folds
583c101c: folds
763a399f: calls $0.22
b4bad238: calls $0.17
Hero: folds
*** FLOP *** [8h Kd 4c]
b4bad238: checks
6a0a729e: checks
763a399f: checks
*** TURN *** [8h Kd 4c] [9c]
b4bad238: bets $0.55
6a0a729e: folds
763a399f: raises $1.35 to $1.9
b4bad238: calls $1.35
*** RIVER *** [8h Kd 4c 9c] [Ah]
b4bad238: checks
763a399f: checks
b4bad238: shows [7c 6c] (Ace-High)
763a399f: shows [Tc Jc] (Ace-High)
*** SHOWDOWN ***
763a399f collected $4.19 from pot
*** SUMMARY ***
Total pot $4.56 | Rake $0.22 | Jackpot $0.15 | Bingo $0 | Fortune $0
Board [8h Kd 4c 9c Ah]
Seat 1: 763a399f (button) showed [Tc Jc] and won ($4.19) with Ace-High
Seat 2: b4bad238 (small blind) showed [7c 6c] and lost with Ace-High
Seat 3: Hero (big blind) folded before Flop
Seat 4: 6a0a729e folded on the Turn
Seat 5: 5a7aae45 folded before Flop (didn't bet)
Seat 6: 583c101c folded before Flop (didn't bet)


Poker Hand #RC1433460131: Hold'em No Limit  ($0.05/$0.1) - 2023/03/27 20:19:35
Table 'RushAndCash28195391' 6-max Seat #1 is the button
Seat 1: a1b094d5 ($16.51 in chips)
Seat 2: 39e708ef ($13.04 in chips)
Seat 3: 3d7c56f6 ($10 in chips)
Seat 4: aa6656f4 ($29.19 in chips)
Seat 5: 6c1c848d ($17.03 in chips)
Seat 6: Hero ($26.4 in chips)
39e708ef: posts small blind $0.05
3d7c56f6: posts big blind $0.1
*** HOLE CARDS ***
Dealt to a1b094d5 
Dealt to 39e708ef 
Dealt to 3d7c56f6 
Dealt to aa6656f4 
Dealt to 6c1c848d 
Dealt to Hero [9c 7c]
aa6656f4: folds
6c1c848d: folds
Hero: folds
a1b094d5: folds
39e708ef: folds
Uncalled bet ($0.05) returned to 3d7c56f6
*** SHOWDOWN ***
3d7c56f6 collected $0.1 from pot
*** SUMMARY ***
Total pot $0.1 | Rake $0 | Jackpot $0 | Bingo $0 | Fortune $0
Seat 1: a1b094d5 (button) folded before Flop (didn't bet)
Seat 2: 39e708ef (small blind) folded before Flop
Seat 3: 3d7c56f6 (big blind) collected ($0.1)
Seat 4: aa6656f4 folded before Flop (didn't bet)
Seat 5: 6c1c848d folded before Flop (didn't bet)
Seat 6: Hero folded before Flop (didn't bet)


Poker Hand #RC1433460098: Hold'em No Limit  ($0.05/$0.1) - 2023/03/27 20:19:30
Table 'RushAndCash28195358' 6-max Seat #1 is the button
Seat 1: ca69069b ($10 in chips)
Seat 2: 18ba9fff ($32.2 in chips)
Seat 3: 20609e19 ($10.34 in chips)
Seat 4: Hero ($26.4 in chips)
Seat 5: d472cef2 ($6.47 in chips)
Seat 6: a0ee5955 ($27.56 in chips)
18ba9fff: posts small blind $0.05
20609e19: posts big blind $0.1
*** HOLE CARDS ***
Dealt to ca69069b 
Dealt to 18ba9fff 
Dealt to 20609e19 
Dealt to Hero [2h Qc]
Dealt to d472cef2 
Dealt to a0ee5955 
Hero: folds
d472cef2: folds
a0ee5955: raises $0.1 to $0.2
ca69069b: folds
18ba9fff: folds
20609e19: calls $0.1
*** FLOP *** [8d Kh 7d]
20609e19: checks
a0ee5955: bets $0.15
20609e19: raises $0.38 to $0.53
a0ee5955: folds
Uncalled bet ($0.38) returned to 20609e19
*** SHOWDOWN ***
20609e19 collected $0.72 from pot
*** SUMMARY ***
Total pot $0.75 | Rake $0.03 | Jackpot $0 | Bingo $0 | Fortune $0
Board [8d Kh 7d]
Seat 1: ca69069b (button) folded before Flop (didn't bet)
Seat 2: 18ba9fff (small blind) folded before Flop
Seat 3: 20609e19 (big blind) won ($0.72)
Seat 4: Hero folded before Flop (didn't bet)
Seat 5: d472cef2 folded before Flop (didn't bet)
Seat 6: a0ee5955 folded on the Flop


Poker Hand #RC1433460047: Hold'em No Limit  ($0.05/$0.1) - 2023/03/27 20:19:21
Table 'RushAndCash28195307' 6-max Seat #1 is the button
Seat 1: Hero ($26.4 in chips)
Seat 2: 4fccbb97 ($21.66 in chips)
Seat 3: 60945f94 ($9.95 in chips)
Seat 4: e72322fc ($4.32 in chips)
Seat 5: b4bad238 ($10.11 in chips)
Seat 6: 464ae544 ($7.4 in chips)
4fccbb97: posts small blind $0.05
60945f94: posts big blind $0.1
*** HOLE CARDS ***
Dealt to Hero [Tc 7c]
Dealt to 4fccbb97 
Dealt to 60945f94 
Dealt to e72322fc 
Dealt to b4bad238 
Dealt to 464ae544 
e72322fc: folds
b4bad238: folds
464ae544: folds
Hero: folds
4fccbb97: raises $0.15 to $0.25
60945f94: folds
Uncalled bet ($0.15) returned to 4fccbb97
*** SHOWDOWN ***
4fccbb97 collected $0.2 from pot
*** SUMMARY ***
Total pot $0.2 | Rake $0 | Jackpot $0 | Bingo $0 | Fortune $0
Seat 1: Hero (button) folded before Flop (didn't bet)
Seat 2: 4fccbb97 (small blind) collected ($0.2)
Seat 3: 60945f94 (big blind) folded before Flop
Seat 4: e72322fc folded before Flop (didn't bet)
Seat 5: b4bad238 folded before Flop (didn't bet)
Seat 6: 464ae544 folded before Flop (didn't bet)


Poker Hand #RC1433459877: Hold'em No Limit  ($0.05/$0.1) - 2023/03/27 20:18:55
Table 'RushAndCash28195137' 6-max Seat #1 is the button
Seat 1: Hero ($26.65 in chips)
Seat 2: b4bad238 ($9.79 in chips)
Seat 3: a3f62a8c ($16.02 in chips)
Seat 4: da68cebe ($19.69 in chips)
Seat 5: c682ccb4 ($77.96 in chips)
Seat 6: 21a2f42e ($34.14 in chips)
b4bad238: posts small blind $0.05
a3f62a8c: posts big blind $0.1
*** HOLE CARDS ***
Dealt to Hero [2c 2s]
Dealt to b4bad238 
Dealt to a3f62a8c 
Dealt to da68cebe 
Dealt to c682ccb4 
Dealt to 21a2f42e 
da68cebe: folds
c682ccb4: folds
21a2f42e: folds
Hero: raises $0.15 to $0.25
b4bad238: raises $0.89 to $1.14
a3f62a8c: folds
Hero: folds
Uncalled bet ($0.89) returned to b4bad238
*** SHOWDOWN ***
b4bad238 collected $0.57 from pot
*** SUMMARY ***
Total pot $0.6 | Rake $0.03 | Jackpot $0 | Bingo $0 | Fortune $0
Seat 1: Hero (button) folded before Flop
Seat 2: b4bad238 (small blind) collected ($0.57)
Seat 3: a3f62a8c (big blind) folded before Flop
Seat 4: da68cebe folded before Flop (didn't bet)
Seat 5: c682ccb4 folded before Flop (didn't bet)
Seat 6: 21a2f42e folded before Flop (didn't bet)


Poker Hand #RC1433459371: Hold'em No Limit  ($0.05/$0.1) - 2023/03/27 20:17:38
Table 'RushAndCash28194631' 6-max Seat #1 is the button
Seat 1: 379aabbf ($10.49 in chips)
Seat 2: Hero ($26.7 in chips)
Seat 3: b0948eea ($10 in chips)
Seat 4: bea8bef5 ($8.02 in chips)
Seat 5: 164e766a ($14.17 in chips)
Seat 6: 230aa3ae ($6.36 in chips)
Hero: posts small blind $0.05
b0948eea: posts big blind $0.1
*** HOLE CARDS ***
Dealt to 379aabbf 
Dealt to Hero [6d 5h]
Dealt to b0948eea 
Dealt to bea8bef5 
Dealt to 164e766a 
Dealt to 230aa3ae 
bea8bef5: folds
164e766a: folds
230aa3ae: folds
379aabbf: raises $0.1 to $0.2
Hero: folds
b0948eea: calls $0.1
*** FLOP *** [9c Kh Qd]
b0948eea: checks
379aabbf: checks
*** TURN *** [9c Kh Qd] [As]
b0948eea: bets $0.23
379aabbf: calls $0.23
*** RIVER *** [9c Kh Qd As] [2d]
b0948eea: checks
379aabbf: checks
b0948eea: shows [7s 8h] (Ace-High)
379aabbf: shows [3d Ah] (Pair of Aces)
*** SHOWDOWN ***
379aabbf collected $0.87 from pot
*** SUMMARY ***
Total pot $0.91 | Rake $0.04 | Jackpot $0 | Bingo $0 | Fortune $0
Board [9c Kh Qd As 2d]
Seat 1: 379aabbf (button) showed [3d Ah] and won ($0.87) with Pair of Aces
Seat 2: Hero (small blind) folded before Flop
Seat 3: b0948eea (big blind) showed [7s 8h] and lost with Ace-High
Seat 4: bea8bef5 folded before Flop (didn't bet)
Seat 5: 164e766a folded before Flop (didn't bet)
Seat 6: 230aa3ae folded before Flop (didn't bet)


Poker Hand #RC1433459340: Hold'em No Limit  ($0.05/$0.1) - 2023/03/27 20:17:34
Table 'RushAndCash28194600' 6-max Seat #1 is the button
Seat 1: 29316a1f ($10 in chips)
Seat 2: 51c800a1 ($22.6 in chips)
Seat 3: 55f9a3e1 ($9.5 in chips)
Seat 4: Hero ($26.7 in chips)
Seat 5: 784d04e2 ($10.89 in chips)
Seat 6: bea8bef5 ($8.02 in chips)
51c800a1: posts small blind $0.05
55f9a3e1: posts big blind $0.1
*** HOLE CARDS ***
Dealt to 29316a1f 
Dealt to 51c800a1 
Dealt to 55f9a3e1 
Dealt to Hero [7s 3h]
Dealt to 784d04e2 
Dealt to bea8bef5 
Hero: folds
784d04e2: folds
bea8bef5: folds
29316a1f: raises $0.15 to $0.25
51c800a1: folds
55f9a3e1: folds
Uncalled bet ($0.15) returned to 29316a1f
*** SHOWDOWN ***
29316a1f collected $0.25 from pot
*** SUMMARY ***
Total pot $0.25 | Rake $0 | Jackpot $0 | Bingo $0 | Fortune $0
Seat 1: 29316a1f (button) collected ($0.25)
Seat 2: 51c800a1 (small blind) folded before Flop
Seat 3: 55f9a3e1 (big blind) folded before Flop
Seat 4: Hero folded before Flop (didn't bet)
Seat 5: 784d04e2 folded before Flop (didn't bet)
Seat 6: bea8bef5 folded before Flop (didn't bet)


Poker Hand #RC1433459224: Hold'em No Limit  ($0.05/$0.1) - 2023/03/27 20:17:17
Table 'RushAndCash28194484' 6-max Seat #1 is the button
Seat 1: 25ac5c74 ($10.27 in chips)
Seat 2: 4e3792ac ($9.9 in chips)
Seat 3: Hero ($26.65 in chips)
Seat 4: 1d692ecd ($13.86 in chips)
Seat 5: 1ba2ec26 ($11.99 in chips)
Seat 6: 246e3643 ($10 in chips)
4e3792ac: posts small blind $0.05
Hero: posts big blind $0.1
*** HOLE CARDS ***
Dealt to 25ac5c74 
Dealt to 4e3792ac 
Dealt to Hero [Th As]
Dealt to 1d692ecd 
Dealt to 1ba2ec26 
Dealt to 246e3643 
1d692ecd: folds
1ba2ec26: folds
246e3643: folds
25ac5c74: folds
4e3792ac: folds
Uncalled bet ($0.05) returned to Hero
*** SHOWDOWN ***
Hero collected $0.1 from pot
*** SUMMARY ***
Total pot $0.1 | Rake $0 | Jackpot $0 | Bingo $0 | Fortune $0
Seat 1: 25ac5c74 (button) folded before Flop (didn't bet)
Seat 2: 4e3792ac (small blind) folded before Flop
Seat 3: Hero (big blind) collected ($0.1)
Seat 4: 1d692ecd folded before Flop (didn't bet)
Seat 5: 1ba2ec26 folded before Flop (didn't bet)
Seat 6: 246e3643 folded before Flop (didn't bet)


Poker Hand #RC1433459192: Hold'em No Limit  ($0.05/$0.1) - 2023/03/27 20:17:12
Table 'RushAndCash28194452' 6-max Seat #1 is the button
Seat 1: cd04c282 ($10.3 in chips)
Seat 2: 2ef94abd ($6.01 in chips)
Seat 3: b09ddf1e ($6.35 in chips)
Seat 4: 9d068308 ($36.05 in chips)
Seat 5: Hero ($26.65 in chips)
Seat 6: a0e140b7 ($20.01 in chips)
2ef94abd: posts small blind $0.05
b09ddf1e: posts big blind $0.1
*** HOLE CARDS ***
Dealt to cd04c282 
Dealt to 2ef94abd 
Dealt to b09ddf1e 
Dealt to 9d068308 
Dealt to Hero [Qc 2h]
Dealt to a0e140b7 
9d068308: folds
Hero: folds
a0e140b7: folds
cd04c282: raises $0.15 to $0.25
2ef94abd: folds
b09ddf1e: raises $0.42 to $0.67
cd04c282: calls $0.42
*** FLOP *** [6c Jh 4c]
b09ddf1e: bets $1.05
cd04c282: raises $1.85 to $2.9
b09ddf1e: raises $2.78 to $5.68 and is all-in
cd04c282: calls $2.78
b09ddf1e: shows [Ac 2c] (Ace-High)
cd04c282: shows [Ad Jc] (Pair of Jacks)
*** TURN *** [6c Jh 4c] [9c]
*** RIVER *** [6c Jh 4c 9c] [3c]
*** SHOWDOWN ***
b09ddf1e collected $12.3 from pot
*** SUMMARY ***
Total pot $12.75 | Rake $0.3 | Jackpot $0.15 | Bingo $0 | Fortune $0
Board [6c Jh 4c 9c 3c]
Seat 1: cd04c282 (button) showed [Ad Jc] and lost with Jack High Flush
Seat 2: 2ef94abd (small blind) folded before Flop
Seat 3: b09ddf1e (big blind) showed [Ac 2c] and won ($12.3) with Ace High Flush
Seat 4: 9d068308 folded before Flop (didn't bet)
Seat 5: Hero folded before Flop (didn't bet)
Seat 6: a0e140b7 folded before Flop (didn't bet)


Poker Hand #RC1433459140: Hold'em No Limit  ($0.05/$0.1) - 2023/03/27 20:17:04
Table 'RushAndCash28194400' 6-max Seat #1 is the button
Seat 1: 27eae22d ($8.06 in chips)
Seat 2: a98fbfab ($10 in chips)
Seat 3: 828d8dcf ($7.09 in chips)
Seat 4: cac5b3d4 ($10.37 in chips)
Seat 5: Hero ($26.65 in chips)
Seat 6: 8bc30a96 ($15.03 in chips)
a98fbfab: posts small blind $0.05
828d8dcf: posts big blind $0.1
*** HOLE CARDS ***
Dealt to 27eae22d 
Dealt to a98fbfab 
Dealt to 828d8dcf 
Dealt to cac5b3d4 
Dealt to Hero [3d 7s]
Dealt to 8bc30a96 
cac5b3d4: raises $0.1 to $0.2
Hero: folds
8bc30a96: folds
27eae22d: calls $0.2
a98fbfab: folds
828d8dcf: folds
*** FLOP *** [Ah 6h 9d]
cac5b3d4: bets $0.44
27eae22d: folds
Uncalled bet ($0.44) returned to cac5b3d4
*** SHOWDOWN ***
cac5b3d4 collected $0.53 from pot
*** SUMMARY ***
Total pot $0.55 | Rake $0.02 | Jackpot $0 | Bingo $0 | Fortune $0
Board [Ah 6h 9d]
Seat 1: 27eae22d (button) folded on the Flop
Seat 2: a98fbfab (small blind) folded before Flop
Seat 3: 828d8dcf (big blind) folded before Flop
Seat 4: cac5b3d4 won ($0.53)
Seat 5: Hero folded before Flop (didn't bet)
Seat 6: 8bc30a96 folded before Flop (didn't bet)


Poker Hand #RC1433459000: Hold'em No Limit  ($0.05/$0.1) - 2023/03/27 20:16:44
Table 'RushAndCash28194260' 6-max Seat #1 is the button
Seat 1: 11064df9 ($23.04 in chips)
Seat 2: Hero ($26.7 in chips)
Seat 3: baed1bcd ($11.58 in chips)
Seat 4: 87c29b4a ($10.83 in chips)
Seat 5: abf042fe ($10.32 in chips)
Seat 6: b07336c7 ($10.19 in chips)
Hero: posts small blind $0.05
baed1bcd: posts big blind $0.1
*** HOLE CARDS ***
Dealt to 11064df9 
Dealt to Hero [9d 3c]
Dealt to baed1bcd 
Dealt to 87c29b4a 
Dealt to abf042fe 
Dealt to b07336c7 
87c29b4a: folds
abf042fe: raises $0.2 to $0.3
b07336c7: folds
11064df9: folds
Hero: folds
baed1bcd: folds
Uncalled bet ($0.2) returned to abf042fe
*** SHOWDOWN ***
abf042fe collected $0.25 from pot
*** SUMMARY ***
Total pot $0.25 | Rake $0 | Jackpot $0 | Bingo $0 | Fortune $0
Seat 1: 11064df9 (button) folded before Flop (didn't bet)
Seat 2: Hero (small blind) folded before Flop
Seat 3: baed1bcd (big blind) folded before Flop
Seat 4: 87c29b4a folded before Flop (didn't bet)
Seat 5: abf042fe collected ($0.25)
Seat 6: b07336c7 folded before Flop (didn't bet)


Poker Hand #RC1433458820: Hold'em No Limit  ($0.05/$0.1) - 2023/03/27 20:16:21
Table 'RushAndCash28194080' 6-max Seat #1 is the button
Seat 1: 8077ec64 ($9.94 in chips)
Seat 2: d23ad8f1 ($10 in chips)
Seat 3: 86ee18a4 ($11.41 in chips)
Seat 4: a475074c ($10 in chips)
Seat 5: bb4dcf9b ($12.89 in chips)
Seat 6: Hero ($26.28 in chips)
d23ad8f1: posts small blind $0.05
86ee18a4: posts big blind $0.1
*** HOLE CARDS ***
Dealt to 8077ec64 
Dealt to d23ad8f1 
Dealt to 86ee18a4 
Dealt to a475074c 
Dealt to bb4dcf9b 
Dealt to Hero [Ah Kh]
a475074c: raises $0.2 to $0.3
bb4dcf9b: folds
Hero: raises $0.62 to $0.92
8077ec64: folds
d23ad8f1: folds
86ee18a4: folds
a475074c: folds
Uncalled bet ($0.62) returned to Hero
*** SHOWDOWN ***
Hero collected $0.72 from pot
*** SUMMARY ***
Total pot $0.75 | Rake $0.03 | Jackpot $0 | Bingo $0 | Fortune $0
Seat 1: 8077ec64 (button) folded before Flop (didn't bet)
Seat 2: d23ad8f1 (small blind) folded before Flop
Seat 3: 86ee18a4 (big blind) folded before Flop
Seat 4: a475074c folded before Flop
Seat 5: bb4dcf9b folded before Flop (didn't bet)
Seat 6: Hero collected ($0.72)


Poker Hand #RC1433458782: Hold'em No Limit  ($0.05/$0.1) - 2023/03/27 20:16:15
Table 'RushAndCash28194042' 6-max Seat #1 is the button
Seat 1: e9de9a9d ($11.62 in chips)
Seat 2: 6fbdaf69 ($11.88 in chips)
Seat 3: c123630d ($19.47 in chips)
Seat 4: ed75d67c ($15.51 in chips)
Seat 5: Hero ($26.28 in chips)
Seat 6: 5404c2cc ($10 in chips)
6fbdaf69: posts small blind $0.05
c123630d: posts big blind $0.1
*** HOLE CARDS ***
Dealt to e9de9a9d 
Dealt to 6fbdaf69 
Dealt to c123630d 
Dealt to ed75d67c 
Dealt to Hero [Th Qs]
Dealt to 5404c2cc 
ed75d67c: folds
Hero: folds
5404c2cc: raises $0.15 to $0.25
e9de9a9d: folds
6fbdaf69: calls $0.2
c123630d: folds
*** FLOP *** [3s Ks Jh]
6fbdaf69: checks
5404c2cc: bets $0.3
6fbdaf69: folds
Uncalled bet ($0.3) returned to 5404c2cc
*** SHOWDOWN ***
5404c2cc collected $0.57 from pot
*** SUMMARY ***
Total pot $0.6 | Rake $0.03 | Jackpot $0 | Bingo $0 | Fortune $0
Board [3s Ks Jh]
Seat 1: e9de9a9d (button) folded before Flop (didn't bet)
Seat 2: 6fbdaf69 (small blind) folded on the Flop
Seat 3: c123630d (big blind) folded before Flop
Seat 4: ed75d67c folded before Flop (didn't bet)
Seat 5: Hero folded before Flop (didn't bet)
Seat 6: 5404c2cc won ($0.57)


Poker Hand #RC1433458643: Hold'em No Limit  ($0.05/$0.1) - 2023/03/27 20:15:56
Table 'RushAndCash28193903' 6-max Seat #1 is the button
Seat 1: c331a369 ($9.42 in chips)
Seat 2: 514bd449 ($18.22 in chips)
Seat 3: Hero ($26.38 in chips)
Seat 4: 330b6b8b ($13.07 in chips)
Seat 5: 99f63284 ($11.07 in chips)
Seat 6: bd80dfd4 ($10.6 in chips)
514bd449: posts small blind $0.05
Hero: posts big blind $0.1
*** HOLE CARDS ***
Dealt to c331a369 
Dealt to 514bd449 
Dealt to Hero [5h 8d]
Dealt to 330b6b8b 
Dealt to 99f63284 
Dealt to bd80dfd4 
330b6b8b: folds
99f63284: folds
bd80dfd4: folds
c331a369: raises $0.2 to $0.3
514bd449: folds
Hero: folds
Uncalled bet ($0.2) returned to c331a369
*** SHOWDOWN ***
c331a369 collected $0.25 from pot
*** SUMMARY ***
Total pot $0.25 | Rake $0 | Jackpot $0 | Bingo $0 | Fortune $0
Seat 1: c331a369 (button) collected ($0.25)
Seat 2: 514bd449 (small blind) folded before Flop
Seat 3: Hero (big blind) folded before Flop
Seat 4: 330b6b8b folded before Flop (didn't bet)
Seat 5: 99f63284 folded before Flop (didn't bet)
Seat 6: bd80dfd4 folded before Flop (didn't bet)


Poker Hand #RC1433458602: Hold'em No Limit  ($0.05/$0.1) - 2023/03/27 20:15:51
Table 'RushAndCash28193862' 6-max Seat #1 is the button
Seat 1: 3d7c56f6 ($10 in chips)
Seat 2: 88fd491c ($15.47 in chips)
Seat 3: 2ef94abd ($6.13 in chips)
Seat 4: 1f39b23f ($8.39 in chips)
Seat 5: 85842513 ($1.86 in chips)
Seat 6: Hero ($26.38 in chips)
88fd491c: posts small blind $0.05
2ef94abd: posts big blind $0.1
*** HOLE CARDS ***
Dealt to 3d7c56f6 
Dealt to 88fd491c 
Dealt to 2ef94abd 
Dealt to 1f39b23f 
Dealt to 85842513 
Dealt to Hero [9c 3s]
1f39b23f: folds
85842513: folds
Hero: folds
3d7c56f6: folds
88fd491c: raises $0.2 to $0.3
2ef94abd: calls $0.2
*** FLOP *** [Th Qc 7s]
88fd491c: bets $0.3
2ef94abd: folds
Uncalled bet ($0.3) returned to 88fd491c
*** SHOWDOWN ***
88fd491c collected $0.57 from pot
*** SUMMARY ***
Total pot $0.6 | Rake $0.03 | Jackpot $0 | Bingo $0 | Fortune $0
Board [Th Qc 7s]
Seat 1: 3d7c56f6 (button) folded before Flop (didn't bet)
Seat 2: 88fd491c (small blind) won ($0.57)
Seat 3: 2ef94abd (big blind) folded on the Flop
Seat 4: 1f39b23f folded before Flop (didn't bet)
Seat 5: 85842513 folded before Flop (didn't bet)
Seat 6: Hero folded before Flop (didn't bet)


Poker Hand #RC1433458433: Hold'em No Limit  ($0.05/$0.1) - 2023/03/27 20:15:25
Table 'RushAndCash28193693' 6-max Seat #1 is the button
Seat 1: 92449c60 ($13.66 in chips)
Seat 2: 4eef219b ($10.96 in chips)
Seat 3: Hero ($26.33 in chips)
Seat 4: c1771d30 ($10.15 in chips)
Seat 5: cb21e9b0 ($19.11 in chips)
Seat 6: 80545bf8 ($51.45 in chips)
4eef219b: posts small blind $0.05
Hero: posts big blind $0.1
*** HOLE CARDS ***
Dealt to 92449c60 
Dealt to 4eef219b 
Dealt to Hero [Tc 7h]
Dealt to c1771d30 
Dealt to cb21e9b0 
Dealt to 80545bf8 
c1771d30: folds
cb21e9b0: folds
80545bf8: folds
92449c60: folds
4eef219b: folds
Uncalled bet ($0.05) returned to Hero
*** SHOWDOWN ***
Hero collected $0.1 from pot
*** SUMMARY ***
Total pot $0.1 | Rake $0 | Jackpot $0 | Bingo $0 | Fortune $0
Seat 1: 92449c60 (button) folded before Flop (didn't bet)
Seat 2: 4eef219b (small blind) folded before Flop
Seat 3: Hero (big blind) collected ($0.1)
Seat 4: c1771d30 folded before Flop (didn't bet)
Seat 5: cb21e9b0 folded before Flop (didn't bet)
Seat 6: 80545bf8 folded before Flop (didn't bet)


Poker Hand #RC1433458352: Hold'em No Limit  ($0.05/$0.1) - 2023/03/27 20:15:14
Table 'RushAndCash28193612' 6-max Seat #1 is the button
Seat 1: 6a6e1e5b ($9.95 in chips)
Seat 2: 41556f33 ($12.07 in chips)
Seat 3: f7cc0300 ($11.33 in chips)
Seat 4: Hero ($26.58 in chips)
Seat 5: 4b57e58e ($11.69 in chips)
Seat 6: 11e8a420 ($11.01 in chips)
41556f33: posts small blind $0.05
f7cc0300: posts big blind $0.1
*** HOLE CARDS ***
Dealt to 6a6e1e5b 
Dealt to 41556f33 
Dealt to f7cc0300 
Dealt to Hero [7c 6c]
Dealt to 4b57e58e 
Dealt to 11e8a420 
Hero: raises $0.15 to $0.25
4b57e58e: raises $0.65 to $0.9
11e8a420: folds
6a6e1e5b: folds
41556f33: calls $0.85
f7cc0300: raises $10.43 to $11.33 and is all-in
Hero: folds
4b57e58e: raises $0.36 to $11.69 and is all-in
41556f33: folds
Uncalled bet ($0.36) returned to 4b57e58e
4b57e58e: shows [Ah Kd]
f7cc0300: shows [Qd Qc]
*** FIRST FLOP *** [Jc 2d 9d]
*** FIRST TURN *** [Jc 2d 9d] [4h]
*** FIRST RIVER *** [Jc 2d 9d 4h] [2s]
*** SECOND FLOP *** [2c Ks 4s]
*** SECOND TURN *** [2c Ks 4s] [6d]
*** SECOND RIVER *** [2c Ks 4s 6d] [3h]
*** FIRST SHOWDOWN ***
f7cc0300 collected $11.68 from pot
*** SECOND SHOWDOWN ***
4b57e58e collected $11.68 from pot
*** SUMMARY ***
Total pot $23.81 | Rake $0.3 | Jackpot $0.15 | Bingo $0 | Fortune $0
Hand was run two times
FIRST Board [Jc 2d 9d 4h 2s]
SECOND Board [2c Ks 4s 6d 3h]
Seat 1: 6a6e1e5b (button) folded before Flop (didn't bet)
Seat 2: 41556f33 (small blind) folded before Flop
Seat 3: f7cc0300 (big blind) showed [Qd Qc] and won ($11.68) with Pair of Queens and Pair of Twos, and lost with Pair of Queens
Seat 4: Hero folded before Flop
Seat 5: 4b57e58e showed [Ah Kd] and lost with Pair of Twos, and won ($11.68) with Pair of Kings
Seat 6: 11e8a420 folded before Flop (didn't bet)


Poker Hand #RC1433458319: Hold'em No Limit  ($0.05/$0.1) - 2023/03/27 20:15:10
Table 'RushAndCash28193579' 6-max Seat #1 is the button
Seat 1: 3cb76d35 ($9 in chips)
Seat 2: abe66055 ($10.74 in chips)
Seat 3: f54264d3 ($10 in chips)
Seat 4: fab56f0f ($9.42 in chips)
Seat 5: 2797b5a1 ($9.97 in chips)
Seat 6: Hero ($26.58 in chips)
abe66055: posts small blind $0.05
f54264d3: posts big blind $0.1
*** HOLE CARDS ***
Dealt to 3cb76d35 
Dealt to abe66055 
Dealt to f54264d3 
Dealt to fab56f0f 
Dealt to 2797b5a1 
Dealt to Hero [2s Ah]
fab56f0f: folds
2797b5a1: folds
Hero: folds
3cb76d35: folds
abe66055: folds
Uncalled bet ($0.05) returned to f54264d3
*** SHOWDOWN ***
f54264d3 collected $0.1 from pot
*** SUMMARY ***
Total pot $0.1 | Rake $0 | Jackpot $0 | Bingo $0 | Fortune $0
Seat 1: 3cb76d35 (button) folded before Flop (didn't bet)
Seat 2: abe66055 (small blind) folded before Flop
Seat 3: f54264d3 (big blind) collected ($0.1)
Seat 4: fab56f0f folded before Flop (didn't bet)
Seat 5: 2797b5a1 folded before Flop (didn't bet)
Seat 6: Hero folded before Flop (didn't bet)


Poker Hand #RC1433458287: Hold'em No Limit  ($0.05/$0.1) - 2023/03/27 20:15:05
Table 'RushAndCash28193547' 6-max Seat #1 is the button
Seat 1: d4c108e2 ($19.16 in chips)
Seat 2: c41e3be6 ($10.56 in chips)
Seat 3: Hero ($26.68 in chips)
Seat 4: ca60576f ($11.3 in chips)
Seat 5: e31d985e ($9.95 in chips)
Seat 6: 8642adeb ($10 in chips)
c41e3be6: posts small blind $0.05
Hero: posts big blind $0.1
*** HOLE CARDS ***
Dealt to d4c108e2 
Dealt to c41e3be6 
Dealt to Hero [5d 7d]
Dealt to ca60576f 
Dealt to e31d985e 
Dealt to 8642adeb 
ca60576f: folds
e31d985e: raises $0.12 to $0.22
8642adeb: folds
d4c108e2: folds
c41e3be6: raises $0.68 to $0.9
Hero: folds
e31d985e: folds
Uncalled bet ($0.68) returned to c41e3be6
*** SHOWDOWN ***
c41e3be6 collected $0.52 from pot
*** SUMMARY ***
Total pot $0.54 | Rake $0.02 | Jackpot $0 | Bingo $0 | Fortune $0
Seat 1: d4c108e2 (button) folded before Flop (didn't bet)
Seat 2: c41e3be6 (small blind) collected ($0.52)
Seat 3: Hero (big blind) folded before Flop
Seat 4: ca60576f folded before Flop (didn't bet)
Seat 5: e31d985e folded before Flop
Seat 6: 8642adeb folded before Flop (didn't bet)


Poker Hand #RC1433458214: Hold'em No Limit  ($0.05/$0.1) - 2023/03/27 20:14:56
Table 'RushAndCash28193474' 6-max Seat #1 is the button
Seat 1: ca60576f ($11.3 in chips)
Seat 2: Hero ($26.73 in chips)
Seat 3: a69f0c5a ($10.13 in chips)
Seat 4: 1625034d ($4.74 in chips)
Seat 5: d7795b7 ($10.15 in chips)
Seat 6: 86ee18a4 ($11.41 in chips)
Hero: posts small blind $0.05
a69f0c5a: posts big blind $0.1
*** HOLE CARDS ***
Dealt to ca60576f 
Dealt to Hero [2s 2c]
Dealt to a69f0c5a 
Dealt to 1625034d 
Dealt to d7795b7 
Dealt to 86ee18a4 
1625034d: folds
d7795b7: folds
86ee18a4: raises $0.2 to $0.3
ca60576f: folds
Hero: folds
a69f0c5a: folds
Uncalled bet ($0.2) returned to 86ee18a4
*** SHOWDOWN ***
86ee18a4 collected $0.25 from pot
*** SUMMARY ***
Total pot $0.25 | Rake $0 | Jackpot $0 | Bingo $0 | Fortune $0
Seat 1: ca60576f (button) folded before Flop (didn't bet)
Seat 2: Hero (small blind) folded before Flop
Seat 3: a69f0c5a (big blind) folded before Flop
Seat 4: 1625034d folded before Flop (didn't bet)
Seat 5: d7795b7 folded before Flop (didn't bet)
Seat 6: 86ee18a4 collected ($0.25)


Poker Hand #RC1433458176: Hold'em No Limit  ($0.05/$0.1) - 2023/03/27 20:14:50
Table 'RushAndCash28193436' 6-max Seat #1 is the button
Seat 1: 11b64430 ($14.73 in chips)
Seat 2: 953f7ad2 ($27.21 in chips)
Seat 3: 464ae544 ($7.98 in chips)
Seat 4: dee5b20c ($21.52 in chips)
Seat 5: Hero ($26.73 in chips)
Seat 6: 3d7c56f6 ($10 in chips)
953f7ad2: posts small blind $0.05
464ae544: posts big blind $0.1
*** HOLE CARDS ***
Dealt to 11b64430 
Dealt to 953f7ad2 
Dealt to 464ae544 
Dealt to dee5b20c 
Dealt to Hero [7c 2h]
Dealt to 3d7c56f6 
dee5b20c: folds
Hero: folds
3d7c56f6: raises $0.2 to $0.3
11b64430: raises $0.57 to $0.87
953f7ad2: folds
464ae544: folds
3d7c56f6: folds
Uncalled bet ($0.57) returned to 11b64430
*** SHOWDOWN ***
11b64430 collected $0.72 from pot
*** SUMMARY ***
Total pot $0.75 | Rake $0.03 | Jackpot $0 | Bingo $0 | Fortune $0
Seat 1: 11b64430 (button) collected ($0.72)
Seat 2: 953f7ad2 (small blind) folded before Flop
Seat 3: 464ae544 (big blind) folded before Flop
Seat 4: dee5b20c folded before Flop (didn't bet)
Seat 5: Hero folded before Flop (didn't bet)
Seat 6: 3d7c56f6 folded before Flop


Poker Hand #RC1433458053: Hold'em No Limit  ($0.05/$0.1) - 2023/03/27 20:14:33
Table 'RushAndCash28193313' 6-max Seat #1 is the button
Seat 1: Hero ($26.58 in chips)
Seat 2: c123630d ($21.14 in chips)
Seat 3: 5767ae8f ($13.35 in chips)
Seat 4: 72a16786 ($13.16 in chips)
Seat 5: 4af1e37c ($15.32 in chips)
Seat 6: 26cf3037 ($10.27 in chips)
c123630d: posts small blind $0.05
5767ae8f: posts big blind $0.1
*** HOLE CARDS ***
Dealt to Hero [Ac Td]
Dealt to c123630d 
Dealt to 5767ae8f 
Dealt to 72a16786 
Dealt to 4af1e37c 
Dealt to 26cf3037 
72a16786: folds
4af1e37c: folds
26cf3037: folds
Hero: raises $0.15 to $0.25
c123630d: folds
5767ae8f: folds
Uncalled bet ($0.15) returned to Hero
*** SHOWDOWN ***
Hero collected $0.25 from pot
*** SUMMARY ***
Total pot $0.25 | Rake $0 | Jackpot $0 | Bingo $0 | Fortune $0
Seat 1: Hero (button) collected ($0.25)
Seat 2: c123630d (small blind) folded before Flop
Seat 3: 5767ae8f (big blind) folded before Flop
Seat 4: 72a16786 folded before Flop (didn't bet)
Seat 5: 4af1e37c folded before Flop (didn't bet)
Seat 6: 26cf3037 folded before Flop (didn't bet)


Poker Hand #RC1433458019: Hold'em No Limit  ($0.05/$0.1) - 2023/03/27 20:14:28
Table 'RushAndCash28193279' 6-max Seat #1 is the button
Seat 1: 8030373d ($14.89 in chips)
Seat 2: 80545bf8 ($51.4 in chips)
Seat 3: 8c326938 ($10.76 in chips)
Seat 4: e1445558 ($10 in chips)
Seat 5: 5404c2cc ($10.15 in chips)
Seat 6: Hero ($26.58 in chips)
80545bf8: posts small blind $0.05
8c326938: posts big blind $0.1
*** HOLE CARDS ***
Dealt to 8030373d 
Dealt to 80545bf8 
Dealt to 8c326938 
Dealt to e1445558 
Dealt to 5404c2cc 
Dealt to Hero [4s 6d]
e1445558: folds
5404c2cc: folds
Hero: folds
8030373d: folds
80545bf8: folds
Uncalled bet ($0.05) returned to 8c326938
*** SHOWDOWN ***
8c326938 collected $0.1 from pot
*** SUMMARY ***
Total pot $0.1 | Rake $0 | Jackpot $0 | Bingo $0 | Fortune $0
Seat 1: 8030373d (button) folded before Flop (didn't bet)
Seat 2: 80545bf8 (small blind) folded before Flop
Seat 3: 8c326938 (big blind) collected ($0.1)
Seat 4: e1445558 folded before Flop (didn't bet)
Seat 5: 5404c2cc folded before Flop (didn't bet)
Seat 6: Hero folded before Flop (didn't bet)


Poker Hand #RC1433457978: Hold'em No Limit  ($0.05/$0.1) - 2023/03/27 20:14:23
Table 'RushAndCash28193238' 6-max Seat #1 is the button
Seat 1: 17e7697a ($40.25 in chips)
Seat 2: a318c355 ($10.05 in chips)
Seat 3: 7720e09f ($8.02 in chips)
Seat 4: 72a16786 ($13.16 in chips)
Seat 5: Hero ($26.58 in chips)
Seat 6: e02a8a20 ($5.07 in chips)
a318c355: posts small blind $0.05
7720e09f: posts big blind $0.1
*** HOLE CARDS ***
Dealt to 17e7697a 
Dealt to a318c355 
Dealt to 7720e09f 
Dealt to 72a16786 
Dealt to Hero [2h Qd]
Dealt to e02a8a20 
72a16786: folds
Hero: folds
e02a8a20: folds
17e7697a: folds
a318c355: folds
Uncalled bet ($0.05) returned to 7720e09f
*** SHOWDOWN ***
7720e09f collected $0.1 from pot
*** SUMMARY ***
Total pot $0.1 | Rake $0 | Jackpot $0 | Bingo $0 | Fortune $0
Seat 1: 17e7697a (button) folded before Flop (didn't bet)
Seat 2: a318c355 (small blind) folded before Flop
Seat 3: 7720e09f (big blind) collected ($0.1)
Seat 4: 72a16786 folded before Flop (didn't bet)
Seat 5: Hero folded before Flop (didn't bet)
Seat 6: e02a8a20 folded before Flop (didn't bet)


Poker Hand #RC1433457938: Hold'em No Limit  ($0.05/$0.1) - 2023/03/27 20:14:17
Table 'RushAndCash28193198' 6-max Seat #1 is the button
Seat 1: 4bb05da3 ($9.84 in chips)
Seat 2: 93f4b839 ($13.01 in chips)
Seat 3: 3414e1fc ($15 in chips)
Seat 4: d9ae4646 ($10.51 in chips)
Seat 5: 11064df9 ($23.78 in chips)
Seat 6: Hero ($26.58 in chips)
93f4b839: posts small blind $0.05
3414e1fc: posts big blind $0.1
*** HOLE CARDS ***
Dealt to 4bb05da3 
Dealt to 93f4b839 
Dealt to 3414e1fc 
Dealt to d9ae4646 
Dealt to 11064df9 
Dealt to Hero [6s Js]
d9ae4646: folds
11064df9: folds
Hero: folds
4bb05da3: folds
93f4b839: folds
Uncalled bet ($0.05) returned to 3414e1fc
*** SHOWDOWN ***
3414e1fc collected $0.1 from pot
*** SUMMARY ***
Total pot $0.1 | Rake $0 | Jackpot $0 | Bingo $0 | Fortune $0
Seat 1: 4bb05da3 (button) folded before Flop (didn't bet)
Seat 2: 93f4b839 (small blind) folded before Flop
Seat 3: 3414e1fc (big blind) collected ($0.1)
Seat 4: d9ae4646 folded before Flop (didn't bet)
Seat 5: 11064df9 folded before Flop (didn't bet)
Seat 6: Hero folded before Flop (didn't bet)


Poker Hand #RC1433457889: Hold'em No Limit  ($0.05/$0.1) - 2023/03/27 20:14:10
Table 'RushAndCash28193149' 6-max Seat #1 is the button
Seat 1: 8c326938 ($10.76 in chips)
Seat 2: Hero ($26.63 in chips)
Seat 3: 522e6aae ($58.55 in chips)
Seat 4: 3723f382 ($10.61 in chips)
Seat 5: ff32a000 ($10.15 in chips)
Seat 6: 6f2108de ($10 in chips)
Hero: posts small blind $0.05
522e6aae: posts big blind $0.1
*** HOLE CARDS ***
Dealt to 8c326938 
Dealt to Hero [6s 8h]
Dealt to 522e6aae 
Dealt to 3723f382 
Dealt to ff32a000 
Dealt to 6f2108de 
3723f382: raises $0.15 to $0.25
ff32a000: folds
6f2108de: folds
8c326938: folds
Hero: folds
522e6aae: folds
Uncalled bet ($0.15) returned to 3723f382
*** SHOWDOWN ***
3723f382 collected $0.25 from pot
*** SUMMARY ***
Total pot $0.25 | Rake $0 | Jackpot $0 | Bingo $0 | Fortune $0
Seat 1: 8c326938 (button) folded before Flop (didn't bet)
Seat 2: Hero (small blind) folded before Flop
Seat 3: 522e6aae (big blind) folded before Flop
Seat 4: 3723f382 collected ($0.25)
Seat 5: ff32a000 folded before Flop (didn't bet)
Seat 6: 6f2108de folded before Flop (didn't bet)


Poker Hand #RC1433457729: Hold'em No Limit  ($0.05/$0.1) - 2023/03/27 20:13:48
Table 'RushAndCash28192989' 6-max Seat #1 is the button
Seat 1: fd065037 ($10.96 in chips)
Seat 2: bd6e360d ($10 in chips)
Seat 3: Hero ($26.73 in chips)
Seat 4: f0e39b8f ($13.3 in chips)
Seat 5: 67cfc163 ($33.9 in chips)
Seat 6: 784d04e2 ($10 in chips)
bd6e360d: posts small blind $0.05
Hero: posts big blind $0.1
*** HOLE CARDS ***
Dealt to fd065037 
Dealt to bd6e360d 
Dealt to Hero [Js 3c]
Dealt to f0e39b8f 
Dealt to 67cfc163 
Dealt to 784d04e2 
f0e39b8f: folds
67cfc163: folds
784d04e2: folds
fd065037: raises $0.15 to $0.25
bd6e360d: calls $0.2
Hero: folds
*** FLOP *** [9d Ks 7d]
bd6e360d: checks
fd065037: bets $0.2
bd6e360d: calls $0.2
*** TURN *** [9d Ks 7d] [Kc]
bd6e360d: checks
fd065037: bets $0.5
bd6e360d: calls $0.5
*** RIVER *** [9d Ks 7d Kc] [Qs]
bd6e360d: checks
fd065037: checks
bd6e360d: shows [5d 4d] (Pair of Kings)
fd065037: shows [As 9c] (Pair of Kings and Pair of Nines)
*** SHOWDOWN ***
fd065037 collected $1.9 from pot
*** SUMMARY ***
Total pot $2 | Rake $0.1 | Jackpot $0 | Bingo $0 | Fortune $0
Board [9d Ks 7d Kc Qs]
Seat 1: fd065037 (button) showed [As 9c] and won ($1.9) with Pair of Kings and Pair of Nines
Seat 2: bd6e360d (small blind) showed [5d 4d] and lost with Pair of Kings
Seat 3: Hero (big blind) folded before Flop
Seat 4: f0e39b8f folded before Flop (didn't bet)
Seat 5: 67cfc163 folded before Flop (didn't bet)
Seat 6: 784d04e2 folded before Flop (didn't bet)


Poker Hand #RC1433457694: Hold'em No Limit  ($0.05/$0.1) - 2023/03/27 20:13:43
Table 'RushAndCash28192954' 6-max Seat #1 is the button
Seat 1: Hero ($26.73 in chips)
Seat 2: 1d0d4208 ($10.86 in chips)
Seat 3: 9e9bf69d ($10.45 in chips)
Seat 4: 536906d5 ($12.03 in chips)
Seat 5: d472cef2 ($7.68 in chips)
Seat 6: e90061bc ($11.08 in chips)
1d0d4208: posts small blind $0.05
9e9bf69d: posts big blind $0.1
*** HOLE CARDS ***
Dealt to Hero [7s 4h]
Dealt to 1d0d4208 
Dealt to 9e9bf69d 
Dealt to 536906d5 
Dealt to d472cef2 
Dealt to e90061bc 
536906d5: folds
d472cef2: folds
e90061bc: folds
Hero: folds
1d0d4208: raises $0.2 to $0.3
9e9bf69d: folds
Uncalled bet ($0.2) returned to 1d0d4208
*** SHOWDOWN ***
1d0d4208 collected $0.2 from pot
*** SUMMARY ***
Total pot $0.2 | Rake $0 | Jackpot $0 | Bingo $0 | Fortune $0
Seat 1: Hero (button) folded before Flop (didn't bet)
Seat 2: 1d0d4208 (small blind) collected ($0.2)
Seat 3: 9e9bf69d (big blind) folded before Flop
Seat 4: 536906d5 folded before Flop (didn't bet)
Seat 5: d472cef2 folded before Flop (didn't bet)
Seat 6: e90061bc folded before Flop (didn't bet)


Poker Hand #RC1433457636: Hold'em No Limit  ($0.05/$0.1) - 2023/03/27 20:13:36
Table 'RushAndCash28192896' 6-max Seat #1 is the button
Seat 1: 2ab5be71 ($11.02 in chips)
Seat 2: 2ac8e9fd ($14.32 in chips)
Seat 3: Hero ($26.83 in chips)
Seat 4: c1512d63 ($17.45 in chips)
Seat 5: c6867e9e ($14.55 in chips)
Seat 6: 4fccbb97 ($19.34 in chips)
2ac8e9fd: posts small blind $0.05
Hero: posts big blind $0.1
*** HOLE CARDS ***
Dealt to 2ab5be71 
Dealt to 2ac8e9fd 
Dealt to Hero [Ad 5c]
Dealt to c1512d63 
Dealt to c6867e9e 
Dealt to 4fccbb97 
c1512d63: folds
c6867e9e: folds
4fccbb97: raises $0.15 to $0.25
2ab5be71: folds
2ac8e9fd: folds
Hero: folds
Uncalled bet ($0.15) returned to 4fccbb97
*** SHOWDOWN ***
4fccbb97 collected $0.25 from pot
*** SUMMARY ***
Total pot $0.25 | Rake $0 | Jackpot $0 | Bingo $0 | Fortune $0
Seat 1: 2ab5be71 (button) folded before Flop (didn't bet)
Seat 2: 2ac8e9fd (small blind) folded before Flop
Seat 3: Hero (big blind) folded before Flop
Seat 4: c1512d63 folded before Flop (didn't bet)
Seat 5: c6867e9e folded before Flop (didn't bet)
Seat 6: 4fccbb97 collected ($0.25)


Poker Hand #RC1433457458: Hold'em No Limit  ($0.05/$0.1) - 2023/03/27 20:13:11
Table 'RushAndCash28192718' 6-max Seat #1 is the button
Seat 1: Hero ($26.83 in chips)
Seat 2: a38464e2 ($24.63 in chips)
Seat 3: 953f7ad2 ($26.69 in chips)
Seat 4: 3c50d518 ($10.4 in chips)
Seat 5: 7cd65afb ($20.79 in chips)
Seat 6: cccff941 ($10 in chips)
a38464e2: posts small blind $0.05
953f7ad2: posts big blind $0.1
*** HOLE CARDS ***
Dealt to Hero [2s 3c]
Dealt to a38464e2 
Dealt to 953f7ad2 
Dealt to 3c50d518 
Dealt to 7cd65afb 
Dealt to cccff941 
3c50d518: folds
7cd65afb: folds
cccff941: folds
Hero: folds
a38464e2: folds
Uncalled bet ($0.05) returned to 953f7ad2
*** SHOWDOWN ***
953f7ad2 collected $0.1 from pot
*** SUMMARY ***
Total pot $0.1 | Rake $0 | Jackpot $0 | Bingo $0 | Fortune $0
Seat 1: Hero (button) folded before Flop (didn't bet)
Seat 2: a38464e2 (small blind) folded before Flop
Seat 3: 953f7ad2 (big blind) collected ($0.1)
Seat 4: 3c50d518 folded before Flop (didn't bet)
Seat 5: 7cd65afb folded before Flop (didn't bet)
Seat 6: cccff941 folded before Flop (didn't bet)


Poker Hand #RC1433457425: Hold'em No Limit  ($0.05/$0.1) - 2023/03/27 20:13:06
Table 'RushAndCash28192685' 6-max Seat #1 is the button
Seat 1: 1d692ecd ($22.94 in chips)
Seat 2: fe1e23ee ($10 in chips)
Seat 3: 5cd5006b ($8.11 in chips)
Seat 4: Hero ($26.83 in chips)
Seat 5: be87df52 ($12.89 in chips)
Seat 6: ff633e ($9.27 in chips)
fe1e23ee: posts small blind $0.05
5cd5006b: posts big blind $0.1
*** HOLE CARDS ***
Dealt to 1d692ecd 
Dealt to fe1e23ee 
Dealt to 5cd5006b 
Dealt to Hero [4d 7h]
Dealt to be87df52 
Dealt to ff633e 
Hero: folds
be87df52: folds
ff633e: raises $0.1 to $0.2
1d692ecd: calls $0.2
fe1e23ee: folds
5cd5006b: calls $0.1
*** FLOP *** [2d 5s 5h]
5cd5006b: checks
ff633e: checks
1d692ecd: bets $0.35
5cd5006b: calls $0.35
ff633e: folds
*** TURN *** [2d 5s 5h] [Kd]
5cd5006b: checks
1d692ecd: checks
*** RIVER *** [2d 5s 5h Kd] [Qc]
5cd5006b: bets $0.68
1d692ecd: raises $1.62 to $2.3
5cd5006b: folds
Uncalled bet ($1.62) returned to 1d692ecd
*** SHOWDOWN ***
1d692ecd collected $2.58 from pot
*** SUMMARY ***
Total pot $2.71 | Rake $0.13 | Jackpot $0 | Bingo $0 | Fortune $0
Board [2d 5s 5h Kd Qc]
Seat 1: 1d692ecd (button) won ($2.58)
Seat 2: fe1e23ee (small blind) folded before Flop
Seat 3: 5cd5006b (big blind) folded on the River
Seat 4: Hero folded before Flop (didn't bet)
Seat 5: be87df52 folded before Flop (didn't bet)
Seat 6: ff633e folded on the Flop


Poker Hand #RC1433457323: Hold'em No Limit  ($0.05/$0.1) - 2023/03/27 20:12:51
Table 'RushAndCash28192583' 6-max Seat #1 is the button
Seat 1: 8caece8f ($11.14 in chips)
Seat 2: Hero ($26.88 in chips)
Seat 3: 7f20c0fb ($10 in chips)
Seat 4: e2b2cf58 ($10.07 in chips)
Seat 5: 276936c5 ($18.58 in chips)
Seat 6: 8c326938 ($10.18 in chips)
Hero: posts small blind $0.05
7f20c0fb: posts big blind $0.1
*** HOLE CARDS ***
Dealt to 8caece8f 
Dealt to Hero [Ad 6s]
Dealt to 7f20c0fb 
Dealt to e2b2cf58 
Dealt to 276936c5 
Dealt to 8c326938 
e2b2cf58: folds
276936c5: raises $0.15 to $0.25
8c326938: folds
8caece8f: raises $0.65 to $0.9
Hero: folds
7f20c0fb: folds
276936c5: folds
Uncalled bet ($0.65) returned to 8caece8f
*** SHOWDOWN ***
8caece8f collected $0.62 from pot
*** SUMMARY ***
Total pot $0.65 | Rake $0.03 | Jackpot $0 | Bingo $0 | Fortune $0
Seat 1: 8caece8f (button) collected ($0.62)
Seat 2: Hero (small blind) folded before Flop
Seat 3: 7f20c0fb (big blind) folded before Flop
Seat 4: e2b2cf58 folded before Flop (didn't bet)
Seat 5: 276936c5 folded before Flop
Seat 6: 8c326938 folded before Flop (didn't bet)


Poker Hand #RC1433457219: Hold'em No Limit  ($0.05/$0.1) - 2023/03/27 20:12:35
Table 'RushAndCash28192479' 6-max Seat #1 is the button
Seat 1: 23e44a77 ($10.32 in chips)
Seat 2: fab56f0f ($11.86 in chips)
Seat 3: fb770538 ($20.75 in chips)
Seat 4: fffa798a ($18.79 in chips)
Seat 5: Hero ($26.88 in chips)
Seat 6: 5f35b8c0 ($9.89 in chips)
fab56f0f: posts small blind $0.05
fb770538: posts big blind $0.1
*** HOLE CARDS ***
Dealt to 23e44a77 
Dealt to fab56f0f 
Dealt to fb770538 
Dealt to fffa798a 
Dealt to Hero [Td 9c]
Dealt to 5f35b8c0 
fffa798a: folds
Hero: folds
5f35b8c0: raises $0.15 to $0.25
23e44a77: folds
fab56f0f: calls $0.2
fb770538: calls $0.15
*** FLOP *** [9d Qh 8d]
fab56f0f: checks
fb770538: checks
5f35b8c0: bets $0.6
fab56f0f: calls $0.6
fb770538: folds
*** TURN *** [9d Qh 8d] [5h]
fab56f0f: checks
5f35b8c0: bets $1.29
fab56f0f: calls $1.29
*** RIVER *** [9d Qh 8d 5h] [5d]
fab56f0f: checks
5f35b8c0: checks
fab56f0f: shows [As 9s] (Pair of Nines and Pair of Fives)
5f35b8c0: shows [Ah Qs] (Pair of Queens and Pair of Fives)
*** SHOWDOWN ***
5f35b8c0 collected $4.17 from pot
*** SUMMARY ***
Total pot $4.53 | Rake $0.21 | Jackpot $0.15 | Bingo $0 | Fortune $0
Board [9d Qh 8d 5h 5d]
Seat 1: 23e44a77 (button) folded before Flop (didn't bet)
Seat 2: fab56f0f (small blind) showed [As 9s] and lost with Pair of Nines and Pair of Fives
Seat 3: fb770538 (big blind) folded on the Flop
Seat 4: fffa798a folded before Flop (didn't bet)
Seat 5: Hero folded before Flop (didn't bet)
Seat 6: 5f35b8c0 showed [Ah Qs] and won ($4.17) with Pair of Queens and Pair of Fives


Poker Hand #RC1433457022: Hold'em No Limit  ($0.05/$0.1) - 2023/03/27 20:12:06
Table 'RushAndCash28192282' 6-max Seat #1 is the button
Seat 1: d775ce74 ($12.27 in chips)
Seat 2: 23e44a77 ($10 in chips)
Seat 3: d23ad8f1 ($11.95 in chips)
Seat 4: ea7c7ea0 ($12.6 in chips)
Seat 5: Hero ($27.13 in chips)
Seat 6: e825b3a6 ($11.69 in chips)
23e44a77: posts small blind $0.05
d23ad8f1: posts big blind $0.1
*** HOLE CARDS ***
Dealt to d775ce74 
Dealt to 23e44a77 
Dealt to d23ad8f1 
Dealt to ea7c7ea0 
Dealt to Hero [Qs Jd]
Dealt to e825b3a6 
ea7c7ea0: folds
Hero: raises $0.15 to $0.25
e825b3a6: folds
d775ce74: folds
23e44a77: raises $0.85 to $1.1
d23ad8f1: folds
Hero: folds
Uncalled bet ($0.85) returned to 23e44a77
*** SHOWDOWN ***
23e44a77 collected $0.57 from pot
*** SUMMARY ***
Total pot $0.6 | Rake $0.03 | Jackpot $0 | Bingo $0 | Fortune $0
Seat 1: d775ce74 (button) folded before Flop (didn't bet)
Seat 2: 23e44a77 (small blind) collected ($0.57)
Seat 3: d23ad8f1 (big blind) folded before Flop
Seat 4: ea7c7ea0 folded before Flop (didn't bet)
Seat 5: Hero folded before Flop
Seat 6: e825b3a6 folded before Flop (didn't bet)


Poker Hand #RC1433456986: Hold'em No Limit  ($0.05/$0.1) - 2023/03/27 20:12:01
Table 'RushAndCash28192246' 6-max Seat #1 is the button
Seat 1: c20fb006 ($23.53 in chips)
Seat 2: 2ef94abd ($6.76 in chips)
Seat 3: d7795b7 ($10.25 in chips)
Seat 4: Hero ($27.13 in chips)
Seat 5: 5db28ee7 ($3.65 in chips)
Seat 6: 27d009 ($10.04 in chips)
2ef94abd: posts small blind $0.05
d7795b7: posts big blind $0.1
*** HOLE CARDS ***
Dealt to c20fb006 
Dealt to 2ef94abd 
Dealt to d7795b7 
Dealt to Hero [Js Th]
Dealt to 5db28ee7 
Dealt to 27d009 
Hero: folds
5db28ee7: folds
27d009: raises $0.2 to $0.3
c20fb006: folds
2ef94abd: folds
d7795b7: folds
Uncalled bet ($0.2) returned to 27d009
*** SHOWDOWN ***
27d009 collected $0.25 from pot
*** SUMMARY ***
Total pot $0.25 | Rake $0 | Jackpot $0 | Bingo $0 | Fortune $0
Seat 1: c20fb006 (button) folded before Flop (didn't bet)
Seat 2: 2ef94abd (small blind) folded before Flop
Seat 3: d7795b7 (big blind) folded before Flop
Seat 4: Hero folded before Flop (didn't bet)
Seat 5: 5db28ee7 folded before Flop (didn't bet)
Seat 6: 27d009 collected ($0.25)


Poker Hand #RC1433456894: Hold'em No Limit  ($0.05/$0.1) - 2023/03/27 20:11:48
Table 'RushAndCash28192154' 6-max Seat #1 is the button
Seat 1: fffa798a ($18.79 in chips)
Seat 2: ea181265 ($10.05 in chips)
Seat 3: bf45b565 ($12.19 in chips)
Seat 4: 38b9c56f ($10.77 in chips)
Seat 5: 6a6e1e5b ($10 in chips)
Seat 6: Hero ($27.13 in chips)
ea181265: posts small blind $0.05
bf45b565: posts big blind $0.1
*** HOLE CARDS ***
Dealt to fffa798a 
Dealt to ea181265 
Dealt to bf45b565 
Dealt to 38b9c56f 
Dealt to 6a6e1e5b 
Dealt to Hero [7d 5c]
38b9c56f: raises $0.1 to $0.2
6a6e1e5b: folds
Hero: folds
fffa798a: folds
ea181265: folds
bf45b565: folds
Uncalled bet ($0.1) returned to 38b9c56f
*** SHOWDOWN ***
38b9c56f collected $0.25 from pot
*** SUMMARY ***
Total pot $0.25 | Rake $0 | Jackpot $0 | Bingo $0 | Fortune $0
Seat 1: fffa798a (button) folded before Flop (didn't bet)
Seat 2: ea181265 (small blind) folded before Flop
Seat 3: bf45b565 (big blind) folded before Flop
Seat 4: 38b9c56f collected ($0.25)
Seat 5: 6a6e1e5b folded before Flop (didn't bet)
Seat 6: Hero folded before Flop (didn't bet)


Poker Hand #RC1433456847: Hold'em No Limit  ($0.05/$0.1) - 2023/03/27 20:11:41
Table 'RushAndCash28192107' 6-max Seat #1 is the button
Seat 1: 336f074e ($13.72 in chips)
Seat 2: Hero ($27.18 in chips)
Seat 3: dc5d8f31 ($13.36 in chips)
Seat 4: f3032324 ($10.35 in chips)
Seat 5: 6a6e1e5b ($10 in chips)
Seat 6: 828d8dcf ($8.23 in chips)
Hero: posts small blind $0.05
dc5d8f31: posts big blind $0.1
*** HOLE CARDS ***
Dealt to 336f074e 
Dealt to Hero [6c 5s]
Dealt to dc5d8f31 
Dealt to f3032324 
Dealt to 6a6e1e5b 
Dealt to 828d8dcf 
f3032324: folds
6a6e1e5b: folds
828d8dcf: raises $0.1 to $0.2
336f074e: folds
Hero: folds
dc5d8f31: calls $0.1
*** FLOP *** [Jc 6s 8d]
dc5d8f31: checks
828d8dcf: checks
*** TURN *** [Jc 6s 8d] [9d]
dc5d8f31: checks
828d8dcf: bets $0.34
dc5d8f31: folds
Uncalled bet ($0.34) returned to 828d8dcf
*** SHOWDOWN ***
828d8dcf collected $0.43 from pot
*** SUMMARY ***
Total pot $0.45 | Rake $0.02 | Jackpot $0 | Bingo $0 | Fortune $0
Board [Jc 6s 8d 9d]
Seat 1: 336f074e (button) folded before Flop (didn't bet)
Seat 2: Hero (small blind) folded before Flop
Seat 3: dc5d8f31 (big blind) folded on the Turn
Seat 4: f3032324 folded before Flop (didn't bet)
Seat 5: 6a6e1e5b folded before Flop (didn't bet)
Seat 6: 828d8dcf won ($0.43)


Poker Hand #RC1433456815: Hold'em No Limit  ($0.05/$0.1) - 2023/03/27 20:11:37
Table 'RushAndCash28192075' 6-max Seat #1 is the button
Seat 1: 61dcb0bf ($20.63 in chips)
Seat 2: 33ae8f30 ($10.24 in chips)
Seat 3: be700dc2 ($25.58 in chips)
Seat 4: a9f4a031 ($10.96 in chips)
Seat 5: 8c919b4 ($10.73 in chips)
Seat 6: Hero ($27.18 in chips)
33ae8f30: posts small blind $0.05
be700dc2: posts big blind $0.1
*** HOLE CARDS ***
Dealt to 61dcb0bf 
Dealt to 33ae8f30 
Dealt to be700dc2 
Dealt to a9f4a031 
Dealt to 8c919b4 
Dealt to Hero [5c 4c]
a9f4a031: raises $0.15 to $0.25
8c919b4: folds
Hero: folds
61dcb0bf: folds
33ae8f30: folds
be700dc2: folds
Uncalled bet ($0.15) returned to a9f4a031
*** SHOWDOWN ***
a9f4a031 collected $0.25 from pot
*** SUMMARY ***
Total pot $0.25 | Rake $0 | Jackpot $0 | Bingo $0 | Fortune $0
Seat 1: 61dcb0bf (button) folded before Flop (didn't bet)
Seat 2: 33ae8f30 (small blind) folded before Flop
Seat 3: be700dc2 (big blind) folded before Flop
Seat 4: a9f4a031 collected ($0.25)
Seat 5: 8c919b4 folded before Flop (didn't bet)
Seat 6: Hero folded before Flop (didn't bet)


Poker Hand #RC1433456758: Hold'em No Limit  ($0.05/$0.1) - 2023/03/27 20:11:29
Table 'RushAndCash28192018' 6-max Seat #1 is the button
Seat 1: Hero ($27.18 in chips)
Seat 2: b15fb529 ($21.67 in chips)
Seat 3: 2856e493 ($11.58 in chips)
Seat 4: e4e5aa04 ($16.78 in chips)
Seat 5: bf45b565 ($12.24 in chips)
Seat 6: c8830d8d ($9.97 in chips)
b15fb529: posts small blind $0.05
2856e493: posts big blind $0.1
*** HOLE CARDS ***
Dealt to Hero [9h 3s]
Dealt to b15fb529 
Dealt to 2856e493 
Dealt to e4e5aa04 
Dealt to bf45b565 
Dealt to c8830d8d 
e4e5aa04: raises $0.12 to $0.22
bf45b565: folds
c8830d8d: folds
Hero: folds
b15fb529: calls $0.17
2856e493: folds
*** FLOP *** [9s Kc 7h]
b15fb529: checks
e4e5aa04: bets $0.18
b15fb529: calls $0.18
*** TURN *** [9s Kc 7h] [3h]
b15fb529: checks
e4e5aa04: bets $0.55
b15fb529: calls $0.55
*** RIVER *** [9s Kc 7h 3h] [6h]
b15fb529: checks
e4e5aa04: bets $1.3
b15fb529: folds
Uncalled bet ($1.3) returned to e4e5aa04
*** SHOWDOWN ***
e4e5aa04 collected $1.88 from pot
*** SUMMARY ***
Total pot $2 | Rake $0.12 | Jackpot $0 | Bingo $0 | Fortune $0
Board [9s Kc 7h 3h 6h]
Seat 1: Hero (button) folded before Flop (didn't bet)
Seat 2: b15fb529 (small blind) folded on the River
Seat 3: 2856e493 (big blind) folded before Flop
Seat 4: e4e5aa04 won ($1.88)
Seat 5: bf45b565 folded before Flop (didn't bet)
Seat 6: c8830d8d folded before Flop (didn't bet)


Poker Hand #RC1433456664: Hold'em No Limit  ($0.05/$0.1) - 2023/03/27 20:11:15
Table 'RushAndCash28191924' 6-max Seat #1 is the button
Seat 1: a0e140b7 ($10.19 in chips)
Seat 2: c9033b2c ($12.83 in chips)
Seat 3: 16bfecec ($10.56 in chips)
Seat 4: ed75d67c ($14.43 in chips)
Seat 5: 8630e385 ($12.79 in chips)
Seat 6: Hero ($27.18 in chips)
c9033b2c: posts small blind $0.05
16bfecec: posts big blind $0.1
*** HOLE CARDS ***
Dealt to a0e140b7 
Dealt to c9033b2c 
Dealt to 16bfecec 
Dealt to ed75d67c 
Dealt to 8630e385 
Dealt to Hero [9c 3d]
ed75d67c: folds
8630e385: folds
Hero: folds
a0e140b7: folds
c9033b2c: folds
Uncalled bet ($0.05) returned to 16bfecec
*** SHOWDOWN ***
16bfecec collected $0.1 from pot
*** SUMMARY ***
Total pot $0.1 | Rake $0 | Jackpot $0 | Bingo $0 | Fortune $0
Seat 1: a0e140b7 (button) folded before Flop (didn't bet)
Seat 2: c9033b2c (small blind) folded before Flop
Seat 3: 16bfecec (big blind) collected ($0.1)
Seat 4: ed75d67c folded before Flop (didn't bet)
Seat 5: 8630e385 folded before Flop (didn't bet)
Seat 6: Hero folded before Flop (didn't bet)


Poker Hand #RC1433456603: Hold'em No Limit  ($0.05/$0.1) - 2023/03/27 20:11:07
Table 'RushAndCash28191863' 6-max Seat #1 is the button
Seat 1: 5154a716 ($9.53 in chips)
Seat 2: b15fb529 ($21.72 in chips)
Seat 3: 9ba6ae76 ($17.17 in chips)
Seat 4: dc5d8f31 ($13.41 in chips)
Seat 5: Hero ($27.18 in chips)
Seat 6: bb4dcf9b ($14.18 in chips)
b15fb529: posts small blind $0.05
9ba6ae76: posts big blind $0.1
*** HOLE CARDS ***
Dealt to 5154a716 
Dealt to b15fb529 
Dealt to 9ba6ae76 
Dealt to dc5d8f31 
Dealt to Hero [4h 3h]
Dealt to bb4dcf9b 
dc5d8f31: folds
Hero: folds
bb4dcf9b: folds
5154a716: folds
b15fb529: folds
Uncalled bet ($0.05) returned to 9ba6ae76
*** SHOWDOWN ***
9ba6ae76 collected $0.1 from pot
*** SUMMARY ***
Total pot $0.1 | Rake $0 | Jackpot $0 | Bingo $0 | Fortune $0
Seat 1: 5154a716 (button) folded before Flop (didn't bet)
Seat 2: b15fb529 (small blind) folded before Flop
Seat 3: 9ba6ae76 (big blind) collected ($0.1)
Seat 4: dc5d8f31 folded before Flop (didn't bet)
Seat 5: Hero folded before Flop (didn't bet)
Seat 6: bb4dcf9b folded before Flop (didn't bet)


Poker Hand #RC1433456043: Hold'em No Limit  ($0.05/$0.1) - 2023/03/27 20:09:47
Table 'RushAndCash28191303' 6-max Seat #1 is the button
Seat 1: 5db28ee7 ($1.67 in chips)
Seat 2: 3e2ce794 ($19 in chips)
Seat 3: Hero ($25.1 in chips)
Seat 4: a51bd834 ($10.21 in chips)
Seat 5: aa6656f4 ($29.63 in chips)
Seat 6: 538ebef8 ($10.58 in chips)
3e2ce794: posts small blind $0.05
Hero: posts big blind $0.1
*** HOLE CARDS ***
Dealt to 5db28ee7 
Dealt to 3e2ce794 
Dealt to Hero [Jh Jc]
Dealt to a51bd834 
Dealt to aa6656f4 
Dealt to 538ebef8 
a51bd834: raises $0.15 to $0.25
aa6656f4: folds
538ebef8: calls $0.25
5db28ee7: calls $0.25
3e2ce794: calls $0.2
Hero: raises $1.55 to $1.8
a51bd834: folds
538ebef8: folds
5db28ee7: calls $1.42 and is all-in
3e2ce794: folds
Uncalled bet ($0.13) returned to Hero
Hero: shows [Jh Jc]
5db28ee7: shows [Ac Ts]
*** FLOP *** [Js 6c 6s]
*** TURN *** [Js 6c 6s] [7h]
*** RIVER *** [Js 6c 6s 7h] [8c]
*** SHOWDOWN ***
Hero collected $3.75 from pot
*** SUMMARY ***
Total pot $4.09 | Rake $0.19 | Jackpot $0.15 | Bingo $0 | Fortune $0
Board [Js 6c 6s 7h 8c]
Seat 1: 5db28ee7 (button) showed [Ac Ts] and lost with Pair of Sixes
Seat 2: 3e2ce794 (small blind) folded before Flop
Seat 3: Hero (big blind) showed [Jh Jc] and won ($3.75) with Jacks Full over Sixes
Seat 4: a51bd834 folded before Flop
Seat 5: aa6656f4 folded before Flop (didn't bet)
Seat 6: 538ebef8 folded before Flop


Poker Hand #RC1433456008: Hold'em No Limit  ($0.05/$0.1) - 2023/03/27 20:09:43
Table 'RushAndCash28191268' 6-max Seat #1 is the button
Seat 1: d5571ce8 ($10 in chips)
Seat 2: 5bdca8b7 ($13.3 in chips)
Seat 3: a3d01adf ($9.31 in chips)
Seat 4: Hero ($25.1 in chips)
Seat 5: a0e140b7 ($10.77 in chips)
Seat 6: fba9fe19 ($12.11 in chips)
5bdca8b7: posts small blind $0.05
a3d01adf: posts big blind $0.1
*** HOLE CARDS ***
Dealt to d5571ce8 
Dealt to 5bdca8b7 
Dealt to a3d01adf 
Dealt to Hero [Js 3h]
Dealt to a0e140b7 
Dealt to fba9fe19 
Hero: folds
a0e140b7: folds
fba9fe19: folds
d5571ce8: folds
5bdca8b7: raises $0.2 to $0.3
a3d01adf: calls $0.2
*** FLOP *** [2s Ah 8s]
5bdca8b7: bets $0.2
a3d01adf: raises $0.77 to $0.97
5bdca8b7: folds
Uncalled bet ($0.77) returned to a3d01adf
*** SHOWDOWN ***
a3d01adf collected $0.95 from pot
*** SUMMARY ***
Total pot $1 | Rake $0.05 | Jackpot $0 | Bingo $0 | Fortune $0
Board [2s Ah 8s]
Seat 1: d5571ce8 (button) folded before Flop (didn't bet)
Seat 2: 5bdca8b7 (small blind) folded on the Flop
Seat 3: a3d01adf (big blind) won ($0.95)
Seat 4: Hero folded before Flop (didn't bet)
Seat 5: a0e140b7 folded before Flop (didn't bet)
Seat 6: fba9fe19 folded before Flop (didn't bet)


Poker Hand #RC1433455519: Hold'em No Limit  ($0.05/$0.1) - 2023/03/27 20:08:36
Table 'RushAndCash28190779' 6-max Seat #1 is the button
Seat 1: bd16a6d ($22.63 in chips)
Seat 2: 9b0ffb ($22.64 in chips)
Seat 3: Hero ($24.57 in chips)
Seat 4: cdea2b5b ($10 in chips)
Seat 5: c41e3be6 ($11.66 in chips)
Seat 6: fba9fe19 ($12.49 in chips)
9b0ffb: posts small blind $0.05
Hero: posts big blind $0.1
*** HOLE CARDS ***
Dealt to bd16a6d 
Dealt to 9b0ffb 
Dealt to Hero [Jd Td]
Dealt to cdea2b5b 
Dealt to c41e3be6 
Dealt to fba9fe19 
cdea2b5b: folds
c41e3be6: folds
fba9fe19: raises $0.15 to $0.25
bd16a6d: folds
9b0ffb: folds
Hero: calls $0.15
*** FLOP *** [3h 4s 7s]
Hero: bets $0.28
fba9fe19: calls $0.28
*** TURN *** [3h 4s 7s] [6h]
Hero: bets $0.71
fba9fe19: folds
Uncalled bet ($0.71) returned to Hero
*** SHOWDOWN ***
Hero collected $1.06 from pot
*** SUMMARY ***
Total pot $1.11 | Rake $0.05 | Jackpot $0 | Bingo $0 | Fortune $0
Board [3h 4s 7s 6h]
Seat 1: bd16a6d (button) folded before Flop (didn't bet)
Seat 2: 9b0ffb (small blind) folded before Flop
Seat 3: Hero (big blind) won ($1.06)
Seat 4: cdea2b5b folded before Flop (didn't bet)
Seat 5: c41e3be6 folded before Flop (didn't bet)
Seat 6: fba9fe19 folded on the Turn


Poker Hand #RC1433455179: Hold'em No Limit  ($0.05/$0.1) - 2023/03/27 20:07:52
Table 'RushAndCash28190439' 6-max Seat #1 is the button
Seat 1: 270d5a00 ($7.3 in chips)
Seat 2: b7b24791 ($8.96 in chips)
Seat 3: 2fa1cf2b ($19.69 in chips)
Seat 4: bfc6618d ($12.32 in chips)
Seat 5: c41e3be6 ($11.91 in chips)
Seat 6: Hero ($24.2 in chips)
b7b24791: posts small blind $0.05
2fa1cf2b: posts big blind $0.1
*** HOLE CARDS ***
Dealt to 270d5a00 
Dealt to b7b24791 
Dealt to 2fa1cf2b 
Dealt to bfc6618d 
Dealt to c41e3be6 
Dealt to Hero [Qd Kh]
bfc6618d: folds
c41e3be6: raises $0.15 to $0.25
Hero: raises $0.55 to $0.8
270d5a00: folds
b7b24791: folds
2fa1cf2b: folds
c41e3be6: folds
Uncalled bet ($0.55) returned to Hero
*** SHOWDOWN ***
Hero collected $0.62 from pot
*** SUMMARY ***
Total pot $0.65 | Rake $0.03 | Jackpot $0 | Bingo $0 | Fortune $0
Seat 1: 270d5a00 (button) folded before Flop (didn't bet)
Seat 2: b7b24791 (small blind) folded before Flop
Seat 3: 2fa1cf2b (big blind) folded before Flop
Seat 4: bfc6618d folded before Flop (didn't bet)
Seat 5: c41e3be6 folded before Flop
Seat 6: Hero collected ($0.62)


Poker Hand #RC1433455135: Hold'em No Limit  ($0.05/$0.1) - 2023/03/27 20:07:46
Table 'RushAndCash28190395' 6-max Seat #1 is the button
Seat 1: d37b662e ($10 in chips)
Seat 2: Hero ($24.25 in chips)
Seat 3: 5b794c0c ($14.86 in chips)
Seat 4: 462e8981 ($10.62 in chips)
Seat 5: 4c1d99c ($30.88 in chips)
Seat 6: 6a6e1e5b ($11.11 in chips)
Hero: posts small blind $0.05
5b794c0c: posts big blind $0.1
*** HOLE CARDS ***
Dealt to d37b662e 
Dealt to Hero [Kh 7d]
Dealt to 5b794c0c 
Dealt to 462e8981 
Dealt to 4c1d99c 
Dealt to 6a6e1e5b 
462e8981: folds
4c1d99c: folds
6a6e1e5b: folds
d37b662e: raises $0.15 to $0.25
Hero: folds
5b794c0c: calls $0.15
*** FLOP *** [Jc 5d 4h]
5b794c0c: checks
d37b662e: bets $0.2
5b794c0c: folds
Uncalled bet ($0.2) returned to d37b662e
*** SHOWDOWN ***
d37b662e collected $0.53 from pot
*** SUMMARY ***
Total pot $0.55 | Rake $0.02 | Jackpot $0 | Bingo $0 | Fortune $0
Board [Jc 5d 4h]
Seat 1: d37b662e (button) won ($0.53)
Seat 2: Hero (small blind) folded before Flop
Seat 3: 5b794c0c (big blind) folded on the Flop
Seat 4: 462e8981 folded before Flop (didn't bet)
Seat 5: 4c1d99c folded before Flop (didn't bet)
Seat 6: 6a6e1e5b folded before Flop (didn't bet)


Poker Hand #RC1433455020: Hold'em No Limit  ($0.05/$0.1) - 2023/03/27 20:07:31
Table 'RushAndCash28190280' 6-max Seat #1 is the button
Seat 1: 99f63284 ($12.45 in chips)
Seat 2: Hero ($24.15 in chips)
Seat 3: c0b57707 ($11.32 in chips)
Seat 4: a1d4f810 ($15.22 in chips)
Seat 5: c0f72b91 ($9.45 in chips)
Seat 6: 2d7d9ed3 ($10.47 in chips)
Hero: posts small blind $0.05
c0b57707: posts big blind $0.1
*** HOLE CARDS ***
Dealt to 99f63284 
Dealt to Hero [Qd Ks]
Dealt to c0b57707 
Dealt to a1d4f810 
Dealt to c0f72b91 
Dealt to 2d7d9ed3 
a1d4f810: folds
c0f72b91: folds
2d7d9ed3: folds
99f63284: folds
Hero: raises $0.2 to $0.3
c0b57707: folds
Uncalled bet ($0.2) returned to Hero
*** SHOWDOWN ***
Hero collected $0.2 from pot
*** SUMMARY ***
Total pot $0.2 | Rake $0 | Jackpot $0 | Bingo $0 | Fortune $0
Seat 1: 99f63284 (button) folded before Flop (didn't bet)
Seat 2: Hero (small blind) collected ($0.2)
Seat 3: c0b57707 (big blind) folded before Flop
Seat 4: a1d4f810 folded before Flop (didn't bet)
Seat 5: c0f72b91 folded before Flop (didn't bet)
Seat 6: 2d7d9ed3 folded before Flop (didn't bet)


Poker Hand #RC1433454976: Hold'em No Limit  ($0.05/$0.1) - 2023/03/27 20:07:25
Table 'RushAndCash28190236' 6-max Seat #1 is the button
Seat 1: 7f6cbe2 ($13.92 in chips)
Seat 2: dd050aa7 ($14.24 in chips)
Seat 3: 51c800a1 ($10.84 in chips)
Seat 4: Hero ($24.15 in chips)
Seat 5: 3c34b9dd ($30.98 in chips)
Seat 6: 5f35b8c0 ($8.8 in chips)
dd050aa7: posts small blind $0.05
51c800a1: posts big blind $0.1
*** HOLE CARDS ***
Dealt to 7f6cbe2 
Dealt to dd050aa7 
Dealt to 51c800a1 
Dealt to Hero [8h Jd]
Dealt to 3c34b9dd 
Dealt to 5f35b8c0 
Hero: folds
3c34b9dd: folds
5f35b8c0: raises $0.15 to $0.25
7f6cbe2: folds
dd050aa7: folds
51c800a1: raises $0.55 to $0.8
5f35b8c0: calls $0.55
*** FLOP *** [9c Ts 6c]
51c800a1: bets $1.24
5f35b8c0: calls $1.24
*** TURN *** [9c Ts 6c] [8s]
51c800a1: checks
5f35b8c0: bets $2.73
51c800a1: folds
Uncalled bet ($2.73) returned to 5f35b8c0
*** SHOWDOWN ***
5f35b8c0 collected $3.79 from pot
*** SUMMARY ***
Total pot $4.13 | Rake $0.19 | Jackpot $0.15 | Bingo $0 | Fortune $0
Board [9c Ts 6c 8s]
Seat 1: 7f6cbe2 (button) folded before Flop (didn't bet)
Seat 2: dd050aa7 (small blind) folded before Flop
Seat 3: 51c800a1 (big blind) folded on the Turn
Seat 4: Hero folded before Flop (didn't bet)
Seat 5: 3c34b9dd folded before Flop (didn't bet)
Seat 6: 5f35b8c0 won ($3.79)


Poker Hand #RC1433454878: Hold'em No Limit  ($0.05/$0.1) - 2023/03/27 20:07:10
Table 'RushAndCash28190138' 6-max Seat #1 is the button
Seat 1: 43619f04 ($10.4 in chips)
Seat 2: 9f599caa ($5.59 in chips)
Seat 3: Hero ($24.25 in chips)
Seat 4: 1d0d4208 ($9.85 in chips)
Seat 5: 6f2108de ($10 in chips)
Seat 6: bb4b1d3f ($13.17 in chips)
9f599caa: posts small blind $0.05
Hero: posts big blind $0.1
*** HOLE CARDS ***
Dealt to 43619f04 
Dealt to 9f599caa 
Dealt to Hero [Qd 9h]
Dealt to 1d0d4208 
Dealt to 6f2108de 
Dealt to bb4b1d3f 
1d0d4208: folds
6f2108de: folds
bb4b1d3f: folds
43619f04: raises $0.15 to $0.25
9f599caa: folds
Hero: folds
Uncalled bet ($0.15) returned to 43619f04
*** SHOWDOWN ***
43619f04 collected $0.25 from pot
*** SUMMARY ***
Total pot $0.25 | Rake $0 | Jackpot $0 | Bingo $0 | Fortune $0
Seat 1: 43619f04 (button) collected ($0.25)
Seat 2: 9f599caa (small blind) folded before Flop
Seat 3: Hero (big blind) folded before Flop
Seat 4: 1d0d4208 folded before Flop (didn't bet)
Seat 5: 6f2108de folded before Flop (didn't bet)
Seat 6: bb4b1d3f folded before Flop (didn't bet)


Poker Hand #RC1433454789: Hold'em No Limit  ($0.05/$0.1) - 2023/03/27 20:06:57
Table 'RushAndCash28190049' 6-max Seat #1 is the button
Seat 1: Hero ($24.25 in chips)
Seat 2: 29948ea4 ($10.97 in chips)
Seat 3: 9ba6ae76 ($16.44 in chips)
Seat 4: b3190b70 ($10.59 in chips)
Seat 5: 2dbc16ad ($17.15 in chips)
Seat 6: fc7eade4 ($18.47 in chips)
29948ea4: posts small blind $0.05
9ba6ae76: posts big blind $0.1
*** HOLE CARDS ***
Dealt to Hero [Qh 5s]
Dealt to 29948ea4 
Dealt to 9ba6ae76 
Dealt to b3190b70 
Dealt to 2dbc16ad 
Dealt to fc7eade4 
b3190b70: raises $0.15 to $0.25
2dbc16ad: raises $0.65 to $0.9
fc7eade4: folds
Hero: folds
29948ea4: folds
9ba6ae76: folds
b3190b70: calls $0.65
*** FLOP *** [Kd Ah 3c]
b3190b70: checks
2dbc16ad: bets $0.69
b3190b70: calls $0.69
*** TURN *** [Kd Ah 3c] [5c]
b3190b70: checks
2dbc16ad: bets $1.17
b3190b70: raises $7.83 to $9 and is all-in
2dbc16ad: folds
Uncalled bet ($7.83) returned to b3190b70
*** SHOWDOWN ***
b3190b70 collected $5.25 from pot
*** SUMMARY ***
Total pot $5.67 | Rake $0.27 | Jackpot $0.15 | Bingo $0 | Fortune $0
Board [Kd Ah 3c 5c]
Seat 1: Hero (button) folded before Flop (didn't bet)
Seat 2: 29948ea4 (small blind) folded before Flop
Seat 3: 9ba6ae76 (big blind) folded before Flop
Seat 4: b3190b70 won ($5.25)
Seat 5: 2dbc16ad folded on the Turn
Seat 6: fc7eade4 folded before Flop (didn't bet)


Poker Hand #RC1433424718: Hold'em No Limit  ($0.05/$0.1) - 2023/03/27 20:06:47
Table 'RushAndCash28189978' 6-max Seat #1 is the button
Seat 1: Hero ($24.25 in chips)
Seat 2: 956b04ef ($11.9 in chips)
Seat 3: abf042fe ($10 in chips)
Seat 4: fd9af780 ($10.93 in chips)
Seat 5: 484f9657 ($17.28 in chips)
Seat 6: fd065037 ($10.66 in chips)
956b04ef: posts small blind $0.05
abf042fe: posts big blind $0.1
*** HOLE CARDS ***
Dealt to Hero [6d 2d]
Dealt to 956b04ef 
Dealt to abf042fe 
Dealt to fd9af780 
Dealt to 484f9657 
Dealt to fd065037 
fd9af780: folds
484f9657: folds
fd065037: folds
Hero: folds
956b04ef: folds
Uncalled bet ($0.05) returned to abf042fe
*** SHOWDOWN ***
abf042fe collected $0.1 from pot
*** SUMMARY ***
Total pot $0.1 | Rake $0 | Jackpot $0 | Bingo $0 | Fortune $0
Seat 1: Hero (button) folded before Flop (didn't bet)
Seat 2: 956b04ef (small blind) folded before Flop
Seat 3: abf042fe (big blind) collected ($0.1)
Seat 4: fd9af780 folded before Flop (didn't bet)
Seat 5: 484f9657 folded before Flop (didn't bet)
Seat 6: fd065037 folded before Flop (didn't bet)


Poker Hand #RC1433424681: Hold'em No Limit  ($0.05/$0.1) - 2023/03/27 20:06:43
Table 'RushAndCash28189941' 6-max Seat #1 is the button
Seat 1: 2d7d9ed3 ($10.72 in chips)
Seat 2: a4d9b203 ($11.23 in chips)
Seat 3: a1d4f810 ($14.94 in chips)
Seat 4: Hero ($24.25 in chips)
Seat 5: 2ac8e9fd ($14.49 in chips)
Seat 6: 79fb68ad ($14.28 in chips)
a4d9b203: posts small blind $0.05
a1d4f810: posts big blind $0.1
*** HOLE CARDS ***
Dealt to 2d7d9ed3 
Dealt to a4d9b203 
Dealt to a1d4f810 
Dealt to Hero [Qs 8d]
Dealt to 2ac8e9fd 
Dealt to 79fb68ad 
Hero: folds
2ac8e9fd: folds
79fb68ad: folds
2d7d9ed3: raises $0.15 to $0.25
a4d9b203: folds
a1d4f810: raises $0.91 to $1.16
2d7d9ed3: folds
Uncalled bet ($0.91) returned to a1d4f810
*** SHOWDOWN ***
a1d4f810 collected $0.53 from pot
*** SUMMARY ***
Total pot $0.55 | Rake $0.02 | Jackpot $0 | Bingo $0 | Fortune $0
Seat 1: 2d7d9ed3 (button) folded before Flop
Seat 2: a4d9b203 (small blind) folded before Flop
Seat 3: a1d4f810 (big blind) collected ($0.53)
Seat 4: Hero folded before Flop (didn't bet)
Seat 5: 2ac8e9fd folded before Flop (didn't bet)
Seat 6: 79fb68ad folded before Flop (didn't bet)


Poker Hand #RC1433424596: Hold'em No Limit  ($0.05/$0.1) - 2023/03/27 20:06:32
Table 'RushAndCash28189856' 6-max Seat #1 is the button
Seat 1: 8030373d ($12.47 in chips)
Seat 2: 73c36ec5 ($24.02 in chips)
Seat 3: 270d5a00 ($6.96 in chips)
Seat 4: 9f1bc03c ($10.36 in chips)
Seat 5: 11064df9 ($24.62 in chips)
Seat 6: Hero ($24.25 in chips)
73c36ec5: posts small blind $0.05
270d5a00: posts big blind $0.1
*** HOLE CARDS ***
Dealt to 8030373d 
Dealt to 73c36ec5 
Dealt to 270d5a00 
Dealt to 9f1bc03c 
Dealt to 11064df9 
Dealt to Hero [2h 9d]
9f1bc03c: folds
11064df9: folds
Hero: folds
8030373d: folds
73c36ec5: folds
Uncalled bet ($0.05) returned to 270d5a00
*** SHOWDOWN ***
270d5a00 collected $0.1 from pot
*** SUMMARY ***
Total pot $0.1 | Rake $0 | Jackpot $0 | Bingo $0 | Fortune $0
Seat 1: 8030373d (button) folded before Flop (didn't bet)
Seat 2: 73c36ec5 (small blind) folded before Flop
Seat 3: 270d5a00 (big blind) collected ($0.1)
Seat 4: 9f1bc03c folded before Flop (didn't bet)
Seat 5: 11064df9 folded before Flop (didn't bet)
Seat 6: Hero folded before Flop (didn't bet)


Poker Hand #RC1433424324: Hold'em No Limit  ($0.05/$0.1) - 2023/03/27 20:05:57
Table 'RushAndCash28189584' 6-max Seat #1 is the button
Seat 1: fb770538 ($11.46 in chips)
Seat 2: 7fce2922 ($13.76 in chips)
Seat 3: cd0d9376 ($10 in chips)
Seat 4: fb3559ae ($20.82 in chips)
Seat 5: ffdc49d9 ($8.88 in chips)
Seat 6: Hero ($24.5 in chips)
7fce2922: posts small blind $0.05
cd0d9376: posts big blind $0.1
*** HOLE CARDS ***
Dealt to fb770538 
Dealt to 7fce2922 
Dealt to cd0d9376 
Dealt to fb3559ae 
Dealt to ffdc49d9 
Dealt to Hero [Kc Td]
fb3559ae: folds
ffdc49d9: folds
Hero: raises $0.15 to $0.25
fb770538: folds
7fce2922: calls $0.2
cd0d9376: folds
*** FLOP *** [Jh 8d 4h]
7fce2922: checks
Hero: checks
*** TURN *** [Jh 8d 4h] [7c]
7fce2922: bets $0.3
Hero: folds
Uncalled bet ($0.3) returned to 7fce2922
*** SHOWDOWN ***
7fce2922 collected $0.57 from pot
*** SUMMARY ***
Total pot $0.6 | Rake $0.03 | Jackpot $0 | Bingo $0 | Fortune $0
Board [Jh 8d 4h 7c]
Seat 1: fb770538 (button) folded before Flop (didn't bet)
Seat 2: 7fce2922 (small blind) won ($0.57)
Seat 3: cd0d9376 (big blind) folded before Flop
Seat 4: fb3559ae folded before Flop (didn't bet)
Seat 5: ffdc49d9 folded before Flop (didn't bet)
Seat 6: Hero folded on the Turn


Poker Hand #RC1433424287: Hold'em No Limit  ($0.05/$0.1) - 2023/03/27 20:05:52
Table 'RushAndCash28189547' 6-max Seat #1 is the button
Seat 1: 25c830b1 ($23.59 in chips)
Seat 2: a38464e2 ($25.41 in chips)
Seat 3: 5228b80a ($17.02 in chips)
Seat 4: Hero ($24.5 in chips)
Seat 5: fca90731 ($10 in chips)
Seat 6: 792a727 ($10.73 in chips)
a38464e2: posts small blind $0.05
5228b80a: posts big blind $0.1
*** HOLE CARDS ***
Dealt to 25c830b1 
Dealt to a38464e2 
Dealt to 5228b80a 
Dealt to Hero [9h Ad]
Dealt to fca90731 
Dealt to 792a727 
Hero: folds
fca90731: folds
792a727: folds
25c830b1: folds
a38464e2: folds
Uncalled bet ($0.05) returned to 5228b80a
*** SHOWDOWN ***
5228b80a collected $0.1 from pot
*** SUMMARY ***
Total pot $0.1 | Rake $0 | Jackpot $0 | Bingo $0 | Fortune $0
Seat 1: 25c830b1 (button) folded before Flop (didn't bet)
Seat 2: a38464e2 (small blind) folded before Flop
Seat 3: 5228b80a (big blind) collected ($0.1)
Seat 4: Hero folded before Flop (didn't bet)
Seat 5: fca90731 folded before Flop (didn't bet)
Seat 6: 792a727 folded before Flop (didn't bet)


Poker Hand #RC1433424192: Hold'em No Limit  ($0.05/$0.1) - 2023/03/27 20:05:40
Table 'RushAndCash28189452' 6-max Seat #1 is the button
Seat 1: Hero ($24.5 in chips)
Seat 2: 2358adf ($131.26 in chips)
Seat 3: a641f77b ($13.45 in chips)
Seat 4: bbf18adb ($10.32 in chips)
Seat 5: c0b57707 ($10.63 in chips)
Seat 6: df73a606 ($10.25 in chips)
2358adf: posts small blind $0.05
a641f77b: posts big blind $0.1
*** HOLE CARDS ***
Dealt to Hero [4c Th]
Dealt to 2358adf 
Dealt to a641f77b 
Dealt to bbf18adb 
Dealt to c0b57707 
Dealt to df73a606 
bbf18adb: folds
c0b57707: folds
df73a606: folds
Hero: folds
2358adf: raises $0.2 to $0.3
a641f77b: folds
Uncalled bet ($0.2) returned to 2358adf
*** SHOWDOWN ***
2358adf collected $0.2 from pot
*** SUMMARY ***
Total pot $0.2 | Rake $0 | Jackpot $0 | Bingo $0 | Fortune $0
Seat 1: Hero (button) folded before Flop (didn't bet)
Seat 2: 2358adf (small blind) collected ($0.2)
Seat 3: a641f77b (big blind) folded before Flop
Seat 4: bbf18adb folded before Flop (didn't bet)
Seat 5: c0b57707 folded before Flop (didn't bet)
Seat 6: df73a606 folded before Flop (didn't bet)


Poker Hand #RC1433424032: Hold'em No Limit  ($0.05/$0.1) - 2023/03/27 20:05:19
Table 'RushAndCash28189292' 6-max Seat #1 is the button
Seat 1: fe84cc4f ($14.63 in chips)
Seat 2: Hero ($24.55 in chips)
Seat 3: f7cc0300 ($10.76 in chips)
Seat 4: 62a0afa3 ($10.1 in chips)
Seat 5: 25295a38 ($92.99 in chips)
Seat 6: 763a399f ($10 in chips)
Hero: posts small blind $0.05
f7cc0300: posts big blind $0.1
*** HOLE CARDS ***
Dealt to fe84cc4f 
Dealt to Hero [Kd 3h]
Dealt to f7cc0300 
Dealt to 62a0afa3 
Dealt to 25295a38 
Dealt to 763a399f 
62a0afa3: folds
25295a38: folds
763a399f: raises $0.15 to $0.25
fe84cc4f: folds
Hero: folds
f7cc0300: folds
Uncalled bet ($0.15) returned to 763a399f
*** SHOWDOWN ***
763a399f collected $0.25 from pot
*** SUMMARY ***
Total pot $0.25 | Rake $0 | Jackpot $0 | Bingo $0 | Fortune $0
Seat 1: fe84cc4f (button) folded before Flop (didn't bet)
Seat 2: Hero (small blind) folded before Flop
Seat 3: f7cc0300 (big blind) folded before Flop
Seat 4: 62a0afa3 folded before Flop (didn't bet)
Seat 5: 25295a38 folded before Flop (didn't bet)
Seat 6: 763a399f collected ($0.25)


Poker Hand #RC1433423957: Hold'em No Limit  ($0.05/$0.1) - 2023/03/27 20:05:10
Table 'RushAndCash28189217' 6-max Seat #1 is the button
Seat 1: 784858c ($25.45 in chips)
Seat 2: a958157e ($10.27 in chips)
Seat 3: fe7a4f2b ($12.63 in chips)
Seat 4: 96efd081 ($10.67 in chips)
Seat 5: Hero ($24.55 in chips)
Seat 6: 17e7697a ($37.86 in chips)
a958157e: posts small blind $0.05
fe7a4f2b: posts big blind $0.1
*** HOLE CARDS ***
Dealt to 784858c 
Dealt to a958157e 
Dealt to fe7a4f2b 
Dealt to 96efd081 
Dealt to Hero [3s 7d]
Dealt to 17e7697a 
96efd081: folds
Hero: folds
17e7697a: folds
784858c: folds
a958157e: raises $0.15 to $0.25
fe7a4f2b: folds
Uncalled bet ($0.15) returned to a958157e
*** SHOWDOWN ***
a958157e collected $0.2 from pot
*** SUMMARY ***
Total pot $0.2 | Rake $0 | Jackpot $0 | Bingo $0 | Fortune $0
Seat 1: 784858c (button) folded before Flop (didn't bet)
Seat 2: a958157e (small blind) collected ($0.2)
Seat 3: fe7a4f2b (big blind) folded before Flop
Seat 4: 96efd081 folded before Flop (didn't bet)
Seat 5: Hero folded before Flop (didn't bet)
Seat 6: 17e7697a folded before Flop (didn't bet)


Poker Hand #RC1433423924: Hold'em No Limit  ($0.05/$0.1) - 2023/03/27 20:05:05
Table 'RushAndCash28189184' 6-max Seat #1 is the button
Seat 1: 96efd081 ($10.67 in chips)
Seat 2: ea7c7ea0 ($9.39 in chips)
Seat 3: cc0e713f ($21.86 in chips)
Seat 4: aa70745f ($11.98 in chips)
Seat 5: 941aa8c8 ($13.31 in chips)
Seat 6: Hero ($24.55 in chips)
ea7c7ea0: posts small blind $0.05
cc0e713f: posts big blind $0.1
*** HOLE CARDS ***
Dealt to 96efd081 
Dealt to ea7c7ea0 
Dealt to cc0e713f 
Dealt to aa70745f 
Dealt to 941aa8c8 
Dealt to Hero [7s 3h]
aa70745f: folds
941aa8c8: folds
Hero: folds
96efd081: folds
ea7c7ea0: raises $0.2 to $0.3
cc0e713f: folds
Uncalled bet ($0.2) returned to ea7c7ea0
*** SHOWDOWN ***
ea7c7ea0 collected $0.2 from pot
*** SUMMARY ***
Total pot $0.2 | Rake $0 | Jackpot $0 | Bingo $0 | Fortune $0
Seat 1: 96efd081 (button) folded before Flop (didn't bet)
Seat 2: ea7c7ea0 (small blind) collected ($0.2)
Seat 3: cc0e713f (big blind) folded before Flop
Seat 4: aa70745f folded before Flop (didn't bet)
Seat 5: 941aa8c8 folded before Flop (didn't bet)
Seat 6: Hero folded before Flop (didn't bet)


Poker Hand #RC1433423885: Hold'em No Limit  ($0.05/$0.1) - 2023/03/27 20:05:00
Table 'RushAndCash28189145' 6-max Seat #1 is the button
Seat 1: da68cebe ($12.64 in chips)
Seat 2: 5c2b830f ($29.16 in chips)
Seat 3: 66017d6f ($23.12 in chips)
Seat 4: Hero ($24.55 in chips)
Seat 5: 2a8cfd7d ($11.52 in chips)
Seat 6: 95b5ffce ($14.89 in chips)
5c2b830f: posts small blind $0.05
66017d6f: posts big blind $0.1
*** HOLE CARDS ***
Dealt to da68cebe 
Dealt to 5c2b830f 
Dealt to 66017d6f 
Dealt to Hero [2s 7h]
Dealt to 2a8cfd7d 
Dealt to 95b5ffce 
Hero: folds
2a8cfd7d: folds
95b5ffce: folds
da68cebe: raises $0.15 to $0.25
5c2b830f: folds
66017d6f: folds
Uncalled bet ($0.15) returned to da68cebe
*** SHOWDOWN ***
da68cebe collected $0.25 from pot
*** SUMMARY ***
Total pot $0.25 | Rake $0 | Jackpot $0 | Bingo $0 | Fortune $0
Seat 1: da68cebe (button) collected ($0.25)
Seat 2: 5c2b830f (small blind) folded before Flop
Seat 3: 66017d6f (big blind) folded before Flop
Seat 4: Hero folded before Flop (didn't bet)
Seat 5: 2a8cfd7d folded before Flop (didn't bet)
Seat 6: 95b5ffce folded before Flop (didn't bet)


Poker Hand #RC1433423810: Hold'em No Limit  ($0.05/$0.1) - 2023/03/27 20:04:50
Table 'RushAndCash28189070' 6-max Seat #1 is the button
Seat 1: Hero ($24.4 in chips)
Seat 2: 85842513 ($2.97 in chips)
Seat 3: b09ddf1e ($9.17 in chips)
Seat 4: 42391a92 ($26.45 in chips)
Seat 5: bcc1610b ($6.58 in chips)
Seat 6: b7b24791 ($7 in chips)
85842513: posts small blind $0.05
b09ddf1e: posts big blind $0.1
*** HOLE CARDS ***
Dealt to Hero [9d As]
Dealt to 85842513 
Dealt to b09ddf1e 
Dealt to 42391a92 
Dealt to bcc1610b 
Dealt to b7b24791 
42391a92: folds
bcc1610b: folds
b7b24791: folds
Hero: raises $0.15 to $0.25
85842513: folds
b09ddf1e: folds
Uncalled bet ($0.15) returned to Hero
*** SHOWDOWN ***
Hero collected $0.25 from pot
*** SUMMARY ***
Total pot $0.25 | Rake $0 | Jackpot $0 | Bingo $0 | Fortune $0
Seat 1: Hero (button) collected ($0.25)
Seat 2: 85842513 (small blind) folded before Flop
Seat 3: b09ddf1e (big blind) folded before Flop
Seat 4: 42391a92 folded before Flop (didn't bet)
Seat 5: bcc1610b folded before Flop (didn't bet)
Seat 6: b7b24791 folded before Flop (didn't bet)


Poker Hand #RC1433423548: Hold'em No Limit  ($0.05/$0.1) - 2023/03/27 20:04:14
Table 'RushAndCash28188808' 6-max Seat #1 is the button
Seat 1: 5ff430be ($10.1 in chips)
Seat 2: 5f35b8c0 ($8.03 in chips)
Seat 3: Hero ($23.89 in chips)
Seat 4: bad1df0e ($10.63 in chips)
Seat 5: d9ae4646 ($7.84 in chips)
Seat 6: b09ddf1e ($9.42 in chips)
5f35b8c0: posts small blind $0.05
Hero: posts big blind $0.1
*** HOLE CARDS ***
Dealt to 5ff430be 
Dealt to 5f35b8c0 
Dealt to Hero [Jd Jc]
Dealt to bad1df0e 
Dealt to d9ae4646 
Dealt to b09ddf1e 
bad1df0e: raises $0.15 to $0.25
d9ae4646: folds
b09ddf1e: calls $0.25
5ff430be: folds
5f35b8c0: folds
Hero: raises $1.05 to $1.3
bad1df0e: folds
b09ddf1e: folds
Uncalled bet ($1.05) returned to Hero
*** SHOWDOWN ***
Hero collected $0.76 from pot
*** SUMMARY ***
Total pot $0.8 | Rake $0.04 | Jackpot $0 | Bingo $0 | Fortune $0
Seat 1: 5ff430be (button) folded before Flop (didn't bet)
Seat 2: 5f35b8c0 (small blind) folded before Flop
Seat 3: Hero (big blind) collected ($0.76)
Seat 4: bad1df0e folded before Flop
Seat 5: d9ae4646 folded before Flop (didn't bet)
Seat 6: b09ddf1e folded before Flop


Poker Hand #RC1433423508: Hold'em No Limit  ($0.05/$0.1) - 2023/03/27 20:04:09
Table 'RushAndCash28188768' 6-max Seat #1 is the button
Seat 1: abf042fe ($10.19 in chips)
Seat 2: fa935f5c ($12.46 in chips)
Seat 3: 25c830b1 ($24.01 in chips)
Seat 4: 3a99a4a ($18.12 in chips)
Seat 5: Hero ($23.89 in chips)
Seat 6: 60ef400e ($11.53 in chips)
fa935f5c: posts small blind $0.05
25c830b1: posts big blind $0.1
*** HOLE CARDS ***
Dealt to abf042fe 
Dealt to fa935f5c 
Dealt to 25c830b1 
Dealt to 3a99a4a 
Dealt to Hero [4d 7c]
Dealt to 60ef400e 
3a99a4a: folds
Hero: folds
60ef400e: folds
abf042fe: folds
fa935f5c: raises $0.12 to $0.22
25c830b1: calls $0.12
*** FLOP *** [Ah 2h 5s]
fa935f5c: checks
25c830b1: checks
*** TURN *** [Ah 2h 5s] [Kh]
fa935f5c: checks
25c830b1: checks
*** RIVER *** [Ah 2h 5s Kh] [4h]
fa935f5c: checks
25c830b1: checks
fa935f5c: shows [8s Qs] (Ace-High)
25c830b1: shows [Js 9s] (Ace-High)
*** SHOWDOWN ***
fa935f5c collected $0.42 from pot
*** SUMMARY ***
Total pot $0.44 | Rake $0.02 | Jackpot $0 | Bingo $0 | Fortune $0
Board [Ah 2h 5s Kh 4h]
Seat 1: abf042fe (button) folded before Flop (didn't bet)
Seat 2: fa935f5c (small blind) showed [8s Qs] and won ($0.42) with Ace-High
Seat 3: 25c830b1 (big blind) showed [Js 9s] and lost with Ace-High
Seat 4: 3a99a4a folded before Flop (didn't bet)
Seat 5: Hero folded before Flop (didn't bet)
Seat 6: 60ef400e folded before Flop (didn't bet)


Poker Hand #RC1433423019: Hold'em No Limit  ($0.05/$0.1) - 2023/03/27 20:03:05
Table 'RushAndCash28188279' 6-max Seat #1 is the button
Seat 1: 3723f382 ($13.11 in chips)
Seat 2: 41434d98 ($10.76 in chips)
Seat 3: 2f5f4c4f ($21.43 in chips)
Seat 4: 514bd449 ($19.88 in chips)
Seat 5: Hero ($24.14 in chips)
Seat 6: 3a99a4a ($17.56 in chips)
41434d98: posts small blind $0.05
2f5f4c4f: posts big blind $0.1
*** HOLE CARDS ***
Dealt to 3723f382 
Dealt to 41434d98 
Dealt to 2f5f4c4f 
Dealt to 514bd449 
Dealt to Hero [Ad 7d]
Dealt to 3a99a4a 
514bd449: folds
Hero: raises $0.15 to $0.25
3a99a4a: calls $0.25
3723f382: folds
41434d98: calls $0.2
2f5f4c4f: folds
*** FLOP *** [Jc Kh 6d]
41434d98: checks
Hero: checks
3a99a4a: bets $0.27
41434d98: folds
Hero: folds
Uncalled bet ($0.27) returned to 3a99a4a
*** SHOWDOWN ***
3a99a4a collected $0.81 from pot
*** SUMMARY ***
Total pot $0.85 | Rake $0.04 | Jackpot $0 | Bingo $0 | Fortune $0
Board [Jc Kh 6d]
Seat 1: 3723f382 (button) folded before Flop (didn't bet)
Seat 2: 41434d98 (small blind) folded on the Flop
Seat 3: 2f5f4c4f (big blind) folded before Flop
Seat 4: 514bd449 folded before Flop (didn't bet)
Seat 5: Hero folded on the Flop
Seat 6: 3a99a4a won ($0.81)


Poker Hand #RC1433422907: Hold'em No Limit  ($0.05/$0.1) - 2023/03/27 20:02:50
Table 'RushAndCash28188167' 6-max Seat #1 is the button
Seat 1: e972d1c ($13.78 in chips)
Seat 2: c41e3be6 ($12.29 in chips)
Seat 3: Hero ($24.24 in chips)
Seat 4: 50908537 ($36.16 in chips)
Seat 5: 1f4bfc51 ($13.99 in chips)
Seat 6: 9bc2c2b3 ($13.62 in chips)
c41e3be6: posts small blind $0.05
Hero: posts big blind $0.1
*** HOLE CARDS ***
Dealt to e972d1c 
Dealt to c41e3be6 
Dealt to Hero [8d 5d]
Dealt to 50908537 
Dealt to 1f4bfc51 
Dealt to 9bc2c2b3 
50908537: folds
1f4bfc51: folds
9bc2c2b3: raises $0.15 to $0.25
e972d1c: folds
c41e3be6: folds
Hero: folds
Uncalled bet ($0.15) returned to 9bc2c2b3
*** SHOWDOWN ***
9bc2c2b3 collected $0.25 from pot
*** SUMMARY ***
Total pot $0.25 | Rake $0 | Jackpot $0 | Bingo $0 | Fortune $0
Seat 1: e972d1c (button) folded before Flop (didn't bet)
Seat 2: c41e3be6 (small blind) folded before Flop
Seat 3: Hero (big blind) folded before Flop
Seat 4: 50908537 folded before Flop (didn't bet)
Seat 5: 1f4bfc51 folded before Flop (didn't bet)
Seat 6: 9bc2c2b3 collected ($0.25)


Poker Hand #RC1433422553: Hold'em No Limit  ($0.05/$0.1) - 2023/03/27 20:02:04
Table 'RushAndCash28187813' 6-max Seat #1 is the button
Seat 1: 39e708ef ($9.89 in chips)
Seat 2: b98e778e ($8.58 in chips)
Seat 3: c41e3be6 ($11.86 in chips)
Seat 4: f8f3d156 ($13.62 in chips)
Seat 5: 9b0ffb ($27.89 in chips)
Seat 6: Hero ($24.66 in chips)
b98e778e: posts small blind $0.05
c41e3be6: posts big blind $0.1
*** HOLE CARDS ***
Dealt to 39e708ef 
Dealt to b98e778e 
Dealt to c41e3be6 
Dealt to f8f3d156 
Dealt to 9b0ffb 
Dealt to Hero [3h 3c]
f8f3d156: folds
9b0ffb: folds
Hero: raises $0.15 to $0.25
39e708ef: folds
b98e778e: folds
c41e3be6: calls $0.15
*** FLOP *** [4d 8d 4s]
c41e3be6: bets $0.17
Hero: calls $0.17
*** TURN *** [4d 8d 4s] [9c]
c41e3be6: bets $0.4
Hero: folds
Uncalled bet ($0.4) returned to c41e3be6
*** SHOWDOWN ***
c41e3be6 collected $0.85 from pot
*** SUMMARY ***
Total pot $0.89 | Rake $0.04 | Jackpot $0 | Bingo $0 | Fortune $0
Board [4d 8d 4s 9c]
Seat 1: 39e708ef (button) folded before Flop (didn't bet)
Seat 2: b98e778e (small blind) folded before Flop
Seat 3: c41e3be6 (big blind) won ($0.85)
Seat 4: f8f3d156 folded before Flop (didn't bet)
Seat 5: 9b0ffb folded before Flop (didn't bet)
Seat 6: Hero folded on the Turn


Poker Hand #RC1433422500: Hold'em No Limit  ($0.05/$0.1) - 2023/03/27 20:01:57
Table 'RushAndCash28187760' 6-max Seat #1 is the button
Seat 1: 1f9c5684 ($22.76 in chips)
Seat 2: Hero ($24.71 in chips)
Seat 3: cac5b3d4 ($13.79 in chips)
Seat 4: 25c830b1 ($26.47 in chips)
Seat 5: d775ce74 ($10 in chips)
Seat 6: 2bb65c38 ($14.46 in chips)
Hero: posts small blind $0.05
cac5b3d4: posts big blind $0.1
*** HOLE CARDS ***
Dealt to 1f9c5684 
Dealt to Hero [4s Ts]
Dealt to cac5b3d4 
Dealt to 25c830b1 
Dealt to d775ce74 
Dealt to 2bb65c38 
25c830b1: folds
d775ce74: folds
2bb65c38: raises $0.15 to $0.25
1f9c5684: folds
Hero: folds
cac5b3d4: folds
Uncalled bet ($0.15) returned to 2bb65c38
*** SHOWDOWN ***
2bb65c38 collected $0.25 from pot
*** SUMMARY ***
Total pot $0.25 | Rake $0 | Jackpot $0 | Bingo $0 | Fortune $0
Seat 1: 1f9c5684 (button) folded before Flop (didn't bet)
Seat 2: Hero (small blind) folded before Flop
Seat 3: cac5b3d4 (big blind) folded before Flop
Seat 4: 25c830b1 folded before Flop (didn't bet)
Seat 5: d775ce74 folded before Flop (didn't bet)
Seat 6: 2bb65c38 collected ($0.25)


Poker Hand #RC1433422245: Hold'em No Limit  ($0.05/$0.1) - 2023/03/27 20:01:23
Table 'RushAndCash28187505' 6-max Seat #1 is the button
Seat 1: fb612793 ($12.11 in chips)
Seat 2: Hero ($24.39 in chips)
Seat 3: dd35185f ($10.05 in chips)
Seat 4: fe7a4f2b ($11.92 in chips)
Seat 5: 2bb65c38 ($14.71 in chips)
Seat 6: d23ad8f1 ($11.33 in chips)
Hero: posts small blind $0.05
dd35185f: posts big blind $0.1
*** HOLE CARDS ***
Dealt to fb612793 
Dealt to Hero [Kc Kh]
Dealt to dd35185f 
Dealt to fe7a4f2b 
Dealt to 2bb65c38 
Dealt to d23ad8f1 
fe7a4f2b: folds
2bb65c38: raises $0.15 to $0.25
d23ad8f1: folds
fb612793: folds
Hero: raises $0.8 to $1.05
dd35185f: folds
2bb65c38: folds
Uncalled bet ($0.8) returned to Hero
*** SHOWDOWN ***
Hero collected $0.57 from pot
*** SUMMARY ***
Total pot $0.6 | Rake $0.03 | Jackpot $0 | Bingo $0 | Fortune $0
Seat 1: fb612793 (button) folded before Flop (didn't bet)
Seat 2: Hero (small blind) collected ($0.57)
Seat 3: dd35185f (big blind) folded before Flop
Seat 4: fe7a4f2b folded before Flop (didn't bet)
Seat 5: 2bb65c38 folded before Flop
Seat 6: d23ad8f1 folded before Flop (didn't bet)


Poker Hand #RC1433422172: Hold'em No Limit  ($0.05/$0.1) - 2023/03/27 20:01:12
Table 'RushAndCash28187432' 6-max Seat #1 is the button
Seat 1: Hero ($24.39 in chips)
Seat 2: a38464e2 ($22.83 in chips)
Seat 3: 829baf64 ($21.19 in chips)
Seat 4: c546be70 ($19.96 in chips)
Seat 5: a77b563e ($13.1 in chips)
Seat 6: f931bb61 ($9.69 in chips)
a38464e2: posts small blind $0.05
829baf64: posts big blind $0.1
*** HOLE CARDS ***
Dealt to Hero [9d 6s]
Dealt to a38464e2 
Dealt to 829baf64 
Dealt to c546be70 
Dealt to a77b563e 
Dealt to f931bb61 
c546be70: folds
a77b563e: folds
f931bb61: calls $0.1
Hero: folds
a38464e2: calls $0.05
829baf64: checks
*** FLOP *** [3d 8c 8h]
a38464e2: checks
829baf64: checks
f931bb61: checks
*** TURN *** [3d 8c 8h] [6d]
a38464e2: checks
829baf64: checks
f931bb61: checks
*** RIVER *** [3d 8c 8h 6d] [Kh]
a38464e2: checks
829baf64: checks
f931bb61: checks
a38464e2: shows [6h 4h] (Pair of Eights and Pair of Sixes)
829baf64: shows [Jh 2d] (Pair of Eights)
f931bb61: shows [5c Ad] (Pair of Eights)
*** SHOWDOWN ***
a38464e2 collected $0.29 from pot
*** SUMMARY ***
Total pot $0.3 | Rake $0.01 | Jackpot $0 | Bingo $0 | Fortune $0
Board [3d 8c 8h 6d Kh]
Seat 1: Hero (button) folded before Flop (didn't bet)
Seat 2: a38464e2 (small blind) showed [6h 4h] and won ($0.29) with Pair of Eights and Pair of Sixes
Seat 3: 829baf64 (big blind) showed [Jh 2d] and lost with Pair of Eights
Seat 4: c546be70 folded before Flop (didn't bet)
Seat 5: a77b563e folded before Flop (didn't bet)
Seat 6: f931bb61 showed [5c Ad] and lost with Pair of Eights


Poker Hand #RC1433422122: Hold'em No Limit  ($0.05/$0.1) - 2023/03/27 20:01:07
Table 'RushAndCash28187382' 6-max Seat #1 is the button
Seat 1: f770dcf2 ($10.58 in chips)
Seat 2: ca043baa ($10.8 in chips)
Seat 3: 3a99a4a ($17.36 in chips)
Seat 4: ed11bab9 ($11.08 in chips)
Seat 5: Hero ($24.39 in chips)
Seat 6: 9386f657 ($10 in chips)
ca043baa: posts small blind $0.05
3a99a4a: posts big blind $0.1
*** HOLE CARDS ***
Dealt to f770dcf2 
Dealt to ca043baa 
Dealt to 3a99a4a 
Dealt to ed11bab9 
Dealt to Hero [9h Kd]
Dealt to 9386f657 
ed11bab9: folds
Hero: folds
9386f657: folds
f770dcf2: folds
ca043baa: raises $0.2 to $0.3
3a99a4a: folds
Uncalled bet ($0.2) returned to ca043baa
*** SHOWDOWN ***
ca043baa collected $0.2 from pot
*** SUMMARY ***
Total pot $0.2 | Rake $0 | Jackpot $0 | Bingo $0 | Fortune $0
Seat 1: f770dcf2 (button) folded before Flop (didn't bet)
Seat 2: ca043baa (small blind) collected ($0.2)
Seat 3: 3a99a4a (big blind) folded before Flop
Seat 4: ed11bab9 folded before Flop (didn't bet)
Seat 5: Hero folded before Flop (didn't bet)
Seat 6: 9386f657 folded before Flop (didn't bet)


Poker Hand #RC1433422081: Hold'em No Limit  ($0.05/$0.1) - 2023/03/27 20:01:02
Table 'RushAndCash28187341' 6-max Seat #1 is the button
Seat 1: 3de0f141 ($24.47 in chips)
Seat 2: 9f4fbe01 ($6.06 in chips)
Seat 3: e0f23917 ($23.28 in chips)
Seat 4: Hero ($24.39 in chips)
Seat 5: ff02b2f8 ($7.47 in chips)
Seat 6: 7157fd86 ($12 in chips)
9f4fbe01: posts small blind $0.05
e0f23917: posts big blind $0.1
*** HOLE CARDS ***
Dealt to 3de0f141 
Dealt to 9f4fbe01 
Dealt to e0f23917 
Dealt to Hero [7s 6s]
Dealt to ff02b2f8 
Dealt to 7157fd86 
Hero: folds
ff02b2f8: folds
7157fd86: folds
3de0f141: folds
9f4fbe01: folds
Uncalled bet ($0.05) returned to e0f23917
*** SHOWDOWN ***
e0f23917 collected $0.1 from pot
*** SUMMARY ***
Total pot $0.1 | Rake $0 | Jackpot $0 | Bingo $0 | Fortune $0
Seat 1: 3de0f141 (button) folded before Flop (didn't bet)
Seat 2: 9f4fbe01 (small blind) folded before Flop
Seat 3: e0f23917 (big blind) collected ($0.1)
Seat 4: Hero folded before Flop (didn't bet)
Seat 5: ff02b2f8 folded before Flop (didn't bet)
Seat 6: 7157fd86 folded before Flop (didn't bet)


Poker Hand #RC1433421971: Hold'em No Limit  ($0.05/$0.1) - 2023/03/27 20:00:49
Table 'RushAndCash28187231' 6-max Seat #1 is the button
Seat 1: c373ffff ($10.02 in chips)
Seat 2: a63ae8e1 ($9.9 in chips)
Seat 3: 5a65710 ($20.97 in chips)
Seat 4: 462e8981 ($10.37 in chips)
Seat 5: d49576df ($9.45 in chips)
Seat 6: Hero ($24.39 in chips)
a63ae8e1: posts small blind $0.05
5a65710: posts big blind $0.1
*** HOLE CARDS ***
Dealt to c373ffff 
Dealt to a63ae8e1 
Dealt to 5a65710 
Dealt to 462e8981 
Dealt to d49576df 
Dealt to Hero [2h Ad]
462e8981: folds
d49576df: folds
Hero: folds
c373ffff: folds
a63ae8e1: folds
Uncalled bet ($0.05) returned to 5a65710
*** SHOWDOWN ***
5a65710 collected $0.1 from pot
*** SUMMARY ***
Total pot $0.1 | Rake $0 | Jackpot $0 | Bingo $0 | Fortune $0
Seat 1: c373ffff (button) folded before Flop (didn't bet)
Seat 2: a63ae8e1 (small blind) folded before Flop
Seat 3: 5a65710 (big blind) collected ($0.1)
Seat 4: 462e8981 folded before Flop (didn't bet)
Seat 5: d49576df folded before Flop (didn't bet)
Seat 6: Hero folded before Flop (didn't bet)


Poker Hand #RC1433421825: Hold'em No Limit  ($0.05/$0.1) - 2023/03/27 20:00:30
Table 'RushAndCash28187085' 6-max Seat #1 is the button
Seat 1: 1719ea1e ($10.15 in chips)
Seat 2: fca90731 ($10.05 in chips)
Seat 3: Hero ($24.49 in chips)
Seat 4: bde4b311 ($10.93 in chips)
Seat 5: ca043baa ($10.9 in chips)
Seat 6: 48a17f8e ($28.61 in chips)
fca90731: posts small blind $0.05
Hero: posts big blind $0.1
*** HOLE CARDS ***
Dealt to 1719ea1e 
Dealt to fca90731 
Dealt to Hero [9s 5s]
Dealt to bde4b311 
Dealt to ca043baa 
Dealt to 48a17f8e 
bde4b311: raises $0.15 to $0.25
ca043baa: folds
48a17f8e: folds
1719ea1e: folds
fca90731: folds
Hero: folds
Uncalled bet ($0.15) returned to bde4b311
*** SHOWDOWN ***
bde4b311 collected $0.25 from pot
*** SUMMARY ***
Total pot $0.25 | Rake $0 | Jackpot $0 | Bingo $0 | Fortune $0
Seat 1: 1719ea1e (button) folded before Flop (didn't bet)
Seat 2: fca90731 (small blind) folded before Flop
Seat 3: Hero (big blind) folded before Flop
Seat 4: bde4b311 collected ($0.25)
Seat 5: ca043baa folded before Flop (didn't bet)
Seat 6: 48a17f8e folded before Flop (didn't bet)


Poker Hand #RC1433421776: Hold'em No Limit  ($0.05/$0.1) - 2023/03/27 20:00:23
Table 'RushAndCash28187036' 6-max Seat #1 is the button
Seat 1: 462e8981 ($10 in chips)
Seat 2: 827546bd ($23.39 in chips)
Seat 3: 1224b2f5 ($11.38 in chips)
Seat 4: 60232bae ($10 in chips)
Seat 5: Hero ($24.49 in chips)
Seat 6: d49576df ($9.7 in chips)
827546bd: posts small blind $0.05
1224b2f5: posts big blind $0.1
*** HOLE CARDS ***
Dealt to 462e8981 
Dealt to 827546bd 
Dealt to 1224b2f5 
Dealt to 60232bae 
Dealt to Hero [8c Qd]
Dealt to d49576df 
60232bae: folds
Hero: folds
d49576df: raises $0.15 to $0.25
462e8981: raises $0.52 to $0.77
827546bd: folds
1224b2f5: folds
d49576df: folds
Uncalled bet ($0.52) returned to 462e8981
*** SHOWDOWN ***
462e8981 collected $0.62 from pot
*** SUMMARY ***
Total pot $0.65 | Rake $0.03 | Jackpot $0 | Bingo $0 | Fortune $0
Seat 1: 462e8981 (button) collected ($0.62)
Seat 2: 827546bd (small blind) folded before Flop
Seat 3: 1224b2f5 (big blind) folded before Flop
Seat 4: 60232bae folded before Flop (didn't bet)
Seat 5: Hero folded before Flop (didn't bet)
Seat 6: d49576df folded before Flop


Poker Hand #RC1433421683: Hold'em No Limit  ($0.05/$0.1) - 2023/03/27 20:00:11
Table 'RushAndCash28186943' 6-max Seat #1 is the button
Seat 1: 49115bd7 ($13.03 in chips)
Seat 2: bf45b565 ($11.89 in chips)
Seat 3: Hero ($24.59 in chips)
Seat 4: 36447d0e ($12.61 in chips)
Seat 5: 1b112a36 ($11.67 in chips)
Seat 6: 827546bd ($23.39 in chips)
bf45b565: posts small blind $0.05
Hero: posts big blind $0.1
*** HOLE CARDS ***
Dealt to 49115bd7 
Dealt to bf45b565 
Dealt to Hero [3h 9h]
Dealt to 36447d0e 
Dealt to 1b112a36 
Dealt to 827546bd 
36447d0e: raises $0.15 to $0.25
1b112a36: folds
827546bd: folds
49115bd7: folds
bf45b565: folds
Hero: folds
Uncalled bet ($0.15) returned to 36447d0e
*** SHOWDOWN ***
36447d0e collected $0.25 from pot
*** SUMMARY ***
Total pot $0.25 | Rake $0 | Jackpot $0 | Bingo $0 | Fortune $0
Seat 1: 49115bd7 (button) folded before Flop (didn't bet)
Seat 2: bf45b565 (small blind) folded before Flop
Seat 3: Hero (big blind) folded before Flop
Seat 4: 36447d0e collected ($0.25)
Seat 5: 1b112a36 folded before Flop (didn't bet)
Seat 6: 827546bd folded before Flop (didn't bet)


Poker Hand #RC1433421589: Hold'em No Limit  ($0.05/$0.1) - 2023/03/27 19:59:59
Table 'RushAndCash28186849' 6-max Seat #1 is the button
Seat 1: 383a1187 ($9.96 in chips)
Seat 2: fc2ad3d9 ($13.78 in chips)
Seat 3: 65cd6bba ($14.33 in chips)
Seat 4: e5558e5d ($15.83 in chips)
Seat 5: 6f2108de ($13.83 in chips)
Seat 6: Hero ($24.59 in chips)
fc2ad3d9: posts small blind $0.05
65cd6bba: posts big blind $0.1
*** HOLE CARDS ***
Dealt to 383a1187 
Dealt to fc2ad3d9 
Dealt to 65cd6bba 
Dealt to e5558e5d 
Dealt to 6f2108de 
Dealt to Hero [7d 2c]
e5558e5d: raises $0.15 to $0.25
6f2108de: folds
Hero: folds
383a1187: calls $0.25
fc2ad3d9: folds
65cd6bba: calls $0.15
*** FLOP *** [Ad 4s Qd]
65cd6bba: checks
e5558e5d: checks
383a1187: bets $0.27
65cd6bba: folds
e5558e5d: folds
Uncalled bet ($0.27) returned to 383a1187
*** SHOWDOWN ***
383a1187 collected $0.76 from pot
*** SUMMARY ***
Total pot $0.8 | Rake $0.04 | Jackpot $0 | Bingo $0 | Fortune $0
Board [Ad 4s Qd]
Seat 1: 383a1187 (button) won ($0.76)
Seat 2: fc2ad3d9 (small blind) folded before Flop
Seat 3: 65cd6bba (big blind) folded on the Flop
Seat 4: e5558e5d folded on the Flop
Seat 5: 6f2108de folded before Flop (didn't bet)
Seat 6: Hero folded before Flop (didn't bet)


Poker Hand #RC1433421449: Hold'em No Limit  ($0.05/$0.1) - 2023/03/27 19:59:42
Table 'RushAndCash28186709' 6-max Seat #1 is the button
Seat 1: 74aeaadc ($34.52 in chips)
Seat 2: Hero ($24.64 in chips)
Seat 3: cd69ffb3 ($7.13 in chips)
Seat 4: 6a6e1e5b ($10 in chips)
Seat 5: 8780c7dc ($10 in chips)
Seat 6: 39e8110d ($40.06 in chips)
Hero: posts small blind $0.05
cd69ffb3: posts big blind $0.1
*** HOLE CARDS ***
Dealt to 74aeaadc 
Dealt to Hero [Ks 7c]
Dealt to cd69ffb3 
Dealt to 6a6e1e5b 
Dealt to 8780c7dc 
Dealt to 39e8110d 
6a6e1e5b: raises $0.15 to $0.25
8780c7dc: folds
39e8110d: folds
74aeaadc: folds
Hero: folds
cd69ffb3: folds
Uncalled bet ($0.15) returned to 6a6e1e5b
*** SHOWDOWN ***
6a6e1e5b collected $0.25 from pot
*** SUMMARY ***
Total pot $0.25 | Rake $0 | Jackpot $0 | Bingo $0 | Fortune $0
Seat 1: 74aeaadc (button) folded before Flop (didn't bet)
Seat 2: Hero (small blind) folded before Flop
Seat 3: cd69ffb3 (big blind) folded before Flop
Seat 4: 6a6e1e5b collected ($0.25)
Seat 5: 8780c7dc folded before Flop (didn't bet)
Seat 6: 39e8110d folded before Flop (didn't bet)


Poker Hand #RC1433421304: Hold'em No Limit  ($0.05/$0.1) - 2023/03/27 19:59:21
Table 'RushAndCash28186564' 6-max Seat #1 is the button
Seat 1: 2a6214a4 ($9.13 in chips)
Seat 2: b95c5a94 ($22.44 in chips)
Seat 3: 1465f502 ($16.57 in chips)
Seat 4: d31f0aeb ($11.82 in chips)
Seat 5: 9386f657 ($10 in chips)
Seat 6: Hero ($24.64 in chips)
b95c5a94: posts small blind $0.05
1465f502: posts big blind $0.1
*** HOLE CARDS ***
Dealt to 2a6214a4 
Dealt to b95c5a94 
Dealt to 1465f502 
Dealt to d31f0aeb 
Dealt to 9386f657 
Dealt to Hero [7s 6c]
d31f0aeb: folds
9386f657: folds
Hero: folds
2a6214a4: folds
b95c5a94: folds
Uncalled bet ($0.05) returned to 1465f502
*** SHOWDOWN ***
1465f502 collected $0.1 from pot
*** SUMMARY ***
Total pot $0.1 | Rake $0 | Jackpot $0 | Bingo $0 | Fortune $0
Seat 1: 2a6214a4 (button) folded before Flop (didn't bet)
Seat 2: b95c5a94 (small blind) folded before Flop
Seat 3: 1465f502 (big blind) collected ($0.1)
Seat 4: d31f0aeb folded before Flop (didn't bet)
Seat 5: 9386f657 folded before Flop (didn't bet)
Seat 6: Hero folded before Flop (didn't bet)


Poker Hand #RC1433421248: Hold'em No Limit  ($0.05/$0.1) - 2023/03/27 19:59:13
Table 'RushAndCash28186508' 6-max Seat #1 is the button
Seat 1: 1224b2f5 ($11.82 in chips)
Seat 2: 276936c5 ($20.62 in chips)
Seat 3: b33f3b23 ($10.15 in chips)
Seat 4: d775ce74 ($10.41 in chips)
Seat 5: a8749690 ($22.51 in chips)
Seat 6: Hero ($24.64 in chips)
276936c5: posts small blind $0.05
b33f3b23: posts big blind $0.1
*** HOLE CARDS ***
Dealt to 1224b2f5 
Dealt to 276936c5 
Dealt to b33f3b23 
Dealt to d775ce74 
Dealt to a8749690 
Dealt to Hero [2s 2d]
d775ce74: raises $0.12 to $0.22
a8749690: folds
Hero: folds
1224b2f5: folds
276936c5: folds
b33f3b23: folds
Uncalled bet ($0.12) returned to d775ce74
*** SHOWDOWN ***
d775ce74 collected $0.25 from pot
*** SUMMARY ***
Total pot $0.25 | Rake $0 | Jackpot $0 | Bingo $0 | Fortune $0
Seat 1: 1224b2f5 (button) folded before Flop (didn't bet)
Seat 2: 276936c5 (small blind) folded before Flop
Seat 3: b33f3b23 (big blind) folded before Flop
Seat 4: d775ce74 collected ($0.25)
Seat 5: a8749690 folded before Flop (didn't bet)
Seat 6: Hero folded before Flop (didn't bet)


Poker Hand #RC1433421196: Hold'em No Limit  ($0.05/$0.1) - 2023/03/27 19:59:06
Table 'RushAndCash28186456' 6-max Seat #1 is the button
Seat 1: e3ec02d8 ($10 in chips)
Seat 2: Hero ($24.69 in chips)
Seat 3: a072fee2 ($22.28 in chips)
Seat 4: b95c5a94 ($22.44 in chips)
Seat 5: 593ff255 ($25.78 in chips)
Seat 6: 5b794c0c ($10 in chips)
Hero: posts small blind $0.05
a072fee2: posts big blind $0.1
*** HOLE CARDS ***
Dealt to e3ec02d8 
Dealt to Hero [8s Tc]
Dealt to a072fee2 
Dealt to b95c5a94 
Dealt to 593ff255 
Dealt to 5b794c0c 
b95c5a94: folds
593ff255: folds
5b794c0c: folds
e3ec02d8: raises $0.12 to $0.22
Hero: folds
a072fee2: calls $0.12
*** FLOP *** [2h Td 4s]
a072fee2: checks
e3ec02d8: checks
*** TURN *** [2h Td 4s] [3s]
a072fee2: bets $0.25
e3ec02d8: folds
Uncalled bet ($0.25) returned to a072fee2
*** SHOWDOWN ***
a072fee2 collected $0.47 from pot
*** SUMMARY ***
Total pot $0.49 | Rake $0.02 | Jackpot $0 | Bingo $0 | Fortune $0
Board [2h Td 4s 3s]
Seat 1: e3ec02d8 (button) folded on the Turn
Seat 2: Hero (small blind) folded before Flop
Seat 3: a072fee2 (big blind) won ($0.47)
Seat 4: b95c5a94 folded before Flop (didn't bet)
Seat 5: 593ff255 folded before Flop (didn't bet)
Seat 6: 5b794c0c folded before Flop (didn't bet)


Poker Hand #RC1433421168: Hold'em No Limit  ($0.05/$0.1) - 2023/03/27 19:59:02
Table 'RushAndCash28186428' 6-max Seat #1 is the button
Seat 1: dc5d8f31 ($14.11 in chips)
Seat 2: fffa798a ($17.68 in chips)
Seat 3: cb21e9b0 ($10.17 in chips)
Seat 4: Hero ($24.69 in chips)
Seat 5: 95295879 ($19.65 in chips)
Seat 6: 598c3445 ($10 in chips)
fffa798a: posts small blind $0.05
cb21e9b0: posts big blind $0.1
*** HOLE CARDS ***
Dealt to dc5d8f31 
Dealt to fffa798a 
Dealt to cb21e9b0 
Dealt to Hero [7s 5h]
Dealt to 95295879 
Dealt to 598c3445 
Hero: folds
95295879: folds
598c3445: raises $0.15 to $0.25
dc5d8f31: folds
fffa798a: folds
cb21e9b0: calls $0.15
*** FLOP *** [2d 8c Kd]
cb21e9b0: checks
598c3445: bets $0.28
cb21e9b0: folds
Uncalled bet ($0.28) returned to 598c3445
*** SHOWDOWN ***
598c3445 collected $0.53 from pot
*** SUMMARY ***
Total pot $0.55 | Rake $0.02 | Jackpot $0 | Bingo $0 | Fortune $0
Board [2d 8c Kd]
Seat 1: dc5d8f31 (button) folded before Flop (didn't bet)
Seat 2: fffa798a (small blind) folded before Flop
Seat 3: cb21e9b0 (big blind) folded on the Flop
Seat 4: Hero folded before Flop (didn't bet)
Seat 5: 95295879 folded before Flop (didn't bet)
Seat 6: 598c3445 won ($0.53)


Poker Hand #RC1433421062: Hold'em No Limit  ($0.05/$0.1) - 2023/03/27 19:58:48
Table 'RushAndCash28186322' 6-max Seat #1 is the button
Seat 1: Hero ($24.54 in chips)
Seat 2: cb07d9e3 ($10 in chips)
Seat 3: 9d068308 ($36.79 in chips)
Seat 4: 5703c24a ($10.02 in chips)
Seat 5: f59c9ff2 ($20.37 in chips)
Seat 6: d6d3c886 ($13.32 in chips)
cb07d9e3: posts small blind $0.05
9d068308: posts big blind $0.1
*** HOLE CARDS ***
Dealt to Hero [Ad 9s]
Dealt to cb07d9e3 
Dealt to 9d068308 
Dealt to 5703c24a 
Dealt to f59c9ff2 
Dealt to d6d3c886 
5703c24a: folds
f59c9ff2: folds
d6d3c886: folds
Hero: raises $0.15 to $0.25
cb07d9e3: folds
9d068308: folds
Uncalled bet ($0.15) returned to Hero
*** SHOWDOWN ***
Hero collected $0.25 from pot
*** SUMMARY ***
Total pot $0.25 | Rake $0 | Jackpot $0 | Bingo $0 | Fortune $0
Seat 1: Hero (button) collected ($0.25)
Seat 2: cb07d9e3 (small blind) folded before Flop
Seat 3: 9d068308 (big blind) folded before Flop
Seat 4: 5703c24a folded before Flop (didn't bet)
Seat 5: f59c9ff2 folded before Flop (didn't bet)
Seat 6: d6d3c886 folded before Flop (didn't bet)


Poker Hand #RC1433421020: Hold'em No Limit  ($0.05/$0.1) - 2023/03/27 19:58:43
Table 'RushAndCash28186280' 6-max Seat #1 is the button
Seat 1: cf8aa551 ($7.53 in chips)
Seat 2: 48c9ce8 ($10.52 in chips)
Seat 3: b37d67b5 ($11.02 in chips)
Seat 4: Hero ($24.54 in chips)
Seat 5: 330b6b8b ($10 in chips)
Seat 6: 49f6e3fa ($10 in chips)
48c9ce8: posts small blind $0.05
b37d67b5: posts big blind $0.1
*** HOLE CARDS ***
Dealt to cf8aa551 
Dealt to 48c9ce8 
Dealt to b37d67b5 
Dealt to Hero [4s Ad]
Dealt to 330b6b8b 
Dealt to 49f6e3fa 
Hero: folds
330b6b8b: folds
49f6e3fa: folds
cf8aa551: raises $0.15 to $0.25
48c9ce8: folds
b37d67b5: folds
Uncalled bet ($0.15) returned to cf8aa551
*** SHOWDOWN ***
cf8aa551 collected $0.25 from pot
*** SUMMARY ***
Total pot $0.25 | Rake $0 | Jackpot $0 | Bingo $0 | Fortune $0
Seat 1: cf8aa551 (button) collected ($0.25)
Seat 2: 48c9ce8 (small blind) folded before Flop
Seat 3: b37d67b5 (big blind) folded before Flop
Seat 4: Hero folded before Flop (didn't bet)
Seat 5: 330b6b8b folded before Flop (didn't bet)
Seat 6: 49f6e3fa folded before Flop (didn't bet)


Poker Hand #RC1433420910: Hold'em No Limit  ($0.05/$0.1) - 2023/03/27 19:58:27
Table 'RushAndCash28186170' 6-max Seat #1 is the button
Seat 1: Hero ($24.54 in chips)
Seat 2: 11b64430 ($16.97 in chips)
Seat 3: 983458b3 ($10.17 in chips)
Seat 4: 48a17f8e ($28.53 in chips)
Seat 5: dca30c55 ($11.26 in chips)
Seat 6: c8d773b0 ($9.61 in chips)
11b64430: posts small blind $0.05
983458b3: posts big blind $0.1
*** HOLE CARDS ***
Dealt to Hero [3d 2d]
Dealt to 11b64430 
Dealt to 983458b3 
Dealt to 48a17f8e 
Dealt to dca30c55 
Dealt to c8d773b0 
48a17f8e: folds
dca30c55: raises $0.2 to $0.3
c8d773b0: folds
Hero: folds
11b64430: folds
983458b3: folds
Uncalled bet ($0.2) returned to dca30c55
*** SHOWDOWN ***
dca30c55 collected $0.25 from pot
*** SUMMARY ***
Total pot $0.25 | Rake $0 | Jackpot $0 | Bingo $0 | Fortune $0
Seat 1: Hero (button) folded before Flop (didn't bet)
Seat 2: 11b64430 (small blind) folded before Flop
Seat 3: 983458b3 (big blind) folded before Flop
Seat 4: 48a17f8e folded before Flop (didn't bet)
Seat 5: dca30c55 collected ($0.25)
Seat 6: c8d773b0 folded before Flop (didn't bet)


Poker Hand #RC1433420829: Hold'em No Limit  ($0.05/$0.1) - 2023/03/27 19:58:18
Table 'RushAndCash28186089' 6-max Seat #1 is the button
Seat 1: 5bdca8b7 ($14.04 in chips)
Seat 2: Hero ($24.59 in chips)
Seat 3: 34a727ec ($15.89 in chips)
Seat 4: aba43cc3 ($10 in chips)
Seat 5: a958157e ($11.22 in chips)
Seat 6: 983458b3 ($10.17 in chips)
Hero: posts small blind $0.05
34a727ec: posts big blind $0.1
*** HOLE CARDS ***
Dealt to 5bdca8b7 
Dealt to Hero [Jc 4h]
Dealt to 34a727ec 
Dealt to aba43cc3 
Dealt to a958157e 
Dealt to 983458b3 
aba43cc3: folds
a958157e: folds
983458b3: folds
5bdca8b7: folds
Hero: folds
Uncalled bet ($0.05) returned to 34a727ec
*** SHOWDOWN ***
34a727ec collected $0.1 from pot
*** SUMMARY ***
Total pot $0.1 | Rake $0 | Jackpot $0 | Bingo $0 | Fortune $0
Seat 1: 5bdca8b7 (button) folded before Flop (didn't bet)
Seat 2: Hero (small blind) folded before Flop
Seat 3: 34a727ec (big blind) collected ($0.1)
Seat 4: aba43cc3 folded before Flop (didn't bet)
Seat 5: a958157e folded before Flop (didn't bet)
Seat 6: 983458b3 folded before Flop (didn't bet)


Poker Hand #RC1433420767: Hold'em No Limit  ($0.05/$0.1) - 2023/03/27 19:58:09
Table 'RushAndCash28186027' 6-max Seat #1 is the button
Seat 1: Hero ($24.59 in chips)
Seat 2: 32d03af5 ($26.58 in chips)
Seat 3: 29e6c0ca ($13.13 in chips)
Seat 4: 3f48a6c1 ($12.05 in chips)
Seat 5: b474cf69 ($10.71 in chips)
Seat 6: 39e8110d ($39.84 in chips)
32d03af5: posts small blind $0.05
29e6c0ca: posts big blind $0.1
*** HOLE CARDS ***
Dealt to Hero [4s 5d]
Dealt to 32d03af5 
Dealt to 29e6c0ca 
Dealt to 3f48a6c1 
Dealt to b474cf69 
Dealt to 39e8110d 
3f48a6c1: folds
b474cf69: folds
39e8110d: folds
Hero: folds
32d03af5: folds
Uncalled bet ($0.05) returned to 29e6c0ca
*** SHOWDOWN ***
29e6c0ca collected $0.1 from pot
*** SUMMARY ***
Total pot $0.1 | Rake $0 | Jackpot $0 | Bingo $0 | Fortune $0
Seat 1: Hero (button) folded before Flop (didn't bet)
Seat 2: 32d03af5 (small blind) folded before Flop
Seat 3: 29e6c0ca (big blind) collected ($0.1)
Seat 4: 3f48a6c1 folded before Flop (didn't bet)
Seat 5: b474cf69 folded before Flop (didn't bet)
Seat 6: 39e8110d folded before Flop (didn't bet)


Poker Hand #RC1433420582: Hold'em No Limit  ($0.05/$0.1) - 2023/03/27 19:57:46
Table 'RushAndCash28185842' 6-max Seat #1 is the button
Seat 1: aa6656f4 ($18.88 in chips)
Seat 2: 2d7d9ed3 ($10.05 in chips)
Seat 3: Hero ($24.69 in chips)
Seat 4: a8749690 ($21.21 in chips)
Seat 5: 2012d077 ($10.46 in chips)
Seat 6: 85a21540 ($9.59 in chips)
2d7d9ed3: posts small blind $0.05
Hero: posts big blind $0.1
*** HOLE CARDS ***
Dealt to aa6656f4 
Dealt to 2d7d9ed3 
Dealt to Hero [9d Kc]
Dealt to a8749690 
Dealt to 2012d077 
Dealt to 85a21540 
a8749690: raises $0.2 to $0.3
2012d077: folds
85a21540: folds
aa6656f4: folds
2d7d9ed3: folds
Hero: folds
Uncalled bet ($0.2) returned to a8749690
*** SHOWDOWN ***
a8749690 collected $0.25 from pot
*** SUMMARY ***
Total pot $0.25 | Rake $0 | Jackpot $0 | Bingo $0 | Fortune $0
Seat 1: aa6656f4 (button) folded before Flop (didn't bet)
Seat 2: 2d7d9ed3 (small blind) folded before Flop
Seat 3: Hero (big blind) folded before Flop
Seat 4: a8749690 collected ($0.25)
Seat 5: 2012d077 folded before Flop (didn't bet)
Seat 6: 85a21540 folded before Flop (didn't bet)


Poker Hand #RC1433420464: Hold'em No Limit  ($0.05/$0.1) - 2023/03/27 19:57:30
Table 'RushAndCash28185724' 6-max Seat #1 is the button
Seat 1: 9bc2c2b3 ($11.77 in chips)
Seat 2: 7fbc674c ($10.05 in chips)
Seat 3: abe66055 ($8.99 in chips)
Seat 4: Hero ($24.54 in chips)
Seat 5: 62cd9292 ($9.56 in chips)
Seat 6: e7f48829 ($10.32 in chips)
7fbc674c: posts small blind $0.05
abe66055: posts big blind $0.1
*** HOLE CARDS ***
Dealt to 9bc2c2b3 
Dealt to 7fbc674c 
Dealt to abe66055 
Dealt to Hero [Td Th]
Dealt to 62cd9292 
Dealt to e7f48829 
Hero: raises $0.15 to $0.25
62cd9292: folds
e7f48829: folds
9bc2c2b3: folds
7fbc674c: folds
abe66055: folds
Uncalled bet ($0.15) returned to Hero
*** SHOWDOWN ***
Hero collected $0.25 from pot
*** SUMMARY ***
Total pot $0.25 | Rake $0 | Jackpot $0 | Bingo $0 | Fortune $0
Seat 1: 9bc2c2b3 (button) folded before Flop (didn't bet)
Seat 2: 7fbc674c (small blind) folded before Flop
Seat 3: abe66055 (big blind) folded before Flop
Seat 4: Hero collected ($0.25)
Seat 5: 62cd9292 folded before Flop (didn't bet)
Seat 6: e7f48829 folded before Flop (didn't bet)


Poker Hand #RC1433420422: Hold'em No Limit  ($0.05/$0.1) - 2023/03/27 19:57:24
Table 'RushAndCash28185682' 6-max Seat #1 is the button
Seat 1: Hero ($24.54 in chips)
Seat 2: 784858c ($24.52 in chips)
Seat 3: 5b06e1bc ($10.84 in chips)
Seat 4: 2d7d9ed3 ($10 in chips)
Seat 5: eca19ee0 ($28.48 in chips)
Seat 6: c3bde2ae ($40.56 in chips)
784858c: posts small blind $0.05
5b06e1bc: posts big blind $0.1
*** HOLE CARDS ***
Dealt to Hero [5d Ks]
Dealt to 784858c 
Dealt to 5b06e1bc 
Dealt to 2d7d9ed3 
Dealt to eca19ee0 
Dealt to c3bde2ae 
2d7d9ed3: folds
eca19ee0: folds
c3bde2ae: folds
Hero: folds
784858c: folds
Uncalled bet ($0.05) returned to 5b06e1bc
*** SHOWDOWN ***
5b06e1bc collected $0.1 from pot
*** SUMMARY ***
Total pot $0.1 | Rake $0 | Jackpot $0 | Bingo $0 | Fortune $0
Seat 1: Hero (button) folded before Flop (didn't bet)
Seat 2: 784858c (small blind) folded before Flop
Seat 3: 5b06e1bc (big blind) collected ($0.1)
Seat 4: 2d7d9ed3 folded before Flop (didn't bet)
Seat 5: eca19ee0 folded before Flop (didn't bet)
Seat 6: c3bde2ae folded before Flop (didn't bet)


Poker Hand #RC1433420368: Hold'em No Limit  ($0.05/$0.1) - 2023/03/27 19:57:17
Table 'RushAndCash28185628' 6-max Seat #1 is the button
Seat 1: Hero ($24.54 in chips)
Seat 2: dc998080 ($19.26 in chips)
Seat 3: b29a11f ($12.45 in chips)
Seat 4: 43619f04 ($10.05 in chips)
Seat 5: 8780c7dc ($9.75 in chips)
Seat 6: ee6da5a5 ($9 in chips)
dc998080: posts small blind $0.05
b29a11f: posts big blind $0.1
*** HOLE CARDS ***
Dealt to Hero [9d 6c]
Dealt to dc998080 
Dealt to b29a11f 
Dealt to 43619f04 
Dealt to 8780c7dc 
Dealt to ee6da5a5 
43619f04: folds
8780c7dc: folds
ee6da5a5: folds
Hero: folds
dc998080: folds
Uncalled bet ($0.05) returned to b29a11f
*** SHOWDOWN ***
b29a11f collected $0.1 from pot
*** SUMMARY ***
Total pot $0.1 | Rake $0 | Jackpot $0 | Bingo $0 | Fortune $0
Seat 1: Hero (button) folded before Flop (didn't bet)
Seat 2: dc998080 (small blind) folded before Flop
Seat 3: b29a11f (big blind) collected ($0.1)
Seat 4: 43619f04 folded before Flop (didn't bet)
Seat 5: 8780c7dc folded before Flop (didn't bet)
Seat 6: ee6da5a5 folded before Flop (didn't bet)


Poker Hand #RC1433420253: Hold'em No Limit  ($0.05/$0.1) - 2023/03/27 19:57:02
Table 'RushAndCash28185513' 6-max Seat #1 is the button
Seat 1: a2b79453 ($8.94 in chips)
Seat 2: b7a4653a ($10.39 in chips)
Seat 3: Hero ($24.64 in chips)
Seat 4: 947ec40d ($10.75 in chips)
Seat 5: ed53e62f ($2.78 in chips)
Seat 6: d775ce74 ($10.76 in chips)
b7a4653a: posts small blind $0.05
Hero: posts big blind $0.1
*** HOLE CARDS ***
Dealt to a2b79453 
Dealt to b7a4653a 
Dealt to Hero [3s 4s]
Dealt to 947ec40d 
Dealt to ed53e62f 
Dealt to d775ce74 
947ec40d: folds
ed53e62f: folds
d775ce74: folds
a2b79453: raises $0.15 to $0.25
b7a4653a: folds
Hero: folds
Uncalled bet ($0.15) returned to a2b79453
*** SHOWDOWN ***
a2b79453 collected $0.25 from pot
*** SUMMARY ***
Total pot $0.25 | Rake $0 | Jackpot $0 | Bingo $0 | Fortune $0
Seat 1: a2b79453 (button) collected ($0.25)
Seat 2: b7a4653a (small blind) folded before Flop
Seat 3: Hero (big blind) folded before Flop
Seat 4: 947ec40d folded before Flop (didn't bet)
Seat 5: ed53e62f folded before Flop (didn't bet)
Seat 6: d775ce74 folded before Flop (didn't bet)


Poker Hand #RC1433420095: Hold'em No Limit  ($0.05/$0.1) - 2023/03/27 19:56:41
Table 'RushAndCash28185355' 6-max Seat #1 is the button
Seat 1: 7b273955 ($12.9 in chips)
Seat 2: Hero ($24.69 in chips)
Seat 3: 47503c44 ($25.91 in chips)
Seat 4: 8359c553 ($11.7 in chips)
Seat 5: 39e8110d ($39.94 in chips)
Seat 6: f137d313 ($11.14 in chips)
Hero: posts small blind $0.05
47503c44: posts big blind $0.1
*** HOLE CARDS ***
Dealt to 7b273955 
Dealt to Hero [Jh 6d]
Dealt to 47503c44 
Dealt to 8359c553 
Dealt to 39e8110d 
Dealt to f137d313 
8359c553: folds
39e8110d: folds
f137d313: folds
7b273955: raises $0.15 to $0.25
Hero: folds
47503c44: folds
Uncalled bet ($0.15) returned to 7b273955
*** SHOWDOWN ***
7b273955 collected $0.25 from pot
*** SUMMARY ***
Total pot $0.25 | Rake $0 | Jackpot $0 | Bingo $0 | Fortune $0
Seat 1: 7b273955 (button) collected ($0.25)
Seat 2: Hero (small blind) folded before Flop
Seat 3: 47503c44 (big blind) folded before Flop
Seat 4: 8359c553 folded before Flop (didn't bet)
Seat 5: 39e8110d folded before Flop (didn't bet)
Seat 6: f137d313 folded before Flop (didn't bet)


Poker Hand #RC1433420062: Hold'em No Limit  ($0.05/$0.1) - 2023/03/27 19:56:36
Table 'RushAndCash28185322' 6-max Seat #1 is the button
Seat 1: dca30c55 ($9.92 in chips)
Seat 2: efc583b ($10 in chips)
Seat 3: b98e778e ($10 in chips)
Seat 4: a725b62e ($30.23 in chips)
Seat 5: 2dbc16ad ($13.13 in chips)
Seat 6: Hero ($24.69 in chips)
efc583b: posts small blind $0.05
b98e778e: posts big blind $0.1
*** HOLE CARDS ***
Dealt to dca30c55 
Dealt to efc583b 
Dealt to b98e778e 
Dealt to a725b62e 
Dealt to 2dbc16ad 
Dealt to Hero [Js 4s]
a725b62e: folds
2dbc16ad: folds
Hero: folds
dca30c55: folds
efc583b: folds
Uncalled bet ($0.05) returned to b98e778e
*** SHOWDOWN ***
b98e778e collected $0.1 from pot
*** SUMMARY ***
Total pot $0.1 | Rake $0 | Jackpot $0 | Bingo $0 | Fortune $0
Seat 1: dca30c55 (button) folded before Flop (didn't bet)
Seat 2: efc583b (small blind) folded before Flop
Seat 3: b98e778e (big blind) collected ($0.1)
Seat 4: a725b62e folded before Flop (didn't bet)
Seat 5: 2dbc16ad folded before Flop (didn't bet)
Seat 6: Hero folded before Flop (didn't bet)


Poker Hand #RC1433419806: Hold'em No Limit  ($0.05/$0.1) - 2023/03/27 19:56:03
Table 'RushAndCash28185066' 6-max Seat #1 is the button
Seat 1: 2dbc16ad ($12.76 in chips)
Seat 2: 1b112a36 ($10.92 in chips)
Seat 3: 6fbdaf69 ($12.42 in chips)
Seat 4: efc583b ($10.08 in chips)
Seat 5: Hero ($24.94 in chips)
Seat 6: abf042fe ($10.54 in chips)
1b112a36: posts small blind $0.05
6fbdaf69: posts big blind $0.1
*** HOLE CARDS ***
Dealt to 2dbc16ad 
Dealt to 1b112a36 
Dealt to 6fbdaf69 
Dealt to efc583b 
Dealt to Hero [7c 8c]
Dealt to abf042fe 
efc583b: folds
Hero: raises $0.15 to $0.25
abf042fe: folds
2dbc16ad: raises $0.55 to $0.8
1b112a36: folds
6fbdaf69: folds
Hero: folds
Uncalled bet ($0.55) returned to 2dbc16ad
*** SHOWDOWN ***
2dbc16ad collected $0.62 from pot
*** SUMMARY ***
Total pot $0.65 | Rake $0.03 | Jackpot $0 | Bingo $0 | Fortune $0
Seat 1: 2dbc16ad (button) collected ($0.62)
Seat 2: 1b112a36 (small blind) folded before Flop
Seat 3: 6fbdaf69 (big blind) folded before Flop
Seat 4: efc583b folded before Flop (didn't bet)
Seat 5: Hero folded before Flop
Seat 6: abf042fe folded before Flop (didn't bet)


Poker Hand #RC1433419714: Hold'em No Limit  ($0.05/$0.1) - 2023/03/27 19:55:51
Table 'RushAndCash28184974' 6-max Seat #1 is the button
Seat 1: dd35185f ($11.11 in chips)
Seat 2: Hero ($24.84 in chips)
Seat 3: 484f9657 ($16.66 in chips)
Seat 4: 6b714094 ($16.04 in chips)
Seat 5: ed45c484 ($5.03 in chips)
Seat 6: 9d068308 ($36.16 in chips)
Hero: posts small blind $0.05
484f9657: posts big blind $0.1
*** HOLE CARDS ***
Dealt to dd35185f 
Dealt to Hero [Ks Qh]
Dealt to 484f9657 
Dealt to 6b714094 
Dealt to ed45c484 
Dealt to 9d068308 
6b714094: folds
ed45c484: folds
9d068308: folds
dd35185f: folds
Hero: raises $0.2 to $0.3
484f9657: folds
Uncalled bet ($0.2) returned to Hero
*** SHOWDOWN ***
Hero collected $0.2 from pot
*** SUMMARY ***
Total pot $0.2 | Rake $0 | Jackpot $0 | Bingo $0 | Fortune $0
Seat 1: dd35185f (button) folded before Flop (didn't bet)
Seat 2: Hero (small blind) collected ($0.2)
Seat 3: 484f9657 (big blind) folded before Flop
Seat 4: 6b714094 folded before Flop (didn't bet)
Seat 5: ed45c484 folded before Flop (didn't bet)
Seat 6: 9d068308 folded before Flop (didn't bet)


Poker Hand #RC1433419322: Hold'em No Limit  ($0.05/$0.1) - 2023/03/27 19:54:53
Table 'RushAndCash28184582' 6-max Seat #1 is the button
Seat 1: a2eabb9a ($20.37 in chips)
Seat 2: ed45c484 ($7.08 in chips)
Seat 3: 53989c53 ($27.09 in chips)
Seat 4: Hero ($23.04 in chips)
Seat 5: 29e6c0ca ($13.43 in chips)
Seat 6: 126c704e ($20.64 in chips)
ed45c484: posts small blind $0.05
53989c53: posts big blind $0.1
*** HOLE CARDS ***
Dealt to a2eabb9a 
Dealt to ed45c484 
Dealt to 53989c53 
Dealt to Hero [Ad Js]
Dealt to 29e6c0ca 
Dealt to 126c704e 
Hero: raises $0.15 to $0.25
29e6c0ca: folds
126c704e: folds
a2eabb9a: folds
ed45c484: calls $0.2
53989c53: folds
*** FLOP *** [9c Jc 8s]
ed45c484: checks
Hero: bets $0.3
ed45c484: calls $0.3
*** TURN *** [9c Jc 8s] [2h]
ed45c484: checks
Hero: bets $0.6
ed45c484: calls $0.6
*** RIVER *** [9c Jc 8s 2h] [3d]
ed45c484: checks
Hero: bets $0.9
ed45c484: calls $0.9
Hero: shows [Ad Js] (Pair of Jacks)
ed45c484: shows [4c 4s] (Pair of Fours)
*** SHOWDOWN ***
Hero collected $3.85 from pot
*** SUMMARY ***
Total pot $4.2 | Rake $0.2 | Jackpot $0.15 | Bingo $0 | Fortune $0
Board [9c Jc 8s 2h 3d]
Seat 1: a2eabb9a (button) folded before Flop (didn't bet)
Seat 2: ed45c484 (small blind) showed [4c 4s] and lost with Pair of Fours
Seat 3: 53989c53 (big blind) folded before Flop
Seat 4: Hero showed [Ad Js] and won ($3.85) with Pair of Jacks
Seat 5: 29e6c0ca folded before Flop (didn't bet)
Seat 6: 126c704e folded before Flop (didn't bet)


Poker Hand #RC1433419282: Hold'em No Limit  ($0.05/$0.1) - 2023/03/27 19:54:47
Table 'RushAndCash28184542' 6-max Seat #1 is the button
Seat 1: fde8b9ee ($21.54 in chips)
Seat 2: f3de17dc ($39.51 in chips)
Seat 3: 94b5d25e ($19.19 in chips)
Seat 4: Hero ($23.04 in chips)
Seat 5: 276936c5 ($19.98 in chips)
Seat 6: 68d06b70 ($13.45 in chips)
f3de17dc: posts small blind $0.05
94b5d25e: posts big blind $0.1
*** HOLE CARDS ***
Dealt to fde8b9ee 
Dealt to f3de17dc 
Dealt to 94b5d25e 
Dealt to Hero [Qs 6s]
Dealt to 276936c5 
Dealt to 68d06b70 
Hero: folds
276936c5: raises $0.15 to $0.25
68d06b70: folds
fde8b9ee: folds
f3de17dc: folds
94b5d25e: folds
Uncalled bet ($0.15) returned to 276936c5
*** SHOWDOWN ***
276936c5 collected $0.25 from pot
*** SUMMARY ***
Total pot $0.25 | Rake $0 | Jackpot $0 | Bingo $0 | Fortune $0
Seat 1: fde8b9ee (button) folded before Flop (didn't bet)
Seat 2: f3de17dc (small blind) folded before Flop
Seat 3: 94b5d25e (big blind) folded before Flop
Seat 4: Hero folded before Flop (didn't bet)
Seat 5: 276936c5 collected ($0.25)
Seat 6: 68d06b70 folded before Flop (didn't bet)


Poker Hand #RC1433419252: Hold'em No Limit  ($0.05/$0.1) - 2023/03/27 19:54:43
Table 'RushAndCash28184512' 6-max Seat #1 is the button
Seat 1: c2c593b0 ($17.07 in chips)
Seat 2: c373ffff ($10 in chips)
Seat 3: 409d9b29 ($23.05 in chips)
Seat 4: Hero ($23.04 in chips)
Seat 5: b6561df5 ($10.39 in chips)
Seat 6: a196a486 ($10.67 in chips)
c373ffff: posts small blind $0.05
409d9b29: posts big blind $0.1
*** HOLE CARDS ***
Dealt to c2c593b0 
Dealt to c373ffff 
Dealt to 409d9b29 
Dealt to Hero [8d 5d]
Dealt to b6561df5 
Dealt to a196a486 
Hero: folds
b6561df5: raises $0.15 to $0.25
a196a486: calls $0.25
c2c593b0: folds
c373ffff: folds
409d9b29: folds
*** FLOP *** [2s Qh 3h]
b6561df5: bets $0.22
a196a486: calls $0.22
*** TURN *** [2s Qh 3h] [Js]
b6561df5: checks
a196a486: bets $0.56
b6561df5: calls $0.56
*** RIVER *** [2s Qh 3h Js] [8h]
b6561df5: checks
a196a486: checks
b6561df5: shows [4h 5h] (Queen High Flush)
a196a486: shows [Td Qd] (Pair of Queens)
*** SHOWDOWN ***
b6561df5 collected $2.1 from pot
*** SUMMARY ***
Total pot $2.21 | Rake $0.11 | Jackpot $0 | Bingo $0 | Fortune $0
Board [2s Qh 3h Js 8h]
Seat 1: c2c593b0 (button) folded before Flop (didn't bet)
Seat 2: c373ffff (small blind) folded before Flop
Seat 3: 409d9b29 (big blind) folded before Flop
Seat 4: Hero folded before Flop (didn't bet)
Seat 5: b6561df5 showed [4h 5h] and won ($2.1) with Queen High Flush
Seat 6: a196a486 showed [Td Qd] and lost with Pair of Queens


Poker Hand #RC1433419083: Hold'em No Limit  ($0.05/$0.1) - 2023/03/27 19:54:20
Table 'RushAndCash28184343' 6-max Seat #1 is the button
Seat 1: 95d8c2ff ($10 in chips)
Seat 2: c2c593b0 ($17.12 in chips)
Seat 3: f9e611b4 ($10.17 in chips)
Seat 4: b8cfc951 ($19.6 in chips)
Seat 5: 1f96c8a9 ($10.98 in chips)
Seat 6: Hero ($21.76 in chips)
Cash Drop to Pot : total $1 
c2c593b0: posts small blind $0.05
f9e611b4: posts big blind $0.1
*** HOLE CARDS ***
Dealt to 95d8c2ff 
Dealt to c2c593b0 
Dealt to f9e611b4 
Dealt to b8cfc951 
Dealt to 1f96c8a9 
Dealt to Hero [8d Qd]
b8cfc951: raises $0.1 to $0.2
1f96c8a9: folds
Hero: raises $0.83 to $1.03
95d8c2ff: folds
c2c593b0: folds
f9e611b4: folds
b8cfc951: folds
Uncalled bet ($0.83) returned to Hero
*** SHOWDOWN ***
Hero collected $1.48 from pot
*** SUMMARY ***
Total pot $1.55 | Rake $0.07 | Jackpot $0 | Bingo $0 | Fortune $0
Seat 1: 95d8c2ff (button) folded before Flop (didn't bet)
Seat 2: c2c593b0 (small blind) folded before Flop
Seat 3: f9e611b4 (big blind) folded before Flop
Seat 4: b8cfc951 folded before Flop
Seat 5: 1f96c8a9 folded before Flop (didn't bet)
Seat 6: Hero collected ($1.48)


Poker Hand #RC1433418972: Hold'em No Limit  ($0.05/$0.1) - 2023/03/27 19:54:05
Table 'RushAndCash28184232' 6-max Seat #1 is the button
Seat 1: 94b5d25e ($19.04 in chips)
Seat 2: ef5704e0 ($7.79 in chips)
Seat 3: Hero ($21.71 in chips)
Seat 4: 2ffaa8f4 ($11.91 in chips)
Seat 5: ad0b92ed ($13.39 in chips)
Seat 6: 5f35b8c0 ($9.39 in chips)
ef5704e0: posts small blind $0.05
Hero: posts big blind $0.1
*** HOLE CARDS ***
Dealt to 94b5d25e 
Dealt to ef5704e0 
Dealt to Hero [Jd Ks]
Dealt to 2ffaa8f4 
Dealt to ad0b92ed 
Dealt to 5f35b8c0 
2ffaa8f4: folds
ad0b92ed: folds
5f35b8c0: folds
94b5d25e: folds
ef5704e0: folds
Uncalled bet ($0.05) returned to Hero
*** SHOWDOWN ***
Hero collected $0.1 from pot
*** SUMMARY ***
Total pot $0.1 | Rake $0 | Jackpot $0 | Bingo $0 | Fortune $0
Seat 1: 94b5d25e (button) folded before Flop (didn't bet)
Seat 2: ef5704e0 (small blind) folded before Flop
Seat 3: Hero (big blind) collected ($0.1)
Seat 4: 2ffaa8f4 folded before Flop (didn't bet)
Seat 5: ad0b92ed folded before Flop (didn't bet)
Seat 6: 5f35b8c0 folded before Flop (didn't bet)


Poker Hand #RC1433418939: Hold'em No Limit  ($0.05/$0.1) - 2023/03/27 19:54:00
Table 'RushAndCash28184199' 6-max Seat #1 is the button
Seat 1: 84607f77 ($4.8 in chips)
Seat 2: 7465263d ($55.65 in chips)
Seat 3: 98a8ff04 ($21.75 in chips)
Seat 4: 9a168a2f ($9.68 in chips)
Seat 5: dee5b20c ($18.79 in chips)
Seat 6: Hero ($21.71 in chips)
7465263d: posts small blind $0.05
98a8ff04: posts big blind $0.1
*** HOLE CARDS ***
Dealt to 84607f77 
Dealt to 7465263d 
Dealt to 98a8ff04 
Dealt to 9a168a2f 
Dealt to dee5b20c 
Dealt to Hero [2h Th]
9a168a2f: folds
dee5b20c: folds
Hero: folds
84607f77: raises $0.1 to $0.2
7465263d: folds
98a8ff04: calls $0.1
*** FLOP *** [Qd 3s 7s]
98a8ff04: checks
84607f77: checks
*** TURN *** [Qd 3s 7s] [4d]
98a8ff04: bets $0.34
84607f77: folds
Uncalled bet ($0.34) returned to 98a8ff04
*** SHOWDOWN ***
98a8ff04 collected $0.43 from pot
*** SUMMARY ***
Total pot $0.45 | Rake $0.02 | Jackpot $0 | Bingo $0 | Fortune $0
Board [Qd 3s 7s 4d]
Seat 1: 84607f77 (button) folded on the Turn
Seat 2: 7465263d (small blind) folded before Flop
Seat 3: 98a8ff04 (big blind) won ($0.43)
Seat 4: 9a168a2f folded before Flop (didn't bet)
Seat 5: dee5b20c folded before Flop (didn't bet)
Seat 6: Hero folded before Flop (didn't bet)


Poker Hand #RC1433418757: Hold'em No Limit  ($0.05/$0.1) - 2023/03/27 19:53:33
Table 'RushAndCash28184017' 6-max Seat #1 is the button
Seat 1: Hero ($21.96 in chips)
Seat 2: 84607f77 ($4.48 in chips)
Seat 3: ef336825 ($10 in chips)
Seat 4: b2418ee6 ($11.09 in chips)
Seat 5: f3de17dc ($39.76 in chips)
Seat 6: f572762b ($10 in chips)
84607f77: posts small blind $0.05
ef336825: posts big blind $0.1
*** HOLE CARDS ***
Dealt to Hero [Ac Jd]
Dealt to 84607f77 
Dealt to ef336825 
Dealt to b2418ee6 
Dealt to f3de17dc 
Dealt to f572762b 
b2418ee6: folds
f3de17dc: folds
f572762b: folds
Hero: raises $0.15 to $0.25
84607f77: raises $4.23 to $4.48 and is all-in
ef336825: folds
Hero: folds
Uncalled bet ($4.23) returned to 84607f77
*** SHOWDOWN ***
84607f77 collected $0.57 from pot
*** SUMMARY ***
Total pot $0.6 | Rake $0.03 | Jackpot $0 | Bingo $0 | Fortune $0
Seat 1: Hero (button) folded before Flop
Seat 2: 84607f77 (small blind) collected ($0.57)
Seat 3: ef336825 (big blind) folded before Flop
Seat 4: b2418ee6 folded before Flop (didn't bet)
Seat 5: f3de17dc folded before Flop (didn't bet)
Seat 6: f572762b folded before Flop (didn't bet)


Poker Hand #RC1433418732: Hold'em No Limit  ($0.05/$0.1) - 2023/03/27 19:53:29
Table 'RushAndCash28183992' 6-max Seat #1 is the button
Seat 1: 5bdca8b7 ($10.08 in chips)
Seat 2: d4c108e2 ($10.63 in chips)
Seat 3: e5659ca5 ($12.24 in chips)
Seat 4: Hero ($21.96 in chips)
Seat 5: eba8363c ($10.92 in chips)
Seat 6: d4d72a49 ($12.1 in chips)
d4c108e2: posts small blind $0.05
e5659ca5: posts big blind $0.1
*** HOLE CARDS ***
Dealt to 5bdca8b7 
Dealt to d4c108e2 
Dealt to e5659ca5 
Dealt to Hero [5c 4d]
Dealt to eba8363c 
Dealt to d4d72a49 
Hero: folds
eba8363c: folds
d4d72a49: folds
5bdca8b7: folds
d4c108e2: folds
Uncalled bet ($0.05) returned to e5659ca5
*** SHOWDOWN ***
e5659ca5 collected $0.1 from pot
*** SUMMARY ***
Total pot $0.1 | Rake $0 | Jackpot $0 | Bingo $0 | Fortune $0
Seat 1: 5bdca8b7 (button) folded before Flop (didn't bet)
Seat 2: d4c108e2 (small blind) folded before Flop
Seat 3: e5659ca5 (big blind) collected ($0.1)
Seat 4: Hero folded before Flop (didn't bet)
Seat 5: eba8363c folded before Flop (didn't bet)
Seat 6: d4d72a49 folded before Flop (didn't bet)


Poker Hand #RC1433418683: Hold'em No Limit  ($0.05/$0.1) - 2023/03/27 19:53:22
Table 'RushAndCash28183943' 6-max Seat #1 is the button
Seat 1: 6e7fc55e ($10 in chips)
Seat 2: Hero ($21.86 in chips)
Seat 3: 126c704e ($21.45 in chips)
Seat 4: bc26d926 ($4.51 in chips)
Seat 5: 834fe7f8 ($10.33 in chips)
Seat 6: 725f7e50 ($25.31 in chips)
Hero: posts small blind $0.05
126c704e: posts big blind $0.1
*** HOLE CARDS ***
Dealt to 6e7fc55e 
Dealt to Hero [Td 8h]
Dealt to 126c704e 
Dealt to bc26d926 
Dealt to 834fe7f8 
Dealt to 725f7e50 
bc26d926: folds
834fe7f8: folds
725f7e50: raises $0.15 to $0.25
6e7fc55e: folds
Hero: folds
126c704e: folds
Uncalled bet ($0.15) returned to 725f7e50
*** SHOWDOWN ***
725f7e50 collected $0.25 from pot
*** SUMMARY ***
Total pot $0.25 | Rake $0 | Jackpot $0 | Bingo $0 | Fortune $0
Seat 1: 6e7fc55e (button) folded before Flop (didn't bet)
Seat 2: Hero (small blind) folded before Flop
Seat 3: 126c704e (big blind) folded before Flop
Seat 4: bc26d926 folded before Flop (didn't bet)
Seat 5: 834fe7f8 folded before Flop (didn't bet)
Seat 6: 725f7e50 collected ($0.25)


Poker Hand #RC1433418625: Hold'em No Limit  ($0.05/$0.1) - 2023/03/27 19:53:13
Table 'RushAndCash28183885' 6-max Seat #1 is the button
Seat 1: 264ce4df ($11.02 in chips)
Seat 2: b8cfc951 ($10 in chips)
Seat 3: Hero ($21.96 in chips)
Seat 4: 5228b80a ($11.08 in chips)
Seat 5: 93130014 ($9.01 in chips)
Seat 6: 6e870e2c ($10 in chips)
b8cfc951: posts small blind $0.05
Hero: posts big blind $0.1
*** HOLE CARDS ***
Dealt to 264ce4df 
Dealt to b8cfc951 
Dealt to Hero [5d Td]
Dealt to 5228b80a 
Dealt to 93130014 
Dealt to 6e870e2c 
5228b80a: folds
93130014: folds
6e870e2c: folds
264ce4df: folds
b8cfc951: folds
Uncalled bet ($0.05) returned to Hero
*** SHOWDOWN ***
Hero collected $0.1 from pot
*** SUMMARY ***
Total pot $0.1 | Rake $0 | Jackpot $0 | Bingo $0 | Fortune $0
Seat 1: 264ce4df (button) folded before Flop (didn't bet)
Seat 2: b8cfc951 (small blind) folded before Flop
Seat 3: Hero (big blind) collected ($0.1)
Seat 4: 5228b80a folded before Flop (didn't bet)
Seat 5: 93130014 folded before Flop (didn't bet)
Seat 6: 6e870e2c folded before Flop (didn't bet)


Poker Hand #RC1433418506: Hold'em No Limit  ($0.05/$0.1) - 2023/03/27 19:52:58
Table 'RushAndCash28183766' 6-max Seat #1 is the button
Seat 1: Hero ($21.96 in chips)
Seat 2: 90dcd918 ($9.55 in chips)
Seat 3: 43a0177a ($3.18 in chips)
Seat 4: f9178b32 ($12.17 in chips)
Seat 5: f9e611b4 ($10.25 in chips)
Seat 6: b3291988 ($14.32 in chips)
90dcd918: posts small blind $0.05
43a0177a: posts big blind $0.1
*** HOLE CARDS ***
Dealt to Hero [Kc 4c]
Dealt to 90dcd918 
Dealt to 43a0177a 
Dealt to f9178b32 
Dealt to f9e611b4 
Dealt to b3291988 
f9178b32: folds
f9e611b4: folds
b3291988: folds
Hero: folds
90dcd918: folds
Uncalled bet ($0.05) returned to 43a0177a
*** SHOWDOWN ***
43a0177a collected $0.1 from pot
*** SUMMARY ***
Total pot $0.1 | Rake $0 | Jackpot $0 | Bingo $0 | Fortune $0
Seat 1: Hero (button) folded before Flop (didn't bet)
Seat 2: 90dcd918 (small blind) folded before Flop
Seat 3: 43a0177a (big blind) collected ($0.1)
Seat 4: f9178b32 folded before Flop (didn't bet)
Seat 5: f9e611b4 folded before Flop (didn't bet)
Seat 6: b3291988 folded before Flop (didn't bet)


Poker Hand #RC1433418433: Hold'em No Limit  ($0.05/$0.1) - 2023/03/27 19:52:48
Table 'RushAndCash28183693' 6-max Seat #1 is the button
Seat 1: efc583b ($10.6 in chips)
Seat 2: f3de17dc ($39.91 in chips)
Seat 3: Hero ($22.06 in chips)
Seat 4: 2358adf ($132.2 in chips)
Seat 5: 8abbf745 ($10.03 in chips)
Seat 6: 9fc53b1d ($10.82 in chips)
f3de17dc: posts small blind $0.05
Hero: posts big blind $0.1
*** HOLE CARDS ***
Dealt to efc583b 
Dealt to f3de17dc 
Dealt to Hero [6c Jc]
Dealt to 2358adf 
Dealt to 8abbf745 
Dealt to 9fc53b1d 
2358adf: raises $0.15 to $0.25
8abbf745: folds
9fc53b1d: folds
efc583b: folds
f3de17dc: folds
Hero: folds
Uncalled bet ($0.15) returned to 2358adf
*** SHOWDOWN ***
2358adf collected $0.25 from pot
*** SUMMARY ***
Total pot $0.25 | Rake $0 | Jackpot $0 | Bingo $0 | Fortune $0
Seat 1: efc583b (button) folded before Flop (didn't bet)
Seat 2: f3de17dc (small blind) folded before Flop
Seat 3: Hero (big blind) folded before Flop
Seat 4: 2358adf collected ($0.25)
Seat 5: 8abbf745 folded before Flop (didn't bet)
Seat 6: 9fc53b1d folded before Flop (didn't bet)


Poker Hand #RC1433418399: Hold'em No Limit  ($0.05/$0.1) - 2023/03/27 19:52:44
Table 'RushAndCash28183659' 6-max Seat #1 is the button
Seat 1: 8caece8f ($12.09 in chips)
Seat 2: d7ef21d5 ($15.55 in chips)
Seat 3: 9bd4e018 ($10.97 in chips)
Seat 4: Hero ($22.06 in chips)
Seat 5: 8885995f ($12 in chips)
Seat 6: c2c593b0 ($18.22 in chips)
d7ef21d5: posts small blind $0.05
9bd4e018: posts big blind $0.1
*** HOLE CARDS ***
Dealt to 8caece8f 
Dealt to d7ef21d5 
Dealt to 9bd4e018 
Dealt to Hero [Td Jh]
Dealt to 8885995f 
Dealt to c2c593b0 
Hero: folds
8885995f: raises $0.14 to $0.24
c2c593b0: folds
8caece8f: folds
d7ef21d5: folds
9bd4e018: calls $0.14
*** FLOP *** [7h 2h 4d]
9bd4e018: checks
8885995f: bets $0.24
9bd4e018: calls $0.24
*** TURN *** [7h 2h 4d] [7d]
9bd4e018: bets $0.34
8885995f: calls $0.34
*** RIVER *** [7h 2h 4d 7d] [Qc]
9bd4e018: bets $0.85
8885995f: calls $0.85
9bd4e018: shows [4c 3c] (Pair of Sevens and Pair of Fours)
8885995f: shows [As Ad] (Pair of Aces and Pair of Sevens)
*** SHOWDOWN ***
8885995f collected $3.08 from pot
*** SUMMARY ***
Total pot $3.39 | Rake $0.16 | Jackpot $0.15 | Bingo $0 | Fortune $0
Board [7h 2h 4d 7d Qc]
Seat 1: 8caece8f (button) folded before Flop (didn't bet)
Seat 2: d7ef21d5 (small blind) folded before Flop
Seat 3: 9bd4e018 (big blind) showed [4c 3c] and lost with Pair of Sevens and Pair of Fours
Seat 4: Hero folded before Flop (didn't bet)
Seat 5: 8885995f showed [As Ad] and won ($3.08) with Pair of Aces and Pair of Sevens
Seat 6: c2c593b0 folded before Flop (didn't bet)


Poker Hand #RC1433418341: Hold'em No Limit  ($0.05/$0.1) - 2023/03/27 19:52:36
Table 'RushAndCash28183601' 6-max Seat #1 is the button
Seat 1: f9e611b4 ($10.05 in chips)
Seat 2: 2358adf ($132.25 in chips)
Seat 3: 9a168a2f ($9.98 in chips)
Seat 4: 279ee455 ($23.41 in chips)
Seat 5: 2f5f4c4f ($10.22 in chips)
Seat 6: Hero ($22.06 in chips)
2358adf: posts small blind $0.05
9a168a2f: posts big blind $0.1
*** HOLE CARDS ***
Dealt to f9e611b4 
Dealt to 2358adf 
Dealt to 9a168a2f 
Dealt to 279ee455 
Dealt to 2f5f4c4f 
Dealt to Hero [5c Jh]
279ee455: folds
2f5f4c4f: raises $0.15 to $0.25
Hero: folds
f9e611b4: folds
2358adf: folds
9a168a2f: folds
Uncalled bet ($0.15) returned to 2f5f4c4f
*** SHOWDOWN ***
2f5f4c4f collected $0.25 from pot
*** SUMMARY ***
Total pot $0.25 | Rake $0 | Jackpot $0 | Bingo $0 | Fortune $0
Seat 1: f9e611b4 (button) folded before Flop (didn't bet)
Seat 2: 2358adf (small blind) folded before Flop
Seat 3: 9a168a2f (big blind) folded before Flop
Seat 4: 279ee455 folded before Flop (didn't bet)
Seat 5: 2f5f4c4f collected ($0.25)
Seat 6: Hero folded before Flop (didn't bet)


Poker Hand #RC1433418088: Hold'em No Limit  ($0.05/$0.1) - 2023/03/27 19:52:00
Table 'RushAndCash28183348' 6-max Seat #1 is the button
Seat 1: b8381bc1 ($20.29 in chips)
Seat 2: 148b1cdb ($39.3 in chips)
Seat 3: Hero ($21.92 in chips)
Seat 4: 41434d98 ($9.37 in chips)
Seat 5: 47503c44 ($14.01 in chips)
Seat 6: c78ccd23 ($8.95 in chips)
148b1cdb: posts small blind $0.05
Hero: posts big blind $0.1
*** HOLE CARDS ***
Dealt to b8381bc1 
Dealt to 148b1cdb 
Dealt to Hero [6d 5s]
Dealt to 41434d98 
Dealt to 47503c44 
Dealt to c78ccd23 
41434d98: calls $0.1
47503c44: folds
c78ccd23: folds
b8381bc1: folds
148b1cdb: folds
Hero: checks
*** FLOP *** [Jh 9c Qh]
Hero: checks
41434d98: checks
*** TURN *** [Jh 9c Qh] [Qc]
Hero: bets $0.13
41434d98: folds
Uncalled bet ($0.13) returned to Hero
*** SHOWDOWN ***
Hero collected $0.24 from pot
*** SUMMARY ***
Total pot $0.25 | Rake $0.01 | Jackpot $0 | Bingo $0 | Fortune $0
Board [Jh 9c Qh Qc]
Seat 1: b8381bc1 (button) folded before Flop (didn't bet)
Seat 2: 148b1cdb (small blind) folded before Flop
Seat 3: Hero (big blind) won ($0.24)
Seat 4: 41434d98 folded on the Turn
Seat 5: 47503c44 folded before Flop (didn't bet)
Seat 6: c78ccd23 folded before Flop (didn't bet)


Poker Hand #RC1433418031: Hold'em No Limit  ($0.05/$0.1) - 2023/03/27 19:51:52
Table 'RushAndCash28183291' 6-max Seat #1 is the button
Seat 1: 21c698eb ($11.15 in chips)
Seat 2: Hero ($21.97 in chips)
Seat 3: 93130014 ($8.42 in chips)
Seat 4: 279ee455 ($23.56 in chips)
Seat 5: 7cd65afb ($18.2 in chips)
Seat 6: 7f3fb3a4 ($10.22 in chips)
Hero: posts small blind $0.05
93130014: posts big blind $0.1
*** HOLE CARDS ***
Dealt to 21c698eb 
Dealt to Hero [9d Tc]
Dealt to 93130014 
Dealt to 279ee455 
Dealt to 7cd65afb 
Dealt to 7f3fb3a4 
279ee455: folds
7cd65afb: folds
7f3fb3a4: folds
21c698eb: raises $0.1 to $0.2
Hero: folds
93130014: folds
Uncalled bet ($0.1) returned to 21c698eb
*** SHOWDOWN ***
21c698eb collected $0.25 from pot
*** SUMMARY ***
Total pot $0.25 | Rake $0 | Jackpot $0 | Bingo $0 | Fortune $0
Seat 1: 21c698eb (button) collected ($0.25)
Seat 2: Hero (small blind) folded before Flop
Seat 3: 93130014 (big blind) folded before Flop
Seat 4: 279ee455 folded before Flop (didn't bet)
Seat 5: 7cd65afb folded before Flop (didn't bet)
Seat 6: 7f3fb3a4 folded before Flop (didn't bet)


Poker Hand #RC1433417867: Hold'em No Limit  ($0.05/$0.1) - 2023/03/27 19:51:28
Table 'RushAndCash28183127' 6-max Seat #1 is the button
Seat 1: e790e4ec ($10.05 in chips)
Seat 2: dca30c55 ($9.92 in chips)
Seat 3: aa70745f ($12.1 in chips)
Seat 4: Hero ($21.6 in chips)
Seat 5: 5b464716 ($11.87 in chips)
Seat 6: 93130014 ($8.67 in chips)
dca30c55: posts small blind $0.05
aa70745f: posts big blind $0.1
*** HOLE CARDS ***
Dealt to e790e4ec 
Dealt to dca30c55 
Dealt to aa70745f 
Dealt to Hero [Qc Ks]
Dealt to 5b464716 
Dealt to 93130014 
Hero: raises $0.15 to $0.25
5b464716: folds
93130014: calls $0.25
e790e4ec: folds
dca30c55: folds
aa70745f: folds
*** FLOP *** [As 2d 7c]
Hero: bets $0.33
93130014: folds
Uncalled bet ($0.33) returned to Hero
*** SHOWDOWN ***
Hero collected $0.62 from pot
*** SUMMARY ***
Total pot $0.65 | Rake $0.03 | Jackpot $0 | Bingo $0 | Fortune $0
Board [As 2d 7c]
Seat 1: e790e4ec (button) folded before Flop (didn't bet)
Seat 2: dca30c55 (small blind) folded before Flop
Seat 3: aa70745f (big blind) folded before Flop
Seat 4: Hero won ($0.62)
Seat 5: 5b464716 folded before Flop (didn't bet)
Seat 6: 93130014 folded on the Flop


Poker Hand #RC1433417829: Hold'em No Limit  ($0.05/$0.1) - 2023/03/27 19:51:22
Table 'RushAndCash28183089' 6-max Seat #1 is the button
Seat 1: a0169227 ($9.75 in chips)
Seat 2: 276936c5 ($21.18 in chips)
Seat 3: 383a1187 ($7.67 in chips)
Seat 4: 8885995f ($10.46 in chips)
Seat 5: 1463bd14 ($17.92 in chips)
Seat 6: Hero ($21.6 in chips)
276936c5: posts small blind $0.05
383a1187: posts big blind $0.1
*** HOLE CARDS ***
Dealt to a0169227 
Dealt to 276936c5 
Dealt to 383a1187 
Dealt to 8885995f 
Dealt to 1463bd14 
Dealt to Hero [Qh 8c]
8885995f: raises $0.14 to $0.24
1463bd14: folds
Hero: folds
a0169227: calls $0.24
276936c5: folds
383a1187: calls $0.14
*** FLOP *** [3s Kd 6d]
383a1187: checks
8885995f: bets $0.34
a0169227: folds
383a1187: calls $0.34
*** TURN *** [3s Kd 6d] [Ts]
383a1187: checks
8885995f: bets $1.09
383a1187: calls $1.09
*** RIVER *** [3s Kd 6d Ts] [Js]
383a1187: checks
8885995f: bets $1.6
383a1187: folds
Uncalled bet ($1.6) returned to 8885995f
*** SHOWDOWN ***
8885995f collected $3.31 from pot
*** SUMMARY ***
Total pot $3.63 | Rake $0.17 | Jackpot $0.15 | Bingo $0 | Fortune $0
Board [3s Kd 6d Ts Js]
Seat 1: a0169227 (button) folded on the Flop
Seat 2: 276936c5 (small blind) folded before Flop
Seat 3: 383a1187 (big blind) folded on the River
Seat 4: 8885995f won ($3.31)
Seat 5: 1463bd14 folded before Flop (didn't bet)
Seat 6: Hero folded before Flop (didn't bet)


Poker Hand #RC1433417763: Hold'em No Limit  ($0.05/$0.1) - 2023/03/27 19:51:12
Table 'RushAndCash28183023' 6-max Seat #1 is the button
Seat 1: 27d009 ($12.94 in chips)
Seat 2: Hero ($21.65 in chips)
Seat 3: dd233af4 ($10 in chips)
Seat 4: 765e555a ($15.39 in chips)
Seat 5: 4fccbb97 ($6.59 in chips)
Seat 6: d4d72a49 ($12.61 in chips)
Hero: posts small blind $0.05
dd233af4: posts big blind $0.1
*** HOLE CARDS ***
Dealt to 27d009 
Dealt to Hero [5s 9c]
Dealt to dd233af4 
Dealt to 765e555a 
Dealt to 4fccbb97 
Dealt to d4d72a49 
765e555a: folds
4fccbb97: folds
d4d72a49: raises $0.13 to $0.23
27d009: folds
Hero: folds
dd233af4: folds
Uncalled bet ($0.13) returned to d4d72a49
*** SHOWDOWN ***
d4d72a49 collected $0.25 from pot
*** SUMMARY ***
Total pot $0.25 | Rake $0 | Jackpot $0 | Bingo $0 | Fortune $0
Seat 1: 27d009 (button) folded before Flop (didn't bet)
Seat 2: Hero (small blind) folded before Flop
Seat 3: dd233af4 (big blind) folded before Flop
Seat 4: 765e555a folded before Flop (didn't bet)
Seat 5: 4fccbb97 folded before Flop (didn't bet)
Seat 6: d4d72a49 collected ($0.25)


Poker Hand #RC1433417726: Hold'em No Limit  ($0.05/$0.1) - 2023/03/27 19:51:06
Table 'RushAndCash28182986' 6-max Seat #1 is the button
Seat 1: a9f4a031 ($10.8 in chips)
Seat 2: 96dfc279 ($13.47 in chips)
Seat 3: 4552969d ($7.8 in chips)
Seat 4: aa70745f ($11.95 in chips)
Seat 5: d7795b7 ($11.63 in chips)
Seat 6: Hero ($21.65 in chips)
96dfc279: posts small blind $0.05
4552969d: posts big blind $0.1
*** HOLE CARDS ***
Dealt to a9f4a031 
Dealt to 96dfc279 
Dealt to 4552969d 
Dealt to aa70745f 
Dealt to d7795b7 
Dealt to Hero [Js 6s]
aa70745f: folds
d7795b7: raises $0.15 to $0.25
Hero: folds
a9f4a031: raises $0.5 to $0.75
96dfc279: folds
4552969d: folds
d7795b7: folds
Uncalled bet ($0.5) returned to a9f4a031
*** SHOWDOWN ***
a9f4a031 collected $0.62 from pot
*** SUMMARY ***
Total pot $0.65 | Rake $0.03 | Jackpot $0 | Bingo $0 | Fortune $0
Seat 1: a9f4a031 (button) collected ($0.62)
Seat 2: 96dfc279 (small blind) folded before Flop
Seat 3: 4552969d (big blind) folded before Flop
Seat 4: aa70745f folded before Flop (didn't bet)
Seat 5: d7795b7 folded before Flop
Seat 6: Hero folded before Flop (didn't bet)


Poker Hand #RC1433417699: Hold'em No Limit  ($0.05/$0.1) - 2023/03/27 19:51:02
Table 'RushAndCash28182959' 6-max Seat #1 is the button
Seat 1: d7795b7 ($11.63 in chips)
Seat 2: 197ebdde ($20.73 in chips)
Seat 3: 276936c5 ($21.13 in chips)
Seat 4: Hero ($21.65 in chips)
Seat 5: a0e140b7 ($14.82 in chips)
Seat 6: aa70745f ($11.95 in chips)
197ebdde: posts small blind $0.05
276936c5: posts big blind $0.1
*** HOLE CARDS ***
Dealt to d7795b7 
Dealt to 197ebdde 
Dealt to 276936c5 
Dealt to Hero [3h 9d]
Dealt to a0e140b7 
Dealt to aa70745f 
Hero: folds
a0e140b7: folds
aa70745f: folds
d7795b7: folds
197ebdde: folds
Uncalled bet ($0.05) returned to 276936c5
*** SHOWDOWN ***
276936c5 collected $0.1 from pot
*** SUMMARY ***
Total pot $0.1 | Rake $0 | Jackpot $0 | Bingo $0 | Fortune $0
Seat 1: d7795b7 (button) folded before Flop (didn't bet)
Seat 2: 197ebdde (small blind) folded before Flop
Seat 3: 276936c5 (big blind) collected ($0.1)
Seat 4: Hero folded before Flop (didn't bet)
Seat 5: a0e140b7 folded before Flop (didn't bet)
Seat 6: aa70745f folded before Flop (didn't bet)


Poker Hand #RC1433417320: Hold'em No Limit  ($0.05/$0.1) - 2023/03/27 19:50:05
Table 'RushAndCash28182580' 6-max Seat #1 is the button
Seat 1: 197ebdde ($20.45 in chips)
Seat 2: c6867e9e ($14.98 in chips)
Seat 3: Hero ($21.9 in chips)
Seat 4: ccf6ba4d ($15.28 in chips)
Seat 5: 7f6cbe2 ($11 in chips)
Seat 6: 87fbd846 ($11.64 in chips)
c6867e9e: posts small blind $0.05
Hero: posts big blind $0.1
*** HOLE CARDS ***
Dealt to 197ebdde 
Dealt to c6867e9e 
Dealt to Hero [2h 2c]
Dealt to ccf6ba4d 
Dealt to 7f6cbe2 
Dealt to 87fbd846 
ccf6ba4d: folds
7f6cbe2: folds
87fbd846: folds
197ebdde: raises $0.15 to $0.25
c6867e9e: folds
Hero: calls $0.15
*** FLOP *** [Qs 6h 8s]
Hero: checks
197ebdde: checks
*** TURN *** [Qs 6h 8s] [Ts]
Hero: checks
197ebdde: bets $0.36
Hero: folds
Uncalled bet ($0.36) returned to 197ebdde
*** SHOWDOWN ***
197ebdde collected $0.53 from pot
*** SUMMARY ***
Total pot $0.55 | Rake $0.02 | Jackpot $0 | Bingo $0 | Fortune $0
Board [Qs 6h 8s Ts]
Seat 1: 197ebdde (button) won ($0.53)
Seat 2: c6867e9e (small blind) folded before Flop
Seat 3: Hero (big blind) folded on the Turn
Seat 4: ccf6ba4d folded before Flop (didn't bet)
Seat 5: 7f6cbe2 folded before Flop (didn't bet)
Seat 6: 87fbd846 folded before Flop (didn't bet)


Poker Hand #RC1433417289: Hold'em No Limit  ($0.05/$0.1) - 2023/03/27 19:50:01
Table 'RushAndCash28182549' 6-max Seat #1 is the button
Seat 1: c1cbc2c2 ($28.73 in chips)
Seat 2: dbcec84c ($14.47 in chips)
Seat 3: 51ac6c64 ($10 in chips)
Seat 4: Hero ($21.9 in chips)
Seat 5: efc583b ($12.27 in chips)
Seat 6: c3bde2ae ($41.66 in chips)
dbcec84c: posts small blind $0.05
51ac6c64: posts big blind $0.1
*** HOLE CARDS ***
Dealt to c1cbc2c2 
Dealt to dbcec84c 
Dealt to 51ac6c64 
Dealt to Hero [Th 8s]
Dealt to efc583b 
Dealt to c3bde2ae 
Hero: folds
efc583b: folds
c3bde2ae: raises $0.15 to $0.25
c1cbc2c2: folds
dbcec84c: folds
51ac6c64: folds
Uncalled bet ($0.15) returned to c3bde2ae
*** SHOWDOWN ***
c3bde2ae collected $0.25 from pot
*** SUMMARY ***
Total pot $0.25 | Rake $0 | Jackpot $0 | Bingo $0 | Fortune $0
Seat 1: c1cbc2c2 (button) folded before Flop (didn't bet)
Seat 2: dbcec84c (small blind) folded before Flop
Seat 3: 51ac6c64 (big blind) folded before Flop
Seat 4: Hero folded before Flop (didn't bet)
Seat 5: efc583b folded before Flop (didn't bet)
Seat 6: c3bde2ae collected ($0.25)


Poker Hand #RC1433416858: Hold'em No Limit  ($0.05/$0.1) - 2023/03/27 19:49:03
Table 'RushAndCash28182118' 6-max Seat #1 is the button
Seat 1: b8cfc951 ($9.85 in chips)
Seat 2: 3a7cafde ($10 in chips)
Seat 3: ed53e62f ($10.81 in chips)
Seat 4: efc583b ($12.96 in chips)
Seat 5: 896b5d16 ($10.6 in chips)
Seat 6: Hero ($21.13 in chips)
3a7cafde: posts small blind $0.05
ed53e62f: posts big blind $0.1
*** HOLE CARDS ***
Dealt to b8cfc951 
Dealt to 3a7cafde 
Dealt to ed53e62f 
Dealt to efc583b 
Dealt to 896b5d16 
Dealt to Hero [Kc Ks]
efc583b: raises $0.13 to $0.23
896b5d16: folds
Hero: raises $0.46 to $0.69
b8cfc951: folds
3a7cafde: folds
ed53e62f: folds
efc583b: calls $0.46
*** FLOP *** [2c Qd 9h]
efc583b: checks
Hero: bets $0.77
efc583b: folds
Uncalled bet ($0.77) returned to Hero
*** SHOWDOWN ***
Hero collected $1.46 from pot
*** SUMMARY ***
Total pot $1.53 | Rake $0.07 | Jackpot $0 | Bingo $0 | Fortune $0
Board [2c Qd 9h]
Seat 1: b8cfc951 (button) folded before Flop (didn't bet)
Seat 2: 3a7cafde (small blind) folded before Flop
Seat 3: ed53e62f (big blind) folded before Flop
Seat 4: efc583b folded on the Flop
Seat 5: 896b5d16 folded before Flop (didn't bet)
Seat 6: Hero won ($1.46)


Poker Hand #RC1433416814: Hold'em No Limit  ($0.05/$0.1) - 2023/03/27 19:48:57
Table 'RushAndCash28182074' 6-max Seat #1 is the button
Seat 1: bf45b565 ($10.08 in chips)
Seat 2: a76b3c83 ($6.82 in chips)
Seat 3: fdbcc7d3 ($10 in chips)
Seat 4: a0169227 ($8.61 in chips)
Seat 5: Hero ($21.13 in chips)
Seat 6: 7a70a521 ($10.31 in chips)
a76b3c83: posts small blind $0.05
fdbcc7d3: posts big blind $0.1
*** HOLE CARDS ***
Dealt to bf45b565 
Dealt to a76b3c83 
Dealt to fdbcc7d3 
Dealt to a0169227 
Dealt to Hero [4h Kd]
Dealt to 7a70a521 
a0169227: folds
Hero: folds
7a70a521: folds
bf45b565: folds
a76b3c83: folds
Uncalled bet ($0.05) returned to fdbcc7d3
*** SHOWDOWN ***
fdbcc7d3 collected $0.1 from pot
*** SUMMARY ***
Total pot $0.1 | Rake $0 | Jackpot $0 | Bingo $0 | Fortune $0
Seat 1: bf45b565 (button) folded before Flop (didn't bet)
Seat 2: a76b3c83 (small blind) folded before Flop
Seat 3: fdbcc7d3 (big blind) collected ($0.1)
Seat 4: a0169227 folded before Flop (didn't bet)
Seat 5: Hero folded before Flop (didn't bet)
Seat 6: 7a70a521 folded before Flop (didn't bet)


Poker Hand #RC1433416778: Hold'em No Limit  ($0.05/$0.1) - 2023/03/27 19:48:52
Table 'RushAndCash28182038' 6-max Seat #1 is the button
Seat 1: f09c363f ($40.09 in chips)
Seat 2: Hero ($21.18 in chips)
Seat 3: 64e1e854 ($19.03 in chips)
Seat 4: 18ba9fff ($12.07 in chips)
Seat 5: 8e854de7 ($9.54 in chips)
Seat 6: 3de0f141 ($12.26 in chips)
Hero: posts small blind $0.05
64e1e854: posts big blind $0.1
*** HOLE CARDS ***
Dealt to f09c363f 
Dealt to Hero [9h 4h]
Dealt to 64e1e854 
Dealt to 18ba9fff 
Dealt to 8e854de7 
Dealt to 3de0f141 
18ba9fff: folds
8e854de7: folds
3de0f141: folds
f09c363f: folds
Hero: folds
Uncalled bet ($0.05) returned to 64e1e854
*** SHOWDOWN ***
64e1e854 collected $0.1 from pot
*** SUMMARY ***
Total pot $0.1 | Rake $0 | Jackpot $0 | Bingo $0 | Fortune $0
Seat 1: f09c363f (button) folded before Flop (didn't bet)
Seat 2: Hero (small blind) folded before Flop
Seat 3: 64e1e854 (big blind) collected ($0.1)
Seat 4: 18ba9fff folded before Flop (didn't bet)
Seat 5: 8e854de7 folded before Flop (didn't bet)
Seat 6: 3de0f141 folded before Flop (didn't bet)


Poker Hand #RC1433416736: Hold'em No Limit  ($0.05/$0.1) - 2023/03/27 19:48:45
Table 'RushAndCash28181996' 6-max Seat #1 is the button
Seat 1: Hero ($21.18 in chips)
Seat 2: dd7744c9 ($23.99 in chips)
Seat 3: 69f5b96a ($7.09 in chips)
Seat 4: f0fce8d0 ($10.15 in chips)
Seat 5: dc5d8f31 ($10.96 in chips)
Seat 6: 8bc30a96 ($9.58 in chips)
dd7744c9: posts small blind $0.05
69f5b96a: posts big blind $0.1
*** HOLE CARDS ***
Dealt to Hero [4c 2d]
Dealt to dd7744c9 
Dealt to 69f5b96a 
Dealt to f0fce8d0 
Dealt to dc5d8f31 
Dealt to 8bc30a96 
f0fce8d0: folds
dc5d8f31: folds
8bc30a96: folds
Hero: folds
dd7744c9: raises $0.2 to $0.3
69f5b96a: folds
Uncalled bet ($0.2) returned to dd7744c9
*** SHOWDOWN ***
dd7744c9 collected $0.2 from pot
*** SUMMARY ***
Total pot $0.2 | Rake $0 | Jackpot $0 | Bingo $0 | Fortune $0
Seat 1: Hero (button) folded before Flop (didn't bet)
Seat 2: dd7744c9 (small blind) collected ($0.2)
Seat 3: 69f5b96a (big blind) folded before Flop
Seat 4: f0fce8d0 folded before Flop (didn't bet)
Seat 5: dc5d8f31 folded before Flop (didn't bet)
Seat 6: 8bc30a96 folded before Flop (didn't bet)


Poker Hand #RC1433415957: Hold'em No Limit  ($0.05/$0.1) - 2023/03/27 19:46:57
Table 'RushAndCash28181217' 6-max Seat #1 is the button
Seat 1: ec3bebf3 ($18.81 in chips)
Seat 2: e90061bc ($10.15 in chips)
Seat 3: 67cfc163 ($20.41 in chips)
Seat 4: eca19ee0 ($19.23 in chips)
Seat 5: e790e4ec ($10.1 in chips)
Seat 6: Hero ($24.48 in chips)
e90061bc: posts small blind $0.05
67cfc163: posts big blind $0.1
*** HOLE CARDS ***
Dealt to ec3bebf3 
Dealt to e90061bc 
Dealt to 67cfc163 
Dealt to eca19ee0 
Dealt to e790e4ec 
Dealt to Hero [Qs Qd]
eca19ee0: folds
e790e4ec: folds
Hero: raises $0.15 to $0.25
ec3bebf3: folds
e90061bc: folds
67cfc163: raises $0.86 to $1.11
Hero: calls $0.86
*** FLOP *** [8c Th 7s]
67cfc163: checks
Hero: bets $1.14
67cfc163: calls $1.14
*** TURN *** [8c Th 7s] [6h]
67cfc163: checks
Hero: checks
*** RIVER *** [8c Th 7s 6h] [Ac]
67cfc163: checks
Hero: bets $1.05
67cfc163: calls $1.05
Hero: shows [Qs Qd] (Pair of Queens)
67cfc163: shows [Jh Ad] (Pair of Aces)
*** SHOWDOWN ***
67cfc163 collected $6.2 from pot
*** SUMMARY ***
Total pot $6.65 | Rake $0.3 | Jackpot $0.15 | Bingo $0 | Fortune $0
Board [8c Th 7s 6h Ac]
Seat 1: ec3bebf3 (button) folded before Flop (didn't bet)
Seat 2: e90061bc (small blind) folded before Flop
Seat 3: 67cfc163 (big blind) showed [Jh Ad] and won ($6.2) with Pair of Aces
Seat 4: eca19ee0 folded before Flop (didn't bet)
Seat 5: e790e4ec folded before Flop (didn't bet)
Seat 6: Hero showed [Qs Qd] and lost with Pair of Queens


Poker Hand #RC1433415868: Hold'em No Limit  ($0.05/$0.1) - 2023/03/27 19:46:44
Table 'RushAndCash28181128' 6-max Seat #1 is the button
Seat 1: Hero ($24.48 in chips)
Seat 2: dca30c55 ($11.03 in chips)
Seat 3: 6043f541 ($12.51 in chips)
Seat 4: 5b075bb ($10.34 in chips)
Seat 5: 484f9657 ($15.66 in chips)
Seat 6: be87df52 ($10.59 in chips)
dca30c55: posts small blind $0.05
6043f541: posts big blind $0.1
*** HOLE CARDS ***
Dealt to Hero [Qc 9h]
Dealt to dca30c55 
Dealt to 6043f541 
Dealt to 5b075bb 
Dealt to 484f9657 
Dealt to be87df52 
5b075bb: folds
484f9657: folds
be87df52: raises $0.15 to $0.25
Hero: folds
dca30c55: folds
6043f541: folds
Uncalled bet ($0.15) returned to be87df52
*** SHOWDOWN ***
be87df52 collected $0.25 from pot
*** SUMMARY ***
Total pot $0.25 | Rake $0 | Jackpot $0 | Bingo $0 | Fortune $0
Seat 1: Hero (button) folded before Flop (didn't bet)
Seat 2: dca30c55 (small blind) folded before Flop
Seat 3: 6043f541 (big blind) folded before Flop
Seat 4: 5b075bb folded before Flop (didn't bet)
Seat 5: 484f9657 folded before Flop (didn't bet)
Seat 6: be87df52 collected ($0.25)


Poker Hand #RC1433415788: Hold'em No Limit  ($0.05/$0.1) - 2023/03/27 19:46:33
Table 'RushAndCash28181048' 6-max Seat #1 is the button
Seat 1: fec0d8cf ($10 in chips)
Seat 2: Hero ($24.53 in chips)
Seat 3: 8caece8f ($13.47 in chips)
Seat 4: 634a1d5 ($23.92 in chips)
Seat 5: 92d83bd7 ($15.94 in chips)
Seat 6: 8bb57da ($7.8 in chips)
Hero: posts small blind $0.05
8caece8f: posts big blind $0.1
*** HOLE CARDS ***
Dealt to fec0d8cf 
Dealt to Hero [5s 3s]
Dealt to 8caece8f 
Dealt to 634a1d5 
Dealt to 92d83bd7 
Dealt to 8bb57da 
634a1d5: folds
92d83bd7: folds
8bb57da: raises $0.1 to $0.2
fec0d8cf: folds
Hero: folds
8caece8f: folds
Uncalled bet ($0.1) returned to 8bb57da
*** SHOWDOWN ***
8bb57da collected $0.25 from pot
*** SUMMARY ***
Total pot $0.25 | Rake $0 | Jackpot $0 | Bingo $0 | Fortune $0
Seat 1: fec0d8cf (button) folded before Flop (didn't bet)
Seat 2: Hero (small blind) folded before Flop
Seat 3: 8caece8f (big blind) folded before Flop
Seat 4: 634a1d5 folded before Flop (didn't bet)
Seat 5: 92d83bd7 folded before Flop (didn't bet)
Seat 6: 8bb57da collected ($0.25)


Poker Hand #RC1433415652: Hold'em No Limit  ($0.05/$0.1) - 2023/03/27 19:46:12
Table 'RushAndCash28180912' 6-max Seat #1 is the button
Seat 1: 4637b2c8 ($17.75 in chips)
Seat 2: Hero ($24.58 in chips)
Seat 3: 492bd702 ($10.68 in chips)
Seat 4: 1b112a36 ($10.07 in chips)
Seat 5: 95b5ffce ($12.76 in chips)
Seat 6: 54d5200f ($28.94 in chips)
Hero: posts small blind $0.05
492bd702: posts big blind $0.1
*** HOLE CARDS ***
Dealt to 4637b2c8 
Dealt to Hero [2c Kd]
Dealt to 492bd702 
Dealt to 1b112a36 
Dealt to 95b5ffce 
Dealt to 54d5200f 
1b112a36: folds
95b5ffce: folds
54d5200f: folds
4637b2c8: folds
Hero: folds
Uncalled bet ($0.05) returned to 492bd702
*** SHOWDOWN ***
492bd702 collected $0.1 from pot
*** SUMMARY ***
Total pot $0.1 | Rake $0 | Jackpot $0 | Bingo $0 | Fortune $0
Seat 1: 4637b2c8 (button) folded before Flop (didn't bet)
Seat 2: Hero (small blind) folded before Flop
Seat 3: 492bd702 (big blind) collected ($0.1)
Seat 4: 1b112a36 folded before Flop (didn't bet)
Seat 5: 95b5ffce folded before Flop (didn't bet)
Seat 6: 54d5200f folded before Flop (didn't bet)


Poker Hand #RC1433415580: Hold'em No Limit  ($0.05/$0.1) - 2023/03/27 19:46:01
Table 'RushAndCash28180840' 6-max Seat #1 is the button
Seat 1: 69f5b96a ($7.01 in chips)
Seat 2: 4eef219b ($12.96 in chips)
Seat 3: Hero ($24.53 in chips)
Seat 4: b5c2a326 ($10.15 in chips)
Seat 5: 66ef94b6 ($8.98 in chips)
Seat 6: ef155876 ($10 in chips)
4eef219b: posts small blind $0.05
Hero: posts big blind $0.1
*** HOLE CARDS ***
Dealt to 69f5b96a 
Dealt to 4eef219b 
Dealt to Hero [Jd Kh]
Dealt to b5c2a326 
Dealt to 66ef94b6 
Dealt to ef155876 
b5c2a326: folds
66ef94b6: folds
ef155876: folds
69f5b96a: folds
4eef219b: folds
Uncalled bet ($0.05) returned to Hero
*** SHOWDOWN ***
Hero collected $0.1 from pot
*** SUMMARY ***
Total pot $0.1 | Rake $0 | Jackpot $0 | Bingo $0 | Fortune $0
Seat 1: 69f5b96a (button) folded before Flop (didn't bet)
Seat 2: 4eef219b (small blind) folded before Flop
Seat 3: Hero (big blind) collected ($0.1)
Seat 4: b5c2a326 folded before Flop (didn't bet)
Seat 5: 66ef94b6 folded before Flop (didn't bet)
Seat 6: ef155876 folded before Flop (didn't bet)


Poker Hand #RC1433415548: Hold'em No Limit  ($0.05/$0.1) - 2023/03/27 19:45:57
Table 'RushAndCash28180808' 6-max Seat #1 is the button
Seat 1: ad0b92ed ($12.85 in chips)
Seat 2: b5d2c99b ($3.73 in chips)
Seat 3: 66017d6f ($26.43 in chips)
Seat 4: b3291988 ($11.38 in chips)
Seat 5: Hero ($24.53 in chips)
Seat 6: ebbe1497 ($10 in chips)
b5d2c99b: posts small blind $0.05
66017d6f: posts big blind $0.1
*** HOLE CARDS ***
Dealt to ad0b92ed 
Dealt to b5d2c99b 
Dealt to 66017d6f 
Dealt to b3291988 
Dealt to Hero [As 7c]
Dealt to ebbe1497 
b3291988: folds
Hero: folds
ebbe1497: raises $0.15 to $0.25
ad0b92ed: folds
b5d2c99b: calls $0.2
66017d6f: calls $0.15
*** FLOP *** [Th 2d 3h]
b5d2c99b: checks
66017d6f: checks
ebbe1497: checks
*** TURN *** [Th 2d 3h] [Ah]
b5d2c99b: checks
66017d6f: checks
ebbe1497: checks
*** RIVER *** [Th 2d 3h Ah] [4d]
b5d2c99b: checks
66017d6f: checks
ebbe1497: checks
b5d2c99b: shows [9s 9d] (Pair of Nines)
66017d6f: shows [Jh 8d] (Ace-High)
ebbe1497: shows [7s 7d] (Pair of Sevens)
*** SHOWDOWN ***
b5d2c99b collected $0.72 from pot
*** SUMMARY ***
Total pot $0.75 | Rake $0.03 | Jackpot $0 | Bingo $0 | Fortune $0
Board [Th 2d 3h Ah 4d]
Seat 1: ad0b92ed (button) folded before Flop (didn't bet)
Seat 2: b5d2c99b (small blind) showed [9s 9d] and won ($0.72) with Pair of Nines
Seat 3: 66017d6f (big blind) showed [Jh 8d] and lost with Ace-High
Seat 4: b3291988 folded before Flop (didn't bet)
Seat 5: Hero folded before Flop (didn't bet)
Seat 6: ebbe1497 showed [7s 7d] and lost with Pair of Sevens


Poker Hand #RC1433415501: Hold'em No Limit  ($0.05/$0.1) - 2023/03/27 19:45:50
Table 'RushAndCash28180761' 6-max Seat #1 is the button
Seat 1: Hero ($24.53 in chips)
Seat 2: 21c698eb ($10 in chips)
Seat 3: f8d5e105 ($10 in chips)
Seat 4: dd35185f ($10.42 in chips)
Seat 5: 947b43c2 ($22.83 in chips)
Seat 6: 34fa0825 ($4.75 in chips)
21c698eb: posts small blind $0.05
f8d5e105: posts big blind $0.1
*** HOLE CARDS ***
Dealt to Hero [3c Jd]
Dealt to 21c698eb 
Dealt to f8d5e105 
Dealt to dd35185f 
Dealt to 947b43c2 
Dealt to 34fa0825 
dd35185f: folds
947b43c2: folds
34fa0825: folds
Hero: folds
21c698eb: folds
Uncalled bet ($0.05) returned to f8d5e105
*** SHOWDOWN ***
f8d5e105 collected $0.1 from pot
*** SUMMARY ***
Total pot $0.1 | Rake $0 | Jackpot $0 | Bingo $0 | Fortune $0
Seat 1: Hero (button) folded before Flop (didn't bet)
Seat 2: 21c698eb (small blind) folded before Flop
Seat 3: f8d5e105 (big blind) collected ($0.1)
Seat 4: dd35185f folded before Flop (didn't bet)
Seat 5: 947b43c2 folded before Flop (didn't bet)
Seat 6: 34fa0825 folded before Flop (didn't bet)


Poker Hand #RC1433415471: Hold'em No Limit  ($0.05/$0.1) - 2023/03/27 19:45:47
Table 'RushAndCash28180731' 6-max Seat #1 is the button
Seat 1: 2cdb9821 ($14.24 in chips)
Seat 2: 3e2ce794 ($21.73 in chips)
Seat 3: Hero ($24.63 in chips)
Seat 4: 2ac8e9fd ($11.65 in chips)
Seat 5: 9ba6ae76 ($12.09 in chips)
Seat 6: 4cc658cf ($14.99 in chips)
3e2ce794: posts small blind $0.05
Hero: posts big blind $0.1
*** HOLE CARDS ***
Dealt to 2cdb9821 
Dealt to 3e2ce794 
Dealt to Hero [2h 7c]
Dealt to 2ac8e9fd 
Dealt to 9ba6ae76 
Dealt to 4cc658cf 
2ac8e9fd: folds
9ba6ae76: raises $0.11 to $0.21
4cc658cf: folds
2cdb9821: folds
3e2ce794: folds
Hero: folds
Uncalled bet ($0.11) returned to 9ba6ae76
*** SHOWDOWN ***
9ba6ae76 collected $0.25 from pot
*** SUMMARY ***
Total pot $0.25 | Rake $0 | Jackpot $0 | Bingo $0 | Fortune $0
Seat 1: 2cdb9821 (button) folded before Flop (didn't bet)
Seat 2: 3e2ce794 (small blind) folded before Flop
Seat 3: Hero (big blind) folded before Flop
Seat 4: 2ac8e9fd folded before Flop (didn't bet)
Seat 5: 9ba6ae76 collected ($0.25)
Seat 6: 4cc658cf folded before Flop (didn't bet)


Poker Hand #RC1433415431: Hold'em No Limit  ($0.05/$0.1) - 2023/03/27 19:45:40
Table 'RushAndCash28180691' 6-max Seat #1 is the button
Seat 1: ba9f55a3 ($23.8 in chips)
Seat 2: fcc43a00 ($10.29 in chips)
Seat 3: 8639b271 ($9.35 in chips)
Seat 4: ff082cd5 ($10.49 in chips)
Seat 5: Hero ($24.63 in chips)
Seat 6: 2bb65c38 ($8.15 in chips)
fcc43a00: posts small blind $0.05
8639b271: posts big blind $0.1
*** HOLE CARDS ***
Dealt to ba9f55a3 
Dealt to fcc43a00 
Dealt to 8639b271 
Dealt to ff082cd5 
Dealt to Hero [6d 7s]
Dealt to 2bb65c38 
ff082cd5: folds
Hero: folds
2bb65c38: folds
ba9f55a3: folds
fcc43a00: raises $0.15 to $0.25
8639b271: folds
Uncalled bet ($0.15) returned to fcc43a00
*** SHOWDOWN ***
fcc43a00 collected $0.2 from pot
*** SUMMARY ***
Total pot $0.2 | Rake $0 | Jackpot $0 | Bingo $0 | Fortune $0
Seat 1: ba9f55a3 (button) folded before Flop (didn't bet)
Seat 2: fcc43a00 (small blind) collected ($0.2)
Seat 3: 8639b271 (big blind) folded before Flop
Seat 4: ff082cd5 folded before Flop (didn't bet)
Seat 5: Hero folded before Flop (didn't bet)
Seat 6: 2bb65c38 folded before Flop (didn't bet)


Poker Hand #RC1433415404: Hold'em No Limit  ($0.05/$0.1) - 2023/03/27 19:45:35
Table 'RushAndCash28180664' 6-max Seat #1 is the button
Seat 1: c999d48d ($25.65 in chips)
Seat 2: a328d1ad ($9.95 in chips)
Seat 3: 264ce4df ($10.32 in chips)
Seat 4: Hero ($24.63 in chips)
Seat 5: ff49bf9a ($20.78 in chips)
Seat 6: 827546bd ($18.32 in chips)
a328d1ad: posts small blind $0.05
264ce4df: posts big blind $0.1
*** HOLE CARDS ***
Dealt to c999d48d 
Dealt to a328d1ad 
Dealt to 264ce4df 
Dealt to Hero [5c 7d]
Dealt to ff49bf9a 
Dealt to 827546bd 
Hero: folds
ff49bf9a: folds
827546bd: folds
c999d48d: raises $0.15 to $0.25
a328d1ad: raises $0.75 to $1
264ce4df: folds
c999d48d: calls $0.75
*** FLOP *** [6c Qd 2h]
a328d1ad: checks
c999d48d: bets $0.5
a328d1ad: calls $0.5
*** TURN *** [6c Qd 2h] [8h]
a328d1ad: checks
c999d48d: checks
*** RIVER *** [6c Qd 2h 8h] [2c]
a328d1ad: bets $1
c999d48d: folds
Uncalled bet ($1) returned to a328d1ad
*** SHOWDOWN ***
a328d1ad collected $2.81 from pot
*** SUMMARY ***
Total pot $3.1 | Rake $0.14 | Jackpot $0.15 | Bingo $0 | Fortune $0
Board [6c Qd 2h 8h 2c]
Seat 1: c999d48d (button) folded on the River
Seat 2: a328d1ad (small blind) won ($2.81)
Seat 3: 264ce4df (big blind) folded before Flop
Seat 4: Hero folded before Flop (didn't bet)
Seat 5: ff49bf9a folded before Flop (didn't bet)
Seat 6: 827546bd folded before Flop (didn't bet)


Poker Hand #RC1433415369: Hold'em No Limit  ($0.05/$0.1) - 2023/03/27 19:45:29
Table 'RushAndCash28180629' 6-max Seat #1 is the button
Seat 1: a9a0de0c ($10 in chips)
Seat 2: 67cfc163 ($23.76 in chips)
Seat 3: 72b7452d ($10.66 in chips)
Seat 4: 5c49a7dc ($10.17 in chips)
Seat 5: c2c593b0 ($20.81 in chips)
Seat 6: Hero ($24.63 in chips)
67cfc163: posts small blind $0.05
72b7452d: posts big blind $0.1
*** HOLE CARDS ***
Dealt to a9a0de0c 
Dealt to 67cfc163 
Dealt to 72b7452d 
Dealt to 5c49a7dc 
Dealt to c2c593b0 
Dealt to Hero [3d Td]
5c49a7dc: raises $0.2 to $0.3
c2c593b0: folds
Hero: folds
a9a0de0c: folds
67cfc163: calls $0.25
72b7452d: calls $0.2
*** FLOP *** [3s Kd 2s]
67cfc163: checks
72b7452d: checks
5c49a7dc: bets $0.3
67cfc163: raises $0.9 to $1.2
72b7452d: folds
5c49a7dc: raises $1.05 to $2.25
67cfc163: calls $1.05
*** TURN *** [3s Kd 2s] [Qd]
67cfc163: checks
5c49a7dc: bets $0.8
67cfc163: calls $0.8
*** RIVER *** [3s Kd 2s Qd] [9h]
67cfc163: checks
5c49a7dc: checks
67cfc163: shows [Qs Js] (Pair of Queens)
5c49a7dc: shows [Ac Kc] (Pair of Kings)
*** SHOWDOWN ***
5c49a7dc collected $6.55 from pot
*** SUMMARY ***
Total pot $7 | Rake $0.3 | Jackpot $0.15 | Bingo $0 | Fortune $0
Board [3s Kd 2s Qd 9h]
Seat 1: a9a0de0c (button) folded before Flop (didn't bet)
Seat 2: 67cfc163 (small blind) showed [Qs Js] and lost with Pair of Queens
Seat 3: 72b7452d (big blind) folded on the Flop
Seat 4: 5c49a7dc showed [Ac Kc] and won ($6.55) with Pair of Kings
Seat 5: c2c593b0 folded before Flop (didn't bet)
Seat 6: Hero folded before Flop (didn't bet)


Poker Hand #RC1433415314: Hold'em No Limit  ($0.05/$0.1) - 2023/03/27 19:45:20
Table 'RushAndCash28180574' 6-max Seat #1 is the button
Seat 1: a1d4f810 ($10 in chips)
Seat 2: 9b3cdb65 ($45.66 in chips)
Seat 3: ef5704e0 ($8.28 in chips)
Seat 4: Hero ($24.63 in chips)
Seat 5: 6e7fc55e ($10.58 in chips)
Seat 6: b90da366 ($11.71 in chips)
9b3cdb65: posts small blind $0.05
ef5704e0: posts big blind $0.1
*** HOLE CARDS ***
Dealt to a1d4f810 
Dealt to 9b3cdb65 
Dealt to ef5704e0 
Dealt to Hero [Jc 3d]
Dealt to 6e7fc55e 
Dealt to b90da366 
Hero: folds
6e7fc55e: folds
b90da366: raises $0.2 to $0.3
a1d4f810: raises $0.58 to $0.88
9b3cdb65: folds
ef5704e0: folds
b90da366: calls $0.58
*** FLOP *** [Ad 4c 7d]
b90da366: checks
a1d4f810: bets $0.64
b90da366: folds
Uncalled bet ($0.64) returned to a1d4f810
*** SHOWDOWN ***
a1d4f810 collected $1.82 from pot
*** SUMMARY ***
Total pot $1.91 | Rake $0.09 | Jackpot $0 | Bingo $0 | Fortune $0
Board [Ad 4c 7d]
Seat 1: a1d4f810 (button) won ($1.82)
Seat 2: 9b3cdb65 (small blind) folded before Flop
Seat 3: ef5704e0 (big blind) folded before Flop
Seat 4: Hero folded before Flop (didn't bet)
Seat 5: 6e7fc55e folded before Flop (didn't bet)
Seat 6: b90da366 folded on the Flop


Poker Hand #RC1433415240: Hold'em No Limit  ($0.05/$0.1) - 2023/03/27 19:45:09
Table 'RushAndCash28180500' 6-max Seat #1 is the button
Seat 1: be87df52 ($11.05 in chips)
Seat 2: e5558e5d ($20.39 in chips)
Seat 3: f770dcf2 ($9.96 in chips)
Seat 4: 92d16a23 ($5.17 in chips)
Seat 5: bd83b99 ($21.46 in chips)
Seat 6: Hero ($24.63 in chips)
e5558e5d: posts small blind $0.05
f770dcf2: posts big blind $0.1
*** HOLE CARDS ***
Dealt to be87df52 
Dealt to e5558e5d 
Dealt to f770dcf2 
Dealt to 92d16a23 
Dealt to bd83b99 
Dealt to Hero [Th 2h]
92d16a23: raises $0.21 to $0.31
bd83b99: calls $0.31
Hero: folds
be87df52: calls $0.31
e5558e5d: calls $0.26
f770dcf2: folds
*** FLOP *** [5h 6d 5d]
e5558e5d: checks
92d16a23: bets $0.89
bd83b99: folds
be87df52: folds
e5558e5d: folds
Uncalled bet ($0.89) returned to 92d16a23
*** SHOWDOWN ***
92d16a23 collected $1.28 from pot
*** SUMMARY ***
Total pot $1.34 | Rake $0.06 | Jackpot $0 | Bingo $0 | Fortune $0
Board [5h 6d 5d]
Seat 1: be87df52 (button) folded on the Flop
Seat 2: e5558e5d (small blind) folded on the Flop
Seat 3: f770dcf2 (big blind) folded before Flop
Seat 4: 92d16a23 won ($1.28)
Seat 5: bd83b99 folded on the Flop
Seat 6: Hero folded before Flop (didn't bet)


Poker Hand #RC1433414780: Hold'em No Limit  ($0.05/$0.1) - 2023/03/27 19:44:05
Table 'RushAndCash28180040' 6-max Seat #1 is the button
Seat 1: f6b4fed3 ($11.43 in chips)
Seat 2: fa62c5da ($10.15 in chips)
Seat 3: Hero ($22.57 in chips)
Seat 4: a328d1ad ($10.3 in chips)
Seat 5: 92d16a23 ($7.35 in chips)
Seat 6: 50908537 ($34.97 in chips)
fa62c5da: posts small blind $0.05
Hero: posts big blind $0.1
*** HOLE CARDS ***
Dealt to f6b4fed3 
Dealt to fa62c5da 
Dealt to Hero [As Qs]
Dealt to a328d1ad 
Dealt to 92d16a23 
Dealt to 50908537 
a328d1ad: raises $0.1 to $0.2
92d16a23: calls $0.2
50908537: folds
f6b4fed3: folds
fa62c5da: folds
Hero: raises $0.85 to $1.05
a328d1ad: folds
92d16a23: calls $0.85
*** FLOP *** [Qh Kd 3c]
Hero: checks
92d16a23: checks
*** TURN *** [Qh Kd 3c] [7s]
Hero: checks
92d16a23: checks
*** RIVER *** [Qh Kd 3c 7s] [5h]
Hero: bets $1.13
92d16a23: calls $1.13
Hero: shows [As Qs] (Pair of Queens)
92d16a23: shows [Qc Tc] (Pair of Queens)
*** SHOWDOWN ***
Hero collected $4.24 from pot
*** SUMMARY ***
Total pot $4.61 | Rake $0.22 | Jackpot $0.15 | Bingo $0 | Fortune $0
Board [Qh Kd 3c 7s 5h]
Seat 1: f6b4fed3 (button) folded before Flop (didn't bet)
Seat 2: fa62c5da (small blind) folded before Flop
Seat 3: Hero (big blind) showed [As Qs] and won ($4.24) with Pair of Queens
Seat 4: a328d1ad folded before Flop
Seat 5: 92d16a23 showed [Qc Tc] and lost with Pair of Queens
Seat 6: 50908537 folded before Flop (didn't bet)


Poker Hand #RC1433374670: Hold'em No Limit  ($0.05/$0.1) - 2023/03/27 19:43:50
Table 'RushAndCash28179930' 6-max Seat #1 is the button
Seat 1: Hero ($22.57 in chips)
Seat 2: 492bd702 ($10.55 in chips)
Seat 3: f0e39b8f ($10.3 in chips)
Seat 4: 39e708ef ($13.54 in chips)
Seat 5: d7795b7 ($11.76 in chips)
Seat 6: 5d8bcdeb ($13.86 in chips)
492bd702: posts small blind $0.05
f0e39b8f: posts big blind $0.1
*** HOLE CARDS ***
Dealt to Hero [5h 7d]
Dealt to 492bd702 
Dealt to f0e39b8f 
Dealt to 39e708ef 
Dealt to d7795b7 
Dealt to 5d8bcdeb 
39e708ef: folds
d7795b7: folds
5d8bcdeb: folds
Hero: folds
492bd702: folds
Uncalled bet ($0.05) returned to f0e39b8f
*** SHOWDOWN ***
f0e39b8f collected $0.1 from pot
*** SUMMARY ***
Total pot $0.1 | Rake $0 | Jackpot $0 | Bingo $0 | Fortune $0
Seat 1: Hero (button) folded before Flop (didn't bet)
Seat 2: 492bd702 (small blind) folded before Flop
Seat 3: f0e39b8f (big blind) collected ($0.1)
Seat 4: 39e708ef folded before Flop (didn't bet)
Seat 5: d7795b7 folded before Flop (didn't bet)
Seat 6: 5d8bcdeb folded before Flop (didn't bet)


Poker Hand #RC1433374578: Hold'em No Limit  ($0.05/$0.1) - 2023/03/27 19:43:36
Table 'RushAndCash28179838' 6-max Seat #1 is the button
Seat 1: d763ecdf ($23.2 in chips)
Seat 2: 36216ab ($23.88 in chips)
Seat 3: a77b563e ($10.25 in chips)
Seat 4: Hero ($22.57 in chips)
Seat 5: fc7eade4 ($10 in chips)
Seat 6: fc3cf172 ($10.47 in chips)
36216ab: posts small blind $0.05
a77b563e: posts big blind $0.1
*** HOLE CARDS ***
Dealt to d763ecdf 
Dealt to 36216ab 
Dealt to a77b563e 
Dealt to Hero [9d 7s]
Dealt to fc7eade4 
Dealt to fc3cf172 
Hero: folds
fc7eade4: folds
fc3cf172: folds
d763ecdf: folds
36216ab: raises $0.2 to $0.3
a77b563e: folds
Uncalled bet ($0.2) returned to 36216ab
*** SHOWDOWN ***
36216ab collected $0.2 from pot
*** SUMMARY ***
Total pot $0.2 | Rake $0 | Jackpot $0 | Bingo $0 | Fortune $0
Seat 1: d763ecdf (button) folded before Flop (didn't bet)
Seat 2: 36216ab (small blind) collected ($0.2)
Seat 3: a77b563e (big blind) folded before Flop
Seat 4: Hero folded before Flop (didn't bet)
Seat 5: fc7eade4 folded before Flop (didn't bet)
Seat 6: fc3cf172 folded before Flop (didn't bet)


Poker Hand #RC1433374482: Hold'em No Limit  ($0.05/$0.1) - 2023/03/27 19:43:23
Table 'RushAndCash28179742' 6-max Seat #1 is the button
Seat 1: 99925e41 ($11.4 in chips)
Seat 2: 155f5447 ($10.77 in chips)
Seat 3: dd99ad10 ($8.21 in chips)
Seat 4: Hero ($22.42 in chips)
Seat 5: 8d824d61 ($12.76 in chips)
Seat 6: 9aac1dcb ($10.14 in chips)
155f5447: posts small blind $0.05
dd99ad10: posts big blind $0.1
*** HOLE CARDS ***
Dealt to 99925e41 
Dealt to 155f5447 
Dealt to dd99ad10 
Dealt to Hero [Ks Kh]
Dealt to 8d824d61 
Dealt to 9aac1dcb 
Hero: raises $0.15 to $0.25
8d824d61: folds
9aac1dcb: folds
99925e41: folds
155f5447: folds
dd99ad10: folds
Uncalled bet ($0.15) returned to Hero
*** SHOWDOWN ***
Hero collected $0.25 from pot
*** SUMMARY ***
Total pot $0.25 | Rake $0 | Jackpot $0 | Bingo $0 | Fortune $0
Seat 1: 99925e41 (button) folded before Flop (didn't bet)
Seat 2: 155f5447 (small blind) folded before Flop
Seat 3: dd99ad10 (big blind) folded before Flop
Seat 4: Hero collected ($0.25)
Seat 5: 8d824d61 folded before Flop (didn't bet)
Seat 6: 9aac1dcb folded before Flop (didn't bet)


Poker Hand #RC1433374432: Hold'em No Limit  ($0.05/$0.1) - 2023/03/27 19:43:16
Table 'RushAndCash28179692' 6-max Seat #1 is the button
Seat 1: 9ba6ae76 ($12.04 in chips)
Seat 2: b90da366 ($11.24 in chips)
Seat 3: 2012d077 ($10.26 in chips)
Seat 4: ceed2bdd ($9.89 in chips)
Seat 5: 1308311b ($16.36 in chips)
Seat 6: Hero ($22.42 in chips)
b90da366: posts small blind $0.05
2012d077: posts big blind $0.1
*** HOLE CARDS ***
Dealt to 9ba6ae76 
Dealt to b90da366 
Dealt to 2012d077 
Dealt to ceed2bdd 
Dealt to 1308311b 
Dealt to Hero [3c Kh]
ceed2bdd: folds
1308311b: folds
Hero: folds
9ba6ae76: folds
b90da366: folds
Uncalled bet ($0.05) returned to 2012d077
*** SHOWDOWN ***
2012d077 collected $0.1 from pot
*** SUMMARY ***
Total pot $0.1 | Rake $0 | Jackpot $0 | Bingo $0 | Fortune $0
Seat 1: 9ba6ae76 (button) folded before Flop (didn't bet)
Seat 2: b90da366 (small blind) folded before Flop
Seat 3: 2012d077 (big blind) collected ($0.1)
Seat 4: ceed2bdd folded before Flop (didn't bet)
Seat 5: 1308311b folded before Flop (didn't bet)
Seat 6: Hero folded before Flop (didn't bet)


Poker Hand #RC1433374402: Hold'em No Limit  ($0.05/$0.1) - 2023/03/27 19:43:12
Table 'RushAndCash28179662' 6-max Seat #1 is the button
Seat 1: 336f074e ($11.41 in chips)
Seat 2: Hero ($22.47 in chips)
Seat 3: 95bcae3a ($6.7 in chips)
Seat 4: b179857a ($11.24 in chips)
Seat 5: 221cac95 ($31.33 in chips)
Seat 6: df73a606 ($9.7 in chips)
Hero: posts small blind $0.05
95bcae3a: posts big blind $0.1
*** HOLE CARDS ***
Dealt to 336f074e 
Dealt to Hero [2s Qh]
Dealt to 95bcae3a 
Dealt to b179857a 
Dealt to 221cac95 
Dealt to df73a606 
b179857a: folds
221cac95: folds
df73a606: folds
336f074e: folds
Hero: folds
Uncalled bet ($0.05) returned to 95bcae3a
*** SHOWDOWN ***
95bcae3a collected $0.1 from pot
*** SUMMARY ***
Total pot $0.1 | Rake $0 | Jackpot $0 | Bingo $0 | Fortune $0
Seat 1: 336f074e (button) folded before Flop (didn't bet)
Seat 2: Hero (small blind) folded before Flop
Seat 3: 95bcae3a (big blind) collected ($0.1)
Seat 4: b179857a folded before Flop (didn't bet)
Seat 5: 221cac95 folded before Flop (didn't bet)
Seat 6: df73a606 folded before Flop (didn't bet)


Poker Hand #RC1433374221: Hold'em No Limit  ($0.05/$0.1) - 2023/03/27 19:42:48
Table 'RushAndCash28179481' 6-max Seat #1 is the button
Seat 1: Hero ($22.32 in chips)
Seat 2: f0e39b8f ($10 in chips)
Seat 3: c30ea873 ($16.32 in chips)
Seat 4: 15aecec1 ($10 in chips)
Seat 5: 60e059ec ($12.98 in chips)
Seat 6: 57e47a67 ($10 in chips)
f0e39b8f: posts small blind $0.05
c30ea873: posts big blind $0.1
*** HOLE CARDS ***
Dealt to Hero [2c Kc]
Dealt to f0e39b8f 
Dealt to c30ea873 
Dealt to 15aecec1 
Dealt to 60e059ec 
Dealt to 57e47a67 
15aecec1: folds
60e059ec: folds
57e47a67: folds
Hero: raises $0.15 to $0.25
f0e39b8f: folds
c30ea873: folds
Uncalled bet ($0.15) returned to Hero
*** SHOWDOWN ***
Hero collected $0.25 from pot
*** SUMMARY ***
Total pot $0.25 | Rake $0 | Jackpot $0 | Bingo $0 | Fortune $0
Seat 1: Hero (button) collected ($0.25)
Seat 2: f0e39b8f (small blind) folded before Flop
Seat 3: c30ea873 (big blind) folded before Flop
Seat 4: 15aecec1 folded before Flop (didn't bet)
Seat 5: 60e059ec folded before Flop (didn't bet)
Seat 6: 57e47a67 folded before Flop (didn't bet)


Poker Hand #RC1433374138: Hold'em No Limit  ($0.05/$0.1) - 2023/03/27 19:42:38
Table 'RushAndCash28179398' 6-max Seat #1 is the button
Seat 1: 148b1cdb ($22.95 in chips)
Seat 2: 32df2317 ($23.32 in chips)
Seat 3: aa6656f4 ($9.03 in chips)
Seat 4: 66017d6f ($26.58 in chips)
Seat 5: Hero ($22.32 in chips)
Seat 6: 634a1d5 ($15.87 in chips)
32df2317: posts small blind $0.05
aa6656f4: posts big blind $0.1
*** HOLE CARDS ***
Dealt to 148b1cdb 
Dealt to 32df2317 
Dealt to aa6656f4 
Dealt to 66017d6f 
Dealt to Hero [2d 4s]
Dealt to 634a1d5 
66017d6f: folds
Hero: folds
634a1d5: raises $0.15 to $0.25
148b1cdb: folds
32df2317: calls $0.2
aa6656f4: folds
*** FLOP *** [9h Td Ac]
32df2317: checks
634a1d5: bets $0.2
32df2317: calls $0.2
*** TURN *** [9h Td Ac] [Ah]
32df2317: checks
634a1d5: checks
*** RIVER *** [9h Td Ac Ah] [9s]
32df2317: bets $1.5
634a1d5: folds
Uncalled bet ($1.5) returned to 32df2317
*** SHOWDOWN ***
32df2317 collected $0.94 from pot
*** SUMMARY ***
Total pot $1 | Rake $0.06 | Jackpot $0 | Bingo $0 | Fortune $0
Board [9h Td Ac Ah 9s]
Seat 1: 148b1cdb (button) folded before Flop (didn't bet)
Seat 2: 32df2317 (small blind) won ($0.94)
Seat 3: aa6656f4 (big blind) folded before Flop
Seat 4: 66017d6f folded before Flop (didn't bet)
Seat 5: Hero folded before Flop (didn't bet)
Seat 6: 634a1d5 folded on the River


Poker Hand #RC1433374080: Hold'em No Limit  ($0.05/$0.1) - 2023/03/27 19:42:29
Table 'RushAndCash28179340' 6-max Seat #1 is the button
Seat 1: 7decfbbe ($10.15 in chips)
Seat 2: d7ef21d5 ($17 in chips)
Seat 3: Hero ($22.42 in chips)
Seat 4: f59c9ff2 ($21.41 in chips)
Seat 5: 2004f2dc ($10.4 in chips)
Seat 6: b8f54584 ($10.56 in chips)
d7ef21d5: posts small blind $0.05
Hero: posts big blind $0.1
*** HOLE CARDS ***
Dealt to 7decfbbe 
Dealt to d7ef21d5 
Dealt to Hero [3d 9d]
Dealt to f59c9ff2 
Dealt to 2004f2dc 
Dealt to b8f54584 
f59c9ff2: raises $0.15 to $0.25
2004f2dc: folds
b8f54584: folds
7decfbbe: folds
d7ef21d5: folds
Hero: folds
Uncalled bet ($0.15) returned to f59c9ff2
*** SHOWDOWN ***
f59c9ff2 collected $0.25 from pot
*** SUMMARY ***
Total pot $0.25 | Rake $0 | Jackpot $0 | Bingo $0 | Fortune $0
Seat 1: 7decfbbe (button) folded before Flop (didn't bet)
Seat 2: d7ef21d5 (small blind) folded before Flop
Seat 3: Hero (big blind) folded before Flop
Seat 4: f59c9ff2 collected ($0.25)
Seat 5: 2004f2dc folded before Flop (didn't bet)
Seat 6: b8f54584 folded before Flop (didn't bet)


Poker Hand #RC1433374013: Hold'em No Limit  ($0.05/$0.1) - 2023/03/27 19:42:20
Table 'RushAndCash28179273' 6-max Seat #1 is the button
Seat 1: f770dcf2 ($10.59 in chips)
Seat 2: 7c84e01d ($39.76 in chips)
Seat 3: 35386212 ($17.24 in chips)
Seat 4: eda6868 ($29.64 in chips)
Seat 5: 74aeaadc ($41.88 in chips)
Seat 6: Hero ($22.42 in chips)
7c84e01d: posts small blind $0.05
35386212: posts big blind $0.1
*** HOLE CARDS ***
Dealt to f770dcf2 
Dealt to 7c84e01d 
Dealt to 35386212 
Dealt to eda6868 
Dealt to 74aeaadc 
Dealt to Hero [4s Qc]
eda6868: folds
74aeaadc: folds
Hero: folds
f770dcf2: raises $0.15 to $0.25
7c84e01d: folds
35386212: folds
Uncalled bet ($0.15) returned to f770dcf2
*** SHOWDOWN ***
f770dcf2 collected $0.25 from pot
*** SUMMARY ***
Total pot $0.25 | Rake $0 | Jackpot $0 | Bingo $0 | Fortune $0
Seat 1: f770dcf2 (button) collected ($0.25)
Seat 2: 7c84e01d (small blind) folded before Flop
Seat 3: 35386212 (big blind) folded before Flop
Seat 4: eda6868 folded before Flop (didn't bet)
Seat 5: 74aeaadc folded before Flop (didn't bet)
Seat 6: Hero folded before Flop (didn't bet)


Poker Hand #RC1433373961: Hold'em No Limit  ($0.05/$0.1) - 2023/03/27 19:42:13
Table 'RushAndCash28179221' 6-max Seat #1 is the button
Seat 1: b95c5a94 ($19.91 in chips)
Seat 2: 8ee12122 ($16.48 in chips)
Seat 3: 62a0afa3 ($15.96 in chips)
Seat 4: 49753712 ($10.34 in chips)
Seat 5: Hero ($22.42 in chips)
Seat 6: cb63059 ($24.17 in chips)
8ee12122: posts small blind $0.05
62a0afa3: posts big blind $0.1
*** HOLE CARDS ***
Dealt to b95c5a94 
Dealt to 8ee12122 
Dealt to 62a0afa3 
Dealt to 49753712 
Dealt to Hero [6c 5s]
Dealt to cb63059 
49753712: folds
Hero: folds
cb63059: folds
b95c5a94: folds
8ee12122: folds
Uncalled bet ($0.05) returned to 62a0afa3
*** SHOWDOWN ***
62a0afa3 collected $0.1 from pot
*** SUMMARY ***
Total pot $0.1 | Rake $0 | Jackpot $0 | Bingo $0 | Fortune $0
Seat 1: b95c5a94 (button) folded before Flop (didn't bet)
Seat 2: 8ee12122 (small blind) folded before Flop
Seat 3: 62a0afa3 (big blind) collected ($0.1)
Seat 4: 49753712 folded before Flop (didn't bet)
Seat 5: Hero folded before Flop (didn't bet)
Seat 6: cb63059 folded before Flop (didn't bet)


Poker Hand #RC1433373914: Hold'em No Limit  ($0.05/$0.1) - 2023/03/27 19:42:07
Table 'RushAndCash28179174' 6-max Seat #1 is the button
Seat 1: 60ef400e ($12.53 in chips)
Seat 2: 9ba6ae76 ($12.74 in chips)
Seat 3: b90da366 ($10.61 in chips)
Seat 4: a9f4a031 ($11.3 in chips)
Seat 5: 4ce292a0 ($10.14 in chips)
Seat 6: Hero ($22.42 in chips)
9ba6ae76: posts small blind $0.05
b90da366: posts big blind $0.1
*** HOLE CARDS ***
Dealt to 60ef400e 
Dealt to 9ba6ae76 
Dealt to b90da366 
Dealt to a9f4a031 
Dealt to 4ce292a0 
Dealt to Hero [6h 4c]
a9f4a031: folds
4ce292a0: folds
Hero: folds
60ef400e: folds
9ba6ae76: raises $0.18 to $0.28
b90da366: calls $0.18
*** FLOP *** [As Qs Kc]
9ba6ae76: bets $0.42
b90da366: calls $0.42
*** TURN *** [As Qs Kc] [Tc]
9ba6ae76: checks
b90da366: bets $1.05
9ba6ae76: folds
Uncalled bet ($1.05) returned to b90da366
*** SHOWDOWN ***
b90da366 collected $1.33 from pot
*** SUMMARY ***
Total pot $1.4 | Rake $0.07 | Jackpot $0 | Bingo $0 | Fortune $0
Board [As Qs Kc Tc]
Seat 1: 60ef400e (button) folded before Flop (didn't bet)
Seat 2: 9ba6ae76 (small blind) folded on the Turn
Seat 3: b90da366 (big blind) won ($1.33)
Seat 4: a9f4a031 folded before Flop (didn't bet)
Seat 5: 4ce292a0 folded before Flop (didn't bet)
Seat 6: Hero folded before Flop (didn't bet)


Poker Hand #RC1433373873: Hold'em No Limit  ($0.05/$0.1) - 2023/03/27 19:42:02
Table 'RushAndCash28179133' 6-max Seat #1 is the button
Seat 1: 9024126a ($10.04 in chips)
Seat 2: Hero ($22.47 in chips)
Seat 3: 593ff255 ($10.47 in chips)
Seat 4: 7125b3e8 ($5.78 in chips)
Seat 5: e0f23917 ($23.9 in chips)
Seat 6: 622837e ($10.31 in chips)
Hero: posts small blind $0.05
593ff255: posts big blind $0.1
*** HOLE CARDS ***
Dealt to 9024126a 
Dealt to Hero [5c 6d]
Dealt to 593ff255 
Dealt to 7125b3e8 
Dealt to e0f23917 
Dealt to 622837e 
7125b3e8: folds
e0f23917: folds
622837e: folds
9024126a: folds
Hero: folds
Uncalled bet ($0.05) returned to 593ff255
*** SHOWDOWN ***
593ff255 collected $0.1 from pot
*** SUMMARY ***
Total pot $0.1 | Rake $0 | Jackpot $0 | Bingo $0 | Fortune $0
Seat 1: 9024126a (button) folded before Flop (didn't bet)
Seat 2: Hero (small blind) folded before Flop
Seat 3: 593ff255 (big blind) collected ($0.1)
Seat 4: 7125b3e8 folded before Flop (didn't bet)
Seat 5: e0f23917 folded before Flop (didn't bet)
Seat 6: 622837e folded before Flop (didn't bet)


Poker Hand #RC1433373724: Hold'em No Limit  ($0.05/$0.1) - 2023/03/27 19:41:42
Table 'RushAndCash28178984' 6-max Seat #1 is the button
Seat 1: Hero ($22.32 in chips)
Seat 2: 7c2e9189 ($11.96 in chips)
Seat 3: 5c49a7dc ($10.57 in chips)
Seat 4: 19803eba ($10 in chips)
Seat 5: 784858c ($19.05 in chips)
Seat 6: 7c3efb34 ($11.01 in chips)
7c2e9189: posts small blind $0.05
5c49a7dc: posts big blind $0.1
*** HOLE CARDS ***
Dealt to Hero [3h 4h]
Dealt to 7c2e9189 
Dealt to 5c49a7dc 
Dealt to 19803eba 
Dealt to 784858c 
Dealt to 7c3efb34 
19803eba: folds
784858c: folds
7c3efb34: folds
Hero: raises $0.15 to $0.25
7c2e9189: folds
5c49a7dc: folds
Uncalled bet ($0.15) returned to Hero
*** SHOWDOWN ***
Hero collected $0.25 from pot
*** SUMMARY ***
Total pot $0.25 | Rake $0 | Jackpot $0 | Bingo $0 | Fortune $0
Seat 1: Hero (button) collected ($0.25)
Seat 2: 7c2e9189 (small blind) folded before Flop
Seat 3: 5c49a7dc (big blind) folded before Flop
Seat 4: 19803eba folded before Flop (didn't bet)
Seat 5: 784858c folded before Flop (didn't bet)
Seat 6: 7c3efb34 folded before Flop (didn't bet)


Poker Hand #RC1433373689: Hold'em No Limit  ($0.05/$0.1) - 2023/03/27 19:41:37
Table 'RushAndCash28178949' 6-max Seat #1 is the button
Seat 1: 1f39b23f ($3.06 in chips)
Seat 2: b90da366 ($10.51 in chips)
Seat 3: Hero ($22.42 in chips)
Seat 4: f65a170a ($10.22 in chips)
Seat 5: b6ccf254 ($51.62 in chips)
Seat 6: 91b20660 ($21.44 in chips)
b90da366: posts small blind $0.05
Hero: posts big blind $0.1
*** HOLE CARDS ***
Dealt to 1f39b23f 
Dealt to b90da366 
Dealt to Hero [Qh 4c]
Dealt to f65a170a 
Dealt to b6ccf254 
Dealt to 91b20660 
f65a170a: folds
b6ccf254: folds
91b20660: folds
1f39b23f: folds
b90da366: raises $0.2 to $0.3
Hero: folds
Uncalled bet ($0.2) returned to b90da366
*** SHOWDOWN ***
b90da366 collected $0.2 from pot
*** SUMMARY ***
Total pot $0.2 | Rake $0 | Jackpot $0 | Bingo $0 | Fortune $0
Seat 1: 1f39b23f (button) folded before Flop (didn't bet)
Seat 2: b90da366 (small blind) collected ($0.2)
Seat 3: Hero (big blind) folded before Flop
Seat 4: f65a170a folded before Flop (didn't bet)
Seat 5: b6ccf254 folded before Flop (didn't bet)
Seat 6: 91b20660 folded before Flop (didn't bet)


Poker Hand #RC1433373662: Hold'em No Limit  ($0.05/$0.1) - 2023/03/27 19:41:34
Table 'RushAndCash28178922' 6-max Seat #1 is the button
Seat 1: b3291988 ($10 in chips)
Seat 2: 9ccb6a6f ($11.37 in chips)
Seat 3: 91b20660 ($21.54 in chips)
Seat 4: 88eb6bb7 ($16.95 in chips)
Seat 5: Hero ($22.42 in chips)
Seat 6: 197ebdde ($21.8 in chips)
9ccb6a6f: posts small blind $0.05
91b20660: posts big blind $0.1
*** HOLE CARDS ***
Dealt to b3291988 
Dealt to 9ccb6a6f 
Dealt to 91b20660 
Dealt to 88eb6bb7 
Dealt to Hero [Qh 6s]
Dealt to 197ebdde 
88eb6bb7: folds
Hero: folds
197ebdde: folds
b3291988: folds
9ccb6a6f: calls $0.05
91b20660: checks
*** FLOP *** [Kd 4c Qd]
9ccb6a6f: checks
91b20660: checks
*** TURN *** [Kd 4c Qd] [9h]
9ccb6a6f: bets $0.1
91b20660: folds
Uncalled bet ($0.1) returned to 9ccb6a6f
*** SHOWDOWN ***
9ccb6a6f collected $0.19 from pot
*** SUMMARY ***
Total pot $0.2 | Rake $0.01 | Jackpot $0 | Bingo $0 | Fortune $0
Board [Kd 4c Qd 9h]
Seat 1: b3291988 (button) folded before Flop (didn't bet)
Seat 2: 9ccb6a6f (small blind) won ($0.19)
Seat 3: 91b20660 (big blind) folded on the Turn
Seat 4: 88eb6bb7 folded before Flop (didn't bet)
Seat 5: Hero folded before Flop (didn't bet)
Seat 6: 197ebdde folded before Flop (didn't bet)


Poker Hand #RC1433373225: Hold'em No Limit  ($0.05/$0.1) - 2023/03/27 19:40:31
Table 'RushAndCash28178485' 6-max Seat #1 is the button
Seat 1: Hero ($22.67 in chips)
Seat 2: aa6656f4 ($8.95 in chips)
Seat 3: 197ebdde ($21.52 in chips)
Seat 4: c6867e9e ($11.57 in chips)
Seat 5: 8030373d ($10.2 in chips)
Seat 6: abf042fe ($10.15 in chips)
aa6656f4: posts small blind $0.05
197ebdde: posts big blind $0.1
*** HOLE CARDS ***
Dealt to Hero [Jh Ad]
Dealt to aa6656f4 
Dealt to 197ebdde 
Dealt to c6867e9e 
Dealt to 8030373d 
Dealt to abf042fe 
c6867e9e: folds
8030373d: folds
abf042fe: folds
Hero: raises $0.15 to $0.25
aa6656f4: folds
197ebdde: calls $0.15
*** FLOP *** [5d 8s 6d]
197ebdde: checks
Hero: checks
*** TURN *** [5d 8s 6d] [Tc]
197ebdde: checks
Hero: checks
*** RIVER *** [5d 8s 6d Tc] [Th]
197ebdde: bets $0.66
Hero: folds
Uncalled bet ($0.66) returned to 197ebdde
*** SHOWDOWN ***
197ebdde collected $0.53 from pot
*** SUMMARY ***
Total pot $0.55 | Rake $0.02 | Jackpot $0 | Bingo $0 | Fortune $0
Board [5d 8s 6d Tc Th]
Seat 1: Hero (button) folded on the River
Seat 2: aa6656f4 (small blind) folded before Flop
Seat 3: 197ebdde (big blind) won ($0.53)
Seat 4: c6867e9e folded before Flop (didn't bet)
Seat 5: 8030373d folded before Flop (didn't bet)
Seat 6: abf042fe folded before Flop (didn't bet)


Poker Hand #RC1433373104: Hold'em No Limit  ($0.05/$0.1) - 2023/03/27 19:40:14
Table 'RushAndCash28178364' 6-max Seat #1 is the button
Seat 1: a9a0de0c ($10 in chips)
Seat 2: 99925e41 ($10 in chips)
Seat 3: 1308311b ($16.21 in chips)
Seat 4: 197ebdde ($21.52 in chips)
Seat 5: e83ac0f9 ($10.97 in chips)
Seat 6: Hero ($22.67 in chips)
99925e41: posts small blind $0.05
1308311b: posts big blind $0.1
*** HOLE CARDS ***
Dealt to a9a0de0c 
Dealt to 99925e41 
Dealt to 1308311b 
Dealt to 197ebdde 
Dealt to e83ac0f9 
Dealt to Hero [Tc 9s]
197ebdde: folds
e83ac0f9: raises $0.1 to $0.2
Hero: folds
a9a0de0c: folds
99925e41: folds
1308311b: calls $0.1
*** FLOP *** [Td 2c 9d]
1308311b: checks
e83ac0f9: checks
*** TURN *** [Td 2c 9d] [8c]
1308311b: checks
e83ac0f9: checks
*** RIVER *** [Td 2c 9d 8c] [Kd]
1308311b: checks
e83ac0f9: checks
1308311b: shows [4h 7c] (King-High)
e83ac0f9: shows [Qc Ad] (Ace-High)
*** SHOWDOWN ***
e83ac0f9 collected $0.43 from pot
*** SUMMARY ***
Total pot $0.45 | Rake $0.02 | Jackpot $0 | Bingo $0 | Fortune $0
Board [Td 2c 9d 8c Kd]
Seat 1: a9a0de0c (button) folded before Flop (didn't bet)
Seat 2: 99925e41 (small blind) folded before Flop
Seat 3: 1308311b (big blind) showed [4h 7c] and lost with King-High
Seat 4: 197ebdde folded before Flop (didn't bet)
Seat 5: e83ac0f9 showed [Qc Ad] and won ($0.43) with Ace-High
Seat 6: Hero folded before Flop (didn't bet)


Poker Hand #RC1433372571: Hold'em No Limit  ($0.05/$0.1) - 2023/03/27 19:39:05
Table 'RushAndCash28177831' 6-max Seat #1 is the button
Seat 1: 884e8f0c ($10.15 in chips)
Seat 2: e83ac0f9 ($10.07 in chips)
Seat 3: Hero ($23.67 in chips)
Seat 4: e8004c2c ($11.3 in chips)
Seat 5: c682ccb4 ($67.81 in chips)
Seat 6: f3de17dc ($40.86 in chips)
e83ac0f9: posts small blind $0.05
Hero: posts big blind $0.1
*** HOLE CARDS ***
Dealt to 884e8f0c 
Dealt to e83ac0f9 
Dealt to Hero [3s 3c]
Dealt to e8004c2c 
Dealt to c682ccb4 
Dealt to f3de17dc 
e8004c2c: folds
c682ccb4: folds
f3de17dc: folds
884e8f0c: folds
e83ac0f9: raises $0.2 to $0.3
Hero: calls $0.2
*** FLOP *** [As 4s Ac]
e83ac0f9: bets $0.2
Hero: calls $0.2
*** TURN *** [As 4s Ac] [7c]
e83ac0f9: bets $0.5
Hero: calls $0.5
*** RIVER *** [As 4s Ac 7c] [5c]
e83ac0f9: bets $1.5
Hero: folds
Uncalled bet ($1.5) returned to e83ac0f9
*** SHOWDOWN ***
e83ac0f9 collected $1.9 from pot
*** SUMMARY ***
Total pot $2 | Rake $0.1 | Jackpot $0 | Bingo $0 | Fortune $0
Board [As 4s Ac 7c 5c]
Seat 1: 884e8f0c (button) folded before Flop (didn't bet)
Seat 2: e83ac0f9 (small blind) won ($1.9)
Seat 3: Hero (big blind) folded on the River
Seat 4: e8004c2c folded before Flop (didn't bet)
Seat 5: c682ccb4 folded before Flop (didn't bet)
Seat 6: f3de17dc folded before Flop (didn't bet)


Poker Hand #RC1433372448: Hold'em No Limit  ($0.05/$0.1) - 2023/03/27 19:38:46
Table 'RushAndCash28177708' 6-max Seat #1 is the button
Seat 1: 7720e09f ($10 in chips)
Seat 2: 2797b5a1 ($10.77 in chips)
Seat 3: 70e0090 ($14.12 in chips)
Seat 4: adf3599f ($10.15 in chips)
Seat 5: f73707ab ($28.68 in chips)
Seat 6: Hero ($23.67 in chips)
2797b5a1: posts small blind $0.05
70e0090: posts big blind $0.1
*** HOLE CARDS ***
Dealt to 7720e09f 
Dealt to 2797b5a1 
Dealt to 70e0090 
Dealt to adf3599f 
Dealt to f73707ab 
Dealt to Hero [6d Js]
adf3599f: folds
f73707ab: folds
Hero: folds
7720e09f: folds
2797b5a1: raises $0.15 to $0.25
70e0090: folds
Uncalled bet ($0.15) returned to 2797b5a1
*** SHOWDOWN ***
2797b5a1 collected $0.2 from pot
*** SUMMARY ***
Total pot $0.2 | Rake $0 | Jackpot $0 | Bingo $0 | Fortune $0
Seat 1: 7720e09f (button) folded before Flop (didn't bet)
Seat 2: 2797b5a1 (small blind) collected ($0.2)
Seat 3: 70e0090 (big blind) folded before Flop
Seat 4: adf3599f folded before Flop (didn't bet)
Seat 5: f73707ab folded before Flop (didn't bet)
Seat 6: Hero folded before Flop (didn't bet)


Poker Hand #RC1433372269: Hold'em No Limit  ($0.05/$0.1) - 2023/03/27 19:38:21
Table 'RushAndCash28177529' 6-max Seat #1 is the button
Seat 1: d42fe13b ($9.5 in chips)
Seat 2: Hero ($23.72 in chips)
Seat 3: a3d01adf ($9.56 in chips)
Seat 4: 2012d077 ($10.29 in chips)
Seat 5: 5a65710 ($12.43 in chips)
Seat 6: 6640ee20 ($12.69 in chips)
Hero: posts small blind $0.05
a3d01adf: posts big blind $0.1
*** HOLE CARDS ***
Dealt to d42fe13b 
Dealt to Hero [Jh 4h]
Dealt to a3d01adf 
Dealt to 2012d077 
Dealt to 5a65710 
Dealt to 6640ee20 
2012d077: folds
5a65710: folds
6640ee20: folds
d42fe13b: raises $0.12 to $0.22
Hero: folds
a3d01adf: folds
Uncalled bet ($0.12) returned to d42fe13b
*** SHOWDOWN ***
d42fe13b collected $0.25 from pot
*** SUMMARY ***
Total pot $0.25 | Rake $0 | Jackpot $0 | Bingo $0 | Fortune $0
Seat 1: d42fe13b (button) collected ($0.25)
Seat 2: Hero (small blind) folded before Flop
Seat 3: a3d01adf (big blind) folded before Flop
Seat 4: 2012d077 folded before Flop (didn't bet)
Seat 5: 5a65710 folded before Flop (didn't bet)
Seat 6: 6640ee20 folded before Flop (didn't bet)


Poker Hand #RC1433372239: Hold'em No Limit  ($0.05/$0.1) - 2023/03/27 19:38:17
Table 'RushAndCash28177499' 6-max Seat #1 is the button
Seat 1: 71339143 ($9.18 in chips)
Seat 2: 409d9b29 ($31.01 in chips)
Seat 3: fec0d8cf ($12.64 in chips)
Seat 4: Hero ($23.72 in chips)
Seat 5: 43fd38b3 ($10 in chips)
Seat 6: 2012d077 ($10.29 in chips)
409d9b29: posts small blind $0.05
fec0d8cf: posts big blind $0.1
*** HOLE CARDS ***
Dealt to 71339143 
Dealt to 409d9b29 
Dealt to fec0d8cf 
Dealt to Hero [7s 4s]
Dealt to 43fd38b3 
Dealt to 2012d077 
Hero: folds
43fd38b3: folds
2012d077: folds
71339143: folds
409d9b29: raises $0.1 to $0.2
fec0d8cf: folds
Uncalled bet ($0.1) returned to 409d9b29
*** SHOWDOWN ***
409d9b29 collected $0.2 from pot
*** SUMMARY ***
Total pot $0.2 | Rake $0 | Jackpot $0 | Bingo $0 | Fortune $0
Seat 1: 71339143 (button) folded before Flop (didn't bet)
Seat 2: 409d9b29 (small blind) collected ($0.2)
Seat 3: fec0d8cf (big blind) folded before Flop
Seat 4: Hero folded before Flop (didn't bet)
Seat 5: 43fd38b3 folded before Flop (didn't bet)
Seat 6: 2012d077 folded before Flop (didn't bet)


Poker Hand #RC1433372186: Hold'em No Limit  ($0.05/$0.1) - 2023/03/27 19:38:09
Table 'RushAndCash28177446' 6-max Seat #1 is the button
Seat 1: 9155be4d ($10 in chips)
Seat 2: 71339143 ($9.33 in chips)
Seat 3: daf46909 ($16.58 in chips)
Seat 4: 672dfe81 ($37.58 in chips)
Seat 5: Hero ($23.72 in chips)
Seat 6: 7e0e949 ($10.05 in chips)
71339143: posts small blind $0.05
daf46909: posts big blind $0.1
*** HOLE CARDS ***
Dealt to 9155be4d 
Dealt to 71339143 
Dealt to daf46909 
Dealt to 672dfe81 
Dealt to Hero [Td 8c]
Dealt to 7e0e949 
672dfe81: folds
Hero: folds
7e0e949: raises $0.15 to $0.25
9155be4d: folds
71339143: folds
daf46909: calls $0.15
*** FLOP *** [2s 5c 8h]
daf46909: checks
7e0e949: bets $0.2
daf46909: calls $0.2
*** TURN *** [2s 5c 8h] [Js]
daf46909: checks
7e0e949: checks
*** RIVER *** [2s 5c 8h Js] [9d]
daf46909: bets $0.48
7e0e949: folds
Uncalled bet ($0.48) returned to daf46909
*** SHOWDOWN ***
daf46909 collected $0.91 from pot
*** SUMMARY ***
Total pot $0.95 | Rake $0.04 | Jackpot $0 | Bingo $0 | Fortune $0
Board [2s 5c 8h Js 9d]
Seat 1: 9155be4d (button) folded before Flop (didn't bet)
Seat 2: 71339143 (small blind) folded before Flop
Seat 3: daf46909 (big blind) won ($0.91)
Seat 4: 672dfe81 folded before Flop (didn't bet)
Seat 5: Hero folded before Flop (didn't bet)
Seat 6: 7e0e949 folded on the River


Poker Hand #RC1433372080: Hold'em No Limit  ($0.05/$0.1) - 2023/03/27 19:37:54
Table 'RushAndCash28177340' 6-max Seat #1 is the button
Seat 1: 880f1c43 ($22.81 in chips)
Seat 2: Hero ($23.77 in chips)
Seat 3: 84765ddc ($13.63 in chips)
Seat 4: d146c7ed ($12.17 in chips)
Seat 5: 725f7e50 ($24.4 in chips)
Seat 6: b3645cfc ($12.47 in chips)
Hero: posts small blind $0.05
84765ddc: posts big blind $0.1
*** HOLE CARDS ***
Dealt to 880f1c43 
Dealt to Hero [Ah Th]
Dealt to 84765ddc 
Dealt to d146c7ed 
Dealt to 725f7e50 
Dealt to b3645cfc 
d146c7ed: folds
725f7e50: raises $0.15 to $0.25
b3645cfc: raises $0.49 to $0.74
880f1c43: folds
Hero: folds
84765ddc: calls $0.64
725f7e50: folds
*** FLOP *** [6c 8h Qs]
84765ddc: checks
b3645cfc: bets $0.59
84765ddc: calls $0.59
*** TURN *** [6c 8h Qs] [3s]
84765ddc: checks
b3645cfc: bets $1.7
84765ddc: folds
Uncalled bet ($1.7) returned to b3645cfc
*** SHOWDOWN ***
b3645cfc collected $2.82 from pot
*** SUMMARY ***
Total pot $2.96 | Rake $0.14 | Jackpot $0 | Bingo $0 | Fortune $0
Board [6c 8h Qs 3s]
Seat 1: 880f1c43 (button) folded before Flop (didn't bet)
Seat 2: Hero (small blind) folded before Flop
Seat 3: 84765ddc (big blind) folded on the Turn
Seat 4: d146c7ed folded before Flop (didn't bet)
Seat 5: 725f7e50 folded before Flop
Seat 6: b3645cfc won ($2.82)


Poker Hand #RC1433372001: Hold'em No Limit  ($0.05/$0.1) - 2023/03/27 19:37:43
Table 'RushAndCash28177261' 6-max Seat #1 is the button
Seat 1: Hero ($23.77 in chips)
Seat 2: df73a606 ($10.66 in chips)
Seat 3: e972d1c ($10 in chips)
Seat 4: 7bd6a3d3 ($26.85 in chips)
Seat 5: c522d2b5 ($15.8 in chips)
Seat 6: 5a08e02b ($10 in chips)
df73a606: posts small blind $0.05
e972d1c: posts big blind $0.1
*** HOLE CARDS ***
Dealt to Hero [9s Th]
Dealt to df73a606 
Dealt to e972d1c 
Dealt to 7bd6a3d3 
Dealt to c522d2b5 
Dealt to 5a08e02b 
7bd6a3d3: folds
c522d2b5: folds
5a08e02b: raises $0.2 to $0.3
Hero: folds
df73a606: folds
e972d1c: raises $0.85 to $1.15
5a08e02b: calls $0.85
*** FLOP *** [Ks 7s Jc]
e972d1c: bets $1.77
5a08e02b: raises $1.77 to $3.54
e972d1c: raises $5.31 to $8.85 and is all-in
5a08e02b: folds
Uncalled bet ($5.31) returned to e972d1c
*** SHOWDOWN ***
e972d1c collected $8.98 from pot
*** SUMMARY ***
Total pot $9.43 | Rake $0.3 | Jackpot $0.15 | Bingo $0 | Fortune $0
Board [Ks 7s Jc]
Seat 1: Hero (button) folded before Flop (didn't bet)
Seat 2: df73a606 (small blind) folded before Flop
Seat 3: e972d1c (big blind) won ($8.98)
Seat 4: 7bd6a3d3 folded before Flop (didn't bet)
Seat 5: c522d2b5 folded before Flop (didn't bet)
Seat 6: 5a08e02b folded on the Flop


Poker Hand #RC1433371968: Hold'em No Limit  ($0.05/$0.1) - 2023/03/27 19:37:38
Table 'RushAndCash28177228' 6-max Seat #1 is the button
Seat 1: 6fbdaf69 ($8.5 in chips)
Seat 2: 48c9ce8 ($10.05 in chips)
Seat 3: 17e87098 ($10.79 in chips)
Seat 4: 859207b8 ($21.23 in chips)
Seat 5: fd065037 ($15.04 in chips)
Seat 6: Hero ($23.77 in chips)
48c9ce8: posts small blind $0.05
17e87098: posts big blind $0.1
*** HOLE CARDS ***
Dealt to 6fbdaf69 
Dealt to 48c9ce8 
Dealt to 17e87098 
Dealt to 859207b8 
Dealt to fd065037 
Dealt to Hero [9d 4d]
859207b8: folds
fd065037: folds
Hero: folds
6fbdaf69: folds
48c9ce8: raises $0.2 to $0.3
17e87098: calls $0.2
*** FLOP *** [Jh Ks 2h]
48c9ce8: bets $0.2
17e87098: raises $0.5 to $0.7
48c9ce8: folds
Uncalled bet ($0.5) returned to 17e87098
*** SHOWDOWN ***
17e87098 collected $0.95 from pot
*** SUMMARY ***
Total pot $1 | Rake $0.05 | Jackpot $0 | Bingo $0 | Fortune $0
Board [Jh Ks 2h]
Seat 1: 6fbdaf69 (button) folded before Flop (didn't bet)
Seat 2: 48c9ce8 (small blind) folded on the Flop
Seat 3: 17e87098 (big blind) won ($0.95)
Seat 4: 859207b8 folded before Flop (didn't bet)
Seat 5: fd065037 folded before Flop (didn't bet)
Seat 6: Hero folded before Flop (didn't bet)


Poker Hand #RC1433371905: Hold'em No Limit  ($0.05/$0.1) - 2023/03/27 19:37:29
Table 'RushAndCash28177165' 6-max Seat #1 is the button
Seat 1: ad1db046 ($13.58 in chips)
Seat 2: a77b563e ($10.05 in chips)
Seat 3: 5c0db35c ($10.18 in chips)
Seat 4: f73707ab ($28.68 in chips)
Seat 5: Hero ($23.77 in chips)
Seat 6: 8bc30a96 ($9.88 in chips)
a77b563e: posts small blind $0.05
5c0db35c: posts big blind $0.1
*** HOLE CARDS ***
Dealt to ad1db046 
Dealt to a77b563e 
Dealt to 5c0db35c 
Dealt to f73707ab 
Dealt to Hero [6d 7c]
Dealt to 8bc30a96 
f73707ab: folds
Hero: folds
8bc30a96: raises $0.15 to $0.25
ad1db046: folds
a77b563e: folds
5c0db35c: calls $0.15
*** FLOP *** [9s 8d 2d]
5c0db35c: checks
8bc30a96: bets $0.42
5c0db35c: folds
Uncalled bet ($0.42) returned to 8bc30a96
*** SHOWDOWN ***
8bc30a96 collected $0.53 from pot
*** SUMMARY ***
Total pot $0.55 | Rake $0.02 | Jackpot $0 | Bingo $0 | Fortune $0
Board [9s 8d 2d]
Seat 1: ad1db046 (button) folded before Flop (didn't bet)
Seat 2: a77b563e (small blind) folded before Flop
Seat 3: 5c0db35c (big blind) folded on the Flop
Seat 4: f73707ab folded before Flop (didn't bet)
Seat 5: Hero folded before Flop (didn't bet)
Seat 6: 8bc30a96 won ($0.53)


Poker Hand #RC1433371758: Hold'em No Limit  ($0.05/$0.1) - 2023/03/27 19:37:09
Table 'RushAndCash28177018' 6-max Seat #1 is the button
Seat 1: 66017d6f ($25 in chips)
Seat 2: 3f48a6c1 ($12.07 in chips)
Seat 3: f3de17dc ($40.68 in chips)
Seat 4: 634a1d5 ($14.7 in chips)
Seat 5: 34fa0825 ($12.05 in chips)
Seat 6: Hero ($23.77 in chips)
3f48a6c1: posts small blind $0.05
f3de17dc: posts big blind $0.1
*** HOLE CARDS ***
Dealt to 66017d6f 
Dealt to 3f48a6c1 
Dealt to f3de17dc 
Dealt to 634a1d5 
Dealt to 34fa0825 
Dealt to Hero [As 2c]
634a1d5: raises $0.15 to $0.25
34fa0825: folds
Hero: folds
66017d6f: folds
3f48a6c1: calls $0.2
f3de17dc: folds
*** FLOP *** [Jc 2h 6d]
3f48a6c1: checks
634a1d5: bets $0.2
3f48a6c1: calls $0.2
*** TURN *** [Jc 2h 6d] [6s]
3f48a6c1: checks
634a1d5: bets $0.75
3f48a6c1: folds
Uncalled bet ($0.75) returned to 634a1d5
*** SHOWDOWN ***
634a1d5 collected $0.95 from pot
*** SUMMARY ***
Total pot $1 | Rake $0.05 | Jackpot $0 | Bingo $0 | Fortune $0
Board [Jc 2h 6d 6s]
Seat 1: 66017d6f (button) folded before Flop (didn't bet)
Seat 2: 3f48a6c1 (small blind) folded on the Turn
Seat 3: f3de17dc (big blind) folded before Flop
Seat 4: 634a1d5 won ($0.95)
Seat 5: 34fa0825 folded before Flop (didn't bet)
Seat 6: Hero folded before Flop (didn't bet)


Poker Hand #RC1433371725: Hold'em No Limit  ($0.05/$0.1) - 2023/03/27 19:37:04
Table 'RushAndCash28176985' 6-max Seat #1 is the button
Seat 1: Hero ($23.77 in chips)
Seat 2: 74aeaadc ($40.07 in chips)
Seat 3: e82ce252 ($9.17 in chips)
Seat 4: e7f48829 ($10.09 in chips)
Seat 5: 25295a38 ($87.17 in chips)
Seat 6: ec3bebf3 ($21.56 in chips)
74aeaadc: posts small blind $0.05
e82ce252: posts big blind $0.1
*** HOLE CARDS ***
Dealt to Hero [Tc 2h]
Dealt to 74aeaadc 
Dealt to e82ce252 
Dealt to e7f48829 
Dealt to 25295a38 
Dealt to ec3bebf3 
e7f48829: folds
25295a38: folds
ec3bebf3: folds
Hero: folds
74aeaadc: folds
Uncalled bet ($0.05) returned to e82ce252
*** SHOWDOWN ***
e82ce252 collected $0.1 from pot
*** SUMMARY ***
Total pot $0.1 | Rake $0 | Jackpot $0 | Bingo $0 | Fortune $0
Seat 1: Hero (button) folded before Flop (didn't bet)
Seat 2: 74aeaadc (small blind) folded before Flop
Seat 3: e82ce252 (big blind) collected ($0.1)
Seat 4: e7f48829 folded before Flop (didn't bet)
Seat 5: 25295a38 folded before Flop (didn't bet)
Seat 6: ec3bebf3 folded before Flop (didn't bet)


Poker Hand #RC1433371648: Hold'em No Limit  ($0.05/$0.1) - 2023/03/27 19:36:53
Table 'RushAndCash28176908' 6-max Seat #1 is the button
Seat 1: 93d296d ($12.15 in chips)
Seat 2: c999d48d ($24.83 in chips)
Seat 3: Hero ($23.72 in chips)
Seat 4: b37d67b5 ($10 in chips)
Seat 5: 64065079 ($6.86 in chips)
Seat 6: 5715e0e1 ($18.53 in chips)
c999d48d: posts small blind $0.05
Hero: posts big blind $0.1
*** HOLE CARDS ***
Dealt to 93d296d 
Dealt to c999d48d 
Dealt to Hero [2h 8d]
Dealt to b37d67b5 
Dealt to 64065079 
Dealt to 5715e0e1 
b37d67b5: folds
64065079: folds
5715e0e1: folds
93d296d: folds
c999d48d: folds
Uncalled bet ($0.05) returned to Hero
*** SHOWDOWN ***
Hero collected $0.1 from pot
*** SUMMARY ***
Total pot $0.1 | Rake $0 | Jackpot $0 | Bingo $0 | Fortune $0
Seat 1: 93d296d (button) folded before Flop (didn't bet)
Seat 2: c999d48d (small blind) folded before Flop
Seat 3: Hero (big blind) collected ($0.1)
Seat 4: b37d67b5 folded before Flop (didn't bet)
Seat 5: 64065079 folded before Flop (didn't bet)
Seat 6: 5715e0e1 folded before Flop (didn't bet)


Poker Hand #RC1433371606: Hold'em No Limit  ($0.05/$0.1) - 2023/03/27 19:36:46
Table 'RushAndCash28176866' 6-max Seat #1 is the button
Seat 1: 1842548d ($9.8 in chips)
Seat 2: badd0935 ($11.35 in chips)
Seat 3: ec87aeb3 ($11.99 in chips)
Seat 4: d7e969c3 ($10.58 in chips)
Seat 5: Hero ($23.72 in chips)
Seat 6: ff49bf9a ($23.23 in chips)
badd0935: posts small blind $0.05
ec87aeb3: posts big blind $0.1
*** HOLE CARDS ***
Dealt to 1842548d 
Dealt to badd0935 
Dealt to ec87aeb3 
Dealt to d7e969c3 
Dealt to Hero [9c 6c]
Dealt to ff49bf9a 
d7e969c3: folds
Hero: folds
ff49bf9a: folds
1842548d: folds
badd0935: raises $0.2 to $0.3
ec87aeb3: calls $0.2
*** FLOP *** [Qd Tc 6s]
badd0935: bets $0.15
ec87aeb3: calls $0.15
*** TURN *** [Qd Tc 6s] [8s]
badd0935: bets $0.9
ec87aeb3: calls $0.9
*** RIVER *** [Qd Tc 6s 8s] [Ks]
badd0935: checks
ec87aeb3: checks
badd0935: shows [8d 6d] (Pair of Eights and Pair of Sixes)
ec87aeb3: shows [7c Qc] (Pair of Queens)
*** SHOWDOWN ***
badd0935 collected $2.57 from pot
*** SUMMARY ***
Total pot $2.7 | Rake $0.13 | Jackpot $0 | Bingo $0 | Fortune $0
Board [Qd Tc 6s 8s Ks]
Seat 1: 1842548d (button) folded before Flop (didn't bet)
Seat 2: badd0935 (small blind) showed [8d 6d] and won ($2.57) with Pair of Eights and Pair of Sixes
Seat 3: ec87aeb3 (big blind) showed [7c Qc] and lost with Pair of Queens
Seat 4: d7e969c3 folded before Flop (didn't bet)
Seat 5: Hero folded before Flop (didn't bet)
Seat 6: ff49bf9a folded before Flop (didn't bet)


Poker Hand #RC1433371575: Hold'em No Limit  ($0.05/$0.1) - 2023/03/27 19:36:42
Table 'RushAndCash28176835' 6-max Seat #1 is the button
Seat 1: c36ac4b6 ($12.62 in chips)
Seat 2: e5558e5d ($15.07 in chips)
Seat 3: e5df0b41 ($14.28 in chips)
Seat 4: b3f83b4 ($9.7 in chips)
Seat 5: Hero ($23.72 in chips)
Seat 6: b4bad238 ($8.2 in chips)
e5558e5d: posts small blind $0.05
e5df0b41: posts big blind $0.1
*** HOLE CARDS ***
Dealt to c36ac4b6 
Dealt to e5558e5d 
Dealt to e5df0b41 
Dealt to b3f83b4 
Dealt to Hero [6c 4d]
Dealt to b4bad238 
b3f83b4: folds
Hero: folds
b4bad238: raises $0.15 to $0.25
c36ac4b6: raises $0.65 to $0.9
e5558e5d: folds
e5df0b41: folds
b4bad238: folds
Uncalled bet ($0.65) returned to c36ac4b6
*** SHOWDOWN ***
c36ac4b6 collected $0.62 from pot
*** SUMMARY ***
Total pot $0.65 | Rake $0.03 | Jackpot $0 | Bingo $0 | Fortune $0
Seat 1: c36ac4b6 (button) collected ($0.62)
Seat 2: e5558e5d (small blind) folded before Flop
Seat 3: e5df0b41 (big blind) folded before Flop
Seat 4: b3f83b4 folded before Flop (didn't bet)
Seat 5: Hero folded before Flop (didn't bet)
Seat 6: b4bad238 folded before Flop


Poker Hand #RC1433370939: Hold'em No Limit  ($0.05/$0.1) - 2023/03/27 19:35:09
Table 'RushAndCash28176199' 6-max Seat #1 is the button
Seat 1: 60e059ec ($11.22 in chips)
Seat 2: 4d8a05ce ($9.01 in chips)
Seat 3: Hero ($24.57 in chips)
Seat 4: bd16a6d ($20.72 in chips)
Seat 5: c78ccd23 ($8.88 in chips)
Seat 6: 8030373d ($10 in chips)
4d8a05ce: posts small blind $0.05
Hero: posts big blind $0.1
*** HOLE CARDS ***
Dealt to 60e059ec 
Dealt to 4d8a05ce 
Dealt to Hero [As Qh]
Dealt to bd16a6d 
Dealt to c78ccd23 
Dealt to 8030373d 
bd16a6d: raises $0.12 to $0.22
c78ccd23: folds
8030373d: folds
60e059ec: folds
4d8a05ce: folds
Hero: raises $0.63 to $0.85
bd16a6d: calls $0.63
*** FLOP *** [6c 4s 2h]
Hero: checks
bd16a6d: checks
*** TURN *** [6c 4s 2h] [7s]
Hero: checks
bd16a6d: bets $0.88
Hero: folds
Uncalled bet ($0.88) returned to bd16a6d
*** SHOWDOWN ***
bd16a6d collected $1.67 from pot
*** SUMMARY ***
Total pot $1.75 | Rake $0.08 | Jackpot $0 | Bingo $0 | Fortune $0
Board [6c 4s 2h 7s]
Seat 1: 60e059ec (button) folded before Flop (didn't bet)
Seat 2: 4d8a05ce (small blind) folded before Flop
Seat 3: Hero (big blind) folded on the Turn
Seat 4: bd16a6d won ($1.67)
Seat 5: c78ccd23 folded before Flop (didn't bet)
Seat 6: 8030373d folded before Flop (didn't bet)


Poker Hand #RC1433370903: Hold'em No Limit  ($0.05/$0.1) - 2023/03/27 19:35:03
Table 'RushAndCash28176163' 6-max Seat #1 is the button
Seat 1: 2791fdb7 ($7.27 in chips)
Seat 2: 5d6a3dd0 ($30.81 in chips)
Seat 3: 7c38b322 ($12.71 in chips)
Seat 4: 492bd702 ($10.77 in chips)
Seat 5: Hero ($24.57 in chips)
Seat 6: fba9fe19 ($10 in chips)
5d6a3dd0: posts small blind $0.05
7c38b322: posts big blind $0.1
*** HOLE CARDS ***
Dealt to 2791fdb7 
Dealt to 5d6a3dd0 
Dealt to 7c38b322 
Dealt to 492bd702 
Dealt to Hero [7c 9d]
Dealt to fba9fe19 
492bd702: folds
Hero: folds
fba9fe19: raises $0.15 to $0.25
2791fdb7: folds
5d6a3dd0: folds
7c38b322: folds
Uncalled bet ($0.15) returned to fba9fe19
*** SHOWDOWN ***
fba9fe19 collected $0.25 from pot
*** SUMMARY ***
Total pot $0.25 | Rake $0 | Jackpot $0 | Bingo $0 | Fortune $0
Seat 1: 2791fdb7 (button) folded before Flop (didn't bet)
Seat 2: 5d6a3dd0 (small blind) folded before Flop
Seat 3: 7c38b322 (big blind) folded before Flop
Seat 4: 492bd702 folded before Flop (didn't bet)
Seat 5: Hero folded before Flop (didn't bet)
Seat 6: fba9fe19 collected ($0.25)


Poker Hand #RC1433370810: Hold'em No Limit  ($0.05/$0.1) - 2023/03/27 19:34:50
Table 'RushAndCash28176070' 6-max Seat #1 is the button
Seat 1: Hero ($24.57 in chips)
Seat 2: 2797b5a1 ($10 in chips)
Seat 3: 18ba9fff ($9.85 in chips)
Seat 4: aa3228c9 ($10.18 in chips)
Seat 5: 62a9fe57 ($10 in chips)
Seat 6: b3f83b4 ($9.85 in chips)
2797b5a1: posts small blind $0.05
18ba9fff: posts big blind $0.1
*** HOLE CARDS ***
Dealt to Hero [3h 6d]
Dealt to 2797b5a1 
Dealt to 18ba9fff 
Dealt to aa3228c9 
Dealt to 62a9fe57 
Dealt to b3f83b4 
aa3228c9: folds
62a9fe57: raises $0.13 to $0.23
b3f83b4: folds
Hero: folds
2797b5a1: folds
18ba9fff: folds
Uncalled bet ($0.13) returned to 62a9fe57
*** SHOWDOWN ***
62a9fe57 collected $0.25 from pot
*** SUMMARY ***
Total pot $0.25 | Rake $0 | Jackpot $0 | Bingo $0 | Fortune $0
Seat 1: Hero (button) folded before Flop (didn't bet)
Seat 2: 2797b5a1 (small blind) folded before Flop
Seat 3: 18ba9fff (big blind) folded before Flop
Seat 4: aa3228c9 folded before Flop (didn't bet)
Seat 5: 62a9fe57 collected ($0.25)
Seat 6: b3f83b4 folded before Flop (didn't bet)


Poker Hand #RC1433370705: Hold'em No Limit  ($0.05/$0.1) - 2023/03/27 19:34:33
Table 'RushAndCash28175965' 6-max Seat #1 is the button
Seat 1: e2bb9eac ($9.87 in chips)
Seat 2: Hero ($24.62 in chips)
Seat 3: c4636c6a ($11.58 in chips)
Seat 4: aa70745f ($16.64 in chips)
Seat 5: f4b01c1c ($10 in chips)
Seat 6: 70093006 ($10.05 in chips)
Hero: posts small blind $0.05
c4636c6a: posts big blind $0.1
*** HOLE CARDS ***
Dealt to e2bb9eac 
Dealt to Hero [Kd 3h]
Dealt to c4636c6a 
Dealt to aa70745f 
Dealt to f4b01c1c 
Dealt to 70093006 
aa70745f: folds
f4b01c1c: folds
70093006: raises $0.2 to $0.3
e2bb9eac: calls $0.3
Hero: folds
c4636c6a: folds
*** FLOP *** [6s 6c 9h]
70093006: bets $0.25
e2bb9eac: folds
Uncalled bet ($0.25) returned to 70093006
*** SHOWDOWN ***
70093006 collected $0.72 from pot
*** SUMMARY ***
Total pot $0.75 | Rake $0.03 | Jackpot $0 | Bingo $0 | Fortune $0
Board [6s 6c 9h]
Seat 1: e2bb9eac (button) folded on the Flop
Seat 2: Hero (small blind) folded before Flop
Seat 3: c4636c6a (big blind) folded before Flop
Seat 4: aa70745f folded before Flop (didn't bet)
Seat 5: f4b01c1c folded before Flop (didn't bet)
Seat 6: 70093006 won ($0.72)


Poker Hand #RC1433370619: Hold'em No Limit  ($0.05/$0.1) - 2023/03/27 19:34:21
Table 'RushAndCash28175879' 6-max Seat #1 is the button
Seat 1: 89290180 ($10 in chips)
Seat 2: Hero ($24.67 in chips)
Seat 3: 9e07512a ($9.05 in chips)
Seat 4: cdda39a3 ($12.57 in chips)
Seat 5: 80961c5f ($8.83 in chips)
Seat 6: db36033e ($7.44 in chips)
Hero: posts small blind $0.05
9e07512a: posts big blind $0.1
*** HOLE CARDS ***
Dealt to 89290180 
Dealt to Hero [4s 4c]
Dealt to 9e07512a 
Dealt to cdda39a3 
Dealt to 80961c5f 
Dealt to db36033e 
cdda39a3: folds
80961c5f: folds
db36033e: raises $0.2 to $0.3
89290180: folds
Hero: folds
9e07512a: folds
Uncalled bet ($0.2) returned to db36033e
*** SHOWDOWN ***
db36033e collected $0.25 from pot
*** SUMMARY ***
Total pot $0.25 | Rake $0 | Jackpot $0 | Bingo $0 | Fortune $0
Seat 1: 89290180 (button) folded before Flop (didn't bet)
Seat 2: Hero (small blind) folded before Flop
Seat 3: 9e07512a (big blind) folded before Flop
Seat 4: cdda39a3 folded before Flop (didn't bet)
Seat 5: 80961c5f folded before Flop (didn't bet)
Seat 6: db36033e collected ($0.25)


Poker Hand #RC1433370472: Hold'em No Limit  ($0.05/$0.1) - 2023/03/27 19:33:58
Table 'RushAndCash28175732' 6-max Seat #1 is the button
Seat 1: 2539aa37 ($9.45 in chips)
Seat 2: fd065037 ($12.07 in chips)
Seat 3: 7f3fb3a4 ($8.12 in chips)
Seat 4: Hero ($24.3 in chips)
Seat 5: 3a8d3558 ($11.53 in chips)
Seat 6: db36033e ($7.69 in chips)
fd065037: posts small blind $0.05
7f3fb3a4: posts big blind $0.1
*** HOLE CARDS ***
Dealt to 2539aa37 
Dealt to fd065037 
Dealt to 7f3fb3a4 
Dealt to Hero [9d Jd]
Dealt to 3a8d3558 
Dealt to db36033e 
Hero: raises $0.15 to $0.25
3a8d3558: folds
db36033e: calls $0.25
2539aa37: folds
fd065037: folds
7f3fb3a4: folds
*** FLOP *** [2d Ac 7h]
Hero: bets $0.22
db36033e: folds
Uncalled bet ($0.22) returned to Hero
*** SHOWDOWN ***
Hero collected $0.62 from pot
*** SUMMARY ***
Total pot $0.65 | Rake $0.03 | Jackpot $0 | Bingo $0 | Fortune $0
Board [2d Ac 7h]
Seat 1: 2539aa37 (button) folded before Flop (didn't bet)
Seat 2: fd065037 (small blind) folded before Flop
Seat 3: 7f3fb3a4 (big blind) folded before Flop
Seat 4: Hero won ($0.62)
Seat 5: 3a8d3558 folded before Flop (didn't bet)
Seat 6: db36033e folded on the Flop


Poker Hand #RC1433370442: Hold'em No Limit  ($0.05/$0.1) - 2023/03/27 19:33:54
Table 'RushAndCash28175702' 6-max Seat #1 is the button
Seat 1: fa62c5da ($10 in chips)
Seat 2: c85df6ac ($12.41 in chips)
Seat 3: d146c7ed ($10.15 in chips)
Seat 4: Hero ($24.3 in chips)
Seat 5: 3a8d3558 ($11.53 in chips)
Seat 6: 48a17f8e ($9.74 in chips)
c85df6ac: posts small blind $0.05
d146c7ed: posts big blind $0.1
*** HOLE CARDS ***
Dealt to fa62c5da 
Dealt to c85df6ac 
Dealt to d146c7ed 
Dealt to Hero [8c Ts]
Dealt to 3a8d3558 
Dealt to 48a17f8e 
Hero: folds
3a8d3558: folds
48a17f8e: folds
fa62c5da: folds
c85df6ac: raises $0.2 to $0.3
d146c7ed: folds
Uncalled bet ($0.2) returned to c85df6ac
*** SHOWDOWN ***
c85df6ac collected $0.2 from pot
*** SUMMARY ***
Total pot $0.2 | Rake $0 | Jackpot $0 | Bingo $0 | Fortune $0
Seat 1: fa62c5da (button) folded before Flop (didn't bet)
Seat 2: c85df6ac (small blind) collected ($0.2)
Seat 3: d146c7ed (big blind) folded before Flop
Seat 4: Hero folded before Flop (didn't bet)
Seat 5: 3a8d3558 folded before Flop (didn't bet)
Seat 6: 48a17f8e folded before Flop (didn't bet)


Poker Hand #RC1433370337: Hold'em No Limit  ($0.05/$0.1) - 2023/03/27 19:33:38
Table 'RushAndCash28175597' 6-max Seat #1 is the button
Seat 1: eec110ea ($11.96 in chips)
Seat 2: Hero ($24.35 in chips)
Seat 3: cfbab7a9 ($21.57 in chips)
Seat 4: 9b3cdb65 ($45.3 in chips)
Seat 5: 95bcae3a ($8.09 in chips)
Seat 6: 80545bf8 ($42.89 in chips)
Hero: posts small blind $0.05
cfbab7a9: posts big blind $0.1
*** HOLE CARDS ***
Dealt to eec110ea 
Dealt to Hero [4c Qd]
Dealt to cfbab7a9 
Dealt to 9b3cdb65 
Dealt to 95bcae3a 
Dealt to 80545bf8 
9b3cdb65: raises $0.15 to $0.25
95bcae3a: folds
80545bf8: folds
eec110ea: folds
Hero: folds
cfbab7a9: calls $0.15
*** FLOP *** [9s 9c 5c]
cfbab7a9: checks
9b3cdb65: bets $0.19
cfbab7a9: folds
Uncalled bet ($0.19) returned to 9b3cdb65
*** SHOWDOWN ***
9b3cdb65 collected $0.53 from pot
*** SUMMARY ***
Total pot $0.55 | Rake $0.02 | Jackpot $0 | Bingo $0 | Fortune $0
Board [9s 9c 5c]
Seat 1: eec110ea (button) folded before Flop (didn't bet)
Seat 2: Hero (small blind) folded before Flop
Seat 3: cfbab7a9 (big blind) folded on the Flop
Seat 4: 9b3cdb65 won ($0.53)
Seat 5: 95bcae3a folded before Flop (didn't bet)
Seat 6: 80545bf8 folded before Flop (didn't bet)


Poker Hand #RC1433369910: Hold'em No Limit  ($0.05/$0.1) - 2023/03/27 19:32:31
Table 'RushAndCash28175170' 6-max Seat #1 is the button
Seat 1: b95c5a94 ($10.1 in chips)
Seat 2: 662482e5 ($13.06 in chips)
Seat 3: eec110ea ($11.39 in chips)
Seat 4: ec69476a ($10 in chips)
Seat 5: e4f5c0b9 ($15.94 in chips)
Seat 6: Hero ($24.93 in chips)
662482e5: posts small blind $0.05
eec110ea: posts big blind $0.1
*** HOLE CARDS ***
Dealt to b95c5a94 
Dealt to 662482e5 
Dealt to eec110ea 
Dealt to ec69476a 
Dealt to e4f5c0b9 
Dealt to Hero [9h Ac]
ec69476a: folds
e4f5c0b9: folds
Hero: raises $0.15 to $0.25
b95c5a94: folds
662482e5: folds
eec110ea: calls $0.15
*** FLOP *** [Js 6h Qs]
eec110ea: checks
Hero: checks
*** TURN *** [Js 6h Qs] [Kc]
eec110ea: checks
Hero: bets $0.33
eec110ea: calls $0.33
*** RIVER *** [Js 6h Qs Kc] [9d]
eec110ea: checks
Hero: checks
eec110ea: shows [Ks 5s] (Pair of Kings)
Hero: shows [9h Ac] (Pair of Nines)
*** SHOWDOWN ***
eec110ea collected $1.15 from pot
*** SUMMARY ***
Total pot $1.21 | Rake $0.06 | Jackpot $0 | Bingo $0 | Fortune $0
Board [Js 6h Qs Kc 9d]
Seat 1: b95c5a94 (button) folded before Flop (didn't bet)
Seat 2: 662482e5 (small blind) folded before Flop
Seat 3: eec110ea (big blind) showed [Ks 5s] and won ($1.15) with Pair of Kings
Seat 4: ec69476a folded before Flop (didn't bet)
Seat 5: e4f5c0b9 folded before Flop (didn't bet)
Seat 6: Hero showed [9h Ac] and lost with Pair of Nines


Poker Hand #RC1433369809: Hold'em No Limit  ($0.05/$0.1) - 2023/03/27 19:32:17
Table 'RushAndCash28175069' 6-max Seat #1 is the button
Seat 1: ac377bbe ($22.51 in chips)
Seat 2: bb395351 ($22.14 in chips)
Seat 3: Hero ($25.03 in chips)
Seat 4: 1b112a36 ($12.81 in chips)
Seat 5: 7c84e01d ($40.68 in chips)
Seat 6: ed45c484 ($12.03 in chips)
bb395351: posts small blind $0.05
Hero: posts big blind $0.1
*** HOLE CARDS ***
Dealt to ac377bbe 
Dealt to bb395351 
Dealt to Hero [3c 4c]
Dealt to 1b112a36 
Dealt to 7c84e01d 
Dealt to ed45c484 
1b112a36: folds
7c84e01d: folds
ed45c484: raises $0.15 to $0.25
ac377bbe: raises $0.45 to $0.7
bb395351: folds
Hero: folds
ed45c484: calls $0.45
*** FLOP *** [Ts 6h 9c]
ed45c484: checks
ac377bbe: bets $0.78
ed45c484: calls $0.78
*** TURN *** [Ts 6h 9c] [Th]
ed45c484: checks
ac377bbe: checks
*** RIVER *** [Ts 6h 9c Th] [3d]
ed45c484: bets $1
ac377bbe: calls $1
ed45c484: shows [9s Kd] (Pair of Tens and Pair of Nines)
ac377bbe: shows [Jc Js] (Pair of Jacks and Pair of Tens)
*** SHOWDOWN ***
ac377bbe collected $4.72 from pot
*** SUMMARY ***
Total pot $5.11 | Rake $0.24 | Jackpot $0.15 | Bingo $0 | Fortune $0
Board [Ts 6h 9c Th 3d]
Seat 1: ac377bbe (button) showed [Jc Js] and won ($4.72) with Pair of Jacks and Pair of Tens
Seat 2: bb395351 (small blind) folded before Flop
Seat 3: Hero (big blind) folded before Flop
Seat 4: 1b112a36 folded before Flop (didn't bet)
Seat 5: 7c84e01d folded before Flop (didn't bet)
Seat 6: ed45c484 showed [9s Kd] and lost with Pair of Tens and Pair of Nines


Poker Hand #RC1433369764: Hold'em No Limit  ($0.05/$0.1) - 2023/03/27 19:32:11
Table 'RushAndCash28175024' 6-max Seat #1 is the button
Seat 1: Hero ($25.03 in chips)
Seat 2: aa3228c9 ($11.93 in chips)
Seat 3: 12ca5b2c ($10.32 in chips)
Seat 4: 9d068308 ($36.19 in chips)
Seat 5: e2bb9eac ($10.32 in chips)
Seat 6: 193ce148 ($10.46 in chips)
aa3228c9: posts small blind $0.05
12ca5b2c: posts big blind $0.1
*** HOLE CARDS ***
Dealt to Hero [2c 6h]
Dealt to aa3228c9 
Dealt to 12ca5b2c 
Dealt to 9d068308 
Dealt to e2bb9eac 
Dealt to 193ce148 
9d068308: raises $0.15 to $0.25
e2bb9eac: folds
193ce148: folds
Hero: folds
aa3228c9: folds
12ca5b2c: folds
Uncalled bet ($0.15) returned to 9d068308
*** SHOWDOWN ***
9d068308 collected $0.25 from pot
*** SUMMARY ***
Total pot $0.25 | Rake $0 | Jackpot $0 | Bingo $0 | Fortune $0
Seat 1: Hero (button) folded before Flop (didn't bet)
Seat 2: aa3228c9 (small blind) folded before Flop
Seat 3: 12ca5b2c (big blind) folded before Flop
Seat 4: 9d068308 collected ($0.25)
Seat 5: e2bb9eac folded before Flop (didn't bet)
Seat 6: 193ce148 folded before Flop (didn't bet)


Poker Hand #RC1433369651: Hold'em No Limit  ($0.05/$0.1) - 2023/03/27 19:31:54
Table 'RushAndCash28174911' 6-max Seat #1 is the button
Seat 1: 8caece8f ($10 in chips)
Seat 2: 12ca5b2c ($10 in chips)
Seat 3: 827546bd ($10 in chips)
Seat 4: 8ee12122 ($16.29 in chips)
Seat 5: Hero ($25.28 in chips)
Seat 6: 36216ab ($22.68 in chips)
12ca5b2c: posts small blind $0.05
827546bd: posts big blind $0.1
*** HOLE CARDS ***
Dealt to 8caece8f 
Dealt to 12ca5b2c 
Dealt to 827546bd 
Dealt to 8ee12122 
Dealt to Hero [7h 9h]
Dealt to 36216ab 
8ee12122: folds
Hero: raises $0.15 to $0.25
36216ab: folds
8caece8f: folds
12ca5b2c: raises $0.45 to $0.7
827546bd: folds
Hero: folds
Uncalled bet ($0.45) returned to 12ca5b2c
*** SHOWDOWN ***
12ca5b2c collected $0.57 from pot
*** SUMMARY ***
Total pot $0.6 | Rake $0.03 | Jackpot $0 | Bingo $0 | Fortune $0
Seat 1: 8caece8f (button) folded before Flop (didn't bet)
Seat 2: 12ca5b2c (small blind) collected ($0.57)
Seat 3: 827546bd (big blind) folded before Flop
Seat 4: 8ee12122 folded before Flop (didn't bet)
Seat 5: Hero folded before Flop
Seat 6: 36216ab folded before Flop (didn't bet)


Poker Hand #RC1433369196: Hold'em No Limit  ($0.05/$0.1) - 2023/03/27 19:30:43
Table 'RushAndCash28174456' 6-max Seat #1 is the button
Seat 1: Hero ($26.21 in chips)
Seat 2: 6d71942c ($16.75 in chips)
Seat 3: 4d8a05ce ($10.09 in chips)
Seat 4: f770dcf2 ($14.77 in chips)
Seat 5: fb4717c0 ($10.6 in chips)
Seat 6: f8c3c3ae ($5.8 in chips)
6d71942c: posts small blind $0.05
4d8a05ce: posts big blind $0.1
*** HOLE CARDS ***
Dealt to Hero [Ad 2d]
Dealt to 6d71942c 
Dealt to 4d8a05ce 
Dealt to f770dcf2 
Dealt to fb4717c0 
Dealt to f8c3c3ae 
f770dcf2: raises $0.15 to $0.25
fb4717c0: folds
f8c3c3ae: folds
Hero: calls $0.25
6d71942c: folds
4d8a05ce: folds
*** FLOP *** [3c 6s As]
f770dcf2: bets $0.22
Hero: calls $0.22
*** TURN *** [3c 6s As] [6h]
f770dcf2: bets $0.46
Hero: calls $0.46
*** RIVER *** [3c 6s As 6h] [Ks]
f770dcf2: bets $1.21
Hero: folds
Uncalled bet ($1.21) returned to f770dcf2
*** SHOWDOWN ***
f770dcf2 collected $1.91 from pot
*** SUMMARY ***
Total pot $2.01 | Rake $0.1 | Jackpot $0 | Bingo $0 | Fortune $0
Board [3c 6s As 6h Ks]
Seat 1: Hero (button) folded on the River
Seat 2: 6d71942c (small blind) folded before Flop
Seat 3: 4d8a05ce (big blind) folded before Flop
Seat 4: f770dcf2 won ($1.91)
Seat 5: fb4717c0 folded before Flop (didn't bet)
Seat 6: f8c3c3ae folded before Flop (didn't bet)


Poker Hand #RC1433369036: Hold'em No Limit  ($0.05/$0.1) - 2023/03/27 19:30:20
Table 'RushAndCash28174296' 6-max Seat #1 is the button
Seat 1: d146c7ed ($10.32 in chips)
Seat 2: 409d9b29 ($30.04 in chips)
Seat 3: 36216ab ($23.23 in chips)
Seat 4: f8c3c3ae ($6 in chips)
Seat 5: b3f83b4 ($9.66 in chips)
Seat 6: Hero ($25.88 in chips)
409d9b29: posts small blind $0.05
36216ab: posts big blind $0.1
*** HOLE CARDS ***
Dealt to d146c7ed 
Dealt to 409d9b29 
Dealt to 36216ab 
Dealt to f8c3c3ae 
Dealt to b3f83b4 
Dealt to Hero [Qc As]
f8c3c3ae: raises $0.1 to $0.2
b3f83b4: folds
Hero: raises $0.42 to $0.62
d146c7ed: folds
409d9b29: folds
36216ab: folds
f8c3c3ae: folds
Uncalled bet ($0.42) returned to Hero
*** SHOWDOWN ***
Hero collected $0.53 from pot
*** SUMMARY ***
Total pot $0.55 | Rake $0.02 | Jackpot $0 | Bingo $0 | Fortune $0
Seat 1: d146c7ed (button) folded before Flop (didn't bet)
Seat 2: 409d9b29 (small blind) folded before Flop
Seat 3: 36216ab (big blind) folded before Flop
Seat 4: f8c3c3ae folded before Flop
Seat 5: b3f83b4 folded before Flop (didn't bet)
Seat 6: Hero collected ($0.53)


Poker Hand #RC1433368951: Hold'em No Limit  ($0.05/$0.1) - 2023/03/27 19:30:07
Table 'RushAndCash28174211' 6-max Seat #1 is the button
Seat 1: b3645cfc ($18.38 in chips)
Seat 2: e51a3115 ($32.41 in chips)
Seat 3: Hero ($25.98 in chips)
Seat 4: 69539208 ($12.82 in chips)
Seat 5: e4f388af ($11.65 in chips)
Seat 6: 3a99a4a ($10.98 in chips)
e51a3115: posts small blind $0.05
Hero: posts big blind $0.1
*** HOLE CARDS ***
Dealt to b3645cfc 
Dealt to e51a3115 
Dealt to Hero [2c Qc]
Dealt to 69539208 
Dealt to e4f388af 
Dealt to 3a99a4a 
69539208: folds
e4f388af: folds
3a99a4a: folds
b3645cfc: raises $0.15 to $0.25
e51a3115: calls $0.2
Hero: folds
*** FLOP *** [Th 3d Ah]
e51a3115: checks
b3645cfc: bets $0.45
e51a3115: calls $0.45
*** TURN *** [Th 3d Ah] [9h]
e51a3115: checks
b3645cfc: bets $1.13
e51a3115: calls $1.13
*** RIVER *** [Th 3d Ah 9h] [As]
e51a3115: checks
b3645cfc: checks
e51a3115: shows [7h Ad] (Three Aces)
b3645cfc: shows [9d Td] (Pair of Aces and Pair of Tens)
*** SHOWDOWN ***
e51a3115 collected $3.43 from pot
*** SUMMARY ***
Total pot $3.76 | Rake $0.18 | Jackpot $0.15 | Bingo $0 | Fortune $0
Board [Th 3d Ah 9h As]
Seat 1: b3645cfc (button) showed [9d Td] and lost with Pair of Aces and Pair of Tens
Seat 2: e51a3115 (small blind) showed [7h Ad] and won ($3.43) with Three Aces
Seat 3: Hero (big blind) folded before Flop
Seat 4: 69539208 folded before Flop (didn't bet)
Seat 5: e4f388af folded before Flop (didn't bet)
Seat 6: 3a99a4a folded before Flop (didn't bet)


Poker Hand #RC1433368918: Hold'em No Limit  ($0.05/$0.1) - 2023/03/27 19:30:01
Table 'RushAndCash28174178' 6-max Seat #1 is the button
Seat 1: 3de0f141 ($16.11 in chips)
Seat 2: f8247b83 ($13.99 in chips)
Seat 3: 89c7e859 ($10 in chips)
Seat 4: 90dcd918 ($9.85 in chips)
Seat 5: Hero ($25.98 in chips)
Seat 6: ebcc5af9 ($8.28 in chips)
f8247b83: posts small blind $0.05
89c7e859: posts big blind $0.1
*** HOLE CARDS ***
Dealt to 3de0f141 
Dealt to f8247b83 
Dealt to 89c7e859 
Dealt to 90dcd918 
Dealt to Hero [2d Js]
Dealt to ebcc5af9 
90dcd918: raises $0.15 to $0.25
Hero: folds
ebcc5af9: folds
3de0f141: folds
f8247b83: folds
89c7e859: calls $0.15
*** FLOP *** [Qd Ks 2c]
89c7e859: checks
90dcd918: bets $0.28
89c7e859: calls $0.28
*** TURN *** [Qd Ks 2c] [3d]
89c7e859: checks
90dcd918: bets $0.84
89c7e859: calls $0.84
*** RIVER *** [Qd Ks 2c 3d] [Kc]
89c7e859: checks
90dcd918: checks
89c7e859: shows [Qc 8c] (Pair of Kings and Pair of Queens)
90dcd918: shows [8d 7d] (Pair of Kings)
*** SHOWDOWN ***
89c7e859 collected $2.65 from pot
*** SUMMARY ***
Total pot $2.79 | Rake $0.14 | Jackpot $0 | Bingo $0 | Fortune $0
Board [Qd Ks 2c 3d Kc]
Seat 1: 3de0f141 (button) folded before Flop (didn't bet)
Seat 2: f8247b83 (small blind) folded before Flop
Seat 3: 89c7e859 (big blind) showed [Qc 8c] and won ($2.65) with Pair of Kings and Pair of Queens
Seat 4: 90dcd918 showed [8d 7d] and lost with Pair of Kings
Seat 5: Hero folded before Flop (didn't bet)
Seat 6: ebcc5af9 folded before Flop (didn't bet)


Poker Hand #RC1433368837: Hold'em No Limit  ($0.05/$0.1) - 2023/03/27 19:29:48
Table 'RushAndCash28174097' 6-max Seat #1 is the button
Seat 1: 4315997c ($9.92 in chips)
Seat 2: Hero ($26.03 in chips)
Seat 3: 164e766a ($11.42 in chips)
Seat 4: f9e611b4 ($7.92 in chips)
Seat 5: 32d03af5 ($17.03 in chips)
Seat 6: dc5bc727 ($4.75 in chips)
Hero: posts small blind $0.05
164e766a: posts big blind $0.1
*** HOLE CARDS ***
Dealt to 4315997c 
Dealt to Hero [Ac 6h]
Dealt to 164e766a 
Dealt to f9e611b4 
Dealt to 32d03af5 
Dealt to dc5bc727 
f9e611b4: raises $0.15 to $0.25
32d03af5: folds
dc5bc727: calls $0.25
4315997c: folds
Hero: folds
164e766a: folds
*** FLOP *** [9c 6c 7d]
f9e611b4: bets $0.33
dc5bc727: folds
Uncalled bet ($0.33) returned to f9e611b4
*** SHOWDOWN ***
f9e611b4 collected $0.62 from pot
*** SUMMARY ***
Total pot $0.65 | Rake $0.03 | Jackpot $0 | Bingo $0 | Fortune $0
Board [9c 6c 7d]
Seat 1: 4315997c (button) folded before Flop (didn't bet)
Seat 2: Hero (small blind) folded before Flop
Seat 3: 164e766a (big blind) folded before Flop
Seat 4: f9e611b4 won ($0.62)
Seat 5: 32d03af5 folded before Flop (didn't bet)
Seat 6: dc5bc727 folded on the Flop


Poker Hand #RC1433368770: Hold'em No Limit  ($0.05/$0.1) - 2023/03/27 19:29:38
Table 'RushAndCash28174030' 6-max Seat #1 is the button
Seat 1: 1c1882ea ($9.85 in chips)
Seat 2: Hero ($26.08 in chips)
Seat 3: 16cda282 ($9.48 in chips)
Seat 4: 64065079 ($9.35 in chips)
Seat 5: 8b6fbfd9 ($10.16 in chips)
Seat 6: 35181a57 ($24.87 in chips)
Hero: posts small blind $0.05
16cda282: posts big blind $0.1
*** HOLE CARDS ***
Dealt to 1c1882ea 
Dealt to Hero [4d 3h]
Dealt to 16cda282 
Dealt to 64065079 
Dealt to 8b6fbfd9 
Dealt to 35181a57 
64065079: folds
8b6fbfd9: folds
35181a57: folds
1c1882ea: folds
Hero: folds
Uncalled bet ($0.05) returned to 16cda282
*** SHOWDOWN ***
16cda282 collected $0.1 from pot
*** SUMMARY ***
Total pot $0.1 | Rake $0 | Jackpot $0 | Bingo $0 | Fortune $0
Seat 1: 1c1882ea (button) folded before Flop (didn't bet)
Seat 2: Hero (small blind) folded before Flop
Seat 3: 16cda282 (big blind) collected ($0.1)
Seat 4: 64065079 folded before Flop (didn't bet)
Seat 5: 8b6fbfd9 folded before Flop (didn't bet)
Seat 6: 35181a57 folded before Flop (didn't bet)


Poker Hand #RC1433368735: Hold'em No Limit  ($0.05/$0.1) - 2023/03/27 19:29:33
Table 'RushAndCash28173995' 6-max Seat #1 is the button
Seat 1: Hero ($26.08 in chips)
Seat 2: fb4717c0 ($10.53 in chips)
Seat 3: e4f388af ($11.43 in chips)
Seat 4: f65a170a ($12.96 in chips)
Seat 5: 79901d8a ($19.02 in chips)
Seat 6: 41556f33 ($10.16 in chips)
fb4717c0: posts small blind $0.05
e4f388af: posts big blind $0.1
*** HOLE CARDS ***
Dealt to Hero [Js 2h]
Dealt to fb4717c0 
Dealt to e4f388af 
Dealt to f65a170a 
Dealt to 79901d8a 
Dealt to 41556f33 
f65a170a: folds
79901d8a: folds
41556f33: folds
Hero: folds
fb4717c0: raises $0.2 to $0.3
e4f388af: raises $0.3 to $0.6
fb4717c0: folds
Uncalled bet ($0.3) returned to e4f388af
*** SHOWDOWN ***
e4f388af collected $0.57 from pot
*** SUMMARY ***
Total pot $0.6 | Rake $0.03 | Jackpot $0 | Bingo $0 | Fortune $0
Seat 1: Hero (button) folded before Flop (didn't bet)
Seat 2: fb4717c0 (small blind) folded before Flop
Seat 3: e4f388af (big blind) collected ($0.57)
Seat 4: f65a170a folded before Flop (didn't bet)
Seat 5: 79901d8a folded before Flop (didn't bet)
Seat 6: 41556f33 folded before Flop (didn't bet)


Poker Hand #RC1433368612: Hold'em No Limit  ($0.05/$0.1) - 2023/03/27 19:29:14
Table 'RushAndCash28173872' 6-max Seat #1 is the button
Seat 1: c85df6ac ($10.15 in chips)
Seat 2: 15caa204 ($10.12 in chips)
Seat 3: 69539208 ($13.17 in chips)
Seat 4: 4271d829 ($13.52 in chips)
Seat 5: Hero ($25.93 in chips)
Seat 6: 1085b481 ($10.65 in chips)
15caa204: posts small blind $0.05
69539208: posts big blind $0.1
*** HOLE CARDS ***
Dealt to c85df6ac 
Dealt to 15caa204 
Dealt to 69539208 
Dealt to 4271d829 
Dealt to Hero [Qd Th]
Dealt to 1085b481 
4271d829: folds
Hero: raises $0.15 to $0.25
1085b481: folds
c85df6ac: folds
15caa204: folds
69539208: folds
Uncalled bet ($0.15) returned to Hero
*** SHOWDOWN ***
Hero collected $0.25 from pot
*** SUMMARY ***
Total pot $0.25 | Rake $0 | Jackpot $0 | Bingo $0 | Fortune $0
Seat 1: c85df6ac (button) folded before Flop (didn't bet)
Seat 2: 15caa204 (small blind) folded before Flop
Seat 3: 69539208 (big blind) folded before Flop
Seat 4: 4271d829 folded before Flop (didn't bet)
Seat 5: Hero collected ($0.25)
Seat 6: 1085b481 folded before Flop (didn't bet)


Poker Hand #RC1433368586: Hold'em No Limit  ($0.05/$0.1) - 2023/03/27 19:29:09
Table 'RushAndCash28173846' 6-max Seat #1 is the button
Seat 1: db5427ed ($10 in chips)
Seat 2: 6640ee20 ($10.79 in chips)
Seat 3: 7a70a521 ($10.15 in chips)
Seat 4: 859207b8 ($18.86 in chips)
Seat 5: Hero ($25.93 in chips)
Seat 6: a3ad4d53 ($24.7 in chips)
6640ee20: posts small blind $0.05
7a70a521: posts big blind $0.1
*** HOLE CARDS ***
Dealt to db5427ed 
Dealt to 6640ee20 
Dealt to 7a70a521 
Dealt to 859207b8 
Dealt to Hero [6h Ad]
Dealt to a3ad4d53 
859207b8: raises $0.15 to $0.25
Hero: folds
a3ad4d53: raises $0.59 to $0.84
db5427ed: folds
6640ee20: folds
7a70a521: folds
859207b8: folds
Uncalled bet ($0.59) returned to a3ad4d53
*** SHOWDOWN ***
a3ad4d53 collected $0.62 from pot
*** SUMMARY ***
Total pot $0.65 | Rake $0.03 | Jackpot $0 | Bingo $0 | Fortune $0
Seat 1: db5427ed (button) folded before Flop (didn't bet)
Seat 2: 6640ee20 (small blind) folded before Flop
Seat 3: 7a70a521 (big blind) folded before Flop
Seat 4: 859207b8 folded before Flop
Seat 5: Hero folded before Flop (didn't bet)
Seat 6: a3ad4d53 collected ($0.62)


Poker Hand #RC1433368059: Hold'em No Limit  ($0.05/$0.1) - 2023/03/27 19:27:47
Table 'RushAndCash28173319' 6-max Seat #1 is the button
Seat 1: 6cb3fe1b ($15.91 in chips)
Seat 2: 11e1f5d4 ($10.34 in chips)
Seat 3: Hero ($26.37 in chips)
Seat 4: 94997c20 ($12.84 in chips)
Seat 5: 75cca39f ($11.02 in chips)
Seat 6: 18547626 ($11.23 in chips)
11e1f5d4: posts small blind $0.05
Hero: posts big blind $0.1
*** HOLE CARDS ***
Dealt to 6cb3fe1b 
Dealt to 11e1f5d4 
Dealt to Hero [As 9s]
Dealt to 94997c20 
Dealt to 75cca39f 
Dealt to 18547626 
94997c20: folds
75cca39f: raises $0.15 to $0.25
18547626: folds
6cb3fe1b: folds
11e1f5d4: folds
Hero: calls $0.15
*** FLOP *** [Ts 2d Kh]
Hero: checks
75cca39f: bets $0.19
Hero: calls $0.19
*** TURN *** [Ts 2d Kh] [6c]
Hero: checks
75cca39f: checks
*** RIVER *** [Ts 2d Kh 6c] [8h]
Hero: checks
75cca39f: bets $0.71
Hero: folds
Uncalled bet ($0.71) returned to 75cca39f
*** SHOWDOWN ***
75cca39f collected $0.89 from pot
*** SUMMARY ***
Total pot $0.93 | Rake $0.04 | Jackpot $0 | Bingo $0 | Fortune $0
Board [Ts 2d Kh 6c 8h]
Seat 1: 6cb3fe1b (button) folded before Flop (didn't bet)
Seat 2: 11e1f5d4 (small blind) folded before Flop
Seat 3: Hero (big blind) folded on the River
Seat 4: 94997c20 folded before Flop (didn't bet)
Seat 5: 75cca39f won ($0.89)
Seat 6: 18547626 folded before Flop (didn't bet)


Poker Hand #RC1433368030: Hold'em No Limit  ($0.05/$0.1) - 2023/03/27 19:27:43
Table 'RushAndCash28173290' 6-max Seat #1 is the button
Seat 1: bc200b82 ($19.96 in chips)
Seat 2: 3a99a4a ($11.33 in chips)
Seat 3: ea4c6c58 ($21.37 in chips)
Seat 4: Hero ($26.37 in chips)
Seat 5: cad3917f ($17.94 in chips)
Seat 6: 5a08e02b ($11.15 in chips)
3a99a4a: posts small blind $0.05
ea4c6c58: posts big blind $0.1
*** HOLE CARDS ***
Dealt to bc200b82 
Dealt to 3a99a4a 
Dealt to ea4c6c58 
Dealt to Hero [Td 2h]
Dealt to cad3917f 
Dealt to 5a08e02b 
Hero: folds
cad3917f: raises $0.15 to $0.25
5a08e02b: raises $0.45 to $0.7
bc200b82: folds
3a99a4a: folds
ea4c6c58: folds
cad3917f: folds
Uncalled bet ($0.45) returned to 5a08e02b
*** SHOWDOWN ***
5a08e02b collected $0.62 from pot
*** SUMMARY ***
Total pot $0.65 | Rake $0.03 | Jackpot $0 | Bingo $0 | Fortune $0
Seat 1: bc200b82 (button) folded before Flop (didn't bet)
Seat 2: 3a99a4a (small blind) folded before Flop
Seat 3: ea4c6c58 (big blind) folded before Flop
Seat 4: Hero folded before Flop (didn't bet)
Seat 5: cad3917f folded before Flop
Seat 6: 5a08e02b collected ($0.62)


Poker Hand #RC1433367955: Hold'em No Limit  ($0.05/$0.1) - 2023/03/27 19:27:30
Table 'RushAndCash28173215' 6-max Seat #1 is the button
Seat 1: Hero ($26.37 in chips)
Seat 2: a38464e2 ($10 in chips)
Seat 3: ad1db046 ($16.95 in chips)
Seat 4: 2ade479b ($16.96 in chips)
Seat 5: cfaf4ca4 ($11.94 in chips)
Seat 6: 54d5200f ($30.23 in chips)
Cash Drop to Pot : total $1 
a38464e2: posts small blind $0.05
ad1db046: posts big blind $0.1
*** HOLE CARDS ***
Dealt to Hero [6h 2c]
Dealt to a38464e2 
Dealt to ad1db046 
Dealt to 2ade479b 
Dealt to cfaf4ca4 
Dealt to 54d5200f 
2ade479b: folds
cfaf4ca4: folds
54d5200f: raises $0.15 to $0.25
Hero: folds
a38464e2: calls $0.2
ad1db046: raises $1.25 to $1.5
54d5200f: calls $1.25
a38464e2: calls $1.25
*** FLOP *** [8c 9s Jc]
a38464e2: checks
ad1db046: checks
54d5200f: checks
*** TURN *** [8c 9s Jc] [Ah]
a38464e2: checks
ad1db046: checks
54d5200f: checks
*** RIVER *** [8c 9s Jc Ah] [Ac]
a38464e2: checks
ad1db046: checks
54d5200f: checks
a38464e2: shows [Ad 4s] (Three Aces)
ad1db046: shows [7s 7c] (Pair of Aces and Pair of Sevens)
54d5200f: shows [Jd Qd] (Pair of Aces and Pair of Jacks)
*** SHOWDOWN ***
a38464e2 collected $5.03 from pot
*** SUMMARY ***
Total pot $5.5 | Rake $0.32 | Jackpot $0.15 | Bingo $0 | Fortune $0
Board [8c 9s Jc Ah Ac]
Seat 1: Hero (button) folded before Flop (didn't bet)
Seat 2: a38464e2 (small blind) showed [Ad 4s] and won ($5.03) with Three Aces
Seat 3: ad1db046 (big blind) showed [7s 7c] and lost with Pair of Aces and Pair of Sevens
Seat 4: 2ade479b folded before Flop (didn't bet)
Seat 5: cfaf4ca4 folded before Flop (didn't bet)
Seat 6: 54d5200f showed [Jd Qd] and lost with Pair of Aces and Pair of Jacks


Poker Hand #RC1433367926: Hold'em No Limit  ($0.05/$0.1) - 2023/03/27 19:27:25
Table 'RushAndCash28173186' 6-max Seat #1 is the button
Seat 1: cb37cb1b ($9.03 in chips)
Seat 2: 17e87098 ($10.36 in chips)
Seat 3: Hero ($26.47 in chips)
Seat 4: 8b498f8a ($19.47 in chips)
Seat 5: 29e6c0ca ($14.91 in chips)
Seat 6: 25295a38 ($88.89 in chips)
17e87098: posts small blind $0.05
Hero: posts big blind $0.1
*** HOLE CARDS ***
Dealt to cb37cb1b 
Dealt to 17e87098 
Dealt to Hero [2s 5c]
Dealt to 8b498f8a 
Dealt to 29e6c0ca 
Dealt to 25295a38 
8b498f8a: folds
29e6c0ca: folds
25295a38: raises $0.12 to $0.22
cb37cb1b: folds
17e87098: folds
Hero: folds
Uncalled bet ($0.12) returned to 25295a38
*** SHOWDOWN ***
25295a38 collected $0.25 from pot
*** SUMMARY ***
Total pot $0.25 | Rake $0 | Jackpot $0 | Bingo $0 | Fortune $0
Seat 1: cb37cb1b (button) folded before Flop (didn't bet)
Seat 2: 17e87098 (small blind) folded before Flop
Seat 3: Hero (big blind) folded before Flop
Seat 4: 8b498f8a folded before Flop (didn't bet)
Seat 5: 29e6c0ca folded before Flop (didn't bet)
Seat 6: 25295a38 collected ($0.25)


Poker Hand #RC1433367898: Hold'em No Limit  ($0.05/$0.1) - 2023/03/27 19:27:21
Table 'RushAndCash28173158' 6-max Seat #1 is the button
Seat 1: 2cb9309 ($9.65 in chips)
Seat 2: 1bd0a248 ($10.97 in chips)
Seat 3: 6addd84b ($9.32 in chips)
Seat 4: 1c1882ea ($3.4 in chips)
Seat 5: Hero ($26.47 in chips)
Seat 6: 43194f47 ($28.43 in chips)
1bd0a248: posts small blind $0.05
6addd84b: posts big blind $0.1
*** HOLE CARDS ***
Dealt to 2cb9309 
Dealt to 1bd0a248 
Dealt to 6addd84b 
Dealt to 1c1882ea 
Dealt to Hero [9c 8h]
Dealt to 43194f47 
1c1882ea: folds
Hero: folds
43194f47: raises $0.12 to $0.22
2cb9309: folds
1bd0a248: folds
6addd84b: calls $0.12
*** FLOP *** [Tc 3c 2c]
6addd84b: checks
43194f47: checks
*** TURN *** [Tc 3c 2c] [2s]
6addd84b: checks
43194f47: checks
*** RIVER *** [Tc 3c 2c 2s] [6s]
6addd84b: checks
43194f47: checks
6addd84b: shows [Ad 9h] (Pair of Twos)
43194f47: shows [5s 5d] (Pair of Fives and Pair of Twos)
*** SHOWDOWN ***
43194f47 collected $0.47 from pot
*** SUMMARY ***
Total pot $0.49 | Rake $0.02 | Jackpot $0 | Bingo $0 | Fortune $0
Board [Tc 3c 2c 2s 6s]
Seat 1: 2cb9309 (button) folded before Flop (didn't bet)
Seat 2: 1bd0a248 (small blind) folded before Flop
Seat 3: 6addd84b (big blind) showed [Ad 9h] and lost with Pair of Twos
Seat 4: 1c1882ea folded before Flop (didn't bet)
Seat 5: Hero folded before Flop (didn't bet)
Seat 6: 43194f47 showed [5s 5d] and won ($0.47) with Pair of Fives and Pair of Twos


Poker Hand #RC1433367526: Hold'em No Limit  ($0.05/$0.1) - 2023/03/27 19:26:25
Table 'RushAndCash28172786' 6-max Seat #1 is the button
Seat 1: 1c1882ea ($4.7 in chips)
Seat 2: Hero ($25.2 in chips)
Seat 3: e5558e5d ($12.41 in chips)
Seat 4: e7f48829 ($10.5 in chips)
Seat 5: a7e3d6b ($11.26 in chips)
Seat 6: 622837e ($10.82 in chips)
Hero: posts small blind $0.05
e5558e5d: posts big blind $0.1
*** HOLE CARDS ***
Dealt to 1c1882ea 
Dealt to Hero [Kd Qh]
Dealt to e5558e5d 
Dealt to e7f48829 
Dealt to a7e3d6b 
Dealt to 622837e 
e7f48829: folds
a7e3d6b: folds
622837e: folds
1c1882ea: raises $0.23 to $0.33
Hero: raises $0.97 to $1.3
e5558e5d: folds
1c1882ea: calls $0.97
*** FLOP *** [9c Ah Ts]
Hero: bets $1.35
1c1882ea: folds
Uncalled bet ($1.35) returned to Hero
*** SHOWDOWN ***
Hero collected $2.57 from pot
*** SUMMARY ***
Total pot $2.7 | Rake $0.13 | Jackpot $0 | Bingo $0 | Fortune $0
Board [9c Ah Ts]
Seat 1: 1c1882ea (button) folded on the Flop
Seat 2: Hero (small blind) won ($2.57)
Seat 3: e5558e5d (big blind) folded before Flop
Seat 4: e7f48829 folded before Flop (didn't bet)
Seat 5: a7e3d6b folded before Flop (didn't bet)
Seat 6: 622837e folded before Flop (didn't bet)


Poker Hand #RC1433367275: Hold'em No Limit  ($0.05/$0.1) - 2023/03/27 19:25:47
Table 'RushAndCash28172535' 6-max Seat #1 is the button
Seat 1: 95bcae3a ($10 in chips)
Seat 2: a7e3d6b ($11.51 in chips)
Seat 3: 998234fc ($12.6 in chips)
Seat 4: 7125b3e8 ($10.61 in chips)
Seat 5: Hero ($24.88 in chips)
Seat 6: 35181a57 ($35.1 in chips)
a7e3d6b: posts small blind $0.05
998234fc: posts big blind $0.1
*** HOLE CARDS ***
Dealt to 95bcae3a 
Dealt to a7e3d6b 
Dealt to 998234fc 
Dealt to 7125b3e8 
Dealt to Hero [5s 5c]
Dealt to 35181a57 
7125b3e8: folds
Hero: raises $0.15 to $0.25
35181a57: folds
95bcae3a: folds
a7e3d6b: calls $0.2
998234fc: folds
*** FLOP *** [Ks Qc 5d]
a7e3d6b: checks
Hero: bets $0.3
a7e3d6b: folds
Uncalled bet ($0.3) returned to Hero
*** SHOWDOWN ***
Hero collected $0.57 from pot
*** SUMMARY ***
Total pot $0.6 | Rake $0.03 | Jackpot $0 | Bingo $0 | Fortune $0
Board [Ks Qc 5d]
Seat 1: 95bcae3a (button) folded before Flop (didn't bet)
Seat 2: a7e3d6b (small blind) folded on the Flop
Seat 3: 998234fc (big blind) folded before Flop
Seat 4: 7125b3e8 folded before Flop (didn't bet)
Seat 5: Hero won ($0.57)
Seat 6: 35181a57 folded before Flop (didn't bet)


Poker Hand #RC1433367177: Hold'em No Limit  ($0.05/$0.1) - 2023/03/27 19:25:35
Table 'RushAndCash28172437' 6-max Seat #1 is the button
Seat 1: 3de0f141 ($12.86 in chips)
Seat 2: e98ae4a0 ($12.71 in chips)
Seat 3: 14f4767 ($10.15 in chips)
Seat 4: Hero ($24.88 in chips)
Seat 5: d13f972 ($11 in chips)
Seat 6: 670150ff ($23.66 in chips)
e98ae4a0: posts small blind $0.05
14f4767: posts big blind $0.1
*** HOLE CARDS ***
Dealt to 3de0f141 
Dealt to e98ae4a0 
Dealt to 14f4767 
Dealt to Hero [As 4d]
Dealt to d13f972 
Dealt to 670150ff 
Hero: folds
d13f972: folds
670150ff: folds
3de0f141: folds
e98ae4a0: folds
Uncalled bet ($0.05) returned to 14f4767
*** SHOWDOWN ***
14f4767 collected $0.1 from pot
*** SUMMARY ***
Total pot $0.1 | Rake $0 | Jackpot $0 | Bingo $0 | Fortune $0
Seat 1: 3de0f141 (button) folded before Flop (didn't bet)
Seat 2: e98ae4a0 (small blind) folded before Flop
Seat 3: 14f4767 (big blind) collected ($0.1)
Seat 4: Hero folded before Flop (didn't bet)
Seat 5: d13f972 folded before Flop (didn't bet)
Seat 6: 670150ff folded before Flop (didn't bet)


Poker Hand #RC1433367126: Hold'em No Limit  ($0.05/$0.1) - 2023/03/27 19:25:28
Table 'RushAndCash28172386' 6-max Seat #1 is the button
Seat 1: 2a2ad61f ($8.51 in chips)
Seat 2: b3645cfc ($18.14 in chips)
Seat 3: f6184b9c ($8.87 in chips)
Seat 4: dbdea2f1 ($10.78 in chips)
Seat 5: 4ba966ea ($16.01 in chips)
Seat 6: Hero ($24.88 in chips)
b3645cfc: posts small blind $0.05
f6184b9c: posts big blind $0.1
*** HOLE CARDS ***
Dealt to 2a2ad61f 
Dealt to b3645cfc 
Dealt to f6184b9c 
Dealt to dbdea2f1 
Dealt to 4ba966ea 
Dealt to Hero [Th 7d]
dbdea2f1: folds
4ba966ea: raises $0.2 to $0.3
Hero: folds
2a2ad61f: folds
b3645cfc: folds
f6184b9c: folds
Uncalled bet ($0.2) returned to 4ba966ea
*** SHOWDOWN ***
4ba966ea collected $0.25 from pot
*** SUMMARY ***
Total pot $0.25 | Rake $0 | Jackpot $0 | Bingo $0 | Fortune $0
Seat 1: 2a2ad61f (button) folded before Flop (didn't bet)
Seat 2: b3645cfc (small blind) folded before Flop
Seat 3: f6184b9c (big blind) folded before Flop
Seat 4: dbdea2f1 folded before Flop (didn't bet)
Seat 5: 4ba966ea collected ($0.25)
Seat 6: Hero folded before Flop (didn't bet)


Poker Hand #RC1433366974: Hold'em No Limit  ($0.05/$0.1) - 2023/03/27 19:25:06
Table 'RushAndCash28172234' 6-max Seat #1 is the button
Seat 1: Hero ($25.13 in chips)
Seat 2: 2a2ad61f ($8.19 in chips)
Seat 3: f8e5f3fd ($10.63 in chips)
Seat 4: 42391a92 ($22.46 in chips)
Seat 5: b959dd5b ($13.72 in chips)
Seat 6: 3e2ce794 ($12.41 in chips)
2a2ad61f: posts small blind $0.05
f8e5f3fd: posts big blind $0.1
*** HOLE CARDS ***
Dealt to Hero [Kh Th]
Dealt to 2a2ad61f 
Dealt to f8e5f3fd 
Dealt to 42391a92 
Dealt to b959dd5b 
Dealt to 3e2ce794 
42391a92: folds
b959dd5b: folds
3e2ce794: folds
Hero: raises $0.15 to $0.25
2a2ad61f: raises $0.6 to $0.85
f8e5f3fd: folds
Hero: folds
Uncalled bet ($0.6) returned to 2a2ad61f
*** SHOWDOWN ***
2a2ad61f collected $0.57 from pot
*** SUMMARY ***
Total pot $0.6 | Rake $0.03 | Jackpot $0 | Bingo $0 | Fortune $0
Seat 1: Hero (button) folded before Flop
Seat 2: 2a2ad61f (small blind) collected ($0.57)
Seat 3: f8e5f3fd (big blind) folded before Flop
Seat 4: 42391a92 folded before Flop (didn't bet)
Seat 5: b959dd5b folded before Flop (didn't bet)
Seat 6: 3e2ce794 folded before Flop (didn't bet)


Poker Hand #RC1433366904: Hold'em No Limit  ($0.05/$0.1) - 2023/03/27 19:24:56
Table 'RushAndCash28172164' 6-max Seat #1 is the button
Seat 1: 75a8cf5a ($12.15 in chips)
Seat 2: 23d21099 ($10 in chips)
Seat 3: c22b7a69 ($12.15 in chips)
Seat 4: Hero ($25.13 in chips)
Seat 5: 2797b5a1 ($11.05 in chips)
Seat 6: c30ea873 ($15.52 in chips)
23d21099: posts small blind $0.05
c22b7a69: posts big blind $0.1
*** HOLE CARDS ***
Dealt to 75a8cf5a 
Dealt to 23d21099 
Dealt to c22b7a69 
Dealt to Hero [Td Js]
Dealt to 2797b5a1 
Dealt to c30ea873 
Hero: folds
2797b5a1: raises $0.12 to $0.22
c30ea873: folds
75a8cf5a: folds
23d21099: folds
c22b7a69: folds
Uncalled bet ($0.12) returned to 2797b5a1
*** SHOWDOWN ***
2797b5a1 collected $0.25 from pot
*** SUMMARY ***
Total pot $0.25 | Rake $0 | Jackpot $0 | Bingo $0 | Fortune $0
Seat 1: 75a8cf5a (button) folded before Flop (didn't bet)
Seat 2: 23d21099 (small blind) folded before Flop
Seat 3: c22b7a69 (big blind) folded before Flop
Seat 4: Hero folded before Flop (didn't bet)
Seat 5: 2797b5a1 collected ($0.25)
Seat 6: c30ea873 folded before Flop (didn't bet)


Poker Hand #RC1433366759: Hold'em No Limit  ($0.05/$0.1) - 2023/03/27 19:24:36
Table 'RushAndCash28172019' 6-max Seat #1 is the button
Seat 1: 8b6fbfd9 ($10 in chips)
Seat 2: 379aabbf ($14.15 in chips)
Seat 3: Hero ($25.23 in chips)
Seat 4: a76b3c83 ($11.29 in chips)
Seat 5: 1afa69b0 ($14.22 in chips)
Seat 6: 831b99c5 ($14.24 in chips)
379aabbf: posts small blind $0.05
Hero: posts big blind $0.1
*** HOLE CARDS ***
Dealt to 8b6fbfd9 
Dealt to 379aabbf 
Dealt to Hero [4s 2s]
Dealt to a76b3c83 
Dealt to 1afa69b0 
Dealt to 831b99c5 
a76b3c83: folds
1afa69b0: folds
831b99c5: raises $0.15 to $0.25
8b6fbfd9: folds
379aabbf: folds
Hero: folds
Uncalled bet ($0.15) returned to 831b99c5
*** SHOWDOWN ***
831b99c5 collected $0.25 from pot
*** SUMMARY ***
Total pot $0.25 | Rake $0 | Jackpot $0 | Bingo $0 | Fortune $0
Seat 1: 8b6fbfd9 (button) folded before Flop (didn't bet)
Seat 2: 379aabbf (small blind) folded before Flop
Seat 3: Hero (big blind) folded before Flop
Seat 4: a76b3c83 folded before Flop (didn't bet)
Seat 5: 1afa69b0 folded before Flop (didn't bet)
Seat 6: 831b99c5 collected ($0.25)


Poker Hand #RC1433366612: Hold'em No Limit  ($0.05/$0.1) - 2023/03/27 19:24:15
Table 'RushAndCash28171872' 6-max Seat #1 is the button
Seat 1: 3253ee1d ($13.17 in chips)
Seat 2: Hero ($25.13 in chips)
Seat 3: 53989c53 ($23.77 in chips)
Seat 4: de97fc62 ($15.93 in chips)
Seat 5: 28f8789 ($10.25 in chips)
Seat 6: 4ba966ea ($15.89 in chips)
Hero: posts small blind $0.05
53989c53: posts big blind $0.1
*** HOLE CARDS ***
Dealt to 3253ee1d 
Dealt to Hero [Ks Qh]
Dealt to 53989c53 
Dealt to de97fc62 
Dealt to 28f8789 
Dealt to 4ba966ea 
de97fc62: folds
28f8789: folds
4ba966ea: folds
3253ee1d: folds
Hero: raises $0.2 to $0.3
53989c53: folds
Uncalled bet ($0.2) returned to Hero
*** SHOWDOWN ***
Hero collected $0.2 from pot
*** SUMMARY ***
Total pot $0.2 | Rake $0 | Jackpot $0 | Bingo $0 | Fortune $0
Seat 1: 3253ee1d (button) folded before Flop (didn't bet)
Seat 2: Hero (small blind) collected ($0.2)
Seat 3: 53989c53 (big blind) folded before Flop
Seat 4: de97fc62 folded before Flop (didn't bet)
Seat 5: 28f8789 folded before Flop (didn't bet)
Seat 6: 4ba966ea folded before Flop (didn't bet)


Poker Hand #RC1433366518: Hold'em No Limit  ($0.05/$0.1) - 2023/03/27 19:24:01
Table 'RushAndCash28171778' 6-max Seat #1 is the button
Seat 1: a7e3d6b ($11.51 in chips)
Seat 2: b16fa7d1 ($8.9 in chips)
Seat 3: 7125b3e8 ($9.7 in chips)
Seat 4: 50908537 ($32.84 in chips)
Seat 5: Hero ($24.98 in chips)
Seat 6: d7ef21d5 ($19.58 in chips)
b16fa7d1: posts small blind $0.05
7125b3e8: posts big blind $0.1
*** HOLE CARDS ***
Dealt to a7e3d6b 
Dealt to b16fa7d1 
Dealt to 7125b3e8 
Dealt to 50908537 
Dealt to Hero [9h 9c]
Dealt to d7ef21d5 
50908537: folds
Hero: raises $0.15 to $0.25
d7ef21d5: folds
a7e3d6b: folds
b16fa7d1: folds
7125b3e8: folds
Uncalled bet ($0.15) returned to Hero
*** SHOWDOWN ***
Hero collected $0.25 from pot
*** SUMMARY ***
Total pot $0.25 | Rake $0 | Jackpot $0 | Bingo $0 | Fortune $0
Seat 1: a7e3d6b (button) folded before Flop (didn't bet)
Seat 2: b16fa7d1 (small blind) folded before Flop
Seat 3: 7125b3e8 (big blind) folded before Flop
Seat 4: 50908537 folded before Flop (didn't bet)
Seat 5: Hero collected ($0.25)
Seat 6: d7ef21d5 folded before Flop (didn't bet)


Poker Hand #RC1433366443: Hold'em No Limit  ($0.05/$0.1) - 2023/03/27 19:23:50
Table 'RushAndCash28171703' 6-max Seat #1 is the button
Seat 1: 88a93721 ($12.15 in chips)
Seat 2: Hero ($25.03 in chips)
Seat 3: 16cda282 ($12.02 in chips)
Seat 4: cd986535 ($12.96 in chips)
Seat 5: 622a2abf ($13.34 in chips)
Seat 6: c5ae1fbf ($17.53 in chips)
Hero: posts small blind $0.05
16cda282: posts big blind $0.1
*** HOLE CARDS ***
Dealt to 88a93721 
Dealt to Hero [8s 2h]
Dealt to 16cda282 
Dealt to cd986535 
Dealt to 622a2abf 
Dealt to c5ae1fbf 
cd986535: folds
622a2abf: folds
c5ae1fbf: folds
88a93721: raises $0.1 to $0.2
Hero: folds
16cda282: folds
Uncalled bet ($0.1) returned to 88a93721
*** SHOWDOWN ***
88a93721 collected $0.25 from pot
*** SUMMARY ***
Total pot $0.25 | Rake $0 | Jackpot $0 | Bingo $0 | Fortune $0
Seat 1: 88a93721 (button) collected ($0.25)
Seat 2: Hero (small blind) folded before Flop
Seat 3: 16cda282 (big blind) folded before Flop
Seat 4: cd986535 folded before Flop (didn't bet)
Seat 5: 622a2abf folded before Flop (didn't bet)
Seat 6: c5ae1fbf folded before Flop (didn't bet)


Poker Hand #RC1433366264: Hold'em No Limit  ($0.05/$0.1) - 2023/03/27 19:23:21
Table 'RushAndCash28171524' 6-max Seat #1 is the button
Seat 1: a839d3e4 ($5.15 in chips)
Seat 2: 47fac11d ($16.01 in chips)
Seat 3: 7141df2d ($10.82 in chips)
Seat 4: 84765ddc ($12.07 in chips)
Seat 5: bb4dcf9b ($20.46 in chips)
Seat 6: Hero ($25.33 in chips)
47fac11d: posts small blind $0.05
7141df2d: posts big blind $0.1
*** HOLE CARDS ***
Dealt to a839d3e4 
Dealt to 47fac11d 
Dealt to 7141df2d 
Dealt to 84765ddc 
Dealt to bb4dcf9b 
Dealt to Hero [7h 7s]
84765ddc: raises $0.2 to $0.3
bb4dcf9b: folds
Hero: calls $0.3
a839d3e4: folds
47fac11d: folds
7141df2d: calls $0.2
*** FLOP *** [Td 3h 9c]
7141df2d: checks
84765ddc: bets $0.53
Hero: folds
7141df2d: folds
Uncalled bet ($0.53) returned to 84765ddc
*** SHOWDOWN ***
84765ddc collected $0.91 from pot
*** SUMMARY ***
Total pot $0.95 | Rake $0.04 | Jackpot $0 | Bingo $0 | Fortune $0
Board [Td 3h 9c]
Seat 1: a839d3e4 (button) folded before Flop (didn't bet)
Seat 2: 47fac11d (small blind) folded before Flop
Seat 3: 7141df2d (big blind) folded on the Flop
Seat 4: 84765ddc won ($0.91)
Seat 5: bb4dcf9b folded before Flop (didn't bet)
Seat 6: Hero folded on the Flop


Poker Hand #RC1433366210: Hold'em No Limit  ($0.05/$0.1) - 2023/03/27 19:23:13
Table 'RushAndCash28171470' 6-max Seat #1 is the button
Seat 1: 32df2317 ($27.9 in chips)
Seat 2: c4636c6a ($9.77 in chips)
Seat 3: Hero ($25.28 in chips)
Seat 4: 84765ddc ($12.07 in chips)
Seat 5: 8b6fbfd9 ($10 in chips)
Seat 6: 11e1f5d4 ($12.69 in chips)
c4636c6a: posts small blind $0.05
Hero: posts big blind $0.1
*** HOLE CARDS ***
Dealt to 32df2317 
Dealt to c4636c6a 
Dealt to Hero [8s 9s]
Dealt to 84765ddc 
Dealt to 8b6fbfd9 
Dealt to 11e1f5d4 
84765ddc: folds
8b6fbfd9: folds
11e1f5d4: folds
32df2317: folds
c4636c6a: folds
Uncalled bet ($0.05) returned to Hero
*** SHOWDOWN ***
Hero collected $0.1 from pot
*** SUMMARY ***
Total pot $0.1 | Rake $0 | Jackpot $0 | Bingo $0 | Fortune $0
Seat 1: 32df2317 (button) folded before Flop (didn't bet)
Seat 2: c4636c6a (small blind) folded before Flop
Seat 3: Hero (big blind) collected ($0.1)
Seat 4: 84765ddc folded before Flop (didn't bet)
Seat 5: 8b6fbfd9 folded before Flop (didn't bet)
Seat 6: 11e1f5d4 folded before Flop (didn't bet)


Poker Hand #RC1433366095: Hold'em No Limit  ($0.05/$0.1) - 2023/03/27 19:22:56
Table 'RushAndCash28171355' 6-max Seat #1 is the button
Seat 1: Hero ($25.28 in chips)
Seat 2: 2a8ab56b ($15.47 in chips)
Seat 3: a9f4a031 ($10.26 in chips)
Seat 4: 598c3445 ($10 in chips)
Seat 5: fc4ebf1c ($10 in chips)
Seat 6: 197ebdde ($20.99 in chips)
2a8ab56b: posts small blind $0.05
a9f4a031: posts big blind $0.1
*** HOLE CARDS ***
Dealt to Hero [Ts 9d]
Dealt to 2a8ab56b 
Dealt to a9f4a031 
Dealt to 598c3445 
Dealt to fc4ebf1c 
Dealt to 197ebdde 
598c3445: folds
fc4ebf1c: raises $0.15 to $0.25
197ebdde: folds
Hero: folds
2a8ab56b: folds
a9f4a031: calls $0.15
*** FLOP *** [5d 8d Ks]
a9f4a031: checks
fc4ebf1c: bets $0.28
a9f4a031: folds
Uncalled bet ($0.28) returned to fc4ebf1c
*** SHOWDOWN ***
fc4ebf1c collected $0.53 from pot
*** SUMMARY ***
Total pot $0.55 | Rake $0.02 | Jackpot $0 | Bingo $0 | Fortune $0
Board [5d 8d Ks]
Seat 1: Hero (button) folded before Flop (didn't bet)
Seat 2: 2a8ab56b (small blind) folded before Flop
Seat 3: a9f4a031 (big blind) folded on the Flop
Seat 4: 598c3445 folded before Flop (didn't bet)
Seat 5: fc4ebf1c won ($0.53)
Seat 6: 197ebdde folded before Flop (didn't bet)


Poker Hand #RC1433366048: Hold'em No Limit  ($0.05/$0.1) - 2023/03/27 19:22:49
Table 'RushAndCash28171308' 6-max Seat #1 is the button
Seat 1: 9fc3730b ($9.17 in chips)
Seat 2: d38afca8 ($12.09 in chips)
Seat 3: 47fac11d ($16.11 in chips)
Seat 4: c20fb006 ($24.86 in chips)
Seat 5: Hero ($25.28 in chips)
Seat 6: 5174df53 ($40.08 in chips)
d38afca8: posts small blind $0.05
47fac11d: posts big blind $0.1
*** HOLE CARDS ***
Dealt to 9fc3730b 
Dealt to d38afca8 
Dealt to 47fac11d 
Dealt to c20fb006 
Dealt to Hero [2c 3c]
Dealt to 5174df53 
c20fb006: folds
Hero: folds
5174df53: folds
9fc3730b: raises $0.15 to $0.25
d38afca8: folds
47fac11d: folds
Uncalled bet ($0.15) returned to 9fc3730b
*** SHOWDOWN ***
9fc3730b collected $0.25 from pot
*** SUMMARY ***
Total pot $0.25 | Rake $0 | Jackpot $0 | Bingo $0 | Fortune $0
Seat 1: 9fc3730b (button) collected ($0.25)
Seat 2: d38afca8 (small blind) folded before Flop
Seat 3: 47fac11d (big blind) folded before Flop
Seat 4: c20fb006 folded before Flop (didn't bet)
Seat 5: Hero folded before Flop (didn't bet)
Seat 6: 5174df53 folded before Flop (didn't bet)


Poker Hand #RC1433365974: Hold'em No Limit  ($0.05/$0.1) - 2023/03/27 19:22:38
Table 'RushAndCash28171234' 6-max Seat #1 is the button
Seat 1: c36ac4b6 ($24.36 in chips)
Seat 2: 2797b5a1 ($10.34 in chips)
Seat 3: 35181a57 ($35.6 in chips)
Seat 4: 9d068308 ($37.26 in chips)
Seat 5: d7795b7 ($10 in chips)
Seat 6: Hero ($25.28 in chips)
2797b5a1: posts small blind $0.05
35181a57: posts big blind $0.1
*** HOLE CARDS ***
Dealt to c36ac4b6 
Dealt to 2797b5a1 
Dealt to 35181a57 
Dealt to 9d068308 
Dealt to d7795b7 
Dealt to Hero [6d 5h]
9d068308: folds
d7795b7: folds
Hero: folds
c36ac4b6: raises $0.13 to $0.23
2797b5a1: raises $0.77 to $1
35181a57: folds
c36ac4b6: folds
Uncalled bet ($0.77) returned to 2797b5a1
*** SHOWDOWN ***
2797b5a1 collected $0.54 from pot
*** SUMMARY ***
Total pot $0.56 | Rake $0.02 | Jackpot $0 | Bingo $0 | Fortune $0
Seat 1: c36ac4b6 (button) folded before Flop
Seat 2: 2797b5a1 (small blind) collected ($0.54)
Seat 3: 35181a57 (big blind) folded before Flop
Seat 4: 9d068308 folded before Flop (didn't bet)
Seat 5: d7795b7 folded before Flop (didn't bet)
Seat 6: Hero folded before Flop (didn't bet)


Poker Hand #RC1433365939: Hold'em No Limit  ($0.05/$0.1) - 2023/03/27 19:22:33
Table 'RushAndCash28171199' 6-max Seat #1 is the button
Seat 1: 309f93e ($10.05 in chips)
Seat 2: 94b5d25e ($21.37 in chips)
Seat 3: 42d7f34b ($11.38 in chips)
Seat 4: 2ba07e93 ($10.48 in chips)
Seat 5: 6c1c848d ($10.4 in chips)
Seat 6: Hero ($25.28 in chips)
94b5d25e: posts small blind $0.05
42d7f34b: posts big blind $0.1
*** HOLE CARDS ***
Dealt to 309f93e 
Dealt to 94b5d25e 
Dealt to 42d7f34b 
Dealt to 2ba07e93 
Dealt to 6c1c848d 
Dealt to Hero [3h Jh]
2ba07e93: folds
6c1c848d: folds
Hero: folds
309f93e: folds
94b5d25e: raises $0.2 to $0.3
42d7f34b: raises $0.6 to $0.9
94b5d25e: folds
Uncalled bet ($0.6) returned to 42d7f34b
*** SHOWDOWN ***
42d7f34b collected $0.57 from pot
*** SUMMARY ***
Total pot $0.6 | Rake $0.03 | Jackpot $0 | Bingo $0 | Fortune $0
Seat 1: 309f93e (button) folded before Flop (didn't bet)
Seat 2: 94b5d25e (small blind) folded before Flop
Seat 3: 42d7f34b (big blind) collected ($0.57)
Seat 4: 2ba07e93 folded before Flop (didn't bet)
Seat 5: 6c1c848d folded before Flop (didn't bet)
Seat 6: Hero folded before Flop (didn't bet)


Poker Hand #RC1433365875: Hold'em No Limit  ($0.05/$0.1) - 2023/03/27 19:22:24
Table 'RushAndCash28171135' 6-max Seat #1 is the button
Seat 1: 99c6207c ($20.17 in chips)
Seat 2: 2de77172 ($10 in chips)
Seat 3: 61c00c39 ($16.4 in chips)
Seat 4: d3a652d6 ($27.24 in chips)
Seat 5: Hero ($25.28 in chips)
Seat 6: 23960419 ($10.83 in chips)
2de77172: posts small blind $0.05
61c00c39: posts big blind $0.1
*** HOLE CARDS ***
Dealt to 99c6207c 
Dealt to 2de77172 
Dealt to 61c00c39 
Dealt to d3a652d6 
Dealt to Hero [Qs 7c]
Dealt to 23960419 
d3a652d6: folds
Hero: folds
23960419: folds
99c6207c: folds
2de77172: folds
Uncalled bet ($0.05) returned to 61c00c39
*** SHOWDOWN ***
61c00c39 collected $0.1 from pot
*** SUMMARY ***
Total pot $0.1 | Rake $0 | Jackpot $0 | Bingo $0 | Fortune $0
Seat 1: 99c6207c (button) folded before Flop (didn't bet)
Seat 2: 2de77172 (small blind) folded before Flop
Seat 3: 61c00c39 (big blind) collected ($0.1)
Seat 4: d3a652d6 folded before Flop (didn't bet)
Seat 5: Hero folded before Flop (didn't bet)
Seat 6: 23960419 folded before Flop (didn't bet)


Poker Hand #RC1433365797: Hold'em No Limit  ($0.05/$0.1) - 2023/03/27 19:22:12
Table 'RushAndCash28171057' 6-max Seat #1 is the button
Seat 1: f5dec364 ($10 in chips)
Seat 2: Hero ($25.33 in chips)
Seat 3: 56367aed ($13.54 in chips)
Seat 4: 55f9a3e1 ($13.94 in chips)
Seat 5: 8077ec64 ($15.71 in chips)
Seat 6: 7720e09f ($14.03 in chips)
Hero: posts small blind $0.05
56367aed: posts big blind $0.1
*** HOLE CARDS ***
Dealt to f5dec364 
Dealt to Hero [6d 3s]
Dealt to 56367aed 
Dealt to 55f9a3e1 
Dealt to 8077ec64 
Dealt to 7720e09f 
55f9a3e1: folds
8077ec64: folds
7720e09f: raises $0.15 to $0.25
f5dec364: raises $0.75 to $1
Hero: folds
56367aed: folds
7720e09f: calls $0.75
*** FLOP *** [Qh 8d Qc]
7720e09f: checks
f5dec364: checks
*** TURN *** [Qh 8d Qc] [Qs]
7720e09f: checks
f5dec364: bets $1.62
7720e09f: raises $4.05 to $5.67
f5dec364: folds
Uncalled bet ($4.05) returned to 7720e09f
*** SHOWDOWN ***
7720e09f collected $4.98 from pot
*** SUMMARY ***
Total pot $5.39 | Rake $0.26 | Jackpot $0.15 | Bingo $0 | Fortune $0
Board [Qh 8d Qc Qs]
Seat 1: f5dec364 (button) folded on the Turn
Seat 2: Hero (small blind) folded before Flop
Seat 3: 56367aed (big blind) folded before Flop
Seat 4: 55f9a3e1 folded before Flop (didn't bet)
Seat 5: 8077ec64 folded before Flop (didn't bet)
Seat 6: 7720e09f won ($4.98)


Poker Hand #RC1433365626: Hold'em No Limit  ($0.05/$0.1) - 2023/03/27 19:21:47
Table 'RushAndCash28170886' 6-max Seat #1 is the button
Seat 1: d9914d5c ($15.68 in chips)
Seat 2: 515bbef4 ($17.73 in chips)
Seat 3: Hero ($25.43 in chips)
Seat 4: 41556f33 ($9.38 in chips)
Seat 5: 35d0c3dd ($11.79 in chips)
Seat 6: b97fed08 ($11.07 in chips)
515bbef4: posts small blind $0.05
Hero: posts big blind $0.1
*** HOLE CARDS ***
Dealt to d9914d5c 
Dealt to 515bbef4 
Dealt to Hero [2c 5h]
Dealt to 41556f33 
Dealt to 35d0c3dd 
Dealt to b97fed08 
41556f33: raises $0.15 to $0.25
35d0c3dd: folds
b97fed08: folds
d9914d5c: folds
515bbef4: folds
Hero: folds
Uncalled bet ($0.15) returned to 41556f33
*** SHOWDOWN ***
41556f33 collected $0.25 from pot
*** SUMMARY ***
Total pot $0.25 | Rake $0 | Jackpot $0 | Bingo $0 | Fortune $0
Seat 1: d9914d5c (button) folded before Flop (didn't bet)
Seat 2: 515bbef4 (small blind) folded before Flop
Seat 3: Hero (big blind) folded before Flop
Seat 4: 41556f33 collected ($0.25)
Seat 5: 35d0c3dd folded before Flop (didn't bet)
Seat 6: b97fed08 folded before Flop (didn't bet)


Poker Hand #RC1433365554: Hold'em No Limit  ($0.05/$0.1) - 2023/03/27 19:21:37
Table 'RushAndCash28170814' 6-max Seat #1 is the button
Seat 1: 2d6bbc78 ($3.21 in chips)
Seat 2: 811aa83 ($20.8 in chips)
Seat 3: 193ce148 ($6.86 in chips)
Seat 4: Hero ($25.43 in chips)
Seat 5: 73c6e90a ($5.08 in chips)
Seat 6: a3ad4d53 ($23.66 in chips)
811aa83: posts small blind $0.05
193ce148: posts big blind $0.1
*** HOLE CARDS ***
Dealt to 2d6bbc78 
Dealt to 811aa83 
Dealt to 193ce148 
Dealt to Hero [Ad 5c]
Dealt to 73c6e90a 
Dealt to a3ad4d53 
Hero: folds
73c6e90a: folds
a3ad4d53: raises $0.13 to $0.23
2d6bbc78: folds
811aa83: folds
193ce148: calls $0.13
*** FLOP *** [3h As 9c]
193ce148: checks
a3ad4d53: bets $0.17
193ce148: calls $0.17
*** TURN *** [3h As 9c] [7s]
193ce148: checks
a3ad4d53: checks
*** RIVER *** [3h As 9c 7s] [4s]
193ce148: checks
a3ad4d53: checks
193ce148: shows [8s 8d] (Pair of Eights)
a3ad4d53: shows [Kc Qd] (Ace-High)
*** SHOWDOWN ***
193ce148 collected $0.81 from pot
*** SUMMARY ***
Total pot $0.85 | Rake $0.04 | Jackpot $0 | Bingo $0 | Fortune $0
Board [3h As 9c 7s 4s]
Seat 1: 2d6bbc78 (button) folded before Flop (didn't bet)
Seat 2: 811aa83 (small blind) folded before Flop
Seat 3: 193ce148 (big blind) showed [8s 8d] and won ($0.81) with Pair of Eights
Seat 4: Hero folded before Flop (didn't bet)
Seat 5: 73c6e90a folded before Flop (didn't bet)
Seat 6: a3ad4d53 showed [Kc Qd] and lost with Ace-High


Poker Hand #RC1433365495: Hold'em No Limit  ($0.05/$0.1) - 2023/03/27 19:21:28
Table 'RushAndCash28170755' 6-max Seat #1 is the button
Seat 1: 2358adf ($125.36 in chips)
Seat 2: 6bde3a02 ($13.27 in chips)
Seat 3: 1240de30 ($20.15 in chips)
Seat 4: 543bc9d6 ($36.28 in chips)
Seat 5: c2c593b0 ($10.74 in chips)
Seat 6: Hero ($25.43 in chips)
6bde3a02: posts small blind $0.05
1240de30: posts big blind $0.1
*** HOLE CARDS ***
Dealt to 2358adf 
Dealt to 6bde3a02 
Dealt to 1240de30 
Dealt to 543bc9d6 
Dealt to c2c593b0 
Dealt to Hero [4s Kc]
543bc9d6: folds
c2c593b0: raises $0.1 to $0.2
Hero: folds
2358adf: calls $0.2
6bde3a02: raises $1.02 to $1.22
1240de30: folds
c2c593b0: folds
2358adf: calls $1.02
*** FLOP *** [9c 8c Td]
6bde3a02: bets $1.67
2358adf: folds
Uncalled bet ($1.67) returned to 6bde3a02
*** SHOWDOWN ***
6bde3a02 collected $2.61 from pot
*** SUMMARY ***
Total pot $2.74 | Rake $0.13 | Jackpot $0 | Bingo $0 | Fortune $0
Board [9c 8c Td]
Seat 1: 2358adf (button) folded on the Flop
Seat 2: 6bde3a02 (small blind) won ($2.61)
Seat 3: 1240de30 (big blind) folded before Flop
Seat 4: 543bc9d6 folded before Flop (didn't bet)
Seat 5: c2c593b0 folded before Flop
Seat 6: Hero folded before Flop (didn't bet)


Poker Hand #RC1433365464: Hold'em No Limit  ($0.05/$0.1) - 2023/03/27 19:21:23
Table 'RushAndCash28170724' 6-max Seat #1 is the button
Seat 1: ec3bebf3 ($21.94 in chips)
Seat 2: b6ccf254 ($48.02 in chips)
Seat 3: 42dea2bf ($28.81 in chips)
Seat 4: Hero ($25.43 in chips)
Seat 5: fa857df7 ($10.38 in chips)
Seat 6: dd35185f ($13.59 in chips)
b6ccf254: posts small blind $0.05
42dea2bf: posts big blind $0.1
*** HOLE CARDS ***
Dealt to ec3bebf3 
Dealt to b6ccf254 
Dealt to 42dea2bf 
Dealt to Hero [2d 8c]
Dealt to fa857df7 
Dealt to dd35185f 
Hero: folds
fa857df7: raises $0.1 to $0.2
dd35185f: folds
ec3bebf3: folds
b6ccf254: folds
42dea2bf: folds
Uncalled bet ($0.1) returned to fa857df7
*** SHOWDOWN ***
fa857df7 collected $0.25 from pot
*** SUMMARY ***
Total pot $0.25 | Rake $0 | Jackpot $0 | Bingo $0 | Fortune $0
Seat 1: ec3bebf3 (button) folded before Flop (didn't bet)
Seat 2: b6ccf254 (small blind) folded before Flop
Seat 3: 42dea2bf (big blind) folded before Flop
Seat 4: Hero folded before Flop (didn't bet)
Seat 5: fa857df7 collected ($0.25)
Seat 6: dd35185f folded before Flop (didn't bet)


Poker Hand #RC1433365415: Hold'em No Limit  ($0.05/$0.1) - 2023/03/27 19:21:15
Table 'RushAndCash28170675' 6-max Seat #1 is the button
Seat 1: Hero ($25.43 in chips)
Seat 2: bb4dcf9b ($21.86 in chips)
Seat 3: 8f234b15 ($13.77 in chips)
Seat 4: e7f48829 ($10.32 in chips)
Seat 5: c365dd54 ($17.2 in chips)
Seat 6: 859207b8 ($17.31 in chips)
bb4dcf9b: posts small blind $0.05
8f234b15: posts big blind $0.1
*** HOLE CARDS ***
Dealt to Hero [Qd 8h]
Dealt to bb4dcf9b 
Dealt to 8f234b15 
Dealt to e7f48829 
Dealt to c365dd54 
Dealt to 859207b8 
e7f48829: folds
c365dd54: folds
859207b8: raises $0.15 to $0.25
Hero: folds
bb4dcf9b: folds
8f234b15: raises $0.89 to $1.14
859207b8: folds
Uncalled bet ($0.89) returned to 8f234b15
*** SHOWDOWN ***
8f234b15 collected $0.53 from pot
*** SUMMARY ***
Total pot $0.55 | Rake $0.02 | Jackpot $0 | Bingo $0 | Fortune $0
Seat 1: Hero (button) folded before Flop (didn't bet)
Seat 2: bb4dcf9b (small blind) folded before Flop
Seat 3: 8f234b15 (big blind) collected ($0.53)
Seat 4: e7f48829 folded before Flop (didn't bet)
Seat 5: c365dd54 folded before Flop (didn't bet)
Seat 6: 859207b8 folded before Flop


Poker Hand #RC1433365335: Hold'em No Limit  ($0.05/$0.1) - 2023/03/27 19:21:03
Table 'RushAndCash28170595' 6-max Seat #1 is the button
Seat 1: 7450df2 ($17.93 in chips)
Seat 2: 896b5d16 ($10.24 in chips)
Seat 3: Hero ($25.53 in chips)
Seat 4: b959dd5b ($12.84 in chips)
Seat 5: 5e8a857b ($7.53 in chips)
Seat 6: 4ba966ea ($11.8 in chips)
896b5d16: posts small blind $0.05
Hero: posts big blind $0.1
*** HOLE CARDS ***
Dealt to 7450df2 
Dealt to 896b5d16 
Dealt to Hero [2d 9h]
Dealt to b959dd5b 
Dealt to 5e8a857b 
Dealt to 4ba966ea 
b959dd5b: raises $0.1 to $0.2
5e8a857b: folds
4ba966ea: calls $0.2
7450df2: folds
896b5d16: folds
Hero: folds
*** FLOP *** [Ad 2s Qs]
b959dd5b: bets $0.2
4ba966ea: calls $0.2
*** TURN *** [Ad 2s Qs] [8d]
b959dd5b: checks
4ba966ea: bets $0.75
b959dd5b: calls $0.75
*** RIVER *** [Ad 2s Qs 8d] [7s]
b959dd5b: checks
4ba966ea: checks
b959dd5b: shows [As Kc] (Pair of Aces)
4ba966ea: shows [5d 5h] (Pair of Fives)
*** SHOWDOWN ***
b959dd5b collected $2.33 from pot
*** SUMMARY ***
Total pot $2.45 | Rake $0.12 | Jackpot $0 | Bingo $0 | Fortune $0
Board [Ad 2s Qs 8d 7s]
Seat 1: 7450df2 (button) folded before Flop (didn't bet)
Seat 2: 896b5d16 (small blind) folded before Flop
Seat 3: Hero (big blind) folded before Flop
Seat 4: b959dd5b showed [As Kc] and won ($2.33) with Pair of Aces
Seat 5: 5e8a857b folded before Flop (didn't bet)
Seat 6: 4ba966ea showed [5d 5h] and lost with Pair of Fives


Poker Hand #RC1433365194: Hold'em No Limit  ($0.05/$0.1) - 2023/03/27 19:20:42
Table 'RushAndCash28170454' 6-max Seat #1 is the button
Seat 1: 309f93e ($10 in chips)
Seat 2: Hero ($25.58 in chips)
Seat 3: 8b6fbfd9 ($10 in chips)
Seat 4: c522d2b5 ($10.72 in chips)
Seat 5: a38464e2 ($10 in chips)
Seat 6: b95c5a94 ($11.79 in chips)
Hero: posts small blind $0.05
8b6fbfd9: posts big blind $0.1
*** HOLE CARDS ***
Dealt to 309f93e 
Dealt to Hero [Ks 8s]
Dealt to 8b6fbfd9 
Dealt to c522d2b5 
Dealt to a38464e2 
Dealt to b95c5a94 
c522d2b5: folds
a38464e2: folds
b95c5a94: raises $0.15 to $0.25
309f93e: folds
Hero: folds
8b6fbfd9: folds
Uncalled bet ($0.15) returned to b95c5a94
*** SHOWDOWN ***
b95c5a94 collected $0.25 from pot
*** SUMMARY ***
Total pot $0.25 | Rake $0 | Jackpot $0 | Bingo $0 | Fortune $0
Seat 1: 309f93e (button) folded before Flop (didn't bet)
Seat 2: Hero (small blind) folded before Flop
Seat 3: 8b6fbfd9 (big blind) folded before Flop
Seat 4: c522d2b5 folded before Flop (didn't bet)
Seat 5: a38464e2 folded before Flop (didn't bet)
Seat 6: b95c5a94 collected ($0.25)


Poker Hand #RC1433365164: Hold'em No Limit  ($0.05/$0.1) - 2023/03/27 19:20:38
Table 'RushAndCash28170424' 6-max Seat #1 is the button
Seat 1: d1ce090 ($31.71 in chips)
Seat 2: 74cf41d6 ($3.27 in chips)
Seat 3: 8bb57da ($4.32 in chips)
Seat 4: Hero ($25.58 in chips)
Seat 5: 42dea2bf ($28.81 in chips)
Seat 6: acd99267 ($10.54 in chips)
74cf41d6: posts small blind $0.05
8bb57da: posts big blind $0.1
*** HOLE CARDS ***
Dealt to d1ce090 
Dealt to 74cf41d6 
Dealt to 8bb57da 
Dealt to Hero [8h 4h]
Dealt to 42dea2bf 
Dealt to acd99267 
Hero: folds
42dea2bf: folds
acd99267: folds
d1ce090: folds
74cf41d6: raises $0.1 to $0.2
8bb57da: folds
Uncalled bet ($0.1) returned to 74cf41d6
*** SHOWDOWN ***
74cf41d6 collected $0.2 from pot
*** SUMMARY ***
Total pot $0.2 | Rake $0 | Jackpot $0 | Bingo $0 | Fortune $0
Seat 1: d1ce090 (button) folded before Flop (didn't bet)
Seat 2: 74cf41d6 (small blind) collected ($0.2)
Seat 3: 8bb57da (big blind) folded before Flop
Seat 4: Hero folded before Flop (didn't bet)
Seat 5: 42dea2bf folded before Flop (didn't bet)
Seat 6: acd99267 folded before Flop (didn't bet)


Poker Hand #RC1433365040: Hold'em No Limit  ($0.05/$0.1) - 2023/03/27 19:20:17
Table 'RushAndCash28170300' 6-max Seat #1 is the button
Seat 1: Hero ($25.83 in chips)
Seat 2: 8bb57da ($4 in chips)
Seat 3: 896b5d16 ($10.69 in chips)
Seat 4: 2a8ab56b ($16.07 in chips)
Seat 5: f6184b9c ($9.67 in chips)
Seat 6: 6cd792de ($10.48 in chips)
8bb57da: posts small blind $0.05
896b5d16: posts big blind $0.1
*** HOLE CARDS ***
Dealt to Hero [Ac 2s]
Dealt to 8bb57da 
Dealt to 896b5d16 
Dealt to 2a8ab56b 
Dealt to f6184b9c 
Dealt to 6cd792de 
2a8ab56b: folds
f6184b9c: folds
6cd792de: folds
Hero: raises $0.15 to $0.25
8bb57da: raises $0.65 to $0.9
896b5d16: folds
Hero: folds
Uncalled bet ($0.65) returned to 8bb57da
*** SHOWDOWN ***
8bb57da collected $0.57 from pot
*** SUMMARY ***
Total pot $0.6 | Rake $0.03 | Jackpot $0 | Bingo $0 | Fortune $0
Seat 1: Hero (button) folded before Flop
Seat 2: 8bb57da (small blind) collected ($0.57)
Seat 3: 896b5d16 (big blind) folded before Flop
Seat 4: 2a8ab56b folded before Flop (didn't bet)
Seat 5: f6184b9c folded before Flop (didn't bet)
Seat 6: 6cd792de folded before Flop (didn't bet)


Poker Hand #RC1433365015: Hold'em No Limit  ($0.05/$0.1) - 2023/03/27 19:20:13
Table 'RushAndCash28170275' 6-max Seat #1 is the button
Seat 1: 148b1cdb ($10.15 in chips)
Seat 2: 2ade479b ($17.03 in chips)
Seat 3: c522d2b5 ($10.72 in chips)
Seat 4: Hero ($25.83 in chips)
Seat 5: 2539aa37 ($7.36 in chips)
Seat 6: f2b3077d ($9.8 in chips)
2ade479b: posts small blind $0.05
c522d2b5: posts big blind $0.1
*** HOLE CARDS ***
Dealt to 148b1cdb 
Dealt to 2ade479b 
Dealt to c522d2b5 
Dealt to Hero [9c 7d]
Dealt to 2539aa37 
Dealt to f2b3077d 
Hero: folds
2539aa37: folds
f2b3077d: folds
148b1cdb: folds
2ade479b: folds
Uncalled bet ($0.05) returned to c522d2b5
*** SHOWDOWN ***
c522d2b5 collected $0.1 from pot
*** SUMMARY ***
Total pot $0.1 | Rake $0 | Jackpot $0 | Bingo $0 | Fortune $0
Seat 1: 148b1cdb (button) folded before Flop (didn't bet)
Seat 2: 2ade479b (small blind) folded before Flop
Seat 3: c522d2b5 (big blind) collected ($0.1)
Seat 4: Hero folded before Flop (didn't bet)
Seat 5: 2539aa37 folded before Flop (didn't bet)
Seat 6: f2b3077d folded before Flop (didn't bet)


Poker Hand #RC1433364988: Hold'em No Limit  ($0.05/$0.1) - 2023/03/27 19:20:09
Table 'RushAndCash28170248' 6-max Seat #1 is the button
Seat 1: Hero ($25.83 in chips)
Seat 2: 32df2317 ($10 in chips)
Seat 3: c3bde2ae ($37.41 in chips)
Seat 4: 3e2ce794 ($13.22 in chips)
Seat 5: f2b3077d ($9.8 in chips)
Seat 6: cd986535 ($11.51 in chips)
32df2317: posts small blind $0.05
c3bde2ae: posts big blind $0.1
*** HOLE CARDS ***
Dealt to Hero [8h 3h]
Dealt to 32df2317 
Dealt to c3bde2ae 
Dealt to 3e2ce794 
Dealt to f2b3077d 
Dealt to cd986535 
3e2ce794: folds
f2b3077d: folds
cd986535: raises $0.15 to $0.25
Hero: folds
32df2317: folds
c3bde2ae: calls $0.15
*** FLOP *** [5d 9c 4h]
c3bde2ae: checks
cd986535: checks
*** TURN *** [5d 9c 4h] [Ts]
c3bde2ae: bets $0.31
cd986535: calls $0.31
*** RIVER *** [5d 9c 4h Ts] [8d]
c3bde2ae: checks
cd986535: checks
c3bde2ae: shows [2d 2s] (Pair of Twos)
cd986535: shows [9d Qd] (Pair of Nines)
*** SHOWDOWN ***
cd986535 collected $1.12 from pot
*** SUMMARY ***
Total pot $1.17 | Rake $0.05 | Jackpot $0 | Bingo $0 | Fortune $0
Board [5d 9c 4h Ts 8d]
Seat 1: Hero (button) folded before Flop (didn't bet)
Seat 2: 32df2317 (small blind) folded before Flop
Seat 3: c3bde2ae (big blind) showed [2d 2s] and lost with Pair of Twos
Seat 4: 3e2ce794 folded before Flop (didn't bet)
Seat 5: f2b3077d folded before Flop (didn't bet)
Seat 6: cd986535 showed [9d Qd] and won ($1.12) with Pair of Nines


Poker Hand #RC1433364960: Hold'em No Limit  ($0.05/$0.1) - 2023/03/27 19:20:05
Table 'RushAndCash28170220' 6-max Seat #1 is the button
Seat 1: 3253ee1d ($11.92 in chips)
Seat 2: 859207b8 ($19.91 in chips)
Seat 3: f9e611b4 ($10.94 in chips)
Seat 4: 831b99c5 ($13.77 in chips)
Seat 5: Hero ($25.83 in chips)
Seat 6: f6184b9c ($9.67 in chips)
859207b8: posts small blind $0.05
f9e611b4: posts big blind $0.1
*** HOLE CARDS ***
Dealt to 3253ee1d 
Dealt to 859207b8 
Dealt to f9e611b4 
Dealt to 831b99c5 
Dealt to Hero [Kc 4c]
Dealt to f6184b9c 
831b99c5: folds
Hero: folds
f6184b9c: folds
3253ee1d: folds
859207b8: folds
Uncalled bet ($0.05) returned to f9e611b4
*** SHOWDOWN ***
f9e611b4 collected $0.1 from pot
*** SUMMARY ***
Total pot $0.1 | Rake $0 | Jackpot $0 | Bingo $0 | Fortune $0
Seat 1: 3253ee1d (button) folded before Flop (didn't bet)
Seat 2: 859207b8 (small blind) folded before Flop
Seat 3: f9e611b4 (big blind) collected ($0.1)
Seat 4: 831b99c5 folded before Flop (didn't bet)
Seat 5: Hero folded before Flop (didn't bet)
Seat 6: f6184b9c folded before Flop (didn't bet)


Poker Hand #RC1433364929: Hold'em No Limit  ($0.05/$0.1) - 2023/03/27 19:20:01
Table 'RushAndCash28170189' 6-max Seat #1 is the button
Seat 1: 43194f47 ($29.57 in chips)
Seat 2: a76b3c83 ($10 in chips)
Seat 3: Hero ($25.93 in chips)
Seat 4: f3716d4a ($10.94 in chips)
Seat 5: 35d68bcb ($7.43 in chips)
Seat 6: 5bca8a1c ($10.15 in chips)
a76b3c83: posts small blind $0.05
Hero: posts big blind $0.1
*** HOLE CARDS ***
Dealt to 43194f47 
Dealt to a76b3c83 
Dealt to Hero [3s 8h]
Dealt to f3716d4a 
Dealt to 35d68bcb 
Dealt to 5bca8a1c 
f3716d4a: folds
35d68bcb: folds
5bca8a1c: raises $0.12 to $0.22
43194f47: folds
a76b3c83: raises $0.66 to $0.88
Hero: folds
5bca8a1c: calls $0.66
*** FLOP *** [5d Kc 4s]
a76b3c83: checks
5bca8a1c: checks
*** TURN *** [5d Kc 4s] [Qc]
a76b3c83: checks
5bca8a1c: checks
*** RIVER *** [5d Kc 4s Qc] [Qs]
a76b3c83: bets $1.4
5bca8a1c: calls $1.4
a76b3c83: shows [Qd Jd] (Three Queens)
5bca8a1c: shows [Js Jh] (Pair of Queens and Pair of Jacks)
*** SHOWDOWN ***
a76b3c83 collected $4.29 from pot
*** SUMMARY ***
Total pot $4.66 | Rake $0.22 | Jackpot $0.15 | Bingo $0 | Fortune $0
Board [5d Kc 4s Qc Qs]
Seat 1: 43194f47 (button) folded before Flop (didn't bet)
Seat 2: a76b3c83 (small blind) showed [Qd Jd] and won ($4.29) with Three Queens
Seat 3: Hero (big blind) folded before Flop
Seat 4: f3716d4a folded before Flop (didn't bet)
Seat 5: 35d68bcb folded before Flop (didn't bet)
Seat 6: 5bca8a1c showed [Js Jh] and lost with Pair of Queens and Pair of Jacks


Poker Hand #RC1433314701: Hold'em No Limit  ($0.05/$0.1) - 2023/03/27 19:19:27
Table 'RushAndCash28169961' 6-max Seat #1 is the button
Seat 1: ba9f55a3 ($20 in chips)
Seat 2: ab5abfa7 ($20.17 in chips)
Seat 3: e790e4ec ($10 in chips)
Seat 4: 4271d829 ($14.57 in chips)
Seat 5: 5e859c99 ($11.04 in chips)
Seat 6: Hero ($26.18 in chips)
ab5abfa7: posts small blind $0.05
e790e4ec: posts big blind $0.1
*** HOLE CARDS ***
Dealt to ba9f55a3 
Dealt to ab5abfa7 
Dealt to e790e4ec 
Dealt to 4271d829 
Dealt to 5e859c99 
Dealt to Hero [Ah 5c]
4271d829: folds
5e859c99: folds
Hero: raises $0.15 to $0.25
ba9f55a3: calls $0.25
ab5abfa7: folds
e790e4ec: folds
*** FLOP *** [Kh 8c Ts]
Hero: checks
ba9f55a3: bets $0.2
Hero: folds
Uncalled bet ($0.2) returned to ba9f55a3
*** SHOWDOWN ***
ba9f55a3 collected $0.62 from pot
*** SUMMARY ***
Total pot $0.65 | Rake $0.03 | Jackpot $0 | Bingo $0 | Fortune $0
Board [Kh 8c Ts]
Seat 1: ba9f55a3 (button) won ($0.62)
Seat 2: ab5abfa7 (small blind) folded before Flop
Seat 3: e790e4ec (big blind) folded before Flop
Seat 4: 4271d829 folded before Flop (didn't bet)
Seat 5: 5e859c99 folded before Flop (didn't bet)
Seat 6: Hero folded on the Flop


Poker Hand #RC1433314674: Hold'em No Limit  ($0.05/$0.1) - 2023/03/27 19:19:23
Table 'RushAndCash28169934' 6-max Seat #1 is the button
Seat 1: Hero ($26.18 in chips)
Seat 2: b8381bc1 ($12.4 in chips)
Seat 3: 880f1c43 ($10.22 in chips)
Seat 4: 72a16786 ($10 in chips)
Seat 5: e51a3115 ($29.63 in chips)
Seat 6: af5417fd ($18.25 in chips)
b8381bc1: posts small blind $0.05
880f1c43: posts big blind $0.1
*** HOLE CARDS ***
Dealt to Hero [6d Kh]
Dealt to b8381bc1 
Dealt to 880f1c43 
Dealt to 72a16786 
Dealt to e51a3115 
Dealt to af5417fd 
72a16786: folds
e51a3115: folds
af5417fd: folds
Hero: folds
b8381bc1: folds
Uncalled bet ($0.05) returned to 880f1c43
*** SHOWDOWN ***
880f1c43 collected $0.1 from pot
*** SUMMARY ***
Total pot $0.1 | Rake $0 | Jackpot $0 | Bingo $0 | Fortune $0
Seat 1: Hero (button) folded before Flop (didn't bet)
Seat 2: b8381bc1 (small blind) folded before Flop
Seat 3: 880f1c43 (big blind) collected ($0.1)
Seat 4: 72a16786 folded before Flop (didn't bet)
Seat 5: e51a3115 folded before Flop (didn't bet)
Seat 6: af5417fd folded before Flop (didn't bet)


Poker Hand #RC1433314594: Hold'em No Limit  ($0.05/$0.1) - 2023/03/27 19:19:10
Table 'RushAndCash28169854' 6-max Seat #1 is the button
Seat 1: 9bc2c2b3 ($10.42 in chips)
Seat 2: 6640ee20 ($12.71 in chips)
Seat 3: Hero ($26.28 in chips)
Seat 4: bf55dfd8 ($10.21 in chips)
Seat 5: 5174df53 ($39.47 in chips)
Seat 6: 2ccdba8a ($10.13 in chips)
6640ee20: posts small blind $0.05
Hero: posts big blind $0.1
*** HOLE CARDS ***
Dealt to 9bc2c2b3 
Dealt to 6640ee20 
Dealt to Hero [4d 2d]
Dealt to bf55dfd8 
Dealt to 5174df53 
Dealt to 2ccdba8a 
bf55dfd8: raises $0.15 to $0.25
5174df53: folds
2ccdba8a: folds
9bc2c2b3: folds
6640ee20: folds
Hero: folds
Uncalled bet ($0.15) returned to bf55dfd8
*** SHOWDOWN ***
bf55dfd8 collected $0.25 from pot
*** SUMMARY ***
Total pot $0.25 | Rake $0 | Jackpot $0 | Bingo $0 | Fortune $0
Seat 1: 9bc2c2b3 (button) folded before Flop (didn't bet)
Seat 2: 6640ee20 (small blind) folded before Flop
Seat 3: Hero (big blind) folded before Flop
Seat 4: bf55dfd8 collected ($0.25)
Seat 5: 5174df53 folded before Flop (didn't bet)
Seat 6: 2ccdba8a folded before Flop (didn't bet)


Poker Hand #RC1433314563: Hold'em No Limit  ($0.05/$0.1) - 2023/03/27 19:19:06
Table 'RushAndCash28169823' 6-max Seat #1 is the button
Seat 1: 915aa7af ($36.58 in chips)
Seat 2: Hero ($26.33 in chips)
Seat 3: 22fe9377 ($17.92 in chips)
Seat 4: a042ec1a ($10.22 in chips)
Seat 5: df4415f ($14.79 in chips)
Seat 6: 2ca6cfad ($1.84 in chips)
Hero: posts small blind $0.05
22fe9377: posts big blind $0.1
*** HOLE CARDS ***
Dealt to 915aa7af 
Dealt to Hero [2s 9c]
Dealt to 22fe9377 
Dealt to a042ec1a 
Dealt to df4415f 
Dealt to 2ca6cfad 
a042ec1a: folds
df4415f: folds
2ca6cfad: raises $1.74 to $1.84 and is all-in
915aa7af: folds
Hero: folds
22fe9377: folds
Uncalled bet ($1.74) returned to 2ca6cfad
*** SHOWDOWN ***
2ca6cfad collected $0.25 from pot
*** SUMMARY ***
Total pot $0.25 | Rake $0 | Jackpot $0 | Bingo $0 | Fortune $0
Seat 1: 915aa7af (button) folded before Flop (didn't bet)
Seat 2: Hero (small blind) folded before Flop
Seat 3: 22fe9377 (big blind) folded before Flop
Seat 4: a042ec1a folded before Flop (didn't bet)
Seat 5: df4415f folded before Flop (didn't bet)
Seat 6: 2ca6cfad collected ($0.25)


Poker Hand #RC1433314437: Hold'em No Limit  ($0.05/$0.1) - 2023/03/27 19:18:49
Table 'RushAndCash28169697' 6-max Seat #1 is the button
Seat 1: b2a92f29 ($10 in chips)
Seat 2: 8ee12122 ($11.91 in chips)
Seat 3: fe8bd5ad ($11.99 in chips)
Seat 4: 74cf41d6 ($3.45 in chips)
Seat 5: 36392a82 ($24.14 in chips)
Seat 6: Hero ($26.18 in chips)
8ee12122: posts small blind $0.05
fe8bd5ad: posts big blind $0.1
*** HOLE CARDS ***
Dealt to b2a92f29 
Dealt to 8ee12122 
Dealt to fe8bd5ad 
Dealt to 74cf41d6 
Dealt to 36392a82 
Dealt to Hero [Jc 9c]
74cf41d6: folds
36392a82: folds
Hero: raises $0.15 to $0.25
b2a92f29: folds
8ee12122: folds
fe8bd5ad: folds
Uncalled bet ($0.15) returned to Hero
*** SHOWDOWN ***
Hero collected $0.25 from pot
*** SUMMARY ***
Total pot $0.25 | Rake $0 | Jackpot $0 | Bingo $0 | Fortune $0
Seat 1: b2a92f29 (button) folded before Flop (didn't bet)
Seat 2: 8ee12122 (small blind) folded before Flop
Seat 3: fe8bd5ad (big blind) folded before Flop
Seat 4: 74cf41d6 folded before Flop (didn't bet)
Seat 5: 36392a82 folded before Flop (didn't bet)
Seat 6: Hero collected ($0.25)


Poker Hand #RC1433314408: Hold'em No Limit  ($0.05/$0.1) - 2023/03/27 19:18:44
Table 'RushAndCash28169668' 6-max Seat #1 is the button
Seat 1: d6492727 ($10.81 in chips)
Seat 2: ca1d00e3 ($16.66 in chips)
Seat 3: fd693c3 ($10.5 in chips)
Seat 4: Hero ($26.18 in chips)
Seat 5: 5bc01431 ($18.09 in chips)
Seat 6: 9b3cdb65 ($36.94 in chips)
ca1d00e3: posts small blind $0.05
fd693c3: posts big blind $0.1
*** HOLE CARDS ***
Dealt to d6492727 
Dealt to ca1d00e3 
Dealt to fd693c3 
Dealt to Hero [2h 3h]
Dealt to 5bc01431 
Dealt to 9b3cdb65 
Hero: folds
5bc01431: folds
9b3cdb65: raises $0.15 to $0.25
d6492727: folds
ca1d00e3: folds
fd693c3: folds
Uncalled bet ($0.15) returned to 9b3cdb65
*** SHOWDOWN ***
9b3cdb65 collected $0.25 from pot
*** SUMMARY ***
Total pot $0.25 | Rake $0 | Jackpot $0 | Bingo $0 | Fortune $0
Seat 1: d6492727 (button) folded before Flop (didn't bet)
Seat 2: ca1d00e3 (small blind) folded before Flop
Seat 3: fd693c3 (big blind) folded before Flop
Seat 4: Hero folded before Flop (didn't bet)
Seat 5: 5bc01431 folded before Flop (didn't bet)
Seat 6: 9b3cdb65 collected ($0.25)


Poker Hand #RC1433314371: Hold'em No Limit  ($0.05/$0.1) - 2023/03/27 19:18:39
Table 'RushAndCash28169631' 6-max Seat #1 is the button
Seat 1: 9ba6ae76 ($18.4 in chips)
Seat 2: b3645cfc ($18.86 in chips)
Seat 3: 11064df9 ($14.87 in chips)
Seat 4: Hero ($26.18 in chips)
Seat 5: fca90731 ($10.15 in chips)
Seat 6: 8fc4f338 ($4.46 in chips)
b3645cfc: posts small blind $0.05
11064df9: posts big blind $0.1
*** HOLE CARDS ***
Dealt to 9ba6ae76 
Dealt to b3645cfc 
Dealt to 11064df9 
Dealt to Hero [Kc Ts]
Dealt to fca90731 
Dealt to 8fc4f338 
Hero: folds
fca90731: raises $0.15 to $0.25
8fc4f338: calls $0.25
9ba6ae76: folds
b3645cfc: folds
11064df9: folds
*** FLOP *** [9d Tc 4h]
fca90731: checks
8fc4f338: checks
*** TURN *** [9d Tc 4h] [8h]
fca90731: bets $0.35
8fc4f338: calls $0.35
*** RIVER *** [9d Tc 4h 8h] [Ac]
fca90731: bets $0.7
8fc4f338: raises $3.16 to $3.86 and is all-in
fca90731: calls $3.16
8fc4f338: shows [Ah Th] (Pair of Aces and Pair of Tens)
fca90731: shows [Qc As] (Pair of Aces)
*** SHOWDOWN ***
8fc4f338 collected $8.62 from pot
*** SUMMARY ***
Total pot $9.07 | Rake $0.3 | Jackpot $0.15 | Bingo $0 | Fortune $0
Board [9d Tc 4h 8h Ac]
Seat 1: 9ba6ae76 (button) folded before Flop (didn't bet)
Seat 2: b3645cfc (small blind) folded before Flop
Seat 3: 11064df9 (big blind) folded before Flop
Seat 4: Hero folded before Flop (didn't bet)
Seat 5: fca90731 showed [Qc As] and lost with Pair of Aces
Seat 6: 8fc4f338 showed [Ah Th] and won ($8.62) with Pair of Aces and Pair of Tens


Poker Hand #RC1433314309: Hold'em No Limit  ($0.05/$0.1) - 2023/03/27 19:18:30
Table 'RushAndCash28169569' 6-max Seat #1 is the button
Seat 1: 71eb2274 ($13.92 in chips)
Seat 2: 6bba56c7 ($10.54 in chips)
Seat 3: 725f7e50 ($12.25 in chips)
Seat 4: Hero ($26.03 in chips)
Seat 5: 10620cac ($15.95 in chips)
Seat 6: 69539208 ($31.54 in chips)
6bba56c7: posts small blind $0.05
725f7e50: posts big blind $0.1
*** HOLE CARDS ***
Dealt to 71eb2274 
Dealt to 6bba56c7 
Dealt to 725f7e50 
Dealt to Hero [Kc Ah]
Dealt to 10620cac 
Dealt to 69539208 
Hero: raises $0.15 to $0.25
10620cac: folds
69539208: folds
71eb2274: folds
6bba56c7: folds
725f7e50: folds
Uncalled bet ($0.15) returned to Hero
*** SHOWDOWN ***
Hero collected $0.25 from pot
*** SUMMARY ***
Total pot $0.25 | Rake $0 | Jackpot $0 | Bingo $0 | Fortune $0
Seat 1: 71eb2274 (button) folded before Flop (didn't bet)
Seat 2: 6bba56c7 (small blind) folded before Flop
Seat 3: 725f7e50 (big blind) folded before Flop
Seat 4: Hero collected ($0.25)
Seat 5: 10620cac folded before Flop (didn't bet)
Seat 6: 69539208 folded before Flop (didn't bet)


Poker Hand #RC1433314285: Hold'em No Limit  ($0.05/$0.1) - 2023/03/27 19:18:26
Table 'RushAndCash28169545' 6-max Seat #1 is the button
Seat 1: dd35185f ($13.89 in chips)
Seat 2: Hero ($26.08 in chips)
Seat 3: 99847cea ($10.3 in chips)
Seat 4: 5f896732 ($13.24 in chips)
Seat 5: 880f1c43 ($10.12 in chips)
Seat 6: 6bde3a02 ($9.92 in chips)
Hero: posts small blind $0.05
99847cea: posts big blind $0.1
*** HOLE CARDS ***
Dealt to dd35185f 
Dealt to Hero [Qc 8s]
Dealt to 99847cea 
Dealt to 5f896732 
Dealt to 880f1c43 
Dealt to 6bde3a02 
5f896732: folds
880f1c43: folds
6bde3a02: folds
dd35185f: folds
Hero: folds
Uncalled bet ($0.05) returned to 99847cea
*** SHOWDOWN ***
99847cea collected $0.1 from pot
*** SUMMARY ***
Total pot $0.1 | Rake $0 | Jackpot $0 | Bingo $0 | Fortune $0
Seat 1: dd35185f (button) folded before Flop (didn't bet)
Seat 2: Hero (small blind) folded before Flop
Seat 3: 99847cea (big blind) collected ($0.1)
Seat 4: 5f896732 folded before Flop (didn't bet)
Seat 5: 880f1c43 folded before Flop (didn't bet)
Seat 6: 6bde3a02 folded before Flop (didn't bet)


Poker Hand #RC1433314241: Hold'em No Limit  ($0.05/$0.1) - 2023/03/27 19:18:20
Table 'RushAndCash28169501' 6-max Seat #1 is the button
Seat 1: c20fb006 ($24.54 in chips)
Seat 2: Hero ($26.13 in chips)
Seat 3: b5c2a326 ($8.26 in chips)
Seat 4: 463d2ce5 ($16.78 in chips)
Seat 5: 5a766e01 ($4.04 in chips)
Seat 6: e1d8f2ef ($10 in chips)
Hero: posts small blind $0.05
b5c2a326: posts big blind $0.1
*** HOLE CARDS ***
Dealt to c20fb006 
Dealt to Hero [3h Th]
Dealt to b5c2a326 
Dealt to 463d2ce5 
Dealt to 5a766e01 
Dealt to e1d8f2ef 
463d2ce5: raises $0.15 to $0.25
5a766e01: folds
e1d8f2ef: folds
c20fb006: folds
Hero: folds
b5c2a326: folds
Uncalled bet ($0.15) returned to 463d2ce5
*** SHOWDOWN ***
463d2ce5 collected $0.25 from pot
*** SUMMARY ***
Total pot $0.25 | Rake $0 | Jackpot $0 | Bingo $0 | Fortune $0
Seat 1: c20fb006 (button) folded before Flop (didn't bet)
Seat 2: Hero (small blind) folded before Flop
Seat 3: b5c2a326 (big blind) folded before Flop
Seat 4: 463d2ce5 collected ($0.25)
Seat 5: 5a766e01 folded before Flop (didn't bet)
Seat 6: e1d8f2ef folded before Flop (didn't bet)


Poker Hand #RC1433314175: Hold'em No Limit  ($0.05/$0.1) - 2023/03/27 19:18:10
Table 'RushAndCash28169435' 6-max Seat #1 is the button
Seat 1: e37c7354 ($16.22 in chips)
Seat 2: efa98784 ($10.91 in chips)
Seat 3: b4780f2d ($14.66 in chips)
Seat 4: 8030373d ($42.71 in chips)
Seat 5: 27d009 ($18.27 in chips)
Seat 6: Hero ($26.13 in chips)
efa98784: posts small blind $0.05
b4780f2d: posts big blind $0.1
*** HOLE CARDS ***
Dealt to e37c7354 
Dealt to efa98784 
Dealt to b4780f2d 
Dealt to 8030373d 
Dealt to 27d009 
Dealt to Hero [Tc Qd]
8030373d: folds
27d009: folds
Hero: folds
e37c7354: folds
efa98784: folds
Uncalled bet ($0.05) returned to b4780f2d
*** SHOWDOWN ***
b4780f2d collected $0.1 from pot
*** SUMMARY ***
Total pot $0.1 | Rake $0 | Jackpot $0 | Bingo $0 | Fortune $0
Seat 1: e37c7354 (button) folded before Flop (didn't bet)
Seat 2: efa98784 (small blind) folded before Flop
Seat 3: b4780f2d (big blind) collected ($0.1)
Seat 4: 8030373d folded before Flop (didn't bet)
Seat 5: 27d009 folded before Flop (didn't bet)
Seat 6: Hero folded before Flop (didn't bet)


Poker Hand #RC1433314003: Hold'em No Limit  ($0.05/$0.1) - 2023/03/27 19:17:47
Table 'RushAndCash28169263' 6-max Seat #1 is the button
Seat 1: 6a783cf0 ($4.16 in chips)
Seat 2: 50908537 ($34.05 in chips)
Seat 3: Hero ($26.23 in chips)
Seat 4: f0f5b924 ($10 in chips)
Seat 5: b4ee20c8 ($10.13 in chips)
Seat 6: f92a7a14 ($17.13 in chips)
50908537: posts small blind $0.05
Hero: posts big blind $0.1
*** HOLE CARDS ***
Dealt to 6a783cf0 
Dealt to 50908537 
Dealt to Hero [Td Jh]
Dealt to f0f5b924 
Dealt to b4ee20c8 
Dealt to f92a7a14 
f0f5b924: raises $0.1 to $0.2
b4ee20c8: folds
f92a7a14: raises $0.4 to $0.6
6a783cf0: folds
50908537: folds
Hero: folds
f0f5b924: calls $0.4
*** FLOP *** [5s 8c 8s]
f0f5b924: checks
f92a7a14: bets $0.45
f0f5b924: folds
Uncalled bet ($0.45) returned to f92a7a14
*** SHOWDOWN ***
f92a7a14 collected $1.29 from pot
*** SUMMARY ***
Total pot $1.35 | Rake $0.06 | Jackpot $0 | Bingo $0 | Fortune $0
Board [5s 8c 8s]
Seat 1: 6a783cf0 (button) folded before Flop (didn't bet)
Seat 2: 50908537 (small blind) folded before Flop
Seat 3: Hero (big blind) folded before Flop
Seat 4: f0f5b924 folded on the Flop
Seat 5: b4ee20c8 folded before Flop (didn't bet)
Seat 6: f92a7a14 won ($1.29)


Poker Hand #RC1433313973: Hold'em No Limit  ($0.05/$0.1) - 2023/03/27 19:17:42
Table 'RushAndCash28169233' 6-max Seat #1 is the button
Seat 1: 5c23bd5 ($10.86 in chips)
Seat 2: ff49bf9a ($10 in chips)
Seat 3: ab5abfa7 ($19.49 in chips)
Seat 4: Hero ($26.23 in chips)
Seat 5: 60232bae ($11.24 in chips)
Seat 6: c62acbd1 ($13.97 in chips)
ff49bf9a: posts small blind $0.05
ab5abfa7: posts big blind $0.1
*** HOLE CARDS ***
Dealt to 5c23bd5 
Dealt to ff49bf9a 
Dealt to ab5abfa7 
Dealt to Hero [Qc 2s]
Dealt to 60232bae 
Dealt to c62acbd1 
Hero: folds
60232bae: raises $0.12 to $0.22
c62acbd1: folds
5c23bd5: folds
ff49bf9a: folds
ab5abfa7: calls $0.12
*** FLOP *** [3c 7h 9d]
ab5abfa7: checks
60232bae: bets $0.37
ab5abfa7: calls $0.37
*** TURN *** [3c 7h 9d] [As]
ab5abfa7: checks
60232bae: checks
*** RIVER *** [3c 7h 9d As] [5d]
ab5abfa7: checks
60232bae: checks
ab5abfa7: shows [7c Kc] (Pair of Sevens)
60232bae: shows [7d 8d] (Pair of Sevens)
*** SHOWDOWN ***
ab5abfa7 collected $1.17 from pot
*** SUMMARY ***
Total pot $1.23 | Rake $0.06 | Jackpot $0 | Bingo $0 | Fortune $0
Board [3c 7h 9d As 5d]
Seat 1: 5c23bd5 (button) folded before Flop (didn't bet)
Seat 2: ff49bf9a (small blind) folded before Flop
Seat 3: ab5abfa7 (big blind) showed [7c Kc] and won ($1.17) with Pair of Sevens
Seat 4: Hero folded before Flop (didn't bet)
Seat 5: 60232bae showed [7d 8d] and lost with Pair of Sevens
Seat 6: c62acbd1 folded before Flop (didn't bet)


Poker Hand #RC1433313926: Hold'em No Limit  ($0.05/$0.1) - 2023/03/27 19:17:35
Table 'RushAndCash28169186' 6-max Seat #1 is the button
Seat 1: 313f9bbc ($22.06 in chips)
Seat 2: d7ef21d5 ($19.96 in chips)
Seat 3: bfd04326 ($10.51 in chips)
Seat 4: bb395351 ($22.27 in chips)
Seat 5: Hero ($26.23 in chips)
Seat 6: c2c593b0 ($11.82 in chips)
d7ef21d5: posts small blind $0.05
bfd04326: posts big blind $0.1
*** HOLE CARDS ***
Dealt to 313f9bbc 
Dealt to d7ef21d5 
Dealt to bfd04326 
Dealt to bb395351 
Dealt to Hero [3s 6h]
Dealt to c2c593b0 
bb395351: folds
Hero: folds
c2c593b0: raises $0.1 to $0.2
313f9bbc: folds
d7ef21d5: folds
bfd04326: calls $0.1
*** FLOP *** [6d Jh Tc]
bfd04326: checks
c2c593b0: bets $0.15
bfd04326: calls $0.15
*** TURN *** [6d Jh Tc] [9c]
bfd04326: checks
c2c593b0: checks
*** RIVER *** [6d Jh Tc 9c] [2c]
bfd04326: checks
c2c593b0: checks
bfd04326: shows [Qh 9h] (Pair of Nines)
c2c593b0: shows [5d 5s] (Pair of Fives)
*** SHOWDOWN ***
bfd04326 collected $0.72 from pot
*** SUMMARY ***
Total pot $0.75 | Rake $0.03 | Jackpot $0 | Bingo $0 | Fortune $0
Board [6d Jh Tc 9c 2c]
Seat 1: 313f9bbc (button) folded before Flop (didn't bet)
Seat 2: d7ef21d5 (small blind) folded before Flop
Seat 3: bfd04326 (big blind) showed [Qh 9h] and won ($0.72) with Pair of Nines
Seat 4: bb395351 folded before Flop (didn't bet)
Seat 5: Hero folded before Flop (didn't bet)
Seat 6: c2c593b0 showed [5d 5s] and lost with Pair of Fives


Poker Hand #RC1433313895: Hold'em No Limit  ($0.05/$0.1) - 2023/03/27 19:17:31
Table 'RushAndCash28169155' 6-max Seat #1 is the button
Seat 1: e9c8b836 ($10.14 in chips)
Seat 2: ec3bebf3 ($21.92 in chips)
Seat 3: 69539208 ($32.09 in chips)
Seat 4: Hero ($26.23 in chips)
Seat 5: fe6c6d80 ($10.15 in chips)
Seat 6: 4aaacbb ($35.29 in chips)
ec3bebf3: posts small blind $0.05
69539208: posts big blind $0.1
*** HOLE CARDS ***
Dealt to e9c8b836 
Dealt to ec3bebf3 
Dealt to 69539208 
Dealt to Hero [Jc 8c]
Dealt to fe6c6d80 
Dealt to 4aaacbb 
Hero: folds
fe6c6d80: folds
4aaacbb: folds
e9c8b836: raises $0.15 to $0.25
ec3bebf3: raises $0.9 to $1.15
69539208: folds
e9c8b836: folds
Uncalled bet ($0.9) returned to ec3bebf3
*** SHOWDOWN ***
ec3bebf3 collected $0.57 from pot
*** SUMMARY ***
Total pot $0.6 | Rake $0.03 | Jackpot $0 | Bingo $0 | Fortune $0
Seat 1: e9c8b836 (button) folded before Flop
Seat 2: ec3bebf3 (small blind) collected ($0.57)
Seat 3: 69539208 (big blind) folded before Flop
Seat 4: Hero folded before Flop (didn't bet)
Seat 5: fe6c6d80 folded before Flop (didn't bet)
Seat 6: 4aaacbb folded before Flop (didn't bet)


Poker Hand #RC1433313836: Hold'em No Limit  ($0.05/$0.1) - 2023/03/27 19:17:23
Table 'RushAndCash28169096' 6-max Seat #1 is the button
Seat 1: caf5a12c ($3.02 in chips)
Seat 2: 1b112a36 ($10.78 in chips)
Seat 3: Hero ($26.33 in chips)
Seat 4: 10620cac ($18.01 in chips)
Seat 5: fd693c3 ($10.7 in chips)
Seat 6: acbbb6b4 ($15.27 in chips)
1b112a36: posts small blind $0.05
Hero: posts big blind $0.1
*** HOLE CARDS ***
Dealt to caf5a12c 
Dealt to 1b112a36 
Dealt to Hero [8d 9c]
Dealt to 10620cac 
Dealt to fd693c3 
Dealt to acbbb6b4 
10620cac: folds
fd693c3: folds
acbbb6b4: folds
caf5a12c: raises $0.2 to $0.3
1b112a36: folds
Hero: folds
Uncalled bet ($0.2) returned to caf5a12c
*** SHOWDOWN ***
caf5a12c collected $0.25 from pot
*** SUMMARY ***
Total pot $0.25 | Rake $0 | Jackpot $0 | Bingo $0 | Fortune $0
Seat 1: caf5a12c (button) collected ($0.25)
Seat 2: 1b112a36 (small blind) folded before Flop
Seat 3: Hero (big blind) folded before Flop
Seat 4: 10620cac folded before Flop (didn't bet)
Seat 5: fd693c3 folded before Flop (didn't bet)
Seat 6: acbbb6b4 folded before Flop (didn't bet)


Poker Hand #RC1433313779: Hold'em No Limit  ($0.05/$0.1) - 2023/03/27 19:17:15
Table 'RushAndCash28169039' 6-max Seat #1 is the button
Seat 1: 928a8131 ($33.96 in chips)
Seat 2: Hero ($26.38 in chips)
Seat 3: b2a92f29 ($10 in chips)
Seat 4: 5e8a857b ($10.52 in chips)
Seat 5: 7c3efb34 ($10.15 in chips)
Seat 6: 5bccc20a ($12 in chips)
Hero: posts small blind $0.05
b2a92f29: posts big blind $0.1
*** HOLE CARDS ***
Dealt to 928a8131 
Dealt to Hero [4c 9c]
Dealt to b2a92f29 
Dealt to 5e8a857b 
Dealt to 7c3efb34 
Dealt to 5bccc20a 
5e8a857b: folds
7c3efb34: folds
5bccc20a: folds
928a8131: folds
Hero: folds
Uncalled bet ($0.05) returned to b2a92f29
*** SHOWDOWN ***
b2a92f29 collected $0.1 from pot
*** SUMMARY ***
Total pot $0.1 | Rake $0 | Jackpot $0 | Bingo $0 | Fortune $0
Seat 1: 928a8131 (button) folded before Flop (didn't bet)
Seat 2: Hero (small blind) folded before Flop
Seat 3: b2a92f29 (big blind) collected ($0.1)
Seat 4: 5e8a857b folded before Flop (didn't bet)
Seat 5: 7c3efb34 folded before Flop (didn't bet)
Seat 6: 5bccc20a folded before Flop (didn't bet)


Poker Hand #RC1433313657: Hold'em No Limit  ($0.05/$0.1) - 2023/03/27 19:16:58
Table 'RushAndCash28168917' 6-max Seat #1 is the button
Seat 1: Hero ($26.23 in chips)
Seat 2: d7ef21d5 ($19.96 in chips)
Seat 3: cfbab7a9 ($10.71 in chips)
Seat 4: 4d8a05ce ($13.1 in chips)
Seat 5: a76b3c83 ($6.45 in chips)
Seat 6: c36ac4b6 ($22.33 in chips)
d7ef21d5: posts small blind $0.05
cfbab7a9: posts big blind $0.1
*** HOLE CARDS ***
Dealt to Hero [As Kc]
Dealt to d7ef21d5 
Dealt to cfbab7a9 
Dealt to 4d8a05ce 
Dealt to a76b3c83 
Dealt to c36ac4b6 
4d8a05ce: folds
a76b3c83: folds
c36ac4b6: folds
Hero: raises $0.15 to $0.25
d7ef21d5: folds
cfbab7a9: folds
Uncalled bet ($0.15) returned to Hero
*** SHOWDOWN ***
Hero collected $0.25 from pot
*** SUMMARY ***
Total pot $0.25 | Rake $0 | Jackpot $0 | Bingo $0 | Fortune $0
Seat 1: Hero (button) collected ($0.25)
Seat 2: d7ef21d5 (small blind) folded before Flop
Seat 3: cfbab7a9 (big blind) folded before Flop
Seat 4: 4d8a05ce folded before Flop (didn't bet)
Seat 5: a76b3c83 folded before Flop (didn't bet)
Seat 6: c36ac4b6 folded before Flop (didn't bet)


Poker Hand #RC1433313454: Hold'em No Limit  ($0.05/$0.1) - 2023/03/27 19:16:30
Table 'RushAndCash28168714' 6-max Seat #1 is the button
Seat 1: c1afae07 ($27.21 in chips)
Seat 2: 9f0de297 ($10.27 in chips)
Seat 3: b4ee20c8 ($10 in chips)
Seat 4: 5c0db35c ($10.05 in chips)
Seat 5: Hero ($26.48 in chips)
Seat 6: f6184b9c ($10.52 in chips)
9f0de297: posts small blind $0.05
b4ee20c8: posts big blind $0.1
*** HOLE CARDS ***
Dealt to c1afae07 
Dealt to 9f0de297 
Dealt to b4ee20c8 
Dealt to 5c0db35c 
Dealt to Hero [3s As]
Dealt to f6184b9c 
5c0db35c: folds
Hero: raises $0.15 to $0.25
f6184b9c: folds
c1afae07: folds
9f0de297: folds
b4ee20c8: raises $0.49 to $0.74
Hero: folds
Uncalled bet ($0.49) returned to b4ee20c8
*** SHOWDOWN ***
b4ee20c8 collected $0.53 from pot
*** SUMMARY ***
Total pot $0.55 | Rake $0.02 | Jackpot $0 | Bingo $0 | Fortune $0
Seat 1: c1afae07 (button) folded before Flop (didn't bet)
Seat 2: 9f0de297 (small blind) folded before Flop
Seat 3: b4ee20c8 (big blind) collected ($0.53)
Seat 4: 5c0db35c folded before Flop (didn't bet)
Seat 5: Hero folded before Flop
Seat 6: f6184b9c folded before Flop (didn't bet)


Poker Hand #RC1433313426: Hold'em No Limit  ($0.05/$0.1) - 2023/03/27 19:16:26
Table 'RushAndCash28168686' 6-max Seat #1 is the button
Seat 1: 784858c ($19.21 in chips)
Seat 2: eb8e066f ($18.91 in chips)
Seat 3: fe080145 ($11.25 in chips)
Seat 4: f73707ab ($24.75 in chips)
Seat 5: 2797b5a1 ($9.58 in chips)
Seat 6: Hero ($26.48 in chips)
eb8e066f: posts small blind $0.05
fe080145: posts big blind $0.1
*** HOLE CARDS ***
Dealt to 784858c 
Dealt to eb8e066f 
Dealt to fe080145 
Dealt to f73707ab 
Dealt to 2797b5a1 
Dealt to Hero [7c 3h]
f73707ab: folds
2797b5a1: folds
Hero: folds
784858c: folds
eb8e066f: raises $0.3 to $0.4
fe080145: folds
Uncalled bet ($0.3) returned to eb8e066f
*** SHOWDOWN ***
eb8e066f collected $0.2 from pot
*** SUMMARY ***
Total pot $0.2 | Rake $0 | Jackpot $0 | Bingo $0 | Fortune $0
Seat 1: 784858c (button) folded before Flop (didn't bet)
Seat 2: eb8e066f (small blind) collected ($0.2)
Seat 3: fe080145 (big blind) folded before Flop
Seat 4: f73707ab folded before Flop (didn't bet)
Seat 5: 2797b5a1 folded before Flop (didn't bet)
Seat 6: Hero folded before Flop (didn't bet)


Poker Hand #RC1433313397: Hold'em No Limit  ($0.05/$0.1) - 2023/03/27 19:16:21
Table 'RushAndCash28168657' 6-max Seat #1 is the button
Seat 1: Hero ($26.48 in chips)
Seat 2: 7c84e01d ($35.4 in chips)
Seat 3: 5c0db35c ($10 in chips)
Seat 4: 54d5200f ($21.46 in chips)
Seat 5: 78361b78 ($10.33 in chips)
Seat 6: 3253ee1d ($13.93 in chips)
7c84e01d: posts small blind $0.05
5c0db35c: posts big blind $0.1
*** HOLE CARDS ***
Dealt to Hero [Jd 4d]
Dealt to 7c84e01d 
Dealt to 5c0db35c 
Dealt to 54d5200f 
Dealt to 78361b78 
Dealt to 3253ee1d 
54d5200f: folds
78361b78: folds
3253ee1d: folds
Hero: folds
7c84e01d: folds
Uncalled bet ($0.05) returned to 5c0db35c
*** SHOWDOWN ***
5c0db35c collected $0.1 from pot
*** SUMMARY ***
Total pot $0.1 | Rake $0 | Jackpot $0 | Bingo $0 | Fortune $0
Seat 1: Hero (button) folded before Flop (didn't bet)
Seat 2: 7c84e01d (small blind) folded before Flop
Seat 3: 5c0db35c (big blind) collected ($0.1)
Seat 4: 54d5200f folded before Flop (didn't bet)
Seat 5: 78361b78 folded before Flop (didn't bet)
Seat 6: 3253ee1d folded before Flop (didn't bet)


Poker Hand #RC1433313375: Hold'em No Limit  ($0.05/$0.1) - 2023/03/27 19:16:17
Table 'RushAndCash28168635' 6-max Seat #1 is the button
Seat 1: af5b0e1f ($7.63 in chips)
Seat 2: 725f7e50 ($11.83 in chips)
Seat 3: 53989c53 ($24.86 in chips)
Seat 4: Hero ($26.48 in chips)
Seat 5: ebcc5af9 ($9.99 in chips)
Seat 6: df31fa90 ($8.38 in chips)
725f7e50: posts small blind $0.05
53989c53: posts big blind $0.1
*** HOLE CARDS ***
Dealt to af5b0e1f 
Dealt to 725f7e50 
Dealt to 53989c53 
Dealt to Hero [5d 4h]
Dealt to ebcc5af9 
Dealt to df31fa90 
Hero: folds
ebcc5af9: raises $0.15 to $0.25
df31fa90: raises $0.65 to $0.9
af5b0e1f: folds
725f7e50: folds
53989c53: folds
ebcc5af9: folds
Uncalled bet ($0.65) returned to df31fa90
*** SHOWDOWN ***
df31fa90 collected $0.62 from pot
*** SUMMARY ***
Total pot $0.65 | Rake $0.03 | Jackpot $0 | Bingo $0 | Fortune $0
Seat 1: af5b0e1f (button) folded before Flop (didn't bet)
Seat 2: 725f7e50 (small blind) folded before Flop
Seat 3: 53989c53 (big blind) folded before Flop
Seat 4: Hero folded before Flop (didn't bet)
Seat 5: ebcc5af9 folded before Flop
Seat 6: df31fa90 collected ($0.62)


Poker Hand #RC1433313339: Hold'em No Limit  ($0.05/$0.1) - 2023/03/27 19:16:12
Table 'RushAndCash28168599' 6-max Seat #1 is the button
Seat 1: b959dd5b ($10.83 in chips)
Seat 2: 309f93e ($10.35 in chips)
Seat 3: 28f8789 ($10.43 in chips)
Seat 4: 2797b5a1 ($9.58 in chips)
Seat 5: Hero ($26.48 in chips)
Seat 6: 8e2d4a82 ($17.07 in chips)
309f93e: posts small blind $0.05
28f8789: posts big blind $0.1
*** HOLE CARDS ***
Dealt to b959dd5b 
Dealt to 309f93e 
Dealt to 28f8789 
Dealt to 2797b5a1 
Dealt to Hero [Ks 3c]
Dealt to 8e2d4a82 
2797b5a1: folds
Hero: folds
8e2d4a82: raises $0.15 to $0.25
b959dd5b: folds
309f93e: folds
28f8789: calls $0.15
*** FLOP *** [Jh 2c 5d]
28f8789: checks
8e2d4a82: checks
*** TURN *** [Jh 2c 5d] [2d]
28f8789: bets $0.31
8e2d4a82: calls $0.31
*** RIVER *** [Jh 2c 5d 2d] [4s]
28f8789: bets $0.65
8e2d4a82: folds
Uncalled bet ($0.65) returned to 28f8789
*** SHOWDOWN ***
28f8789 collected $1.12 from pot
*** SUMMARY ***
Total pot $1.17 | Rake $0.05 | Jackpot $0 | Bingo $0 | Fortune $0
Board [Jh 2c 5d 2d 4s]
Seat 1: b959dd5b (button) folded before Flop (didn't bet)
Seat 2: 309f93e (small blind) folded before Flop
Seat 3: 28f8789 (big blind) won ($1.12)
Seat 4: 2797b5a1 folded before Flop (didn't bet)
Seat 5: Hero folded before Flop (didn't bet)
Seat 6: 8e2d4a82 folded on the River


Poker Hand #RC1433313268: Hold'em No Limit  ($0.05/$0.1) - 2023/03/27 19:16:00
Table 'RushAndCash28168528' 6-max Seat #1 is the button
Seat 1: 5b06e1bc ($14.01 in chips)
Seat 2: 29e6c0ca ($18.92 in chips)
Seat 3: Hero ($26.58 in chips)
Seat 4: f73707ab ($24.9 in chips)
Seat 5: b420b154 ($11.27 in chips)
Seat 6: 42d7f34b ($10.3 in chips)
29e6c0ca: posts small blind $0.05
Hero: posts big blind $0.1
*** HOLE CARDS ***
Dealt to 5b06e1bc 
Dealt to 29e6c0ca 
Dealt to Hero [7h Tc]
Dealt to f73707ab 
Dealt to b420b154 
Dealt to 42d7f34b 
f73707ab: folds
b420b154: folds
42d7f34b: raises $0.15 to $0.25
5b06e1bc: folds
29e6c0ca: folds
Hero: folds
Uncalled bet ($0.15) returned to 42d7f34b
*** SHOWDOWN ***
42d7f34b collected $0.25 from pot
*** SUMMARY ***
Total pot $0.25 | Rake $0 | Jackpot $0 | Bingo $0 | Fortune $0
Seat 1: 5b06e1bc (button) folded before Flop (didn't bet)
Seat 2: 29e6c0ca (small blind) folded before Flop
Seat 3: Hero (big blind) folded before Flop
Seat 4: f73707ab folded before Flop (didn't bet)
Seat 5: b420b154 folded before Flop (didn't bet)
Seat 6: 42d7f34b collected ($0.25)


Poker Hand #RC1433313061: Hold'em No Limit  ($0.05/$0.1) - 2023/03/27 19:15:26
Table 'RushAndCash28168321' 6-max Seat #1 is the button
Seat 1: cb53a7de ($10.61 in chips)
Seat 2: 37903592 ($8.55 in chips)
Seat 3: 29e6c0ca ($19.45 in chips)
Seat 4: Hero ($26.05 in chips)
Seat 5: 409d9b29 ($29.95 in chips)
Seat 6: 880f1c43 ($10.52 in chips)
37903592: posts small blind $0.05
29e6c0ca: posts big blind $0.1
*** HOLE CARDS ***
Dealt to cb53a7de 
Dealt to 37903592 
Dealt to 29e6c0ca 
Dealt to Hero [Js Kd]
Dealt to 409d9b29 
Dealt to 880f1c43 
Hero: raises $0.15 to $0.25
409d9b29: folds
880f1c43: folds
cb53a7de: folds
37903592: folds
29e6c0ca: calls $0.15
*** FLOP *** [4c Kh 8s]
29e6c0ca: checks
Hero: bets $0.28
29e6c0ca: calls $0.28
*** TURN *** [4c Kh 8s] [2d]
29e6c0ca: checks
Hero: bets $0.56
29e6c0ca: folds
Uncalled bet ($0.56) returned to Hero
*** SHOWDOWN ***
Hero collected $1.06 from pot
*** SUMMARY ***
Total pot $1.11 | Rake $0.05 | Jackpot $0 | Bingo $0 | Fortune $0
Board [4c Kh 8s 2d]
Seat 1: cb53a7de (button) folded before Flop (didn't bet)
Seat 2: 37903592 (small blind) folded before Flop
Seat 3: 29e6c0ca (big blind) folded on the Turn
Seat 4: Hero won ($1.06)
Seat 5: 409d9b29 folded before Flop (didn't bet)
Seat 6: 880f1c43 folded before Flop (didn't bet)


Poker Hand #RC1433313035: Hold'em No Limit  ($0.05/$0.1) - 2023/03/27 19:15:22
Table 'RushAndCash28168295' 6-max Seat #1 is the button
Seat 1: 56367aed ($10.58 in chips)
Seat 2: 69539208 ($23.71 in chips)
Seat 3: 162a1aaf ($10 in chips)
Seat 4: 3a99a4a ($14.5 in chips)
Seat 5: eac5269d ($10.21 in chips)
Seat 6: Hero ($26.05 in chips)
69539208: posts small blind $0.05
162a1aaf: posts big blind $0.1
*** HOLE CARDS ***
Dealt to 56367aed 
Dealt to 69539208 
Dealt to 162a1aaf 
Dealt to 3a99a4a 
Dealt to eac5269d 
Dealt to Hero [8s Jd]
3a99a4a: raises $0.1 to $0.2
eac5269d: folds
Hero: folds
56367aed: folds
69539208: folds
162a1aaf: calls $0.1
*** FLOP *** [3d Ah 3h]
162a1aaf: checks
3a99a4a: bets $0.34
162a1aaf: folds
Uncalled bet ($0.34) returned to 3a99a4a
*** SHOWDOWN ***
3a99a4a collected $0.43 from pot
*** SUMMARY ***
Total pot $0.45 | Rake $0.02 | Jackpot $0 | Bingo $0 | Fortune $0
Board [3d Ah 3h]
Seat 1: 56367aed (button) folded before Flop (didn't bet)
Seat 2: 69539208 (small blind) folded before Flop
Seat 3: 162a1aaf (big blind) folded on the Flop
Seat 4: 3a99a4a won ($0.43)
Seat 5: eac5269d folded before Flop (didn't bet)
Seat 6: Hero folded before Flop (didn't bet)


Poker Hand #RC1433312900: Hold'em No Limit  ($0.05/$0.1) - 2023/03/27 19:15:00
Table 'RushAndCash28168160' 6-max Seat #1 is the button
Seat 1: Hero ($25.55 in chips)
Seat 2: 88a93721 ($10.05 in chips)
Seat 3: 947b43c2 ($10.15 in chips)
Seat 4: 2ca6cfad ($2.51 in chips)
Seat 5: 7f3fb3a4 ($9.88 in chips)
Seat 6: ae967dca ($10.02 in chips)
88a93721: posts small blind $0.05
947b43c2: posts big blind $0.1
*** HOLE CARDS ***
Dealt to Hero [3d Kd]
Dealt to 88a93721 
Dealt to 947b43c2 
Dealt to 2ca6cfad 
Dealt to 7f3fb3a4 
Dealt to ae967dca 
2ca6cfad: folds
7f3fb3a4: raises $0.13 to $0.23
ae967dca: folds
Hero: raises $0.52 to $0.75
88a93721: folds
947b43c2: folds
7f3fb3a4: folds
Uncalled bet ($0.52) returned to Hero
*** SHOWDOWN ***
Hero collected $0.58 from pot
*** SUMMARY ***
Total pot $0.61 | Rake $0.03 | Jackpot $0 | Bingo $0 | Fortune $0
Seat 1: Hero (button) collected ($0.58)
Seat 2: 88a93721 (small blind) folded before Flop
Seat 3: 947b43c2 (big blind) folded before Flop
Seat 4: 2ca6cfad folded before Flop (didn't bet)
Seat 5: 7f3fb3a4 folded before Flop
Seat 6: ae967dca folded before Flop (didn't bet)


Poker Hand #RC1433312864: Hold'em No Limit  ($0.05/$0.1) - 2023/03/27 19:14:54
Table 'RushAndCash28168124' 6-max Seat #1 is the button
Seat 1: 8e854de7 ($9.7 in chips)
Seat 2: bb4dcf9b ($21.8 in chips)
Seat 3: Hero ($25.65 in chips)
Seat 4: d3ee906d ($10.55 in chips)
Seat 5: b89bb76c ($3.08 in chips)
Seat 6: 1ef2413 ($18.18 in chips)
bb4dcf9b: posts small blind $0.05
Hero: posts big blind $0.1
*** HOLE CARDS ***
Dealt to 8e854de7 
Dealt to bb4dcf9b 
Dealt to Hero [3h 9d]
Dealt to d3ee906d 
Dealt to b89bb76c 
Dealt to 1ef2413 
d3ee906d: folds
b89bb76c: folds
1ef2413: folds
8e854de7: folds
bb4dcf9b: folds
Uncalled bet ($0.05) returned to Hero
*** SHOWDOWN ***
Hero collected $0.1 from pot
*** SUMMARY ***
Total pot $0.1 | Rake $0 | Jackpot $0 | Bingo $0 | Fortune $0
Seat 1: 8e854de7 (button) folded before Flop (didn't bet)
Seat 2: bb4dcf9b (small blind) folded before Flop
Seat 3: Hero (big blind) collected ($0.1)
Seat 4: d3ee906d folded before Flop (didn't bet)
Seat 5: b89bb76c folded before Flop (didn't bet)
Seat 6: 1ef2413 folded before Flop (didn't bet)


Poker Hand #RC1433312543: Hold'em No Limit  ($0.05/$0.1) - 2023/03/27 19:14:03
Table 'RushAndCash28167803' 6-max Seat #1 is the button
Seat 1: Hero ($26.34 in chips)
Seat 2: e14f9f4 ($10.37 in chips)
Seat 3: 7bd6a3d3 ($15.09 in chips)
Seat 4: 522e6aae ($41.8 in chips)
Seat 5: 58a6ffbd ($10 in chips)
Seat 6: 7249c649 ($18.53 in chips)
e14f9f4: posts small blind $0.05
7bd6a3d3: posts big blind $0.1
*** HOLE CARDS ***
Dealt to Hero [Kd Qs]
Dealt to e14f9f4 
Dealt to 7bd6a3d3 
Dealt to 522e6aae 
Dealt to 58a6ffbd 
Dealt to 7249c649 
522e6aae: folds
58a6ffbd: raises $0.11 to $0.21
7249c649: folds
Hero: raises $0.48 to $0.69
e14f9f4: folds
7bd6a3d3: folds
58a6ffbd: raises $1.16 to $1.85
Hero: folds
Uncalled bet ($1.16) returned to 58a6ffbd
*** SHOWDOWN ***
58a6ffbd collected $1.46 from pot
*** SUMMARY ***
Total pot $1.53 | Rake $0.07 | Jackpot $0 | Bingo $0 | Fortune $0
Seat 1: Hero (button) folded before Flop
Seat 2: e14f9f4 (small blind) folded before Flop
Seat 3: 7bd6a3d3 (big blind) folded before Flop
Seat 4: 522e6aae folded before Flop (didn't bet)
Seat 5: 58a6ffbd collected ($1.46)
Seat 6: 7249c649 folded before Flop (didn't bet)


Poker Hand #RC1433312504: Hold'em No Limit  ($0.05/$0.1) - 2023/03/27 19:13:57
Table 'RushAndCash28167764' 6-max Seat #1 is the button
Seat 1: 42391a92 ($18.09 in chips)
Seat 2: 18ecf19 ($9.79 in chips)
Seat 3: f3716d4a ($9.95 in chips)
Seat 4: fe8bd5ad ($13.21 in chips)
Seat 5: Hero ($26.34 in chips)
Seat 6: 5dd9770d ($31.69 in chips)
18ecf19: posts small blind $0.05
f3716d4a: posts big blind $0.1
*** HOLE CARDS ***
Dealt to 42391a92 
Dealt to 18ecf19 
Dealt to f3716d4a 
Dealt to fe8bd5ad 
Dealt to Hero [2s 9d]
Dealt to 5dd9770d 
fe8bd5ad: folds
Hero: folds
5dd9770d: folds
42391a92: raises $0.1 to $0.2
18ecf19: folds
f3716d4a: calls $0.1
*** FLOP *** [Tc 4c 2h]
f3716d4a: checks
42391a92: checks
*** TURN *** [Tc 4c 2h] [8h]
f3716d4a: checks
42391a92: bets $0.12
f3716d4a: folds
Uncalled bet ($0.12) returned to 42391a92
*** SHOWDOWN ***
42391a92 collected $0.43 from pot
*** SUMMARY ***
Total pot $0.45 | Rake $0.02 | Jackpot $0 | Bingo $0 | Fortune $0
Board [Tc 4c 2h 8h]
Seat 1: 42391a92 (button) won ($0.43)
Seat 2: 18ecf19 (small blind) folded before Flop
Seat 3: f3716d4a (big blind) folded on the Turn
Seat 4: fe8bd5ad folded before Flop (didn't bet)
Seat 5: Hero folded before Flop (didn't bet)
Seat 6: 5dd9770d folded before Flop (didn't bet)


Poker Hand #RC1433312466: Hold'em No Limit  ($0.05/$0.1) - 2023/03/27 19:13:53
Table 'RushAndCash28167726' 6-max Seat #1 is the button
Seat 1: 9098cd98 ($29.38 in chips)
Seat 2: 74aeaadc ($39.99 in chips)
Seat 3: cff7f2dd ($12.28 in chips)
Seat 4: 7720e09f ($15.16 in chips)
Seat 5: 35d0c3dd ($10.01 in chips)
Seat 6: Hero ($26.34 in chips)
74aeaadc: posts small blind $0.05
cff7f2dd: posts big blind $0.1
*** HOLE CARDS ***
Dealt to 9098cd98 
Dealt to 74aeaadc 
Dealt to cff7f2dd 
Dealt to 7720e09f 
Dealt to 35d0c3dd 
Dealt to Hero [4d Qd]
7720e09f: folds
35d0c3dd: folds
Hero: folds
9098cd98: raises $0.1 to $0.2
74aeaadc: folds
cff7f2dd: folds
Uncalled bet ($0.1) returned to 9098cd98
*** SHOWDOWN ***
9098cd98 collected $0.25 from pot
*** SUMMARY ***
Total pot $0.25 | Rake $0 | Jackpot $0 | Bingo $0 | Fortune $0
Seat 1: 9098cd98 (button) collected ($0.25)
Seat 2: 74aeaadc (small blind) folded before Flop
Seat 3: cff7f2dd (big blind) folded before Flop
Seat 4: 7720e09f folded before Flop (didn't bet)
Seat 5: 35d0c3dd folded before Flop (didn't bet)
Seat 6: Hero folded before Flop (didn't bet)


Poker Hand #RC1433312423: Hold'em No Limit  ($0.05/$0.1) - 2023/03/27 19:13:46
Table 'RushAndCash28167683' 6-max Seat #1 is the button
Seat 1: 99e85c0 ($10 in chips)
Seat 2: Hero ($26.39 in chips)
Seat 3: 3fc223dd ($10.42 in chips)
Seat 4: 47503c44 ($10.44 in chips)
Seat 5: acbbb6b4 ($11.28 in chips)
Seat 6: 4ea42cf9 ($14.37 in chips)
Hero: posts small blind $0.05
3fc223dd: posts big blind $0.1
*** HOLE CARDS ***
Dealt to 99e85c0 
Dealt to Hero [9d 6c]
Dealt to 3fc223dd 
Dealt to 47503c44 
Dealt to acbbb6b4 
Dealt to 4ea42cf9 
47503c44: folds
acbbb6b4: raises $0.15 to $0.25
4ea42cf9: folds
99e85c0: folds
Hero: folds
3fc223dd: calls $0.15
*** FLOP *** [Ac Jc 7c]
3fc223dd: checks
acbbb6b4: bets $0.38
3fc223dd: folds
Uncalled bet ($0.38) returned to acbbb6b4
*** SHOWDOWN ***
acbbb6b4 collected $0.53 from pot
*** SUMMARY ***
Total pot $0.55 | Rake $0.02 | Jackpot $0 | Bingo $0 | Fortune $0
Board [Ac Jc 7c]
Seat 1: 99e85c0 (button) folded before Flop (didn't bet)
Seat 2: Hero (small blind) folded before Flop
Seat 3: 3fc223dd (big blind) folded on the Flop
Seat 4: 47503c44 folded before Flop (didn't bet)
Seat 5: acbbb6b4 won ($0.53)
Seat 6: 4ea42cf9 folded before Flop (didn't bet)


Poker Hand #RC1433312016: Hold'em No Limit  ($0.05/$0.1) - 2023/03/27 19:12:36
Table 'RushAndCash28167276' 6-max Seat #1 is the button
Seat 1: acbbb6b4 ($10.67 in chips)
Seat 2: aed1a693 ($25.27 in chips)
Seat 3: fe6c6d80 ($10 in chips)
Seat 4: eda6868 ($27.48 in chips)
Seat 5: 784858c ($17.5 in chips)
Seat 6: Hero ($26.91 in chips)
aed1a693: posts small blind $0.05
fe6c6d80: posts big blind $0.1
*** HOLE CARDS ***
Dealt to acbbb6b4 
Dealt to aed1a693 
Dealt to fe6c6d80 
Dealt to eda6868 
Dealt to 784858c 
Dealt to Hero [Jc Kh]
eda6868: folds
784858c: folds
Hero: raises $0.15 to $0.25
acbbb6b4: calls $0.25
aed1a693: folds
fe6c6d80: folds
*** FLOP *** [2h As 3s]
Hero: bets $0.27
acbbb6b4: calls $0.27
*** TURN *** [2h As 3s] [4c]
Hero: checks
acbbb6b4: checks
*** RIVER *** [2h As 3s 4c] [6c]
Hero: checks
acbbb6b4: checks
Hero: shows [Jc Kh] (Ace-High)
acbbb6b4: shows [Ac 9d] (Pair of Aces)
*** SHOWDOWN ***
acbbb6b4 collected $1.13 from pot
*** SUMMARY ***
Total pot $1.19 | Rake $0.06 | Jackpot $0 | Bingo $0 | Fortune $0
Board [2h As 3s 4c 6c]
Seat 1: acbbb6b4 (button) showed [Ac 9d] and won ($1.13) with Pair of Aces
Seat 2: aed1a693 (small blind) folded before Flop
Seat 3: fe6c6d80 (big blind) folded before Flop
Seat 4: eda6868 folded before Flop (didn't bet)
Seat 5: 784858c folded before Flop (didn't bet)
Seat 6: Hero showed [Jc Kh] and lost with Ace-High


Poker Hand #RC1433311874: Hold'em No Limit  ($0.05/$0.1) - 2023/03/27 19:12:14
Table 'RushAndCash28167134' 6-max Seat #1 is the button
Seat 1: 831b99c5 ($13.59 in chips)
Seat 2: Hero ($26.96 in chips)
Seat 3: a3ad4d53 ($16.75 in chips)
Seat 4: 9d4b5cce ($10.27 in chips)
Seat 5: c1afae07 ($27.94 in chips)
Seat 6: 51de220a ($11.01 in chips)
Hero: posts small blind $0.05
a3ad4d53: posts big blind $0.1
*** HOLE CARDS ***
Dealt to 831b99c5 
Dealt to Hero [2h Kc]
Dealt to a3ad4d53 
Dealt to 9d4b5cce 
Dealt to c1afae07 
Dealt to 51de220a 
9d4b5cce: folds
c1afae07: raises $0.11 to $0.21
51de220a: folds
831b99c5: folds
Hero: folds
a3ad4d53: folds
Uncalled bet ($0.11) returned to c1afae07
*** SHOWDOWN ***
c1afae07 collected $0.25 from pot
*** SUMMARY ***
Total pot $0.25 | Rake $0 | Jackpot $0 | Bingo $0 | Fortune $0
Seat 1: 831b99c5 (button) folded before Flop (didn't bet)
Seat 2: Hero (small blind) folded before Flop
Seat 3: a3ad4d53 (big blind) folded before Flop
Seat 4: 9d4b5cce folded before Flop (didn't bet)
Seat 5: c1afae07 collected ($0.25)
Seat 6: 51de220a folded before Flop (didn't bet)


Poker Hand #RC1433311842: Hold'em No Limit  ($0.05/$0.1) - 2023/03/27 19:12:09
Table 'RushAndCash28167102' 6-max Seat #1 is the button
Seat 1: 4ee6706f ($10.2 in chips)
Seat 2: 35d0c3dd ($10.41 in chips)
Seat 3: 8077ec64 ($13.68 in chips)
Seat 4: Hero ($26.96 in chips)
Seat 5: e14f9f4 ($10 in chips)
Seat 6: e03ca88b ($16.35 in chips)
35d0c3dd: posts small blind $0.05
8077ec64: posts big blind $0.1
*** HOLE CARDS ***
Dealt to 4ee6706f 
Dealt to 35d0c3dd 
Dealt to 8077ec64 
Dealt to Hero [Th Kd]
Dealt to e14f9f4 
Dealt to e03ca88b 
Hero: folds
e14f9f4: folds
e03ca88b: folds
4ee6706f: folds
35d0c3dd: folds
Uncalled bet ($0.05) returned to 8077ec64
*** SHOWDOWN ***
8077ec64 collected $0.1 from pot
*** SUMMARY ***
Total pot $0.1 | Rake $0 | Jackpot $0 | Bingo $0 | Fortune $0
Seat 1: 4ee6706f (button) folded before Flop (didn't bet)
Seat 2: 35d0c3dd (small blind) folded before Flop
Seat 3: 8077ec64 (big blind) collected ($0.1)
Seat 4: Hero folded before Flop (didn't bet)
Seat 5: e14f9f4 folded before Flop (didn't bet)
Seat 6: e03ca88b folded before Flop (didn't bet)


Poker Hand #RC1433311796: Hold'em No Limit  ($0.05/$0.1) - 2023/03/27 19:12:02
Table 'RushAndCash28167056' 6-max Seat #1 is the button
Seat 1: 7d1278da ($13.49 in chips)
Seat 2: Hero ($27.01 in chips)
Seat 3: 2eef6816 ($10.08 in chips)
Seat 4: 4aaacbb ($35.32 in chips)
Seat 5: cc3e63c7 ($6.99 in chips)
Seat 6: 9b3cdb65 ($31.03 in chips)
Hero: posts small blind $0.05
2eef6816: posts big blind $0.1
*** HOLE CARDS ***
Dealt to 7d1278da 
Dealt to Hero [7s Kc]
Dealt to 2eef6816 
Dealt to 4aaacbb 
Dealt to cc3e63c7 
Dealt to 9b3cdb65 
4aaacbb: raises $0.15 to $0.25
cc3e63c7: folds
9b3cdb65: folds
7d1278da: folds
Hero: folds
2eef6816: calls $0.15
*** FLOP *** [7h Qh 9h]
2eef6816: checks
4aaacbb: checks
*** TURN *** [7h Qh 9h] [6c]
2eef6816: bets $0.19
4aaacbb: calls $0.19
*** RIVER *** [7h Qh 9h 6c] [Td]
2eef6816: checks
4aaacbb: checks
2eef6816: shows [Tc Ad] (Pair of Tens)
4aaacbb: shows [Kd Ks] (Pair of Kings)
*** SHOWDOWN ***
4aaacbb collected $0.89 from pot
*** SUMMARY ***
Total pot $0.93 | Rake $0.04 | Jackpot $0 | Bingo $0 | Fortune $0
Board [7h Qh 9h 6c Td]
Seat 1: 7d1278da (button) folded before Flop (didn't bet)
Seat 2: Hero (small blind) folded before Flop
Seat 3: 2eef6816 (big blind) showed [Tc Ad] and lost with Pair of Tens
Seat 4: 4aaacbb showed [Kd Ks] and won ($0.89) with Pair of Kings
Seat 5: cc3e63c7 folded before Flop (didn't bet)
Seat 6: 9b3cdb65 folded before Flop (didn't bet)


Poker Hand #RC1433311728: Hold'em No Limit  ($0.05/$0.1) - 2023/03/27 19:11:51
Table 'RushAndCash28166988' 6-max Seat #1 is the button
Seat 1: Hero ($27.01 in chips)
Seat 2: d13f972 ($10.15 in chips)
Seat 3: e51a3115 ($31.86 in chips)
Seat 4: b2af673f ($11.49 in chips)
Seat 5: f901a999 ($3.85 in chips)
Seat 6: 35d0c3dd ($10.41 in chips)
d13f972: posts small blind $0.05
e51a3115: posts big blind $0.1
*** HOLE CARDS ***
Dealt to Hero [7d 4s]
Dealt to d13f972 
Dealt to e51a3115 
Dealt to b2af673f 
Dealt to f901a999 
Dealt to 35d0c3dd 
b2af673f: raises $0.12 to $0.22
f901a999: folds
35d0c3dd: folds
Hero: folds
d13f972: folds
e51a3115: calls $0.12
*** FLOP *** [6c Tc Kd]
e51a3115: bets $0.3
b2af673f: calls $0.3
*** TURN *** [6c Tc Kd] [9s]
e51a3115: checks
b2af673f: checks
*** RIVER *** [6c Tc Kd 9s] [8c]
e51a3115: checks
b2af673f: checks
e51a3115: shows [Ah 9d] (Pair of Nines)
b2af673f: shows [Ac Qh] (Ace-High)
*** SHOWDOWN ***
e51a3115 collected $1.04 from pot
*** SUMMARY ***
Total pot $1.09 | Rake $0.05 | Jackpot $0 | Bingo $0 | Fortune $0
Board [6c Tc Kd 9s 8c]
Seat 1: Hero (button) folded before Flop (didn't bet)
Seat 2: d13f972 (small blind) folded before Flop
Seat 3: e51a3115 (big blind) showed [Ah 9d] and won ($1.04) with Pair of Nines
Seat 4: b2af673f showed [Ac Qh] and lost with Ace-High
Seat 5: f901a999 folded before Flop (didn't bet)
Seat 6: 35d0c3dd folded before Flop (didn't bet)


Poker Hand #RC1433311681: Hold'em No Limit  ($0.05/$0.1) - 2023/03/27 19:11:43
Table 'RushAndCash28166941' 6-max Seat #1 is the button
Seat 1: 154f3efa ($10.83 in chips)
Seat 2: 9ba6ae76 ($11.44 in chips)
Seat 3: cdbbd2a9 ($7.65 in chips)
Seat 4: 501c483d ($12.65 in chips)
Seat 5: Hero ($27.01 in chips)
Seat 6: d13f972 ($10 in chips)
9ba6ae76: posts small blind $0.05
cdbbd2a9: posts big blind $0.1
*** HOLE CARDS ***
Dealt to 154f3efa 
Dealt to 9ba6ae76 
Dealt to cdbbd2a9 
Dealt to 501c483d 
Dealt to Hero [6h 2s]
Dealt to d13f972 
501c483d: folds
Hero: folds
d13f972: folds
154f3efa: folds
9ba6ae76: raises $0.18 to $0.28
cdbbd2a9: folds
Uncalled bet ($0.18) returned to 9ba6ae76
*** SHOWDOWN ***
9ba6ae76 collected $0.2 from pot
*** SUMMARY ***
Total pot $0.2 | Rake $0 | Jackpot $0 | Bingo $0 | Fortune $0
Seat 1: 154f3efa (button) folded before Flop (didn't bet)
Seat 2: 9ba6ae76 (small blind) collected ($0.2)
Seat 3: cdbbd2a9 (big blind) folded before Flop
Seat 4: 501c483d folded before Flop (didn't bet)
Seat 5: Hero folded before Flop (didn't bet)
Seat 6: d13f972 folded before Flop (didn't bet)


Poker Hand #RC1433311585: Hold'em No Limit  ($0.05/$0.1) - 2023/03/27 19:11:28
Table 'RushAndCash28166845' 6-max Seat #1 is the button
Seat 1: cbf3c4aa ($16.82 in chips)
Seat 2: Hero ($27.06 in chips)
Seat 3: 7047baab ($44 in chips)
Seat 4: 8e854de7 ($10.1 in chips)
Seat 5: a725b62e ($26.2 in chips)
Seat 6: 784858c ($17.8 in chips)
Hero: posts small blind $0.05
7047baab: posts big blind $0.1
*** HOLE CARDS ***
Dealt to cbf3c4aa 
Dealt to Hero [Jc 8d]
Dealt to 7047baab 
Dealt to 8e854de7 
Dealt to a725b62e 
Dealt to 784858c 
8e854de7: folds
a725b62e: folds
784858c: folds
cbf3c4aa: folds
Hero: folds
Uncalled bet ($0.05) returned to 7047baab
*** SHOWDOWN ***
7047baab collected $0.1 from pot
*** SUMMARY ***
Total pot $0.1 | Rake $0 | Jackpot $0 | Bingo $0 | Fortune $0
Seat 1: cbf3c4aa (button) folded before Flop (didn't bet)
Seat 2: Hero (small blind) folded before Flop
Seat 3: 7047baab (big blind) collected ($0.1)
Seat 4: 8e854de7 folded before Flop (didn't bet)
Seat 5: a725b62e folded before Flop (didn't bet)
Seat 6: 784858c folded before Flop (didn't bet)


Poker Hand #RC1433311526: Hold'em No Limit  ($0.05/$0.1) - 2023/03/27 19:11:17
Table 'RushAndCash28166786' 6-max Seat #1 is the button
Seat 1: 4907797c ($11.09 in chips)
Seat 2: 84506d8f ($8.06 in chips)
Seat 3: e8004c2c ($10 in chips)
Seat 4: a6cb7267 ($10.22 in chips)
Seat 5: ed079812 ($9.55 in chips)
Seat 6: Hero ($27.06 in chips)
84506d8f: posts small blind $0.05
e8004c2c: posts big blind $0.1
*** HOLE CARDS ***
Dealt to 4907797c 
Dealt to 84506d8f 
Dealt to e8004c2c 
Dealt to a6cb7267 
Dealt to ed079812 
Dealt to Hero [8h Kc]
a6cb7267: folds
ed079812: folds
Hero: folds
4907797c: raises $0.15 to $0.25
84506d8f: folds
e8004c2c: calls $0.15
*** FLOP *** [Jd 7c Kh]
e8004c2c: checks
4907797c: bets $0.28
e8004c2c: calls $0.28
*** TURN *** [Jd 7c Kh] [Jh]
e8004c2c: checks
4907797c: checks
*** RIVER *** [Jd 7c Kh Jh] [Js]
e8004c2c: checks
4907797c: checks
e8004c2c: shows [9s Th] (Three Jacks)
4907797c: shows [Qs Td] (Three Jacks)
*** SHOWDOWN ***
4907797c collected $1.06 from pot
*** SUMMARY ***
Total pot $1.11 | Rake $0.05 | Jackpot $0 | Bingo $0 | Fortune $0
Board [Jd 7c Kh Jh Js]
Seat 1: 4907797c (button) showed [Qs Td] and won ($1.06) with Three Jacks
Seat 2: 84506d8f (small blind) folded before Flop
Seat 3: e8004c2c (big blind) showed [9s Th] and lost with Three Jacks
Seat 4: a6cb7267 folded before Flop (didn't bet)
Seat 5: ed079812 folded before Flop (didn't bet)
Seat 6: Hero folded before Flop (didn't bet)


Poker Hand #RC1433311465: Hold'em No Limit  ($0.05/$0.1) - 2023/03/27 19:11:08
Table 'RushAndCash28166725' 6-max Seat #1 is the button
Seat 1: b5c2a326 ($8.63 in chips)
Seat 2: ed079812 ($9.6 in chips)
Seat 3: Hero ($27.16 in chips)
Seat 4: 9ecf88a0 ($13.24 in chips)
Seat 5: 2a067861 ($7.69 in chips)
Seat 6: a6cb7267 ($10.22 in chips)
ed079812: posts small blind $0.05
Hero: posts big blind $0.1
*** HOLE CARDS ***
Dealt to b5c2a326 
Dealt to ed079812 
Dealt to Hero [8s 3h]
Dealt to 9ecf88a0 
Dealt to 2a067861 
Dealt to a6cb7267 
9ecf88a0: folds
2a067861: folds
a6cb7267: folds
b5c2a326: raises $0.15 to $0.25
ed079812: folds
Hero: folds
Uncalled bet ($0.15) returned to b5c2a326
*** SHOWDOWN ***
b5c2a326 collected $0.25 from pot
*** SUMMARY ***
Total pot $0.25 | Rake $0 | Jackpot $0 | Bingo $0 | Fortune $0
Seat 1: b5c2a326 (button) collected ($0.25)
Seat 2: ed079812 (small blind) folded before Flop
Seat 3: Hero (big blind) folded before Flop
Seat 4: 9ecf88a0 folded before Flop (didn't bet)
Seat 5: 2a067861 folded before Flop (didn't bet)
Seat 6: a6cb7267 folded before Flop (didn't bet)


Poker Hand #RC1433311234: Hold'em No Limit  ($0.05/$0.1) - 2023/03/27 19:10:34
Table 'RushAndCash28166494' 6-max Seat #1 is the button
Seat 1: 8077ec64 ($13.93 in chips)
Seat 2: a6cb7267 ($10.32 in chips)
Seat 3: Hero ($27.06 in chips)
Seat 4: a623d3a8 ($10.42 in chips)
Seat 5: af5b0e1f ($9.16 in chips)
Seat 6: d4e738b1 ($9.58 in chips)
a6cb7267: posts small blind $0.05
Hero: posts big blind $0.1
*** HOLE CARDS ***
Dealt to 8077ec64 
Dealt to a6cb7267 
Dealt to Hero [5h As]
Dealt to a623d3a8 
Dealt to af5b0e1f 
Dealt to d4e738b1 
a623d3a8: folds
af5b0e1f: folds
d4e738b1: folds
8077ec64: folds
a6cb7267: calls $0.05
Hero: raises $0.25 to $0.35
a6cb7267: folds
Uncalled bet ($0.25) returned to Hero
*** SHOWDOWN ***
Hero collected $0.2 from pot
*** SUMMARY ***
Total pot $0.2 | Rake $0 | Jackpot $0 | Bingo $0 | Fortune $0
Seat 1: 8077ec64 (button) folded before Flop (didn't bet)
Seat 2: a6cb7267 (small blind) folded before Flop
Seat 3: Hero (big blind) collected ($0.2)
Seat 4: a623d3a8 folded before Flop (didn't bet)
Seat 5: af5b0e1f folded before Flop (didn't bet)
Seat 6: d4e738b1 folded before Flop (didn't bet)


Poker Hand #RC1433311167: Hold'em No Limit  ($0.05/$0.1) - 2023/03/27 19:10:23
Table 'RushAndCash28166427' 6-max Seat #1 is the button
Seat 1: Hero ($26.91 in chips)
Seat 2: b59f0022 ($11.24 in chips)
Seat 3: b4ee20c8 ($12.52 in chips)
Seat 4: ec3bebf3 ($22.67 in chips)
Seat 5: 3be5a236 ($5.96 in chips)
Seat 6: c62acbd1 ($10 in chips)
b59f0022: posts small blind $0.05
b4ee20c8: posts big blind $0.1
*** HOLE CARDS ***
Dealt to Hero [Ks Ah]
Dealt to b59f0022 
Dealt to b4ee20c8 
Dealt to ec3bebf3 
Dealt to 3be5a236 
Dealt to c62acbd1 
ec3bebf3: folds
3be5a236: folds
c62acbd1: folds
Hero: raises $0.15 to $0.25
b59f0022: folds
b4ee20c8: folds
Uncalled bet ($0.15) returned to Hero
*** SHOWDOWN ***
Hero collected $0.25 from pot
*** SUMMARY ***
Total pot $0.25 | Rake $0 | Jackpot $0 | Bingo $0 | Fortune $0
Seat 1: Hero (button) collected ($0.25)
Seat 2: b59f0022 (small blind) folded before Flop
Seat 3: b4ee20c8 (big blind) folded before Flop
Seat 4: ec3bebf3 folded before Flop (didn't bet)
Seat 5: 3be5a236 folded before Flop (didn't bet)
Seat 6: c62acbd1 folded before Flop (didn't bet)


Poker Hand #RC1433311032: Hold'em No Limit  ($0.05/$0.1) - 2023/03/27 19:10:00
Table 'RushAndCash28166292' 6-max Seat #1 is the button
Seat 1: 9ecf88a0 ($13.39 in chips)
Seat 2: 3253ee1d ($11.38 in chips)
Seat 3: 38afe7c4 ($12.65 in chips)
Seat 4: 2ba63685 ($10.14 in chips)
Seat 5: Hero ($26.91 in chips)
Seat 6: b16539fc ($10.68 in chips)
3253ee1d: posts small blind $0.05
38afe7c4: posts big blind $0.1
*** HOLE CARDS ***
Dealt to 9ecf88a0 
Dealt to 3253ee1d 
Dealt to 38afe7c4 
Dealt to 2ba63685 
Dealt to Hero [Qc 4d]
Dealt to b16539fc 
2ba63685: folds
Hero: folds
b16539fc: raises $0.15 to $0.25
9ecf88a0: folds
3253ee1d: folds
38afe7c4: folds
Uncalled bet ($0.15) returned to b16539fc
*** SHOWDOWN ***
b16539fc collected $0.25 from pot
*** SUMMARY ***
Total pot $0.25 | Rake $0 | Jackpot $0 | Bingo $0 | Fortune $0
Seat 1: 9ecf88a0 (button) folded before Flop (didn't bet)
Seat 2: 3253ee1d (small blind) folded before Flop
Seat 3: 38afe7c4 (big blind) folded before Flop
Seat 4: 2ba63685 folded before Flop (didn't bet)
Seat 5: Hero folded before Flop (didn't bet)
Seat 6: b16539fc collected ($0.25)


Poker Hand #RC1433310963: Hold'em No Limit  ($0.05/$0.1) - 2023/03/27 19:09:50
Table 'RushAndCash28166223' 6-max Seat #1 is the button
Seat 1: Hero ($26.91 in chips)
Seat 2: 7c84e01d ($38.09 in chips)
Seat 3: 5b06e1bc ($14.63 in chips)
Seat 4: f98d6493 ($10.83 in chips)
Seat 5: ab5abfa7 ($16.32 in chips)
Seat 6: aa5ba7d2 ($9.51 in chips)
7c84e01d: posts small blind $0.05
5b06e1bc: posts big blind $0.1
*** HOLE CARDS ***
Dealt to Hero [Jd 2c]
Dealt to 7c84e01d 
Dealt to 5b06e1bc 
Dealt to f98d6493 
Dealt to ab5abfa7 
Dealt to aa5ba7d2 
f98d6493: folds
ab5abfa7: folds
aa5ba7d2: folds
Hero: folds
7c84e01d: folds
Uncalled bet ($0.05) returned to 5b06e1bc
*** SHOWDOWN ***
5b06e1bc collected $0.1 from pot
*** SUMMARY ***
Total pot $0.1 | Rake $0 | Jackpot $0 | Bingo $0 | Fortune $0
Seat 1: Hero (button) folded before Flop (didn't bet)
Seat 2: 7c84e01d (small blind) folded before Flop
Seat 3: 5b06e1bc (big blind) collected ($0.1)
Seat 4: f98d6493 folded before Flop (didn't bet)
Seat 5: ab5abfa7 folded before Flop (didn't bet)
Seat 6: aa5ba7d2 folded before Flop (didn't bet)


Poker Hand #RC1433310786: Hold'em No Limit  ($0.05/$0.1) - 2023/03/27 19:09:20
Table 'RushAndCash28166046' 6-max Seat #1 is the button
Seat 1: f09c363f ($35.6 in chips)
Seat 2: Hero ($26.64 in chips)
Seat 3: 7c84e01d ($38.39 in chips)
Seat 4: 1ab83526 ($5.4 in chips)
Seat 5: f153bfd6 ($13.12 in chips)
Seat 6: 4ee6706f ($11.07 in chips)
Hero: posts small blind $0.05
7c84e01d: posts big blind $0.1
*** HOLE CARDS ***
Dealt to f09c363f 
Dealt to Hero [4c 4h]
Dealt to 7c84e01d 
Dealt to 1ab83526 
Dealt to f153bfd6 
Dealt to 4ee6706f 
1ab83526: folds
f153bfd6: folds
4ee6706f: folds
f09c363f: folds
Hero: raises $0.2 to $0.3
7c84e01d: calls $0.2
*** FLOP *** [4d 2c Td]
Hero: bets $0.45
7c84e01d: folds
Uncalled bet ($0.45) returned to Hero
*** SHOWDOWN ***
Hero collected $0.57 from pot
*** SUMMARY ***
Total pot $0.6 | Rake $0.03 | Jackpot $0 | Bingo $0 | Fortune $0
Board [4d 2c Td]
Seat 1: f09c363f (button) folded before Flop (didn't bet)
Seat 2: Hero (small blind) won ($0.57)
Seat 3: 7c84e01d (big blind) folded on the Flop
Seat 4: 1ab83526 folded before Flop (didn't bet)
Seat 5: f153bfd6 folded before Flop (didn't bet)
Seat 6: 4ee6706f folded before Flop (didn't bet)


Poker Hand #RC1433310643: Hold'em No Limit  ($0.05/$0.1) - 2023/03/27 19:08:58
Table 'RushAndCash28165903' 6-max Seat #1 is the button
Seat 1: 744add28 ($11.19 in chips)
Seat 2: a6cb7267 ($10.05 in chips)
Seat 3: Hero ($26.74 in chips)
Seat 4: d7e67021 ($10.91 in chips)
Seat 5: bad1df0e ($8.07 in chips)
Seat 6: abb4567e ($10 in chips)
a6cb7267: posts small blind $0.05
Hero: posts big blind $0.1
*** HOLE CARDS ***
Dealt to 744add28 
Dealt to a6cb7267 
Dealt to Hero [6s 7s]
Dealt to d7e67021 
Dealt to bad1df0e 
Dealt to abb4567e 
d7e67021: folds
bad1df0e: raises $0.15 to $0.25
abb4567e: folds
744add28: raises $0.55 to $0.8
a6cb7267: folds
Hero: folds
bad1df0e: folds
Uncalled bet ($0.55) returned to 744add28
*** SHOWDOWN ***
744add28 collected $0.62 from pot
*** SUMMARY ***
Total pot $0.65 | Rake $0.03 | Jackpot $0 | Bingo $0 | Fortune $0
Seat 1: 744add28 (button) collected ($0.62)
Seat 2: a6cb7267 (small blind) folded before Flop
Seat 3: Hero (big blind) folded before Flop
Seat 4: d7e67021 folded before Flop (didn't bet)
Seat 5: bad1df0e folded before Flop
Seat 6: abb4567e folded before Flop (didn't bet)


Poker Hand #RC1433310592: Hold'em No Limit  ($0.05/$0.1) - 2023/03/27 19:08:52
Table 'RushAndCash28165852' 6-max Seat #1 is the button
Seat 1: 30999d4e ($12.71 in chips)
Seat 2: fca90731 ($10 in chips)
Seat 3: c546be70 ($14.55 in chips)
Seat 4: c8fe5a01 ($10 in chips)
Seat 5: Hero ($26.74 in chips)
Seat 6: e5558e5d ($10 in chips)
fca90731: posts small blind $0.05
c546be70: posts big blind $0.1
*** HOLE CARDS ***
Dealt to 30999d4e 
Dealt to fca90731 
Dealt to c546be70 
Dealt to c8fe5a01 
Dealt to Hero [8h Ts]
Dealt to e5558e5d 
c8fe5a01: folds
Hero: folds
e5558e5d: folds
30999d4e: raises $0.2 to $0.3
fca90731: folds
c546be70: folds
Uncalled bet ($0.2) returned to 30999d4e
*** SHOWDOWN ***
30999d4e collected $0.25 from pot
*** SUMMARY ***
Total pot $0.25 | Rake $0 | Jackpot $0 | Bingo $0 | Fortune $0
Seat 1: 30999d4e (button) collected ($0.25)
Seat 2: fca90731 (small blind) folded before Flop
Seat 3: c546be70 (big blind) folded before Flop
Seat 4: c8fe5a01 folded before Flop (didn't bet)
Seat 5: Hero folded before Flop (didn't bet)
Seat 6: e5558e5d folded before Flop (didn't bet)


Poker Hand #RC1433310554: Hold'em No Limit  ($0.05/$0.1) - 2023/03/27 19:08:46
Table 'RushAndCash28165814' 6-max Seat #1 is the button
Seat 1: 191ad11b ($9.58 in chips)
Seat 2: 2a8ab56b ($17.22 in chips)
Seat 3: c522d2b5 ($13.8 in chips)
Seat 4: 401bc80e ($20.95 in chips)
Seat 5: Hero ($26.74 in chips)
Seat 6: 8c661705 ($16.41 in chips)
2a8ab56b: posts small blind $0.05
c522d2b5: posts big blind $0.1
*** HOLE CARDS ***
Dealt to 191ad11b 
Dealt to 2a8ab56b 
Dealt to c522d2b5 
Dealt to 401bc80e 
Dealt to Hero [8h 4c]
Dealt to 8c661705 
401bc80e: folds
Hero: folds
8c661705: folds
191ad11b: raises $0.1 to $0.2
2a8ab56b: folds
c522d2b5: folds
Uncalled bet ($0.1) returned to 191ad11b
*** SHOWDOWN ***
191ad11b collected $0.25 from pot
*** SUMMARY ***
Total pot $0.25 | Rake $0 | Jackpot $0 | Bingo $0 | Fortune $0
Seat 1: 191ad11b (button) collected ($0.25)
Seat 2: 2a8ab56b (small blind) folded before Flop
Seat 3: c522d2b5 (big blind) folded before Flop
Seat 4: 401bc80e folded before Flop (didn't bet)
Seat 5: Hero folded before Flop (didn't bet)
Seat 6: 8c661705 folded before Flop (didn't bet)


Poker Hand #RC1433310483: Hold'em No Limit  ($0.05/$0.1) - 2023/03/27 19:08:36
Table 'RushAndCash28165743' 6-max Seat #1 is the button
Seat 1: b6ccf254 ($47.59 in chips)
Seat 2: 42b5d798 ($5.89 in chips)
Seat 3: 54799540 ($17.91 in chips)
Seat 4: b4ee20c8 ($11.78 in chips)
Seat 5: efc583b ($9.77 in chips)
Seat 6: Hero ($26.74 in chips)
42b5d798: posts small blind $0.05
54799540: posts big blind $0.1
*** HOLE CARDS ***
Dealt to b6ccf254 
Dealt to 42b5d798 
Dealt to 54799540 
Dealt to b4ee20c8 
Dealt to efc583b 
Dealt to Hero [5d 2s]
b4ee20c8: folds
efc583b: folds
Hero: folds
b6ccf254: folds
42b5d798: folds
Uncalled bet ($0.05) returned to 54799540
*** SHOWDOWN ***
54799540 collected $0.1 from pot
*** SUMMARY ***
Total pot $0.1 | Rake $0 | Jackpot $0 | Bingo $0 | Fortune $0
Seat 1: b6ccf254 (button) folded before Flop (didn't bet)
Seat 2: 42b5d798 (small blind) folded before Flop
Seat 3: 54799540 (big blind) collected ($0.1)
Seat 4: b4ee20c8 folded before Flop (didn't bet)
Seat 5: efc583b folded before Flop (didn't bet)
Seat 6: Hero folded before Flop (didn't bet)


Poker Hand #RC1433310440: Hold'em No Limit  ($0.05/$0.1) - 2023/03/27 19:08:30
Table 'RushAndCash28165700' 6-max Seat #1 is the button
Seat 1: 6c1c848d ($12.4 in chips)
Seat 2: 9b3cdb65 ($31.43 in chips)
Seat 3: 74aeaadc ($38.87 in chips)
Seat 4: Hero ($26.74 in chips)
Seat 5: 5a6c8cee ($10.96 in chips)
Seat 6: d06c0c15 ($2.75 in chips)
9b3cdb65: posts small blind $0.05
74aeaadc: posts big blind $0.1
*** HOLE CARDS ***
Dealt to 6c1c848d 
Dealt to 9b3cdb65 
Dealt to 74aeaadc 
Dealt to Hero [7c Td]
Dealt to 5a6c8cee 
Dealt to d06c0c15 
Hero: folds
5a6c8cee: raises $0.15 to $0.25
d06c0c15: folds
6c1c848d: calls $0.25
9b3cdb65: folds
74aeaadc: folds
*** FLOP *** [3c Js Ks]
5a6c8cee: bets $0.33
6c1c848d: calls $0.33
*** TURN *** [3c Js Ks] [Ah]
5a6c8cee: bets $0.99
6c1c848d: folds
Uncalled bet ($0.99) returned to 5a6c8cee
*** SHOWDOWN ***
5a6c8cee collected $1.25 from pot
*** SUMMARY ***
Total pot $1.31 | Rake $0.06 | Jackpot $0 | Bingo $0 | Fortune $0
Board [3c Js Ks Ah]
Seat 1: 6c1c848d (button) folded on the Turn
Seat 2: 9b3cdb65 (small blind) folded before Flop
Seat 3: 74aeaadc (big blind) folded before Flop
Seat 4: Hero folded before Flop (didn't bet)
Seat 5: 5a6c8cee won ($1.25)
Seat 6: d06c0c15 folded before Flop (didn't bet)


Poker Hand #RC1433310325: Hold'em No Limit  ($0.05/$0.1) - 2023/03/27 19:08:13
Table 'RushAndCash28165585' 6-max Seat #1 is the button
Seat 1: Hero ($26.74 in chips)
Seat 2: acd99267 ($13.42 in chips)
Seat 3: 8fe2c36b ($10.38 in chips)
Seat 4: 4ba966ea ($13.39 in chips)
Seat 5: 5eeee9be ($25.27 in chips)
Seat 6: 2fa1cf2b ($25.42 in chips)
acd99267: posts small blind $0.05
8fe2c36b: posts big blind $0.1
*** HOLE CARDS ***
Dealt to Hero [5d Jh]
Dealt to acd99267 
Dealt to 8fe2c36b 
Dealt to 4ba966ea 
Dealt to 5eeee9be 
Dealt to 2fa1cf2b 
4ba966ea: raises $0.1 to $0.2
5eeee9be: folds
2fa1cf2b: raises $0.45 to $0.65
Hero: folds
acd99267: folds
8fe2c36b: folds
4ba966ea: folds
Uncalled bet ($0.45) returned to 2fa1cf2b
*** SHOWDOWN ***
2fa1cf2b collected $0.53 from pot
*** SUMMARY ***
Total pot $0.55 | Rake $0.02 | Jackpot $0 | Bingo $0 | Fortune $0
Seat 1: Hero (button) folded before Flop (didn't bet)
Seat 2: acd99267 (small blind) folded before Flop
Seat 3: 8fe2c36b (big blind) folded before Flop
Seat 4: 4ba966ea folded before Flop
Seat 5: 5eeee9be folded before Flop (didn't bet)
Seat 6: 2fa1cf2b collected ($0.53)


Poker Hand #RC1433310019: Hold'em No Limit  ($0.05/$0.1) - 2023/03/27 19:07:27
Table 'RushAndCash28165279' 6-max Seat #1 is the button
Seat 1: bf5c8e2c ($11.37 in chips)
Seat 2: 409d9b29 ($29.26 in chips)
Seat 3: Hero ($27.44 in chips)
Seat 4: bd1a3075 ($17.91 in chips)
Seat 5: acd99267 ($12.5 in chips)
Seat 6: 7720e09f ($14.83 in chips)
409d9b29: posts small blind $0.05
Hero: posts big blind $0.1
*** HOLE CARDS ***
Dealt to bf5c8e2c 
Dealt to 409d9b29 
Dealt to Hero [Qs Ts]
Dealt to bd1a3075 
Dealt to acd99267 
Dealt to 7720e09f 
bd1a3075: folds
acd99267: raises $0.15 to $0.25
7720e09f: folds
bf5c8e2c: calls $0.25
409d9b29: folds
Hero: calls $0.15
*** FLOP *** [6d 6h 9s]
Hero: bets $0.45
acd99267: raises $0.95 to $1.4
bf5c8e2c: folds
Hero: folds
Uncalled bet ($0.95) returned to acd99267
*** SHOWDOWN ***
acd99267 collected $1.62 from pot
*** SUMMARY ***
Total pot $1.7 | Rake $0.08 | Jackpot $0 | Bingo $0 | Fortune $0
Board [6d 6h 9s]
Seat 1: bf5c8e2c (button) folded on the Flop
Seat 2: 409d9b29 (small blind) folded before Flop
Seat 3: Hero (big blind) folded on the Flop
Seat 4: bd1a3075 folded before Flop (didn't bet)
Seat 5: acd99267 won ($1.62)
Seat 6: 7720e09f folded before Flop (didn't bet)


Poker Hand #RC1433309989: Hold'em No Limit  ($0.05/$0.1) - 2023/03/27 19:07:22
Table 'RushAndCash28165249' 6-max Seat #1 is the button
Seat 1: df4415f ($13.64 in chips)
Seat 2: 17e7697a ($22.21 in chips)
Seat 3: b3645cfc ($14.54 in chips)
Seat 4: Hero ($27.44 in chips)
Seat 5: c1a8516 ($11.1 in chips)
Seat 6: 2a8ab56b ($13.99 in chips)
17e7697a: posts small blind $0.05
b3645cfc: posts big blind $0.1
*** HOLE CARDS ***
Dealt to df4415f 
Dealt to 17e7697a 
Dealt to b3645cfc 
Dealt to Hero [3c 2c]
Dealt to c1a8516 
Dealt to 2a8ab56b 
Hero: folds
c1a8516: folds
2a8ab56b: raises $0.15 to $0.25
df4415f: folds
17e7697a: folds
b3645cfc: raises $0.85 to $1.1
2a8ab56b: calls $0.85
*** FLOP *** [Jc 6d Tc]
b3645cfc: bets $0.75
2a8ab56b: calls $0.75
*** TURN *** [Jc 6d Tc] [Qh]
b3645cfc: bets $1.88
2a8ab56b: raises $10.26 to $12.14 and is all-in
b3645cfc: folds
Uncalled bet ($10.26) returned to 2a8ab56b
*** SHOWDOWN ***
2a8ab56b collected $7.06 from pot
*** SUMMARY ***
Total pot $7.51 | Rake $0.3 | Jackpot $0.15 | Bingo $0 | Fortune $0
Board [Jc 6d Tc Qh]
Seat 1: df4415f (button) folded before Flop (didn't bet)
Seat 2: 17e7697a (small blind) folded before Flop
Seat 3: b3645cfc (big blind) folded on the Turn
Seat 4: Hero folded before Flop (didn't bet)
Seat 5: c1a8516 folded before Flop (didn't bet)
Seat 6: 2a8ab56b won ($7.06)


Poker Hand #RC1433309961: Hold'em No Limit  ($0.05/$0.1) - 2023/03/27 19:07:18
Table 'RushAndCash28165221' 6-max Seat #1 is the button
Seat 1: 57f410da ($17.91 in chips)
Seat 2: Hero ($27.49 in chips)
Seat 3: 2616e50 ($19.74 in chips)
Seat 4: b3645cfc ($14.54 in chips)
Seat 5: d601e59c ($10.72 in chips)
Seat 6: 4271d829 ($19.63 in chips)
Hero: posts small blind $0.05
2616e50: posts big blind $0.1
*** HOLE CARDS ***
Dealt to 57f410da 
Dealt to Hero [Tc 3s]
Dealt to 2616e50 
Dealt to b3645cfc 
Dealt to d601e59c 
Dealt to 4271d829 
b3645cfc: folds
d601e59c: raises $0.1 to $0.2
4271d829: folds
57f410da: folds
Hero: folds
2616e50: calls $0.1
*** FLOP *** [8s 2s Kd]
2616e50: checks
d601e59c: checks
*** TURN *** [8s 2s Kd] [6s]
2616e50: checks
d601e59c: checks
*** RIVER *** [8s 2s Kd 6s] [Ad]
2616e50: checks
d601e59c: checks
2616e50: shows [Jc 5h] (Ace-High)
d601e59c: shows [4s 4h] (Pair of Fours)
*** SHOWDOWN ***
d601e59c collected $0.43 from pot
*** SUMMARY ***
Total pot $0.45 | Rake $0.02 | Jackpot $0 | Bingo $0 | Fortune $0
Board [8s 2s Kd 6s Ad]
Seat 1: 57f410da (button) folded before Flop (didn't bet)
Seat 2: Hero (small blind) folded before Flop
Seat 3: 2616e50 (big blind) showed [Jc 5h] and lost with Ace-High
Seat 4: b3645cfc folded before Flop (didn't bet)
Seat 5: d601e59c showed [4s 4h] and won ($0.43) with Pair of Fours
Seat 6: 4271d829 folded before Flop (didn't bet)


Poker Hand #RC1433309558: Hold'em No Limit  ($0.05/$0.1) - 2023/03/27 19:06:21
Table 'RushAndCash28164818' 6-max Seat #1 is the button
Seat 1: be507587 ($18.76 in chips)
Seat 2: 1a7e6a8 ($7.54 in chips)
Seat 3: 5b464716 ($38.86 in chips)
Seat 4: Hero ($27.49 in chips)
Seat 5: 5ae041e4 ($12.45 in chips)
Seat 6: d4e738b1 ($9.59 in chips)
1a7e6a8: posts small blind $0.05
5b464716: posts big blind $0.1
*** HOLE CARDS ***
Dealt to be507587 
Dealt to 1a7e6a8 
Dealt to 5b464716 
Dealt to Hero [9h 8s]
Dealt to 5ae041e4 
Dealt to d4e738b1 
Hero: folds
5ae041e4: folds
d4e738b1: folds
be507587: raises $0.15 to $0.25
1a7e6a8: calls $0.2
5b464716: raises $1.15 to $1.4
be507587: folds
1a7e6a8: folds
Uncalled bet ($1.15) returned to 5b464716
*** SHOWDOWN ***
5b464716 collected $0.72 from pot
*** SUMMARY ***
Total pot $0.75 | Rake $0.03 | Jackpot $0 | Bingo $0 | Fortune $0
Seat 1: be507587 (button) folded before Flop
Seat 2: 1a7e6a8 (small blind) folded before Flop
Seat 3: 5b464716 (big blind) collected ($0.72)
Seat 4: Hero folded before Flop (didn't bet)
Seat 5: 5ae041e4 folded before Flop (didn't bet)
Seat 6: d4e738b1 folded before Flop (didn't bet)


Poker Hand #RC1433309447: Hold'em No Limit  ($0.05/$0.1) - 2023/03/27 19:06:05
Table 'RushAndCash28164707' 6-max Seat #1 is the button
Seat 1: b16539fc ($21.12 in chips)
Seat 2: c362b68 ($8.85 in chips)
Seat 3: 4b41c725 ($13.77 in chips)
Seat 4: 337f6df3 ($14.05 in chips)
Seat 5: 62cd9292 ($9.85 in chips)
Seat 6: Hero ($27.49 in chips)
c362b68: posts small blind $0.05
4b41c725: posts big blind $0.1
*** HOLE CARDS ***
Dealt to b16539fc 
Dealt to c362b68 
Dealt to 4b41c725 
Dealt to 337f6df3 
Dealt to 62cd9292 
Dealt to Hero [9s 5d]
337f6df3: raises $0.2 to $0.3
62cd9292: folds
Hero: folds
b16539fc: folds
c362b68: calls $0.25
4b41c725: folds
*** FLOP *** [3d 7d Jd]
c362b68: checks
337f6df3: checks
*** TURN *** [3d 7d Jd] [Ks]
c362b68: bets $0.53
337f6df3: calls $0.53
*** RIVER *** [3d 7d Jd Ks] [9h]
c362b68: bets $1.76
337f6df3: folds
Uncalled bet ($1.76) returned to c362b68
337f6df3: shows [As Kh] (Pair of Kings)
*** SHOWDOWN ***
c362b68 collected $1.68 from pot
*** SUMMARY ***
Total pot $1.76 | Rake $0.08 | Jackpot $0 | Bingo $0 | Fortune $0
Board [3d 7d Jd Ks 9h]
Seat 1: b16539fc (button) folded before Flop (didn't bet)
Seat 2: c362b68 (small blind) won ($1.68)
Seat 3: 4b41c725 (big blind) folded before Flop
Seat 4: 337f6df3 folded on the River
Seat 5: 62cd9292 folded before Flop (didn't bet)
Seat 6: Hero folded before Flop (didn't bet)


Poker Hand #RC1433309309: Hold'em No Limit  ($0.05/$0.1) - 2023/03/27 19:05:45
Table 'RushAndCash28164569' 6-max Seat #1 is the button
Seat 1: 9d4b5cce ($10.15 in chips)
Seat 2: 337f6df3 ($14.2 in chips)
Seat 3: Hero ($27.59 in chips)
Seat 4: c365dd54 ($8.18 in chips)
Seat 5: efa98784 ($12.11 in chips)
Seat 6: 32bd07c4 ($10.15 in chips)
337f6df3: posts small blind $0.05
Hero: posts big blind $0.1
*** HOLE CARDS ***
Dealt to 9d4b5cce 
Dealt to 337f6df3 
Dealt to Hero [5s 4d]
Dealt to c365dd54 
Dealt to efa98784 
Dealt to 32bd07c4 
c365dd54: calls $0.1
efa98784: folds
32bd07c4: folds
9d4b5cce: raises $0.2 to $0.3
337f6df3: folds
Hero: folds
c365dd54: calls $0.2
*** FLOP *** [6s 8c 4s]
c365dd54: checks
9d4b5cce: checks
*** TURN *** [6s 8c 4s] [5h]
c365dd54: checks
9d4b5cce: checks
*** RIVER *** [6s 8c 4s 5h] [Ks]
c365dd54: checks
9d4b5cce: checks
c365dd54: shows [6c Tc] (Pair of Sixes)
9d4b5cce: shows [Qh Js] (King-High)
*** SHOWDOWN ***
c365dd54 collected $0.72 from pot
*** SUMMARY ***
Total pot $0.75 | Rake $0.03 | Jackpot $0 | Bingo $0 | Fortune $0
Board [6s 8c 4s 5h Ks]
Seat 1: 9d4b5cce (button) showed [Qh Js] and lost with King-High
Seat 2: 337f6df3 (small blind) folded before Flop
Seat 3: Hero (big blind) folded before Flop
Seat 4: c365dd54 showed [6c Tc] and won ($0.72) with Pair of Sixes
Seat 5: efa98784 folded before Flop (didn't bet)
Seat 6: 32bd07c4 folded before Flop (didn't bet)


Poker Hand #RC1433309243: Hold'em No Limit  ($0.05/$0.1) - 2023/03/27 19:05:35
Table 'RushAndCash28164503' 6-max Seat #1 is the button
Seat 1: e15b2607 ($10 in chips)
Seat 2: 223002eb ($11.2 in chips)
Seat 3: e98ae4a0 ($10.57 in chips)
Seat 4: 67cfc163 ($22.65 in chips)
Seat 5: 996cdd25 ($19.49 in chips)
Seat 6: Hero ($27.59 in chips)
223002eb: posts small blind $0.05
e98ae4a0: posts big blind $0.1
*** HOLE CARDS ***
Dealt to e15b2607 
Dealt to 223002eb 
Dealt to e98ae4a0 
Dealt to 67cfc163 
Dealt to 996cdd25 
Dealt to Hero [8h 4h]
67cfc163: raises $0.15 to $0.25
996cdd25: folds
Hero: folds
e15b2607: folds
223002eb: folds
e98ae4a0: folds
Uncalled bet ($0.15) returned to 67cfc163
*** SHOWDOWN ***
67cfc163 collected $0.25 from pot
*** SUMMARY ***
Total pot $0.25 | Rake $0 | Jackpot $0 | Bingo $0 | Fortune $0
Seat 1: e15b2607 (button) folded before Flop (didn't bet)
Seat 2: 223002eb (small blind) folded before Flop
Seat 3: e98ae4a0 (big blind) folded before Flop
Seat 4: 67cfc163 collected ($0.25)
Seat 5: 996cdd25 folded before Flop (didn't bet)
Seat 6: Hero folded before Flop (didn't bet)


Poker Hand #RC1433309003: Hold'em No Limit  ($0.05/$0.1) - 2023/03/27 19:04:58
Table 'RushAndCash28164263' 6-max Seat #1 is the button
Seat 1: Hero ($27.81 in chips)
Seat 2: defc8945 ($14.27 in chips)
Seat 3: 68daf55d ($10.1 in chips)
Seat 4: 522e6aae ($30.86 in chips)
Seat 5: e98ae4a0 ($10.23 in chips)
Seat 6: 6ff9bbe9 ($16.89 in chips)
defc8945: posts small blind $0.05
68daf55d: posts big blind $0.1
*** HOLE CARDS ***
Dealt to Hero [4s 5s]
Dealt to defc8945 
Dealt to 68daf55d 
Dealt to 522e6aae 
Dealt to e98ae4a0 
Dealt to 6ff9bbe9 
522e6aae: folds
e98ae4a0: raises $0.12 to $0.22
6ff9bbe9: folds
Hero: calls $0.22
defc8945: folds
68daf55d: folds
*** FLOP *** [7c Kh 5h]
e98ae4a0: checks
Hero: checks
*** TURN *** [7c Kh 5h] [8d]
e98ae4a0: bets $0.3
Hero: folds
Uncalled bet ($0.3) returned to e98ae4a0
*** SHOWDOWN ***
e98ae4a0 collected $0.56 from pot
*** SUMMARY ***
Total pot $0.59 | Rake $0.03 | Jackpot $0 | Bingo $0 | Fortune $0
Board [7c Kh 5h 8d]
Seat 1: Hero (button) folded on the Turn
Seat 2: defc8945 (small blind) folded before Flop
Seat 3: 68daf55d (big blind) folded before Flop
Seat 4: 522e6aae folded before Flop (didn't bet)
Seat 5: e98ae4a0 won ($0.56)
Seat 6: 6ff9bbe9 folded before Flop (didn't bet)


Poker Hand #RC1433308796: Hold'em No Limit  ($0.05/$0.1) - 2023/03/27 19:04:27
Table 'RushAndCash28164056' 6-max Seat #1 is the button
Seat 1: c522d2b5 ($10.98 in chips)
Seat 2: Hero ($27.49 in chips)
Seat 3: c5e6dd04 ($19.58 in chips)
Seat 4: e5558e5d ($10 in chips)
Seat 5: 9779c48b ($17.17 in chips)
Seat 6: ec3bebf3 ($23.23 in chips)
Hero: posts small blind $0.05
c5e6dd04: posts big blind $0.1
*** HOLE CARDS ***
Dealt to c522d2b5 
Dealt to Hero [Ac Ts]
Dealt to c5e6dd04 
Dealt to e5558e5d 
Dealt to 9779c48b 
Dealt to ec3bebf3 
e5558e5d: folds
9779c48b: folds
ec3bebf3: raises $0.15 to $0.25
c522d2b5: folds
Hero: raises $0.75 to $1
c5e6dd04: folds
ec3bebf3: folds
Uncalled bet ($0.75) returned to Hero
*** SHOWDOWN ***
Hero collected $0.57 from pot
*** SUMMARY ***
Total pot $0.6 | Rake $0.03 | Jackpot $0 | Bingo $0 | Fortune $0
Seat 1: c522d2b5 (button) folded before Flop (didn't bet)
Seat 2: Hero (small blind) collected ($0.57)
Seat 3: c5e6dd04 (big blind) folded before Flop
Seat 4: e5558e5d folded before Flop (didn't bet)
Seat 5: 9779c48b folded before Flop (didn't bet)
Seat 6: ec3bebf3 folded before Flop


Poker Hand #RC1433308759: Hold'em No Limit  ($0.05/$0.1) - 2023/03/27 19:04:21
Table 'RushAndCash28164019' 6-max Seat #1 is the button
Seat 1: 36392a82 ($7.4 in chips)
Seat 2: eda6868 ($28.05 in chips)
Seat 3: cfbab7a9 ($10 in chips)
Seat 4: 255dc6f2 ($7.82 in chips)
Seat 5: 880f1c43 ($10.15 in chips)
Seat 6: Hero ($27.49 in chips)
eda6868: posts small blind $0.05
cfbab7a9: posts big blind $0.1
*** HOLE CARDS ***
Dealt to 36392a82 
Dealt to eda6868 
Dealt to cfbab7a9 
Dealt to 255dc6f2 
Dealt to 880f1c43 
Dealt to Hero [8s Jd]
255dc6f2: folds
880f1c43: folds
Hero: folds
36392a82: raises $0.2 to $0.3
eda6868: folds
cfbab7a9: folds
Uncalled bet ($0.2) returned to 36392a82
*** SHOWDOWN ***
36392a82 collected $0.25 from pot
*** SUMMARY ***
Total pot $0.25 | Rake $0 | Jackpot $0 | Bingo $0 | Fortune $0
Seat 1: 36392a82 (button) collected ($0.25)
Seat 2: eda6868 (small blind) folded before Flop
Seat 3: cfbab7a9 (big blind) folded before Flop
Seat 4: 255dc6f2 folded before Flop (didn't bet)
Seat 5: 880f1c43 folded before Flop (didn't bet)
Seat 6: Hero folded before Flop (didn't bet)


Poker Hand #RC1433308223: Hold'em No Limit  ($0.05/$0.1) - 2023/03/27 19:02:56
Table 'RushAndCash28163483' 6-max Seat #1 is the button
Seat 1: 25295a38 ($87.68 in chips)
Seat 2: 9098cd98 ($26.15 in chips)
Seat 3: 880f1c43 ($10.15 in chips)
Seat 4: 5c0db35c ($10.15 in chips)
Seat 5: c5e6dd04 ($19.58 in chips)
Seat 6: Hero ($27.49 in chips)
9098cd98: posts small blind $0.05
880f1c43: posts big blind $0.1
*** HOLE CARDS ***
Dealt to 25295a38 
Dealt to 9098cd98 
Dealt to 880f1c43 
Dealt to 5c0db35c 
Dealt to c5e6dd04 
Dealt to Hero [2d 6h]
5c0db35c: folds
c5e6dd04: folds
Hero: folds
25295a38: folds
9098cd98: folds
Uncalled bet ($0.05) returned to 880f1c43
*** SHOWDOWN ***
880f1c43 collected $0.1 from pot
*** SUMMARY ***
Total pot $0.1 | Rake $0 | Jackpot $0 | Bingo $0 | Fortune $0
Seat 1: 25295a38 (button) folded before Flop (didn't bet)
Seat 2: 9098cd98 (small blind) folded before Flop
Seat 3: 880f1c43 (big blind) collected ($0.1)
Seat 4: 5c0db35c folded before Flop (didn't bet)
Seat 5: c5e6dd04 folded before Flop (didn't bet)
Seat 6: Hero folded before Flop (didn't bet)


Poker Hand #RC1433308192: Hold'em No Limit  ($0.05/$0.1) - 2023/03/27 19:02:51
Table 'RushAndCash28163452' 6-max Seat #1 is the button
Seat 1: 341053d6 ($25.32 in chips)
Seat 2: efa98784 ($12.19 in chips)
Seat 3: 2616e50 ($18.34 in chips)
Seat 4: ab5abfa7 ($15.73 in chips)
Seat 5: Hero ($27.49 in chips)
Seat 6: 5e859c99 ($10 in chips)
efa98784: posts small blind $0.05
2616e50: posts big blind $0.1
*** HOLE CARDS ***
Dealt to 341053d6 
Dealt to efa98784 
Dealt to 2616e50 
Dealt to ab5abfa7 
Dealt to Hero [7c Qh]
Dealt to 5e859c99 
ab5abfa7: folds
Hero: folds
5e859c99: folds
341053d6: raises $0.13 to $0.23
efa98784: calls $0.18
2616e50: folds
*** FLOP *** [Jc 2h Th]
efa98784: checks
341053d6: bets $0.28
efa98784: folds
Uncalled bet ($0.28) returned to 341053d6
*** SHOWDOWN ***
341053d6 collected $0.54 from pot
*** SUMMARY ***
Total pot $0.56 | Rake $0.02 | Jackpot $0 | Bingo $0 | Fortune $0
Board [Jc 2h Th]
Seat 1: 341053d6 (button) won ($0.54)
Seat 2: efa98784 (small blind) folded on the Flop
Seat 3: 2616e50 (big blind) folded before Flop
Seat 4: ab5abfa7 folded before Flop (didn't bet)
Seat 5: Hero folded before Flop (didn't bet)
Seat 6: 5e859c99 folded before Flop (didn't bet)


Poker Hand #RC1433308115: Hold'em No Limit  ($0.05/$0.1) - 2023/03/27 19:02:40
Table 'RushAndCash28163375' 6-max Seat #1 is the button
Seat 1: d3a652d6 ($23.21 in chips)
Seat 2: d4e738b1 ($10.1 in chips)
Seat 3: ffca6b72 ($5.78 in chips)
Seat 4: abb4567e ($11.81 in chips)
Seat 5: Hero ($27.34 in chips)
Seat 6: 61c00c39 ($15.52 in chips)
d4e738b1: posts small blind $0.05
ffca6b72: posts big blind $0.1
*** HOLE CARDS ***
Dealt to d3a652d6 
Dealt to d4e738b1 
Dealt to ffca6b72 
Dealt to abb4567e 
Dealt to Hero [Qd Td]
Dealt to 61c00c39 
abb4567e: folds
Hero: raises $0.15 to $0.25
61c00c39: folds
d3a652d6: folds
d4e738b1: folds
ffca6b72: folds
Uncalled bet ($0.15) returned to Hero
*** SHOWDOWN ***
Hero collected $0.25 from pot
*** SUMMARY ***
Total pot $0.25 | Rake $0 | Jackpot $0 | Bingo $0 | Fortune $0
Seat 1: d3a652d6 (button) folded before Flop (didn't bet)
Seat 2: d4e738b1 (small blind) folded before Flop
Seat 3: ffca6b72 (big blind) folded before Flop
Seat 4: abb4567e folded before Flop (didn't bet)
Seat 5: Hero collected ($0.25)
Seat 6: 61c00c39 folded before Flop (didn't bet)


Poker Hand #RC1433308057: Hold'em No Limit  ($0.05/$0.1) - 2023/03/27 19:02:32
Table 'RushAndCash28163317' 6-max Seat #1 is the button
Seat 1: e37c7354 ($40.4 in chips)
Seat 2: 682e00a ($21.33 in chips)
Seat 3: Hero ($27.29 in chips)
Seat 4: c408194d ($10.05 in chips)
Seat 5: 6998845b ($11.27 in chips)
Seat 6: 45ba3752 ($14.35 in chips)
682e00a: posts small blind $0.05
Hero: posts big blind $0.1
*** HOLE CARDS ***
Dealt to e37c7354 
Dealt to 682e00a 
Dealt to Hero [Ts Js]
Dealt to c408194d 
Dealt to 6998845b 
Dealt to 45ba3752 
c408194d: folds
6998845b: folds
45ba3752: folds
e37c7354: folds
682e00a: folds
Uncalled bet ($0.05) returned to Hero
*** SHOWDOWN ***
Hero collected $0.1 from pot
*** SUMMARY ***
Total pot $0.1 | Rake $0 | Jackpot $0 | Bingo $0 | Fortune $0
Seat 1: e37c7354 (button) folded before Flop (didn't bet)
Seat 2: 682e00a (small blind) folded before Flop
Seat 3: Hero (big blind) collected ($0.1)
Seat 4: c408194d folded before Flop (didn't bet)
Seat 5: 6998845b folded before Flop (didn't bet)
Seat 6: 45ba3752 folded before Flop (didn't bet)


Poker Hand #RC1433307985: Hold'em No Limit  ($0.05/$0.1) - 2023/03/27 19:02:22
Table 'RushAndCash28163245' 6-max Seat #1 is the button
Seat 1: b6e393f3 ($11.8 in chips)
Seat 2: Hero ($27.34 in chips)
Seat 3: c8fe5a01 ($10.25 in chips)
Seat 4: d13f972 ($10 in chips)
Seat 5: b2af673f ($13.05 in chips)
Seat 6: 86548f40 ($10.15 in chips)
Hero: posts small blind $0.05
c8fe5a01: posts big blind $0.1
*** HOLE CARDS ***
Dealt to b6e393f3 
Dealt to Hero [5d 3h]
Dealt to c8fe5a01 
Dealt to d13f972 
Dealt to b2af673f 
Dealt to 86548f40 
d13f972: folds
b2af673f: raises $0.12 to $0.22
86548f40: raises $0.48 to $0.7
b6e393f3: folds
Hero: folds
c8fe5a01: folds
b2af673f: folds
Uncalled bet ($0.48) returned to 86548f40
*** SHOWDOWN ***
86548f40 collected $0.56 from pot
*** SUMMARY ***
Total pot $0.59 | Rake $0.03 | Jackpot $0 | Bingo $0 | Fortune $0
Seat 1: b6e393f3 (button) folded before Flop (didn't bet)
Seat 2: Hero (small blind) folded before Flop
Seat 3: c8fe5a01 (big blind) folded before Flop
Seat 4: d13f972 folded before Flop (didn't bet)
Seat 5: b2af673f folded before Flop
Seat 6: 86548f40 collected ($0.56)


Poker Hand #RC1433307900: Hold'em No Limit  ($0.05/$0.1) - 2023/03/27 19:02:10
Table 'RushAndCash28163160' 6-max Seat #1 is the button
Seat 1: Hero ($27.34 in chips)
Seat 2: 1fddc5cb ($17.9 in chips)
Seat 3: 35b2e70e ($10.79 in chips)
Seat 4: 1ef2413 ($10.38 in chips)
Seat 5: 294c3d93 ($14.91 in chips)
Seat 6: 42d7f34b ($10.82 in chips)
1fddc5cb: posts small blind $0.05
35b2e70e: posts big blind $0.1
*** HOLE CARDS ***
Dealt to Hero [Jh 6h]
Dealt to 1fddc5cb 
Dealt to 35b2e70e 
Dealt to 1ef2413 
Dealt to 294c3d93 
Dealt to 42d7f34b 
1ef2413: folds
294c3d93: folds
42d7f34b: folds
Hero: folds
1fddc5cb: folds
Uncalled bet ($0.05) returned to 35b2e70e
*** SHOWDOWN ***
35b2e70e collected $0.1 from pot
*** SUMMARY ***
Total pot $0.1 | Rake $0 | Jackpot $0 | Bingo $0 | Fortune $0
Seat 1: Hero (button) folded before Flop (didn't bet)
Seat 2: 1fddc5cb (small blind) folded before Flop
Seat 3: 35b2e70e (big blind) collected ($0.1)
Seat 4: 1ef2413 folded before Flop (didn't bet)
Seat 5: 294c3d93 folded before Flop (didn't bet)
Seat 6: 42d7f34b folded before Flop (didn't bet)


Poker Hand #RC1433307830: Hold'em No Limit  ($0.05/$0.1) - 2023/03/27 19:02:00
Table 'RushAndCash28163090' 6-max Seat #1 is the button
Seat 1: dd13280c ($10 in chips)
Seat 2: bf98819d ($21.77 in chips)
Seat 3: acd99267 ($13.02 in chips)
Seat 4: 84506d8f ($4.75 in chips)
Seat 5: Hero ($27.34 in chips)
Seat 6: bc200b82 ($10 in chips)
bf98819d: posts small blind $0.05
acd99267: posts big blind $0.1
*** HOLE CARDS ***
Dealt to dd13280c 
Dealt to bf98819d 
Dealt to acd99267 
Dealt to 84506d8f 
Dealt to Hero [9h 6c]
Dealt to bc200b82 
84506d8f: folds
Hero: folds
bc200b82: folds
dd13280c: folds
bf98819d: folds
Uncalled bet ($0.05) returned to acd99267
*** SHOWDOWN ***
acd99267 collected $0.1 from pot
*** SUMMARY ***
Total pot $0.1 | Rake $0 | Jackpot $0 | Bingo $0 | Fortune $0
Seat 1: dd13280c (button) folded before Flop (didn't bet)
Seat 2: bf98819d (small blind) folded before Flop
Seat 3: acd99267 (big blind) collected ($0.1)
Seat 4: 84506d8f folded before Flop (didn't bet)
Seat 5: Hero folded before Flop (didn't bet)
Seat 6: bc200b82 folded before Flop (didn't bet)


Poker Hand #RC1433307771: Hold'em No Limit  ($0.05/$0.1) - 2023/03/27 19:01:52
Table 'RushAndCash28163031' 6-max Seat #1 is the button
Seat 1: 515bbef4 ($12.43 in chips)
Seat 2: 785277bd ($10 in chips)
Seat 3: 82bd9f37 ($8.93 in chips)
Seat 4: Hero ($27.34 in chips)
Seat 5: e4f5c0b9 ($12.31 in chips)
Seat 6: ed6c7787 ($25.61 in chips)
785277bd: posts small blind $0.05
82bd9f37: posts big blind $0.1
*** HOLE CARDS ***
Dealt to 515bbef4 
Dealt to 785277bd 
Dealt to 82bd9f37 
Dealt to Hero [9h 4c]
Dealt to e4f5c0b9 
Dealt to ed6c7787 
Hero: folds
e4f5c0b9: raises $0.15 to $0.25
ed6c7787: folds
515bbef4: calls $0.25
785277bd: calls $0.2
82bd9f37: calls $0.15
*** FLOP *** [4d Qc 9c]
785277bd: checks
82bd9f37: checks
e4f5c0b9: checks
515bbef4: bets $0.33
785277bd: folds
82bd9f37: calls $0.33
e4f5c0b9: raises $1.2 to $1.53
515bbef4: calls $1.2
82bd9f37: folds
*** TURN *** [4d Qc 9c] [8s]
e4f5c0b9: checks
515bbef4: bets $2.8
e4f5c0b9: folds
Uncalled bet ($2.8) returned to 515bbef4
*** SHOWDOWN ***
515bbef4 collected $3.99 from pot
*** SUMMARY ***
Total pot $4.39 | Rake $0.25 | Jackpot $0.15 | Bingo $0 | Fortune $0
Board [4d Qc 9c 8s]
Seat 1: 515bbef4 (button) won ($3.99)
Seat 2: 785277bd (small blind) folded on the Flop
Seat 3: 82bd9f37 (big blind) folded on the Flop
Seat 4: Hero folded before Flop (didn't bet)
Seat 5: e4f5c0b9 folded on the Turn
Seat 6: ed6c7787 folded before Flop (didn't bet)


Poker Hand #RC1433307679: Hold'em No Limit  ($0.05/$0.1) - 2023/03/27 19:01:40
Table 'RushAndCash28162939' 6-max Seat #1 is the button
Seat 1: 3253ee1d ($12.73 in chips)
Seat 2: Hero ($27.39 in chips)
Seat 3: 56367aed ($11.9 in chips)
Seat 4: 8e2d4a82 ($19 in chips)
Seat 5: 47b44bb0 ($15.47 in chips)
Seat 6: aa5ba7d2 ($9.33 in chips)
Hero: posts small blind $0.05
56367aed: posts big blind $0.1
*** HOLE CARDS ***
Dealt to 3253ee1d 
Dealt to Hero [3s Ks]
Dealt to 56367aed 
Dealt to 8e2d4a82 
Dealt to 47b44bb0 
Dealt to aa5ba7d2 
8e2d4a82: folds
47b44bb0: folds
aa5ba7d2: folds
3253ee1d: raises $0.15 to $0.25
Hero: folds
56367aed: folds
Uncalled bet ($0.15) returned to 3253ee1d
*** SHOWDOWN ***
3253ee1d collected $0.25 from pot
*** SUMMARY ***
Total pot $0.25 | Rake $0 | Jackpot $0 | Bingo $0 | Fortune $0
Seat 1: 3253ee1d (button) collected ($0.25)
Seat 2: Hero (small blind) folded before Flop
Seat 3: 56367aed (big blind) folded before Flop
Seat 4: 8e2d4a82 folded before Flop (didn't bet)
Seat 5: 47b44bb0 folded before Flop (didn't bet)
Seat 6: aa5ba7d2 folded before Flop (didn't bet)


Poker Hand #RC1433307634: Hold'em No Limit  ($0.05/$0.1) - 2023/03/27 19:01:34
Table 'RushAndCash28162894' 6-max Seat #1 is the button
Seat 1: 744add28 ($10.87 in chips)
Seat 2: 1ab83526 ($11.4 in chips)
Seat 3: dbd7f305 ($13.9 in chips)
Seat 4: e7f48829 ($11.06 in chips)
Seat 5: 49c376cd ($10 in chips)
Seat 6: Hero ($27.39 in chips)
1ab83526: posts small blind $0.05
dbd7f305: posts big blind $0.1
*** HOLE CARDS ***
Dealt to 744add28 
Dealt to 1ab83526 
Dealt to dbd7f305 
Dealt to e7f48829 
Dealt to 49c376cd 
Dealt to Hero [3c Kc]
e7f48829: folds
49c376cd: folds
Hero: folds
744add28: raises $0.12 to $0.22
1ab83526: folds
dbd7f305: raises $0.98 to $1.2
744add28: folds
Uncalled bet ($0.98) returned to dbd7f305
*** SHOWDOWN ***
dbd7f305 collected $0.47 from pot
*** SUMMARY ***
Total pot $0.49 | Rake $0.02 | Jackpot $0 | Bingo $0 | Fortune $0
Seat 1: 744add28 (button) folded before Flop
Seat 2: 1ab83526 (small blind) folded before Flop
Seat 3: dbd7f305 (big blind) collected ($0.47)
Seat 4: e7f48829 folded before Flop (didn't bet)
Seat 5: 49c376cd folded before Flop (didn't bet)
Seat 6: Hero folded before Flop (didn't bet)


Poker Hand #RC1433307544: Hold'em No Limit  ($0.05/$0.1) - 2023/03/27 19:01:21
Table 'RushAndCash28162804' 6-max Seat #1 is the button
Seat 1: ea4c6c58 ($11.68 in chips)
Seat 2: e7f48829 ($11.11 in chips)
Seat 3: Hero ($27.49 in chips)
Seat 4: 36363360 ($10.41 in chips)
Seat 5: 65897f3a ($9.5 in chips)
Seat 6: d082e5cc ($8.94 in chips)
e7f48829: posts small blind $0.05
Hero: posts big blind $0.1
*** HOLE CARDS ***
Dealt to ea4c6c58 
Dealt to e7f48829 
Dealt to Hero [6c 4d]
Dealt to 36363360 
Dealt to 65897f3a 
Dealt to d082e5cc 
36363360: folds
65897f3a: folds
d082e5cc: folds
ea4c6c58: raises $0.15 to $0.25
e7f48829: folds
Hero: folds
Uncalled bet ($0.15) returned to ea4c6c58
*** SHOWDOWN ***
ea4c6c58 collected $0.25 from pot
*** SUMMARY ***
Total pot $0.25 | Rake $0 | Jackpot $0 | Bingo $0 | Fortune $0
Seat 1: ea4c6c58 (button) collected ($0.25)
Seat 2: e7f48829 (small blind) folded before Flop
Seat 3: Hero (big blind) folded before Flop
Seat 4: 36363360 folded before Flop (didn't bet)
Seat 5: 65897f3a folded before Flop (didn't bet)
Seat 6: d082e5cc folded before Flop (didn't bet)


Poker Hand #RC1433307469: Hold'em No Limit  ($0.05/$0.1) - 2023/03/27 19:01:10
Table 'RushAndCash28162729' 6-max Seat #1 is the button
Seat 1: Hero ($27.49 in chips)
Seat 2: a7e1b99f ($27.11 in chips)
Seat 3: c123630d ($19.51 in chips)
Seat 4: 3a99a4a ($10 in chips)
Seat 5: 945d7391 ($19.78 in chips)
Seat 6: 2a8ab56b ($11.19 in chips)
a7e1b99f: posts small blind $0.05
c123630d: posts big blind $0.1
*** HOLE CARDS ***
Dealt to Hero [Ac 2s]
Dealt to a7e1b99f 
Dealt to c123630d 
Dealt to 3a99a4a 
Dealt to 945d7391 
Dealt to 2a8ab56b 
3a99a4a: folds
945d7391: raises $0.1 to $0.2
2a8ab56b: folds
Hero: folds
a7e1b99f: folds
c123630d: folds
Uncalled bet ($0.1) returned to 945d7391
*** SHOWDOWN ***
945d7391 collected $0.25 from pot
*** SUMMARY ***
Total pot $0.25 | Rake $0 | Jackpot $0 | Bingo $0 | Fortune $0
Seat 1: Hero (button) folded before Flop (didn't bet)
Seat 2: a7e1b99f (small blind) folded before Flop
Seat 3: c123630d (big blind) folded before Flop
Seat 4: 3a99a4a folded before Flop (didn't bet)
Seat 5: 945d7391 collected ($0.25)
Seat 6: 2a8ab56b folded before Flop (didn't bet)


Poker Hand #RC1433307315: Hold'em No Limit  ($0.05/$0.1) - 2023/03/27 19:00:49
Table 'RushAndCash28162575' 6-max Seat #1 is the button
Seat 1: a7e1b99f ($26.74 in chips)
Seat 2: c29830b4 ($25.3 in chips)
Seat 3: b8381bc1 ($19.55 in chips)
Seat 4: b4ee20c8 ($10.86 in chips)
Seat 5: Hero ($27.74 in chips)
Seat 6: 1f3ffa29 ($7.11 in chips)
c29830b4: posts small blind $0.05
b8381bc1: posts big blind $0.1
*** HOLE CARDS ***
Dealt to a7e1b99f 
Dealt to c29830b4 
Dealt to b8381bc1 
Dealt to b4ee20c8 
Dealt to Hero [Qc 9c]
Dealt to 1f3ffa29 
b4ee20c8: folds
Hero: raises $0.15 to $0.25
1f3ffa29: folds
a7e1b99f: raises $0.49 to $0.74
c29830b4: folds
b8381bc1: folds
Hero: folds
Uncalled bet ($0.49) returned to a7e1b99f
*** SHOWDOWN ***
a7e1b99f collected $0.62 from pot
*** SUMMARY ***
Total pot $0.65 | Rake $0.03 | Jackpot $0 | Bingo $0 | Fortune $0
Seat 1: a7e1b99f (button) collected ($0.62)
Seat 2: c29830b4 (small blind) folded before Flop
Seat 3: b8381bc1 (big blind) folded before Flop
Seat 4: b4ee20c8 folded before Flop (didn't bet)
Seat 5: Hero folded before Flop
Seat 6: 1f3ffa29 folded before Flop (didn't bet)


Poker Hand #RC1433307267: Hold'em No Limit  ($0.05/$0.1) - 2023/03/27 19:00:41
Table 'RushAndCash28162527' 6-max Seat #1 is the button
Seat 1: 79fb68ad ($20.92 in chips)
Seat 2: 744add28 ($11.14 in chips)
Seat 3: d7ef21d5 ($5.82 in chips)
Seat 4: 6ade1792 ($27.21 in chips)
Seat 5: Hero ($27.74 in chips)
Seat 6: 8e8a5405 ($18.6 in chips)
744add28: posts small blind $0.05
d7ef21d5: posts big blind $0.1
*** HOLE CARDS ***
Dealt to 79fb68ad 
Dealt to 744add28 
Dealt to d7ef21d5 
Dealt to 6ade1792 
Dealt to Hero [3d Js]
Dealt to 8e8a5405 
6ade1792: folds
Hero: folds
8e8a5405: folds
79fb68ad: raises $0.13 to $0.23
744add28: folds
d7ef21d5: calls $0.13
*** FLOP *** [8c 9d Th]
d7ef21d5: checks
79fb68ad: checks
*** TURN *** [8c 9d Th] [8s]
d7ef21d5: bets $0.39
79fb68ad: calls $0.39
*** RIVER *** [8c 9d Th 8s] [5s]
d7ef21d5: bets $0.97
79fb68ad: folds
Uncalled bet ($0.97) returned to d7ef21d5
*** SHOWDOWN ***
d7ef21d5 collected $1.23 from pot
*** SUMMARY ***
Total pot $1.29 | Rake $0.06 | Jackpot $0 | Bingo $0 | Fortune $0
Board [8c 9d Th 8s 5s]
Seat 1: 79fb68ad (button) folded on the River
Seat 2: 744add28 (small blind) folded before Flop
Seat 3: d7ef21d5 (big blind) won ($1.23)
Seat 4: 6ade1792 folded before Flop (didn't bet)
Seat 5: Hero folded before Flop (didn't bet)
Seat 6: 8e8a5405 folded before Flop (didn't bet)


Poker Hand #RC1433307033: Hold'em No Limit  ($0.05/$0.1) - 2023/03/27 19:00:07
Table 'RushAndCash28162293' 6-max Seat #1 is the button
Seat 1: db5427ed ($11.07 in chips)
Seat 2: Hero ($27.47 in chips)
Seat 3: 744add28 ($11.44 in chips)
Seat 4: d1cc42f1 ($11.26 in chips)
Seat 5: 6838cabf ($10.6 in chips)
Seat 6: 2ca9d64f ($10.39 in chips)
Hero: posts small blind $0.05
744add28: posts big blind $0.1
*** HOLE CARDS ***
Dealt to db5427ed 
Dealt to Hero [Ac Ad]
Dealt to 744add28 
Dealt to d1cc42f1 
Dealt to 6838cabf 
Dealt to 2ca9d64f 
d1cc42f1: folds
6838cabf: folds
2ca9d64f: folds
db5427ed: folds
Hero: raises $0.2 to $0.3
744add28: calls $0.2
*** FLOP *** [Js 6h Tc]
Hero: bets $0.4
744add28: folds
Uncalled bet ($0.4) returned to Hero
*** SHOWDOWN ***
Hero collected $0.57 from pot
*** SUMMARY ***
Total pot $0.6 | Rake $0.03 | Jackpot $0 | Bingo $0 | Fortune $0
Board [Js 6h Tc]
Seat 1: db5427ed (button) folded before Flop (didn't bet)
Seat 2: Hero (small blind) won ($0.57)
Seat 3: 744add28 (big blind) folded on the Flop
Seat 4: d1cc42f1 folded before Flop (didn't bet)
Seat 5: 6838cabf folded before Flop (didn't bet)
Seat 6: 2ca9d64f folded before Flop (didn't bet)


Poker Hand #RC1433306999: Hold'em No Limit  ($0.05/$0.1) - 2023/03/27 19:00:03
Table 'RushAndCash28162259' 6-max Seat #1 is the button
Seat 1: 8f4727d0 ($10.28 in chips)
Seat 2: ffca6b72 ($4.76 in chips)
Seat 3: 9098cd98 ($25.03 in chips)
Seat 4: 9fc3730b ($23.55 in chips)
Seat 5: Hero ($27.47 in chips)
Seat 6: c30ea873 ($10.62 in chips)
ffca6b72: posts small blind $0.05
9098cd98: posts big blind $0.1
*** HOLE CARDS ***
Dealt to 8f4727d0 
Dealt to ffca6b72 
Dealt to 9098cd98 
Dealt to 9fc3730b 
Dealt to Hero [5h 7h]
Dealt to c30ea873 
9fc3730b: folds
Hero: folds
c30ea873: folds
8f4727d0: raises $0.12 to $0.22
ffca6b72: folds
9098cd98: calls $0.12
*** FLOP *** [Qh Ts 7s]
9098cd98: checks
8f4727d0: bets $0.25
9098cd98: folds
Uncalled bet ($0.25) returned to 8f4727d0
*** SHOWDOWN ***
8f4727d0 collected $0.47 from pot
*** SUMMARY ***
Total pot $0.49 | Rake $0.02 | Jackpot $0 | Bingo $0 | Fortune $0
Board [Qh Ts 7s]
Seat 1: 8f4727d0 (button) won ($0.47)
Seat 2: ffca6b72 (small blind) folded before Flop
Seat 3: 9098cd98 (big blind) folded on the Flop
Seat 4: 9fc3730b folded before Flop (didn't bet)
Seat 5: Hero folded before Flop (didn't bet)
Seat 6: c30ea873 folded before Flop (didn't bet)


Poker Hand #RC1433306910: Hold'em No Limit  ($0.05/$0.1) - 2023/03/27 18:59:51
Table 'RushAndCash28162170' 6-max Seat #1 is the button
Seat 1: e0f23917 ($12.15 in chips)
Seat 2: 8115e527 ($36.04 in chips)
Seat 3: Hero ($27.42 in chips)
Seat 4: 1957946f ($2.49 in chips)
Seat 5: 27d009 ($18.02 in chips)
Seat 6: f73707ab ($25.21 in chips)
8115e527: posts small blind $0.05
Hero: posts big blind $0.1
*** HOLE CARDS ***
Dealt to e0f23917 
Dealt to 8115e527 
Dealt to Hero [Qs 6d]
Dealt to 1957946f 
Dealt to 27d009 
Dealt to f73707ab 
1957946f: folds
27d009: folds
f73707ab: folds
e0f23917: folds
8115e527: folds
Uncalled bet ($0.05) returned to Hero
*** SHOWDOWN ***
Hero collected $0.1 from pot
*** SUMMARY ***
Total pot $0.1 | Rake $0 | Jackpot $0 | Bingo $0 | Fortune $0
Seat 1: e0f23917 (button) folded before Flop (didn't bet)
Seat 2: 8115e527 (small blind) folded before Flop
Seat 3: Hero (big blind) collected ($0.1)
Seat 4: 1957946f folded before Flop (didn't bet)
Seat 5: 27d009 folded before Flop (didn't bet)
Seat 6: f73707ab folded before Flop (didn't bet)


Poker Hand #RC1433306795: Hold'em No Limit  ($0.05/$0.1) - 2023/03/27 18:59:35
Table 'RushAndCash28162055' 6-max Seat #1 is the button
Seat 1: 54371fed ($21.59 in chips)
Seat 2: 255dc6f2 ($7.11 in chips)
Seat 3: 53989c53 ($14.72 in chips)
Seat 4: Hero ($27.27 in chips)
Seat 5: df4415f ($10 in chips)
Seat 6: 9ecf88a0 ($10.05 in chips)
255dc6f2: posts small blind $0.05
53989c53: posts big blind $0.1
*** HOLE CARDS ***
Dealt to 54371fed 
Dealt to 255dc6f2 
Dealt to 53989c53 
Dealt to Hero [6s 7s]
Dealt to df4415f 
Dealt to 9ecf88a0 
Hero: raises $0.15 to $0.25
df4415f: folds
9ecf88a0: folds
54371fed: folds
255dc6f2: folds
53989c53: folds
Uncalled bet ($0.15) returned to Hero
*** SHOWDOWN ***
Hero collected $0.25 from pot
*** SUMMARY ***
Total pot $0.25 | Rake $0 | Jackpot $0 | Bingo $0 | Fortune $0
Seat 1: 54371fed (button) folded before Flop (didn't bet)
Seat 2: 255dc6f2 (small blind) folded before Flop
Seat 3: 53989c53 (big blind) folded before Flop
Seat 4: Hero collected ($0.25)
Seat 5: df4415f folded before Flop (didn't bet)
Seat 6: 9ecf88a0 folded before Flop (didn't bet)


Poker Hand #RC1433306765: Hold'em No Limit  ($0.05/$0.1) - 2023/03/27 18:59:30
Table 'RushAndCash28162025' 6-max Seat #1 is the button
Seat 1: Hero ($27.27 in chips)
Seat 2: 96b64d62 ($10.31 in chips)
Seat 3: 9d068308 ($23.4 in chips)
Seat 4: 9ccb6a6f ($10.46 in chips)
Seat 5: bd1a3075 ($11.15 in chips)
Seat 6: 223002eb ($11.42 in chips)
96b64d62: posts small blind $0.05
9d068308: posts big blind $0.1
*** HOLE CARDS ***
Dealt to Hero [3h 4s]
Dealt to 96b64d62 
Dealt to 9d068308 
Dealt to 9ccb6a6f 
Dealt to bd1a3075 
Dealt to 223002eb 
9ccb6a6f: folds
bd1a3075: raises $0.15 to $0.25
223002eb: folds
Hero: folds
96b64d62: folds
9d068308: folds
Uncalled bet ($0.15) returned to bd1a3075
*** SHOWDOWN ***
bd1a3075 collected $0.25 from pot
*** SUMMARY ***
Total pot $0.25 | Rake $0 | Jackpot $0 | Bingo $0 | Fortune $0
Seat 1: Hero (button) folded before Flop (didn't bet)
Seat 2: 96b64d62 (small blind) folded before Flop
Seat 3: 9d068308 (big blind) folded before Flop
Seat 4: 9ccb6a6f folded before Flop (didn't bet)
Seat 5: bd1a3075 collected ($0.25)
Seat 6: 223002eb folded before Flop (didn't bet)


Poker Hand #RC1433306706: Hold'em No Limit  ($0.05/$0.1) - 2023/03/27 18:59:23
Table 'RushAndCash28161966' 6-max Seat #1 is the button
Seat 1: defc8945 ($12.34 in chips)
Seat 2: Hero ($27.32 in chips)
Seat 3: e37c7354 ($44.43 in chips)
Seat 4: 54d5200f ($15.12 in chips)
Seat 5: cb11fb48 ($10 in chips)
Seat 6: be66a3a4 ($14.87 in chips)
Hero: posts small blind $0.05
e37c7354: posts big blind $0.1
*** HOLE CARDS ***
Dealt to defc8945 
Dealt to Hero [Qs 3d]
Dealt to e37c7354 
Dealt to 54d5200f 
Dealt to cb11fb48 
Dealt to be66a3a4 
54d5200f: folds
cb11fb48: folds
be66a3a4: folds
defc8945: folds
Hero: folds
Uncalled bet ($0.05) returned to e37c7354
*** SHOWDOWN ***
e37c7354 collected $0.1 from pot
*** SUMMARY ***
Total pot $0.1 | Rake $0 | Jackpot $0 | Bingo $0 | Fortune $0
Seat 1: defc8945 (button) folded before Flop (didn't bet)
Seat 2: Hero (small blind) folded before Flop
Seat 3: e37c7354 (big blind) collected ($0.1)
Seat 4: 54d5200f folded before Flop (didn't bet)
Seat 5: cb11fb48 folded before Flop (didn't bet)
Seat 6: be66a3a4 folded before Flop (didn't bet)


Poker Hand #RC1433306450: Hold'em No Limit  ($0.05/$0.1) - 2023/03/27 18:58:50
Table 'RushAndCash28161710' 6-max Seat #1 is the button
Seat 1: e41b2960 ($10.76 in chips)
Seat 2: 73076174 ($12.26 in chips)
Seat 3: Hero ($27.57 in chips)
Seat 4: 3b2b33aa ($11.07 in chips)
Seat 5: 28f8789 ($14.62 in chips)
Seat 6: 54d5200f ($14.84 in chips)
73076174: posts small blind $0.05
Hero: posts big blind $0.1
*** HOLE CARDS ***
Dealt to e41b2960 
Dealt to 73076174 
Dealt to Hero [3c 4c]
Dealt to 3b2b33aa 
Dealt to 28f8789 
Dealt to 54d5200f 
3b2b33aa: folds
28f8789: folds
54d5200f: raises $0.15 to $0.25
e41b2960: folds
73076174: folds
Hero: calls $0.15
*** FLOP *** [Ah Jc 6s]
Hero: checks
54d5200f: bets $0.2
Hero: folds
Uncalled bet ($0.2) returned to 54d5200f
*** SHOWDOWN ***
54d5200f collected $0.53 from pot
*** SUMMARY ***
Total pot $0.55 | Rake $0.02 | Jackpot $0 | Bingo $0 | Fortune $0
Board [Ah Jc 6s]
Seat 1: e41b2960 (button) folded before Flop (didn't bet)
Seat 2: 73076174 (small blind) folded before Flop
Seat 3: Hero (big blind) folded on the Flop
Seat 4: 3b2b33aa folded before Flop (didn't bet)
Seat 5: 28f8789 folded before Flop (didn't bet)
Seat 6: 54d5200f won ($0.53)


Poker Hand #RC1433306400: Hold'em No Limit  ($0.05/$0.1) - 2023/03/27 18:58:43
Table 'RushAndCash28161660' 6-max Seat #1 is the button
Seat 1: 928a8131 ($34.08 in chips)
Seat 2: 7c3efb34 ($10 in chips)
Seat 3: b5c2a326 ($20.23 in chips)
Seat 4: Hero ($27.57 in chips)
Seat 5: c8fe5a01 ($10 in chips)
Seat 6: 419bfeaf ($12.61 in chips)
7c3efb34: posts small blind $0.05
b5c2a326: posts big blind $0.1
*** HOLE CARDS ***
Dealt to 928a8131 
Dealt to 7c3efb34 
Dealt to b5c2a326 
Dealt to Hero [6h 5d]
Dealt to c8fe5a01 
Dealt to 419bfeaf 
Hero: folds
c8fe5a01: raises $0.12 to $0.22
419bfeaf: folds
928a8131: folds
7c3efb34: folds
b5c2a326: folds
Uncalled bet ($0.12) returned to c8fe5a01
*** SHOWDOWN ***
c8fe5a01 collected $0.25 from pot
*** SUMMARY ***
Total pot $0.25 | Rake $0 | Jackpot $0 | Bingo $0 | Fortune $0
Seat 1: 928a8131 (button) folded before Flop (didn't bet)
Seat 2: 7c3efb34 (small blind) folded before Flop
Seat 3: b5c2a326 (big blind) folded before Flop
Seat 4: Hero folded before Flop (didn't bet)
Seat 5: c8fe5a01 collected ($0.25)
Seat 6: 419bfeaf folded before Flop (didn't bet)


Poker Hand #RC1433306206: Hold'em No Limit  ($0.05/$0.1) - 2023/03/27 18:58:18
Table 'RushAndCash28161466' 6-max Seat #1 is the button
Seat 1: Hero ($27.25 in chips)
Seat 2: b5c2a326 ($20.48 in chips)
Seat 3: 59832da7 ($9.56 in chips)
Seat 4: bd96fd7f ($10.21 in chips)
Seat 5: 7a91551a ($10 in chips)
Seat 6: d2fec13f ($20.17 in chips)
b5c2a326: posts small blind $0.05
59832da7: posts big blind $0.1
*** HOLE CARDS ***
Dealt to Hero [Jd Qh]
Dealt to b5c2a326 
Dealt to 59832da7 
Dealt to bd96fd7f 
Dealt to 7a91551a 
Dealt to d2fec13f 
bd96fd7f: folds
7a91551a: folds
d2fec13f: folds
Hero: raises $0.15 to $0.25
b5c2a326: calls $0.2
59832da7: folds
*** FLOP *** [3d 2d Qs]
b5c2a326: checks
Hero: bets $0.25
b5c2a326: folds
Uncalled bet ($0.25) returned to Hero
*** SHOWDOWN ***
Hero collected $0.57 from pot
*** SUMMARY ***
Total pot $0.6 | Rake $0.03 | Jackpot $0 | Bingo $0 | Fortune $0
Board [3d 2d Qs]
Seat 1: Hero (button) won ($0.57)
Seat 2: b5c2a326 (small blind) folded on the Flop
Seat 3: 59832da7 (big blind) folded before Flop
Seat 4: bd96fd7f folded before Flop (didn't bet)
Seat 5: 7a91551a folded before Flop (didn't bet)
Seat 6: d2fec13f folded before Flop (didn't bet)


Poker Hand #RC1433306168: Hold'em No Limit  ($0.05/$0.1) - 2023/03/27 18:58:14
Table 'RushAndCash28161428' 6-max Seat #1 is the button
Seat 1: a954c345 ($10.91 in chips)
Seat 2: 78b5cf90 ($9.9 in chips)
Seat 3: d78b4d10 ($16.53 in chips)
Seat 4: Hero ($27.25 in chips)
Seat 5: 96bbaebc ($10.7 in chips)
Seat 6: 6ff9bbe9 ($14.89 in chips)
78b5cf90: posts small blind $0.05
d78b4d10: posts big blind $0.1
*** HOLE CARDS ***
Dealt to a954c345 
Dealt to 78b5cf90 
Dealt to d78b4d10 
Dealt to Hero [Tc Qd]
Dealt to 96bbaebc 
Dealt to 6ff9bbe9 
Hero: folds
96bbaebc: folds
6ff9bbe9: folds
a954c345: raises $0.15 to $0.25
78b5cf90: folds
d78b4d10: folds
Uncalled bet ($0.15) returned to a954c345
*** SHOWDOWN ***
a954c345 collected $0.25 from pot
*** SUMMARY ***
Total pot $0.25 | Rake $0 | Jackpot $0 | Bingo $0 | Fortune $0
Seat 1: a954c345 (button) collected ($0.25)
Seat 2: 78b5cf90 (small blind) folded before Flop
Seat 3: d78b4d10 (big blind) folded before Flop
Seat 4: Hero folded before Flop (didn't bet)
Seat 5: 96bbaebc folded before Flop (didn't bet)
Seat 6: 6ff9bbe9 folded before Flop (didn't bet)


Poker Hand #RC1433306136: Hold'em No Limit  ($0.05/$0.1) - 2023/03/27 18:58:10
Table 'RushAndCash28161396' 6-max Seat #1 is the button
Seat 1: e39804a0 ($11.85 in chips)
Seat 2: 5c2b830f ($11.92 in chips)
Seat 3: ae967dca ($9.63 in chips)
Seat 4: Hero ($27.25 in chips)
Seat 5: 6ff9bbe9 ($14.89 in chips)
Seat 6: 3778945d ($11.13 in chips)
5c2b830f: posts small blind $0.05
ae967dca: posts big blind $0.1
*** HOLE CARDS ***
Dealt to e39804a0 
Dealt to 5c2b830f 
Dealt to ae967dca 
Dealt to Hero [8s Qh]
Dealt to 6ff9bbe9 
Dealt to 3778945d 
Hero: folds
6ff9bbe9: folds
3778945d: folds
e39804a0: folds
5c2b830f: raises $0.15 to $0.25
ae967dca: folds
Uncalled bet ($0.15) returned to 5c2b830f
*** SHOWDOWN ***
5c2b830f collected $0.2 from pot
*** SUMMARY ***
Total pot $0.2 | Rake $0 | Jackpot $0 | Bingo $0 | Fortune $0
Seat 1: e39804a0 (button) folded before Flop (didn't bet)
Seat 2: 5c2b830f (small blind) collected ($0.2)
Seat 3: ae967dca (big blind) folded before Flop
Seat 4: Hero folded before Flop (didn't bet)
Seat 5: 6ff9bbe9 folded before Flop (didn't bet)
Seat 6: 3778945d folded before Flop (didn't bet)


Poker Hand #RC1433306011: Hold'em No Limit  ($0.05/$0.1) - 2023/03/27 18:57:52
Table 'RushAndCash28161271' 6-max Seat #1 is the button
Seat 1: 6998845b ($10 in chips)
Seat 2: 110a9bc2 ($13.79 in chips)
Seat 3: Hero ($27.35 in chips)
Seat 4: de1b3168 ($13.95 in chips)
Seat 5: be884a7d ($11.76 in chips)
Seat 6: 3c46f7b3 ($15.21 in chips)
110a9bc2: posts small blind $0.05
Hero: posts big blind $0.1
*** HOLE CARDS ***
Dealt to 6998845b 
Dealt to 110a9bc2 
Dealt to Hero [Ad 2c]
Dealt to de1b3168 
Dealt to be884a7d 
Dealt to 3c46f7b3 
de1b3168: folds
be884a7d: folds
3c46f7b3: raises $0.2 to $0.3
6998845b: raises $0.48 to $0.78
110a9bc2: folds
Hero: folds
3c46f7b3: calls $0.48
*** FLOP *** [7h 9h Ts]
3c46f7b3: checks
6998845b: checks
*** TURN *** [7h 9h Ts] [6c]
3c46f7b3: bets $1.29
6998845b: folds
Uncalled bet ($1.29) returned to 3c46f7b3
*** SHOWDOWN ***
3c46f7b3 collected $1.63 from pot
*** SUMMARY ***
Total pot $1.71 | Rake $0.08 | Jackpot $0 | Bingo $0 | Fortune $0
Board [7h 9h Ts 6c]
Seat 1: 6998845b (button) folded on the Turn
Seat 2: 110a9bc2 (small blind) folded before Flop
Seat 3: Hero (big blind) folded before Flop
Seat 4: de1b3168 folded before Flop (didn't bet)
Seat 5: be884a7d folded before Flop (didn't bet)
Seat 6: 3c46f7b3 won ($1.63)


Poker Hand #RC1433305971: Hold'em No Limit  ($0.05/$0.1) - 2023/03/27 18:57:47
Table 'RushAndCash28161231' 6-max Seat #1 is the button
Seat 1: e972d1c ($16.95 in chips)
Seat 2: c307f987 ($10 in chips)
Seat 3: b383e4d1 ($11.51 in chips)
Seat 4: 8825fa2b ($16.59 in chips)
Seat 5: Hero ($27.35 in chips)
Seat 6: 197ebdde ($20.03 in chips)
c307f987: posts small blind $0.05
b383e4d1: posts big blind $0.1
*** HOLE CARDS ***
Dealt to e972d1c 
Dealt to c307f987 
Dealt to b383e4d1 
Dealt to 8825fa2b 
Dealt to Hero [9c Qh]
Dealt to 197ebdde 
8825fa2b: folds
Hero: folds
197ebdde: raises $0.15 to $0.25
e972d1c: folds
c307f987: folds
b383e4d1: calls $0.15
*** FLOP *** [9s 4d 8s]
b383e4d1: checks
197ebdde: checks
*** TURN *** [9s 4d 8s] [As]
b383e4d1: bets $0.19
197ebdde: calls $0.19
*** RIVER *** [9s 4d 8s As] [9d]
b383e4d1: checks
197ebdde: bets $0.61
b383e4d1: folds
Uncalled bet ($0.61) returned to 197ebdde
*** SHOWDOWN ***
197ebdde collected $0.89 from pot
*** SUMMARY ***
Total pot $0.93 | Rake $0.04 | Jackpot $0 | Bingo $0 | Fortune $0
Board [9s 4d 8s As 9d]
Seat 1: e972d1c (button) folded before Flop (didn't bet)
Seat 2: c307f987 (small blind) folded before Flop
Seat 3: b383e4d1 (big blind) folded on the River
Seat 4: 8825fa2b folded before Flop (didn't bet)
Seat 5: Hero folded before Flop (didn't bet)
Seat 6: 197ebdde won ($0.89)


Poker Hand #RC1433305941: Hold'em No Limit  ($0.05/$0.1) - 2023/03/27 18:57:44
Table 'RushAndCash28161201' 6-max Seat #1 is the button
Seat 1: ebcc5af9 ($7.33 in chips)
Seat 2: Hero ($27.4 in chips)
Seat 3: 2ba63685 ($9.77 in chips)
Seat 4: 69faa088 ($10.15 in chips)
Seat 5: b95c5a94 ($10.15 in chips)
Seat 6: f2d76bb8 ($12.06 in chips)
Hero: posts small blind $0.05
2ba63685: posts big blind $0.1
*** HOLE CARDS ***
Dealt to ebcc5af9 
Dealt to Hero [9d 7d]
Dealt to 2ba63685 
Dealt to 69faa088 
Dealt to b95c5a94 
Dealt to f2d76bb8 
69faa088: folds
b95c5a94: folds
f2d76bb8: folds
ebcc5af9: folds
Hero: folds
Uncalled bet ($0.05) returned to 2ba63685
*** SHOWDOWN ***
2ba63685 collected $0.1 from pot
*** SUMMARY ***
Total pot $0.1 | Rake $0 | Jackpot $0 | Bingo $0 | Fortune $0
Seat 1: ebcc5af9 (button) folded before Flop (didn't bet)
Seat 2: Hero (small blind) folded before Flop
Seat 3: 2ba63685 (big blind) collected ($0.1)
Seat 4: 69faa088 folded before Flop (didn't bet)
Seat 5: b95c5a94 folded before Flop (didn't bet)
Seat 6: f2d76bb8 folded before Flop (didn't bet)


Poker Hand #RC1433305915: Hold'em No Limit  ($0.05/$0.1) - 2023/03/27 18:57:40
Table 'RushAndCash28161175' 6-max Seat #1 is the button
Seat 1: a12a7b74 ($12.58 in chips)
Seat 2: 163e919 ($19.29 in chips)
Seat 3: c29830b4 ($26.7 in chips)
Seat 4: 2ba63685 ($9.77 in chips)
Seat 5: 2d00c95f ($10.22 in chips)
Seat 6: Hero ($27.4 in chips)
163e919: posts small blind $0.05
c29830b4: posts big blind $0.1
*** HOLE CARDS ***
Dealt to a12a7b74 
Dealt to 163e919 
Dealt to c29830b4 
Dealt to 2ba63685 
Dealt to 2d00c95f 
Dealt to Hero [6c 5d]
2ba63685: folds
2d00c95f: raises $0.12 to $0.22
Hero: folds
a12a7b74: folds
163e919: folds
c29830b4: calls $0.12
*** FLOP *** [5c 9h 5s]
c29830b4: checks
2d00c95f: bets $0.17
c29830b4: folds
Uncalled bet ($0.17) returned to 2d00c95f
*** SHOWDOWN ***
2d00c95f collected $0.47 from pot
*** SUMMARY ***
Total pot $0.49 | Rake $0.02 | Jackpot $0 | Bingo $0 | Fortune $0
Board [5c 9h 5s]
Seat 1: a12a7b74 (button) folded before Flop (didn't bet)
Seat 2: 163e919 (small blind) folded before Flop
Seat 3: c29830b4 (big blind) folded on the Flop
Seat 4: 2ba63685 folded before Flop (didn't bet)
Seat 5: 2d00c95f won ($0.47)
Seat 6: Hero folded before Flop (didn't bet)


Poker Hand #RC1433305821: Hold'em No Limit  ($0.05/$0.1) - 2023/03/27 18:57:27
Table 'RushAndCash28161081' 6-max Seat #1 is the button
Seat 1: 43194f47 ($20.06 in chips)
Seat 2: Hero ($27.45 in chips)
Seat 3: c40700af ($10.03 in chips)
Seat 4: fb2ff06 ($9.85 in chips)
Seat 5: 82bd9f37 ($10 in chips)
Seat 6: 915aa7af ($25.28 in chips)
Hero: posts small blind $0.05
c40700af: posts big blind $0.1
*** HOLE CARDS ***
Dealt to 43194f47 
Dealt to Hero [3h 6s]
Dealt to c40700af 
Dealt to fb2ff06 
Dealt to 82bd9f37 
Dealt to 915aa7af 
fb2ff06: folds
82bd9f37: folds
915aa7af: folds
43194f47: folds
Hero: folds
Uncalled bet ($0.05) returned to c40700af
*** SHOWDOWN ***
c40700af collected $0.1 from pot
*** SUMMARY ***
Total pot $0.1 | Rake $0 | Jackpot $0 | Bingo $0 | Fortune $0
Seat 1: 43194f47 (button) folded before Flop (didn't bet)
Seat 2: Hero (small blind) folded before Flop
Seat 3: c40700af (big blind) collected ($0.1)
Seat 4: fb2ff06 folded before Flop (didn't bet)
Seat 5: 82bd9f37 folded before Flop (didn't bet)
Seat 6: 915aa7af folded before Flop (didn't bet)


Poker Hand #RC1433305791: Hold'em No Limit  ($0.05/$0.1) - 2023/03/27 18:57:23
Table 'RushAndCash28161051' 6-max Seat #1 is the button
Seat 1: c2a7b763 ($10 in chips)
Seat 2: 5537327d ($5.48 in chips)
Seat 3: a954c345 ($10.49 in chips)
Seat 4: Hero ($27.45 in chips)
Seat 5: 5d0e5115 ($22.52 in chips)
Seat 6: bf98819d ($21.21 in chips)
5537327d: posts small blind $0.05
a954c345: posts big blind $0.1
*** HOLE CARDS ***
Dealt to c2a7b763 
Dealt to 5537327d 
Dealt to a954c345 
Dealt to Hero [6h 8d]
Dealt to 5d0e5115 
Dealt to bf98819d 
Hero: folds
5d0e5115: raises $0.15 to $0.25
bf98819d: folds
c2a7b763: folds
5537327d: calls $0.2
a954c345: raises $1.25 to $1.5
5d0e5115: folds
5537327d: folds
Uncalled bet ($1.25) returned to a954c345
*** SHOWDOWN ***
a954c345 collected $0.72 from pot
*** SUMMARY ***
Total pot $0.75 | Rake $0.03 | Jackpot $0 | Bingo $0 | Fortune $0
Seat 1: c2a7b763 (button) folded before Flop (didn't bet)
Seat 2: 5537327d (small blind) folded before Flop
Seat 3: a954c345 (big blind) collected ($0.72)
Seat 4: Hero folded before Flop (didn't bet)
Seat 5: 5d0e5115 folded before Flop
Seat 6: bf98819d folded before Flop (didn't bet)


Poker Hand #RC1433274108: Hold'em No Limit  ($0.05/$0.1) - 2023/03/27 18:53:37
Table 'RushAndCash28159368' 6-max Seat #1 is the button
Seat 1: b8dfa3ec ($11.21 in chips)
Seat 2: 313a1c73 ($37.26 in chips)
Seat 3: Hero ($26.64 in chips)
Seat 4: 22fe9377 ($16.71 in chips)
Seat 5: c30ea873 ($8.94 in chips)
Seat 6: 75240250 ($13.82 in chips)
313a1c73: posts small blind $0.05
Hero: posts big blind $0.1
*** HOLE CARDS ***
Dealt to b8dfa3ec 
Dealt to 313a1c73 
Dealt to Hero [Ts Jc]
Dealt to 22fe9377 
Dealt to c30ea873 
Dealt to 75240250 
22fe9377: raises $0.15 to $0.25
c30ea873: folds
75240250: folds
b8dfa3ec: folds
313a1c73: calls $0.2
Hero: calls $0.15
*** FLOP *** [Th 4s 9c]
313a1c73: checks
Hero: bets $0.38
22fe9377: folds
313a1c73: calls $0.38
*** TURN *** [Th 4s 9c] [3h]
313a1c73: checks
Hero: bets $0.45
313a1c73: folds
Uncalled bet ($0.45) returned to Hero
*** SHOWDOWN ***
Hero collected $1.44 from pot
*** SUMMARY ***
Total pot $1.51 | Rake $0.07 | Jackpot $0 | Bingo $0 | Fortune $0
Board [Th 4s 9c 3h]
Seat 1: b8dfa3ec (button) folded before Flop (didn't bet)
Seat 2: 313a1c73 (small blind) folded on the Turn
Seat 3: Hero (big blind) won ($1.44)
Seat 4: 22fe9377 folded on the Flop
Seat 5: c30ea873 folded before Flop (didn't bet)
Seat 6: 75240250 folded before Flop (didn't bet)


Poker Hand #RC1433274075: Hold'em No Limit  ($0.05/$0.1) - 2023/03/27 18:53:33
Table 'RushAndCash28159335' 6-max Seat #1 is the button
Seat 1: b00730bf ($3.69 in chips)
Seat 2: 2fa1cf2b ($23.03 in chips)
Seat 3: c1cbc2c2 ($17.58 in chips)
Seat 4: Hero ($26.64 in chips)
Seat 5: 9c0f65de ($29.13 in chips)
Seat 6: bf921fb0 ($11.08 in chips)
2fa1cf2b: posts small blind $0.05
c1cbc2c2: posts big blind $0.1
*** HOLE CARDS ***
Dealt to b00730bf 
Dealt to 2fa1cf2b 
Dealt to c1cbc2c2 
Dealt to Hero [4d Ah]
Dealt to 9c0f65de 
Dealt to bf921fb0 
Hero: folds
9c0f65de: folds
bf921fb0: folds
b00730bf: folds
2fa1cf2b: folds
Uncalled bet ($0.05) returned to c1cbc2c2
*** SHOWDOWN ***
c1cbc2c2 collected $0.1 from pot
*** SUMMARY ***
Total pot $0.1 | Rake $0 | Jackpot $0 | Bingo $0 | Fortune $0
Seat 1: b00730bf (button) folded before Flop (didn't bet)
Seat 2: 2fa1cf2b (small blind) folded before Flop
Seat 3: c1cbc2c2 (big blind) collected ($0.1)
Seat 4: Hero folded before Flop (didn't bet)
Seat 5: 9c0f65de folded before Flop (didn't bet)
Seat 6: bf921fb0 folded before Flop (didn't bet)


Poker Hand #RC1433274040: Hold'em No Limit  ($0.05/$0.1) - 2023/03/27 18:53:27
Table 'RushAndCash28159300' 6-max Seat #1 is the button
Seat 1: Hero ($26.64 in chips)
Seat 2: 89e889fe ($10 in chips)
Seat 3: f770dcf2 ($14.89 in chips)
Seat 4: c1cbc2c2 ($17.58 in chips)
Seat 5: a5714da ($14.94 in chips)
Seat 6: efc583b ($12.63 in chips)
89e889fe: posts small blind $0.05
f770dcf2: posts big blind $0.1
*** HOLE CARDS ***
Dealt to Hero [2d 4h]
Dealt to 89e889fe 
Dealt to f770dcf2 
Dealt to c1cbc2c2 
Dealt to a5714da 
Dealt to efc583b 
c1cbc2c2: folds
a5714da: folds
efc583b: raises $0.13 to $0.23
Hero: folds
89e889fe: folds
f770dcf2: folds
Uncalled bet ($0.13) returned to efc583b
*** SHOWDOWN ***
efc583b collected $0.25 from pot
*** SUMMARY ***
Total pot $0.25 | Rake $0 | Jackpot $0 | Bingo $0 | Fortune $0
Seat 1: Hero (button) folded before Flop (didn't bet)
Seat 2: 89e889fe (small blind) folded before Flop
Seat 3: f770dcf2 (big blind) folded before Flop
Seat 4: c1cbc2c2 folded before Flop (didn't bet)
Seat 5: a5714da folded before Flop (didn't bet)
Seat 6: efc583b collected ($0.25)


Poker Hand #RC1433273969: Hold'em No Limit  ($0.05/$0.1) - 2023/03/27 18:53:19
Table 'RushAndCash28159229' 6-max Seat #1 is the button
Seat 1: Hero ($26.64 in chips)
Seat 2: 463d2ce5 ($12.67 in chips)
Seat 3: 880f1c43 ($12.41 in chips)
Seat 4: 5332610a ($11.5 in chips)
Seat 5: c8b55763 ($8.75 in chips)
Seat 6: 4eef219b ($10.54 in chips)
463d2ce5: posts small blind $0.05
880f1c43: posts big blind $0.1
*** HOLE CARDS ***
Dealt to Hero [5c 7c]
Dealt to 463d2ce5 
Dealt to 880f1c43 
Dealt to 5332610a 
Dealt to c8b55763 
Dealt to 4eef219b 
5332610a: folds
c8b55763: folds
4eef219b: raises $0.13 to $0.23
Hero: folds
463d2ce5: raises $0.57 to $0.8
880f1c43: folds
4eef219b: folds
Uncalled bet ($0.57) returned to 463d2ce5
*** SHOWDOWN ***
463d2ce5 collected $0.54 from pot
*** SUMMARY ***
Total pot $0.56 | Rake $0.02 | Jackpot $0 | Bingo $0 | Fortune $0
Seat 1: Hero (button) folded before Flop (didn't bet)
Seat 2: 463d2ce5 (small blind) collected ($0.54)
Seat 3: 880f1c43 (big blind) folded before Flop
Seat 4: 5332610a folded before Flop (didn't bet)
Seat 5: c8b55763 folded before Flop (didn't bet)
Seat 6: 4eef219b folded before Flop


Poker Hand #RC1433273698: Hold'em No Limit  ($0.05/$0.1) - 2023/03/27 18:52:46
Table 'RushAndCash28158958' 6-max Seat #1 is the button
Seat 1: 91126514 ($10.23 in chips)
Seat 2: 4aaacbb ($29.45 in chips)
Seat 3: Hero ($26.13 in chips)
Seat 4: c8b55763 ($9 in chips)
Seat 5: 1a56dcff ($10.34 in chips)
Seat 6: 463d2ce5 ($12.92 in chips)
4aaacbb: posts small blind $0.05
Hero: posts big blind $0.1
*** HOLE CARDS ***
Dealt to 91126514 
Dealt to 4aaacbb 
Dealt to Hero [Tc 8c]
Dealt to c8b55763 
Dealt to 1a56dcff 
Dealt to 463d2ce5 
c8b55763: raises $0.15 to $0.25
1a56dcff: folds
463d2ce5: calls $0.25
91126514: folds
4aaacbb: folds
Hero: calls $0.15
*** FLOP *** [4d Td 8d]
Hero: bets $0.5
c8b55763: folds
463d2ce5: folds
Uncalled bet ($0.5) returned to Hero
*** SHOWDOWN ***
Hero collected $0.76 from pot
*** SUMMARY ***
Total pot $0.8 | Rake $0.04 | Jackpot $0 | Bingo $0 | Fortune $0
Board [4d Td 8d]
Seat 1: 91126514 (button) folded before Flop (didn't bet)
Seat 2: 4aaacbb (small blind) folded before Flop
Seat 3: Hero (big blind) won ($0.76)
Seat 4: c8b55763 folded on the Flop
Seat 5: 1a56dcff folded before Flop (didn't bet)
Seat 6: 463d2ce5 folded on the Flop


Poker Hand #RC1433273665: Hold'em No Limit  ($0.05/$0.1) - 2023/03/27 18:52:41
Table 'RushAndCash28158925' 6-max Seat #1 is the button
Seat 1: 61c00c39 ($16.56 in chips)
Seat 2: feefb968 ($9.65 in chips)
Seat 3: 3ac921d8 ($4.84 in chips)
Seat 4: c58d980 ($10 in chips)
Seat 5: 11ce9473 ($10.87 in chips)
Seat 6: Hero ($26.13 in chips)
feefb968: posts small blind $0.05
3ac921d8: posts big blind $0.1
*** HOLE CARDS ***
Dealt to 61c00c39 
Dealt to feefb968 
Dealt to 3ac921d8 
Dealt to c58d980 
Dealt to 11ce9473 
Dealt to Hero [8h 3d]
c58d980: folds
11ce9473: raises $0.1 to $0.2
Hero: folds
61c00c39: folds
feefb968: folds
3ac921d8: folds
Uncalled bet ($0.1) returned to 11ce9473
*** SHOWDOWN ***
11ce9473 collected $0.25 from pot
*** SUMMARY ***
Total pot $0.25 | Rake $0 | Jackpot $0 | Bingo $0 | Fortune $0
Seat 1: 61c00c39 (button) folded before Flop (didn't bet)
Seat 2: feefb968 (small blind) folded before Flop
Seat 3: 3ac921d8 (big blind) folded before Flop
Seat 4: c58d980 folded before Flop (didn't bet)
Seat 5: 11ce9473 collected ($0.25)
Seat 6: Hero folded before Flop (didn't bet)


Poker Hand #RC1433272510: Hold'em No Limit  ($0.05/$0.1) - 2023/03/27 18:50:07
Table 'RushAndCash28157770' 6-max Seat #1 is the button
Seat 1: d0270177 ($13.29 in chips)
Seat 2: d9d69605 ($25.97 in chips)
Seat 3: a5714da ($27.19 in chips)
Seat 4: 11e8a420 ($13.16 in chips)
Seat 5: 2d64a59a ($10 in chips)
Seat 6: Hero ($26.13 in chips)
d9d69605: posts small blind $0.05
a5714da: posts big blind $0.1
*** HOLE CARDS ***
Dealt to d0270177 
Dealt to d9d69605 
Dealt to a5714da 
Dealt to 11e8a420 
Dealt to 2d64a59a 
Dealt to Hero [3s 6d]
11e8a420: raises $0.2 to $0.3
2d64a59a: folds
Hero: folds
d0270177: folds
d9d69605: folds
a5714da: calls $0.2
*** FLOP *** [Ah 9h 7d]
a5714da: checks
11e8a420: checks
*** TURN *** [Ah 9h 7d] [Ac]
a5714da: bets $0.35
11e8a420: folds
Uncalled bet ($0.35) returned to a5714da
*** SHOWDOWN ***
a5714da collected $0.62 from pot
*** SUMMARY ***
Total pot $0.65 | Rake $0.03 | Jackpot $0 | Bingo $0 | Fortune $0
Board [Ah 9h 7d Ac]
Seat 1: d0270177 (button) folded before Flop (didn't bet)
Seat 2: d9d69605 (small blind) folded before Flop
Seat 3: a5714da (big blind) won ($0.62)
Seat 4: 11e8a420 folded on the Turn
Seat 5: 2d64a59a folded before Flop (didn't bet)
Seat 6: Hero folded before Flop (didn't bet)


Poker Hand #RC1433272351: Hold'em No Limit  ($0.05/$0.1) - 2023/03/27 18:49:47
Table 'RushAndCash28157611' 6-max Seat #1 is the button
Seat 1: 47f5d8ff ($13.4 in chips)
Seat 2: 7123fbfe ($4.66 in chips)
Seat 3: d082e5cc ($8.07 in chips)
Seat 4: b6e393f3 ($10.82 in chips)
Seat 5: Hero ($25.98 in chips)
Seat 6: b1468e60 ($10.83 in chips)
7123fbfe: posts small blind $0.05
d082e5cc: posts big blind $0.1
*** HOLE CARDS ***
Dealt to 47f5d8ff 
Dealt to 7123fbfe 
Dealt to d082e5cc 
Dealt to b6e393f3 
Dealt to Hero [6h 5h]
Dealt to b1468e60 
b6e393f3: folds
Hero: raises $0.15 to $0.25
b1468e60: folds
47f5d8ff: folds
7123fbfe: folds
d082e5cc: folds
Uncalled bet ($0.15) returned to Hero
*** SHOWDOWN ***
Hero collected $0.25 from pot
*** SUMMARY ***
Total pot $0.25 | Rake $0 | Jackpot $0 | Bingo $0 | Fortune $0
Seat 1: 47f5d8ff (button) folded before Flop (didn't bet)
Seat 2: 7123fbfe (small blind) folded before Flop
Seat 3: d082e5cc (big blind) folded before Flop
Seat 4: b6e393f3 folded before Flop (didn't bet)
Seat 5: Hero collected ($0.25)
Seat 6: b1468e60 folded before Flop (didn't bet)


Poker Hand #RC1433272298: Hold'em No Limit  ($0.05/$0.1) - 2023/03/27 18:49:40
Table 'RushAndCash28157558' 6-max Seat #1 is the button
Seat 1: d6e94453 ($12.27 in chips)
Seat 2: 58a6ffbd ($18.96 in chips)
Seat 3: 40051e2 ($10 in chips)
Seat 4: d6241a16 ($11.64 in chips)
Seat 5: Hero ($25.98 in chips)
Seat 6: acd99267 ($10 in chips)
58a6ffbd: posts small blind $0.05
40051e2: posts big blind $0.1
*** HOLE CARDS ***
Dealt to d6e94453 
Dealt to 58a6ffbd 
Dealt to 40051e2 
Dealt to d6241a16 
Dealt to Hero [As 2h]
Dealt to acd99267 
d6241a16: folds
Hero: folds
acd99267: folds
d6e94453: raises $0.15 to $0.25
58a6ffbd: folds
40051e2: calls $0.15
*** FLOP *** [3s 3c 8d]
40051e2: checks
d6e94453: checks
*** TURN *** [3s 3c 8d] [7h]
40051e2: checks
d6e94453: checks
*** RIVER *** [3s 3c 8d 7h] [Td]
40051e2: checks
d6e94453: checks
40051e2: shows [Ks 5s] (Pair of Treys)
d6e94453: shows [2c 2d] (Pair of Treys and Pair of Twos)
*** SHOWDOWN ***
d6e94453 collected $0.53 from pot
*** SUMMARY ***
Total pot $0.55 | Rake $0.02 | Jackpot $0 | Bingo $0 | Fortune $0
Board [3s 3c 8d 7h Td]
Seat 1: d6e94453 (button) showed [2c 2d] and won ($0.53) with Pair of Treys and Pair of Twos
Seat 2: 58a6ffbd (small blind) folded before Flop
Seat 3: 40051e2 (big blind) showed [Ks 5s] and lost with Pair of Treys
Seat 4: d6241a16 folded before Flop (didn't bet)
Seat 5: Hero folded before Flop (didn't bet)
Seat 6: acd99267 folded before Flop (didn't bet)


Poker Hand #RC1433272193: Hold'em No Limit  ($0.05/$0.1) - 2023/03/27 18:49:28
Table 'RushAndCash28157453' 6-max Seat #1 is the button
Seat 1: 58a6ffbd ($18.96 in chips)
Seat 2: Hero ($26.03 in chips)
Seat 3: ac377bbe ($18.91 in chips)
Seat 4: be700dc2 ($9 in chips)
Seat 5: c2c593b0 ($4.92 in chips)
Seat 6: c8952f26 ($10.9 in chips)
Hero: posts small blind $0.05
ac377bbe: posts big blind $0.1
*** HOLE CARDS ***
Dealt to 58a6ffbd 
Dealt to Hero [2s Kd]
Dealt to ac377bbe 
Dealt to be700dc2 
Dealt to c2c593b0 
Dealt to c8952f26 
be700dc2: folds
c2c593b0: raises $0.1 to $0.2
c8952f26: folds
58a6ffbd: folds
Hero: folds
ac377bbe: folds
Uncalled bet ($0.1) returned to c2c593b0
*** SHOWDOWN ***
c2c593b0 collected $0.25 from pot
*** SUMMARY ***
Total pot $0.25 | Rake $0 | Jackpot $0 | Bingo $0 | Fortune $0
Seat 1: 58a6ffbd (button) folded before Flop (didn't bet)
Seat 2: Hero (small blind) folded before Flop
Seat 3: ac377bbe (big blind) folded before Flop
Seat 4: be700dc2 folded before Flop (didn't bet)
Seat 5: c2c593b0 collected ($0.25)
Seat 6: c8952f26 folded before Flop (didn't bet)


Poker Hand #RC1433272147: Hold'em No Limit  ($0.05/$0.1) - 2023/03/27 18:49:22
Table 'RushAndCash28157407' 6-max Seat #1 is the button
Seat 1: ec3bebf3 ($20.4 in chips)
Seat 2: 931c19f6 ($11.12 in chips)
Seat 3: 543bc9d6 ($10 in chips)
Seat 4: 73c36ec5 ($14.9 in chips)
Seat 5: 700f7810 ($9.05 in chips)
Seat 6: Hero ($26.03 in chips)
931c19f6: posts small blind $0.05
543bc9d6: posts big blind $0.1
*** HOLE CARDS ***
Dealt to ec3bebf3 
Dealt to 931c19f6 
Dealt to 543bc9d6 
Dealt to 73c36ec5 
Dealt to 700f7810 
Dealt to Hero [2s 6s]
73c36ec5: folds
700f7810: folds
Hero: folds
ec3bebf3: folds
931c19f6: raises $0.3 to $0.4
543bc9d6: folds
Uncalled bet ($0.3) returned to 931c19f6
*** SHOWDOWN ***
931c19f6 collected $0.2 from pot
*** SUMMARY ***
Total pot $0.2 | Rake $0 | Jackpot $0 | Bingo $0 | Fortune $0
Seat 1: ec3bebf3 (button) folded before Flop (didn't bet)
Seat 2: 931c19f6 (small blind) collected ($0.2)
Seat 3: 543bc9d6 (big blind) folded before Flop
Seat 4: 73c36ec5 folded before Flop (didn't bet)
Seat 5: 700f7810 folded before Flop (didn't bet)
Seat 6: Hero folded before Flop (didn't bet)


Poker Hand #RC1433270472: Hold'em No Limit  ($0.05/$0.1) - 2023/03/27 18:45:43
Table 'RushAndCash28155732' 6-max Seat #1 is the button
Seat 1: c546be70 ($12.41 in chips)
Seat 2: 9ea17a48 ($2.44 in chips)
Seat 3: 91f3952f ($17.19 in chips)
Seat 4: 662b9b07 ($15.12 in chips)
Seat 5: 72e78d5 ($10.49 in chips)
Seat 6: Hero ($25.88 in chips)
9ea17a48: posts small blind $0.05
91f3952f: posts big blind $0.1
*** HOLE CARDS ***
Dealt to c546be70 
Dealt to 9ea17a48 
Dealt to 91f3952f 
Dealt to 662b9b07 
Dealt to 72e78d5 
Dealt to Hero [6d 8d]
662b9b07: folds
72e78d5: folds
Hero: raises $0.15 to $0.25
c546be70: folds
9ea17a48: folds
91f3952f: folds
Uncalled bet ($0.15) returned to Hero
*** SHOWDOWN ***
Hero collected $0.25 from pot
*** SUMMARY ***
Total pot $0.25 | Rake $0 | Jackpot $0 | Bingo $0 | Fortune $0
Seat 1: c546be70 (button) folded before Flop (didn't bet)
Seat 2: 9ea17a48 (small blind) folded before Flop
Seat 3: 91f3952f (big blind) folded before Flop
Seat 4: 662b9b07 folded before Flop (didn't bet)
Seat 5: 72e78d5 folded before Flop (didn't bet)
Seat 6: Hero collected ($0.25)


Poker Hand #RC1433270413: Hold'em No Limit  ($0.05/$0.1) - 2023/03/27 18:45:34
Table 'RushAndCash28155673' 6-max Seat #1 is the button
Seat 1: 7249c649 ($19.75 in chips)
Seat 2: bc200b82 ($10 in chips)
Seat 3: defc8945 ($10 in chips)
Seat 4: Hero ($25.88 in chips)
Seat 5: b3645cfc ($9.68 in chips)
Seat 6: befa88de ($10.15 in chips)
bc200b82: posts small blind $0.05
defc8945: posts big blind $0.1
*** HOLE CARDS ***
Dealt to 7249c649 
Dealt to bc200b82 
Dealt to defc8945 
Dealt to Hero [6s 8s]
Dealt to b3645cfc 
Dealt to befa88de 
Hero: folds
b3645cfc: folds
befa88de: raises $0.15 to $0.25
7249c649: folds
bc200b82: folds
defc8945: folds
Uncalled bet ($0.15) returned to befa88de
*** SHOWDOWN ***
befa88de collected $0.25 from pot
*** SUMMARY ***
Total pot $0.25 | Rake $0 | Jackpot $0 | Bingo $0 | Fortune $0
Seat 1: 7249c649 (button) folded before Flop (didn't bet)
Seat 2: bc200b82 (small blind) folded before Flop
Seat 3: defc8945 (big blind) folded before Flop
Seat 4: Hero folded before Flop (didn't bet)
Seat 5: b3645cfc folded before Flop (didn't bet)
Seat 6: befa88de collected ($0.25)


Poker Hand #RC1433270321: Hold'em No Limit  ($0.05/$0.1) - 2023/03/27 18:45:24
Table 'RushAndCash28155581' 6-max Seat #1 is the button
Seat 1: Hero ($25.88 in chips)
Seat 2: 1222fae3 ($10 in chips)
Seat 3: 35181a57 ($17.48 in chips)
Seat 4: ad1bf850 ($9.55 in chips)
Seat 5: ae967dca ($9.8 in chips)
Seat 6: c307f987 ($10 in chips)
1222fae3: posts small blind $0.05
35181a57: posts big blind $0.1
*** HOLE CARDS ***
Dealt to Hero [2s Qs]
Dealt to 1222fae3 
Dealt to 35181a57 
Dealt to ad1bf850 
Dealt to ae967dca 
Dealt to c307f987 
ad1bf850: folds
ae967dca: folds
c307f987: folds
Hero: folds
1222fae3: raises $0.1 to $0.2
35181a57: folds
Uncalled bet ($0.1) returned to 1222fae3
*** SHOWDOWN ***
1222fae3 collected $0.2 from pot
*** SUMMARY ***
Total pot $0.2 | Rake $0 | Jackpot $0 | Bingo $0 | Fortune $0
Seat 1: Hero (button) folded before Flop (didn't bet)
Seat 2: 1222fae3 (small blind) collected ($0.2)
Seat 3: 35181a57 (big blind) folded before Flop
Seat 4: ad1bf850 folded before Flop (didn't bet)
Seat 5: ae967dca folded before Flop (didn't bet)
Seat 6: c307f987 folded before Flop (didn't bet)


Poker Hand #RC1433270171: Hold'em No Limit  ($0.05/$0.1) - 2023/03/27 18:45:05
Table 'RushAndCash28155431' 6-max Seat #1 is the button
Seat 1: Hero ($25.88 in chips)
Seat 2: d3a652d6 ($18.52 in chips)
Seat 3: c682ccb4 ($51.12 in chips)
Seat 4: 1c31ab5b ($9.55 in chips)
Seat 5: e38578a ($6.4 in chips)
Seat 6: 7465263d ($59.6 in chips)
d3a652d6: posts small blind $0.05
c682ccb4: posts big blind $0.1
*** HOLE CARDS ***
Dealt to Hero [4s 6d]
Dealt to d3a652d6 
Dealt to c682ccb4 
Dealt to 1c31ab5b 
Dealt to e38578a 
Dealt to 7465263d 
1c31ab5b: folds
e38578a: folds
7465263d: folds
Hero: folds
d3a652d6: raises $0.3 to $0.4
c682ccb4: folds
Uncalled bet ($0.3) returned to d3a652d6
*** SHOWDOWN ***
d3a652d6 collected $0.2 from pot
*** SUMMARY ***
Total pot $0.2 | Rake $0 | Jackpot $0 | Bingo $0 | Fortune $0
Seat 1: Hero (button) folded before Flop (didn't bet)
Seat 2: d3a652d6 (small blind) collected ($0.2)
Seat 3: c682ccb4 (big blind) folded before Flop
Seat 4: 1c31ab5b folded before Flop (didn't bet)
Seat 5: e38578a folded before Flop (didn't bet)
Seat 6: 7465263d folded before Flop (didn't bet)


Poker Hand #RC1433270041: Hold'em No Limit  ($0.05/$0.1) - 2023/03/27 18:44:50
Table 'RushAndCash28155301' 6-max Seat #1 is the button
Seat 1: Hero ($25.88 in chips)
Seat 2: cb91e079 ($20.57 in chips)
Seat 3: cfaf4ca4 ($17.53 in chips)
Seat 4: 5a07f9c9 ($10.3 in chips)
Seat 5: c20fb006 ($23.36 in chips)
Seat 6: 42391a92 ($14.21 in chips)
cb91e079: posts small blind $0.05
cfaf4ca4: posts big blind $0.1
*** HOLE CARDS ***
Dealt to Hero [8c 2c]
Dealt to cb91e079 
Dealt to cfaf4ca4 
Dealt to 5a07f9c9 
Dealt to c20fb006 
Dealt to 42391a92 
5a07f9c9: folds
c20fb006: folds
42391a92: raises $0.12 to $0.22
Hero: folds
cb91e079: raises $0.76 to $0.98
cfaf4ca4: folds
42391a92: calls $0.76
*** FLOP *** [2d 4c 3s]
cb91e079: bets $0.68
42391a92: calls $0.68
*** TURN *** [2d 4c 3s] [8d]
cb91e079: checks
42391a92: bets $1.13
cb91e079: raises $3.75 to $4.88
42391a92: calls $3.75
*** RIVER *** [2d 4c 3s 8d] [Qd]
cb91e079: checks
42391a92: bets $2.8
cb91e079: folds
Uncalled bet ($2.8) returned to 42391a92
*** SHOWDOWN ***
42391a92 collected $12.73 from pot
*** SUMMARY ***
Total pot $13.18 | Rake $0.3 | Jackpot $0.15 | Bingo $0 | Fortune $0
Board [2d 4c 3s 8d Qd]
Seat 1: Hero (button) folded before Flop (didn't bet)
Seat 2: cb91e079 (small blind) folded on the River
Seat 3: cfaf4ca4 (big blind) folded before Flop
Seat 4: 5a07f9c9 folded before Flop (didn't bet)
Seat 5: c20fb006 folded before Flop (didn't bet)
Seat 6: 42391a92 won ($12.73)


Poker Hand #RC1433269968: Hold'em No Limit  ($0.05/$0.1) - 2023/03/27 18:44:40
Table 'RushAndCash28155228' 6-max Seat #1 is the button
Seat 1: a4010134 ($10.28 in chips)
Seat 2: Hero ($25.93 in chips)
Seat 3: 3a27c801 ($11.62 in chips)
Seat 4: 17e7697a ($11.24 in chips)
Seat 5: e47f45a5 ($3.08 in chips)
Seat 6: cf3f2b57 ($9.35 in chips)
Hero: posts small blind $0.05
3a27c801: posts big blind $0.1
*** HOLE CARDS ***
Dealt to a4010134 
Dealt to Hero [9s 7c]
Dealt to 3a27c801 
Dealt to 17e7697a 
Dealt to e47f45a5 
Dealt to cf3f2b57 
17e7697a: folds
e47f45a5: raises $0.1 to $0.2
cf3f2b57: folds
a4010134: folds
Hero: folds
3a27c801: folds
Uncalled bet ($0.1) returned to e47f45a5
*** SHOWDOWN ***
e47f45a5 collected $0.25 from pot
*** SUMMARY ***
Total pot $0.25 | Rake $0 | Jackpot $0 | Bingo $0 | Fortune $0
Seat 1: a4010134 (button) folded before Flop (didn't bet)
Seat 2: Hero (small blind) folded before Flop
Seat 3: 3a27c801 (big blind) folded before Flop
Seat 4: 17e7697a folded before Flop (didn't bet)
Seat 5: e47f45a5 collected ($0.25)
Seat 6: cf3f2b57 folded before Flop (didn't bet)


Poker Hand #RC1433269897: Hold'em No Limit  ($0.05/$0.1) - 2023/03/27 18:44:32
Table 'RushAndCash28155157' 6-max Seat #1 is the button
Seat 1: 8f2c52f7 ($11.5 in chips)
Seat 2: a36cc52d ($18.58 in chips)
Seat 3: c1e4a365 ($12.15 in chips)
Seat 4: 4c00ad42 ($10.19 in chips)
Seat 5: 75665ec6 ($10.25 in chips)
Seat 6: Hero ($25.93 in chips)
a36cc52d: posts small blind $0.05
c1e4a365: posts big blind $0.1
*** HOLE CARDS ***
Dealt to 8f2c52f7 
Dealt to a36cc52d 
Dealt to c1e4a365 
Dealt to 4c00ad42 
Dealt to 75665ec6 
Dealt to Hero [Ac 4h]
4c00ad42: folds
75665ec6: folds
Hero: folds
8f2c52f7: raises $0.15 to $0.25
a36cc52d: folds
c1e4a365: folds
Uncalled bet ($0.15) returned to 8f2c52f7
*** SHOWDOWN ***
8f2c52f7 collected $0.25 from pot
*** SUMMARY ***
Total pot $0.25 | Rake $0 | Jackpot $0 | Bingo $0 | Fortune $0
Seat 1: 8f2c52f7 (button) collected ($0.25)
Seat 2: a36cc52d (small blind) folded before Flop
Seat 3: c1e4a365 (big blind) folded before Flop
Seat 4: 4c00ad42 folded before Flop (didn't bet)
Seat 5: 75665ec6 folded before Flop (didn't bet)
Seat 6: Hero folded before Flop (didn't bet)


Poker Hand #RC1433269859: Hold'em No Limit  ($0.05/$0.1) - 2023/03/27 18:44:27
Table 'RushAndCash28155119' 6-max Seat #1 is the button
Seat 1: 76e28aa8 ($15.43 in chips)
Seat 2: 40376670 ($12.05 in chips)
Seat 3: b0e08892 ($16.3 in chips)
Seat 4: Hero ($25.93 in chips)
Seat 5: e79ffd0e ($13.75 in chips)
Seat 6: 2d00c95f ($10.61 in chips)
40376670: posts small blind $0.05
b0e08892: posts big blind $0.1
*** HOLE CARDS ***
Dealt to 76e28aa8 
Dealt to 40376670 
Dealt to b0e08892 
Dealt to Hero [4d 7c]
Dealt to e79ffd0e 
Dealt to 2d00c95f 
Hero: folds
e79ffd0e: folds
2d00c95f: folds
76e28aa8: folds
40376670: raises $0.2 to $0.3
b0e08892: calls $0.2
*** FLOP *** [3d 6h Qh]
40376670: bets $0.32
b0e08892: folds
Uncalled bet ($0.32) returned to 40376670
*** SHOWDOWN ***
40376670 collected $0.57 from pot
*** SUMMARY ***
Total pot $0.6 | Rake $0.03 | Jackpot $0 | Bingo $0 | Fortune $0
Board [3d 6h Qh]
Seat 1: 76e28aa8 (button) folded before Flop (didn't bet)
Seat 2: 40376670 (small blind) won ($0.57)
Seat 3: b0e08892 (big blind) folded on the Flop
Seat 4: Hero folded before Flop (didn't bet)
Seat 5: e79ffd0e folded before Flop (didn't bet)
Seat 6: 2d00c95f folded before Flop (didn't bet)


Poker Hand #RC1433269824: Hold'em No Limit  ($0.05/$0.1) - 2023/03/27 18:44:22
Table 'RushAndCash28155084' 6-max Seat #1 is the button
Seat 1: 4c00ad42 ($10.19 in chips)
Seat 2: Hero ($25.98 in chips)
Seat 3: 6a909d3f ($10 in chips)
Seat 4: 5900f94f ($10 in chips)
Seat 5: 35d0c3dd ($12.36 in chips)
Seat 6: a12a7b74 ($13.27 in chips)
Hero: posts small blind $0.05
6a909d3f: posts big blind $0.1
*** HOLE CARDS ***
Dealt to 4c00ad42 
Dealt to Hero [9c 7s]
Dealt to 6a909d3f 
Dealt to 5900f94f 
Dealt to 35d0c3dd 
Dealt to a12a7b74 
5900f94f: folds
35d0c3dd: folds
a12a7b74: folds
4c00ad42: folds
Hero: folds
Uncalled bet ($0.05) returned to 6a909d3f
*** SHOWDOWN ***
6a909d3f collected $0.1 from pot
*** SUMMARY ***
Total pot $0.1 | Rake $0 | Jackpot $0 | Bingo $0 | Fortune $0
Seat 1: 4c00ad42 (button) folded before Flop (didn't bet)
Seat 2: Hero (small blind) folded before Flop
Seat 3: 6a909d3f (big blind) collected ($0.1)
Seat 4: 5900f94f folded before Flop (didn't bet)
Seat 5: 35d0c3dd folded before Flop (didn't bet)
Seat 6: a12a7b74 folded before Flop (didn't bet)


Poker Hand #RC1433269720: Hold'em No Limit  ($0.05/$0.1) - 2023/03/27 18:44:09
Table 'RushAndCash28154980' 6-max Seat #1 is the button
Seat 1: defc8945 ($10 in chips)
Seat 2: 27d009 ($13.8 in chips)
Seat 3: Hero ($26.08 in chips)
Seat 4: c522d2b5 ($10.41 in chips)
Seat 5: e2d0eb8b ($10 in chips)
Seat 6: 35bdfeec ($19.52 in chips)
27d009: posts small blind $0.05
Hero: posts big blind $0.1
*** HOLE CARDS ***
Dealt to defc8945 
Dealt to 27d009 
Dealt to Hero [6c 2d]
Dealt to c522d2b5 
Dealt to e2d0eb8b 
Dealt to 35bdfeec 
c522d2b5: folds
e2d0eb8b: folds
35bdfeec: folds
defc8945: raises $0.15 to $0.25
27d009: folds
Hero: folds
Uncalled bet ($0.15) returned to defc8945
*** SHOWDOWN ***
defc8945 collected $0.25 from pot
*** SUMMARY ***
Total pot $0.25 | Rake $0 | Jackpot $0 | Bingo $0 | Fortune $0
Seat 1: defc8945 (button) collected ($0.25)
Seat 2: 27d009 (small blind) folded before Flop
Seat 3: Hero (big blind) folded before Flop
Seat 4: c522d2b5 folded before Flop (didn't bet)
Seat 5: e2d0eb8b folded before Flop (didn't bet)
Seat 6: 35bdfeec folded before Flop (didn't bet)


Poker Hand #RC1433269659: Hold'em No Limit  ($0.05/$0.1) - 2023/03/27 18:44:02
Table 'RushAndCash28154919' 6-max Seat #1 is the button
Seat 1: d0270177 ($10.24 in chips)
Seat 2: 2616e50 ($6.96 in chips)
Seat 3: a2aeaf1a ($13.87 in chips)
Seat 4: aed1a693 ($26.34 in chips)
Seat 5: Hero ($26.08 in chips)
Seat 6: b78d4c8b ($4.1 in chips)
2616e50: posts small blind $0.05
a2aeaf1a: posts big blind $0.1
*** HOLE CARDS ***
Dealt to d0270177 
Dealt to 2616e50 
Dealt to a2aeaf1a 
Dealt to aed1a693 
Dealt to Hero [2c 7d]
Dealt to b78d4c8b 
aed1a693: folds
Hero: folds
b78d4c8b: folds
d0270177: folds
2616e50: folds
Uncalled bet ($0.05) returned to a2aeaf1a
*** SHOWDOWN ***
a2aeaf1a collected $0.1 from pot
*** SUMMARY ***
Total pot $0.1 | Rake $0 | Jackpot $0 | Bingo $0 | Fortune $0
Seat 1: d0270177 (button) folded before Flop (didn't bet)
Seat 2: 2616e50 (small blind) folded before Flop
Seat 3: a2aeaf1a (big blind) collected ($0.1)
Seat 4: aed1a693 folded before Flop (didn't bet)
Seat 5: Hero folded before Flop (didn't bet)
Seat 6: b78d4c8b folded before Flop (didn't bet)


Poker Hand #RC1433269618: Hold'em No Limit  ($0.05/$0.1) - 2023/03/27 18:43:56
Table 'RushAndCash28154878' 6-max Seat #1 is the button
Seat 1: 22107aae ($10.74 in chips)
Seat 2: e82aaa44 ($9.75 in chips)
Seat 3: Hero ($26.18 in chips)
Seat 4: 682e00a ($20.53 in chips)
Seat 5: f1319b05 ($10 in chips)
Seat 6: 5e095193 ($6.89 in chips)
e82aaa44: posts small blind $0.05
Hero: posts big blind $0.1
*** HOLE CARDS ***
Dealt to 22107aae 
Dealt to e82aaa44 
Dealt to Hero [4d 8c]
Dealt to 682e00a 
Dealt to f1319b05 
Dealt to 5e095193 
682e00a: folds
f1319b05: folds
5e095193: folds
22107aae: raises $0.15 to $0.25
e82aaa44: folds
Hero: folds
Uncalled bet ($0.15) returned to 22107aae
*** SHOWDOWN ***
22107aae collected $0.25 from pot
*** SUMMARY ***
Total pot $0.25 | Rake $0 | Jackpot $0 | Bingo $0 | Fortune $0
Seat 1: 22107aae (button) collected ($0.25)
Seat 2: e82aaa44 (small blind) folded before Flop
Seat 3: Hero (big blind) folded before Flop
Seat 4: 682e00a folded before Flop (didn't bet)
Seat 5: f1319b05 folded before Flop (didn't bet)
Seat 6: 5e095193 folded before Flop (didn't bet)


Poker Hand #RC1433269358: Hold'em No Limit  ($0.05/$0.1) - 2023/03/27 18:43:20
Table 'RushAndCash28154618' 6-max Seat #1 is the button
Seat 1: a91c01fe ($8.45 in chips)
Seat 2: 4f2d4bac ($9.9 in chips)
Seat 3: e82aaa44 ($10 in chips)
Seat 4: 5f678eeb ($9.85 in chips)
Seat 5: 1148c754 ($20.28 in chips)
Seat 6: Hero ($25.9 in chips)
4f2d4bac: posts small blind $0.05
e82aaa44: posts big blind $0.1
*** HOLE CARDS ***
Dealt to a91c01fe 
Dealt to 4f2d4bac 
Dealt to e82aaa44 
Dealt to 5f678eeb 
Dealt to 1148c754 
Dealt to Hero [Ts Js]
5f678eeb: folds
1148c754: folds
Hero: raises $0.15 to $0.25
a91c01fe: folds
4f2d4bac: folds
e82aaa44: calls $0.15
*** FLOP *** [2h Jd Ad]
e82aaa44: checks
Hero: checks
*** TURN *** [2h Jd Ad] [9d]
e82aaa44: checks
Hero: bets $0.28
e82aaa44: folds
Uncalled bet ($0.28) returned to Hero
*** SHOWDOWN ***
Hero collected $0.53 from pot
*** SUMMARY ***
Total pot $0.55 | Rake $0.02 | Jackpot $0 | Bingo $0 | Fortune $0
Board [2h Jd Ad 9d]
Seat 1: a91c01fe (button) folded before Flop (didn't bet)
Seat 2: 4f2d4bac (small blind) folded before Flop
Seat 3: e82aaa44 (big blind) folded on the Turn
Seat 4: 5f678eeb folded before Flop (didn't bet)
Seat 5: 1148c754 folded before Flop (didn't bet)
Seat 6: Hero won ($0.53)


Poker Hand #RC1433269322: Hold'em No Limit  ($0.05/$0.1) - 2023/03/27 18:43:15
Table 'RushAndCash28154582' 6-max Seat #1 is the button
Seat 1: Hero ($25.9 in chips)
Seat 2: b4780f2d ($18.18 in chips)
Seat 3: 6024565d ($13.11 in chips)
Seat 4: 5dd9770d ($32.37 in chips)
Seat 5: 3e2ce794 ($11.34 in chips)
Seat 6: b8f54584 ($13.31 in chips)
b4780f2d: posts small blind $0.05
6024565d: posts big blind $0.1
*** HOLE CARDS ***
Dealt to Hero [4c 8d]
Dealt to b4780f2d 
Dealt to 6024565d 
Dealt to 5dd9770d 
Dealt to 3e2ce794 
Dealt to b8f54584 
5dd9770d: raises $0.15 to $0.25
3e2ce794: folds
b8f54584: folds
Hero: folds
b4780f2d: folds
6024565d: folds
Uncalled bet ($0.15) returned to 5dd9770d
*** SHOWDOWN ***
5dd9770d collected $0.25 from pot
*** SUMMARY ***
Total pot $0.25 | Rake $0 | Jackpot $0 | Bingo $0 | Fortune $0
Seat 1: Hero (button) folded before Flop (didn't bet)
Seat 2: b4780f2d (small blind) folded before Flop
Seat 3: 6024565d (big blind) folded before Flop
Seat 4: 5dd9770d collected ($0.25)
Seat 5: 3e2ce794 folded before Flop (didn't bet)
Seat 6: b8f54584 folded before Flop (didn't bet)


Poker Hand #RC1433269285: Hold'em No Limit  ($0.05/$0.1) - 2023/03/27 18:43:11
Table 'RushAndCash28154545' 6-max Seat #1 is the button
Seat 1: 3f47bf23 ($9.79 in chips)
Seat 2: 3658c188 ($10 in chips)
Seat 3: 2b301960 ($10 in chips)
Seat 4: Hero ($25.9 in chips)
Seat 5: b95c5a94 ($15.89 in chips)
Seat 6: 91f3952f ($18.41 in chips)
3658c188: posts small blind $0.05
2b301960: posts big blind $0.1
*** HOLE CARDS ***
Dealt to 3f47bf23 
Dealt to 3658c188 
Dealt to 2b301960 
Dealt to Hero [Kc 6d]
Dealt to b95c5a94 
Dealt to 91f3952f 
Hero: folds
b95c5a94: raises $0.15 to $0.25
91f3952f: folds
3f47bf23: folds
3658c188: folds
2b301960: raises $0.75 to $1
b95c5a94: folds
Uncalled bet ($0.75) returned to 2b301960
*** SHOWDOWN ***
2b301960 collected $0.53 from pot
*** SUMMARY ***
Total pot $0.55 | Rake $0.02 | Jackpot $0 | Bingo $0 | Fortune $0
Seat 1: 3f47bf23 (button) folded before Flop (didn't bet)
Seat 2: 3658c188 (small blind) folded before Flop
Seat 3: 2b301960 (big blind) collected ($0.53)
Seat 4: Hero folded before Flop (didn't bet)
Seat 5: b95c5a94 folded before Flop
Seat 6: 91f3952f folded before Flop (didn't bet)


Poker Hand #RC1433269174: Hold'em No Limit  ($0.05/$0.1) - 2023/03/27 18:42:57
Table 'RushAndCash28154434' 6-max Seat #1 is the button
Seat 1: acd99267 ($10 in chips)
Seat 2: b23948da ($15.25 in chips)
Seat 3: Hero ($26 in chips)
Seat 4: 4987624d ($21.23 in chips)
Seat 5: 61c00c39 ($14.63 in chips)
Seat 6: 22332c6 ($10.76 in chips)
b23948da: posts small blind $0.05
Hero: posts big blind $0.1
*** HOLE CARDS ***
Dealt to acd99267 
Dealt to b23948da 
Dealt to Hero [3d 4d]
Dealt to 4987624d 
Dealt to 61c00c39 
Dealt to 22332c6 
4987624d: folds
61c00c39: folds
22332c6: raises $0.2 to $0.3
acd99267: folds
b23948da: folds
Hero: folds
Uncalled bet ($0.2) returned to 22332c6
*** SHOWDOWN ***
22332c6 collected $0.25 from pot
*** SUMMARY ***
Total pot $0.25 | Rake $0 | Jackpot $0 | Bingo $0 | Fortune $0
Seat 1: acd99267 (button) folded before Flop (didn't bet)
Seat 2: b23948da (small blind) folded before Flop
Seat 3: Hero (big blind) folded before Flop
Seat 4: 4987624d folded before Flop (didn't bet)
Seat 5: 61c00c39 folded before Flop (didn't bet)
Seat 6: 22332c6 collected ($0.25)


Poker Hand #RC1433268996: Hold'em No Limit  ($0.05/$0.1) - 2023/03/27 18:42:34
Table 'RushAndCash28154256' 6-max Seat #1 is the button
Seat 1: 237ea5d6 ($13.78 in chips)
Seat 2: Hero ($26.3 in chips)
Seat 3: 4987624d ($20.96 in chips)
Seat 4: 6891f83f ($20.62 in chips)
Seat 5: ec3bebf3 ($22.37 in chips)
Seat 6: aa38b6e4 ($10.76 in chips)
Hero: posts small blind $0.05
4987624d: posts big blind $0.1
*** HOLE CARDS ***
Dealt to 237ea5d6 
Dealt to Hero [Ah Jc]
Dealt to 4987624d 
Dealt to 6891f83f 
Dealt to ec3bebf3 
Dealt to aa38b6e4 
6891f83f: folds
ec3bebf3: folds
aa38b6e4: folds
237ea5d6: folds
Hero: raises $0.2 to $0.3
4987624d: raises $0.8 to $1.1
Hero: folds
Uncalled bet ($0.8) returned to 4987624d
*** SHOWDOWN ***
4987624d collected $0.57 from pot
*** SUMMARY ***
Total pot $0.6 | Rake $0.03 | Jackpot $0 | Bingo $0 | Fortune $0
Seat 1: 237ea5d6 (button) folded before Flop (didn't bet)
Seat 2: Hero (small blind) folded before Flop
Seat 3: 4987624d (big blind) collected ($0.57)
Seat 4: 6891f83f folded before Flop (didn't bet)
Seat 5: ec3bebf3 folded before Flop (didn't bet)
Seat 6: aa38b6e4 folded before Flop (didn't bet)


Poker Hand #RC1433268948: Hold'em No Limit  ($0.05/$0.1) - 2023/03/27 18:42:28
Table 'RushAndCash28154208' 6-max Seat #1 is the button
Seat 1: 89af52a7 ($10.93 in chips)
Seat 2: eac5269d ($12.61 in chips)
Seat 3: cff7f2dd ($10.7 in chips)
Seat 4: b8f54584 ($13.41 in chips)
Seat 5: 4496b4bc ($10 in chips)
Seat 6: Hero ($26.3 in chips)
eac5269d: posts small blind $0.05
cff7f2dd: posts big blind $0.1
*** HOLE CARDS ***
Dealt to 89af52a7 
Dealt to eac5269d 
Dealt to cff7f2dd 
Dealt to b8f54584 
Dealt to 4496b4bc 
Dealt to Hero [9h 4h]
b8f54584: raises $0.1 to $0.2
4496b4bc: folds
Hero: folds
89af52a7: folds
eac5269d: folds
cff7f2dd: folds
Uncalled bet ($0.1) returned to b8f54584
*** SHOWDOWN ***
b8f54584 collected $0.25 from pot
*** SUMMARY ***
Total pot $0.25 | Rake $0 | Jackpot $0 | Bingo $0 | Fortune $0
Seat 1: 89af52a7 (button) folded before Flop (didn't bet)
Seat 2: eac5269d (small blind) folded before Flop
Seat 3: cff7f2dd (big blind) folded before Flop
Seat 4: b8f54584 collected ($0.25)
Seat 5: 4496b4bc folded before Flop (didn't bet)
Seat 6: Hero folded before Flop (didn't bet)


Poker Hand #RC1433268913: Hold'em No Limit  ($0.05/$0.1) - 2023/03/27 18:42:23
Table 'RushAndCash28154173' 6-max Seat #1 is the button
Seat 1: dbb39fc0 ($10.4 in chips)
Seat 2: Hero ($26.35 in chips)
Seat 3: dc2f4d92 ($34.91 in chips)
Seat 4: b23948da ($15.45 in chips)
Seat 5: fa8335e1 ($9.11 in chips)
Seat 6: e9e25e5e ($15.37 in chips)
Hero: posts small blind $0.05
dc2f4d92: posts big blind $0.1
*** HOLE CARDS ***
Dealt to dbb39fc0 
Dealt to Hero [3h Th]
Dealt to dc2f4d92 
Dealt to b23948da 
Dealt to fa8335e1 
Dealt to e9e25e5e 
b23948da: raises $0.1 to $0.2
fa8335e1: folds
e9e25e5e: folds
dbb39fc0: raises $0.61 to $0.81
Hero: folds
dc2f4d92: folds
b23948da: folds
Uncalled bet ($0.61) returned to dbb39fc0
*** SHOWDOWN ***
dbb39fc0 collected $0.53 from pot
*** SUMMARY ***
Total pot $0.55 | Rake $0.02 | Jackpot $0 | Bingo $0 | Fortune $0
Seat 1: dbb39fc0 (button) collected ($0.53)
Seat 2: Hero (small blind) folded before Flop
Seat 3: dc2f4d92 (big blind) folded before Flop
Seat 4: b23948da folded before Flop
Seat 5: fa8335e1 folded before Flop (didn't bet)
Seat 6: e9e25e5e folded before Flop (didn't bet)


Poker Hand #RC1433268873: Hold'em No Limit  ($0.05/$0.1) - 2023/03/27 18:42:18
Table 'RushAndCash28154133' 6-max Seat #1 is the button
Seat 1: 8ca88699 ($10 in chips)
Seat 2: 191ad11b ($10.49 in chips)
Seat 3: 2797b5a1 ($10 in chips)
Seat 4: 5eeee9be ($11.24 in chips)
Seat 5: 45b366a6 ($11.53 in chips)
Seat 6: Hero ($26.35 in chips)
191ad11b: posts small blind $0.05
2797b5a1: posts big blind $0.1
*** HOLE CARDS ***
Dealt to 8ca88699 
Dealt to 191ad11b 
Dealt to 2797b5a1 
Dealt to 5eeee9be 
Dealt to 45b366a6 
Dealt to Hero [9s 7d]
5eeee9be: raises $0.15 to $0.25
45b366a6: folds
Hero: folds
8ca88699: folds
191ad11b: folds
2797b5a1: folds
Uncalled bet ($0.15) returned to 5eeee9be
*** SHOWDOWN ***
5eeee9be collected $0.25 from pot
*** SUMMARY ***
Total pot $0.25 | Rake $0 | Jackpot $0 | Bingo $0 | Fortune $0
Seat 1: 8ca88699 (button) folded before Flop (didn't bet)
Seat 2: 191ad11b (small blind) folded before Flop
Seat 3: 2797b5a1 (big blind) folded before Flop
Seat 4: 5eeee9be collected ($0.25)
Seat 5: 45b366a6 folded before Flop (didn't bet)
Seat 6: Hero folded before Flop (didn't bet)


Poker Hand #RC1433268761: Hold'em No Limit  ($0.05/$0.1) - 2023/03/27 18:42:05
Table 'RushAndCash28154021' 6-max Seat #1 is the button
Seat 1: 71eb2274 ($12.09 in chips)
Seat 2: 21381b8f ($8.1 in chips)
Seat 3: 6b369bcd ($11.6 in chips)
Seat 4: b7aefb17 ($10.23 in chips)
Seat 5: c7000029 ($15.96 in chips)
Seat 6: Hero ($26.2 in chips)
21381b8f: posts small blind $0.05
6b369bcd: posts big blind $0.1
*** HOLE CARDS ***
Dealt to 71eb2274 
Dealt to 21381b8f 
Dealt to 6b369bcd 
Dealt to b7aefb17 
Dealt to c7000029 
Dealt to Hero [5d 5s]
b7aefb17: folds
c7000029: folds
Hero: raises $0.15 to $0.25
71eb2274: folds
21381b8f: folds
6b369bcd: folds
Uncalled bet ($0.15) returned to Hero
*** SHOWDOWN ***
Hero collected $0.25 from pot
*** SUMMARY ***
Total pot $0.25 | Rake $0 | Jackpot $0 | Bingo $0 | Fortune $0
Seat 1: 71eb2274 (button) folded before Flop (didn't bet)
Seat 2: 21381b8f (small blind) folded before Flop
Seat 3: 6b369bcd (big blind) folded before Flop
Seat 4: b7aefb17 folded before Flop (didn't bet)
Seat 5: c7000029 folded before Flop (didn't bet)
Seat 6: Hero collected ($0.25)


Poker Hand #RC1433268726: Hold'em No Limit  ($0.05/$0.1) - 2023/03/27 18:42:00
Table 'RushAndCash28153986' 6-max Seat #1 is the button
Seat 1: 3253ee1d ($11.58 in chips)
Seat 2: 48a73798 ($10 in chips)
Seat 3: 5f896732 ($14.66 in chips)
Seat 4: 5007c72 ($29.86 in chips)
Seat 5: 670bced2 ($18.18 in chips)
Seat 6: Hero ($26.2 in chips)
48a73798: posts small blind $0.05
5f896732: posts big blind $0.1
*** HOLE CARDS ***
Dealt to 3253ee1d 
Dealt to 48a73798 
Dealt to 5f896732 
Dealt to 5007c72 
Dealt to 670bced2 
Dealt to Hero [4c 7c]
5007c72: raises $0.13 to $0.23
670bced2: folds
Hero: folds
3253ee1d: folds
48a73798: raises $0.81 to $1.04
5f896732: folds
5007c72: calls $0.81
*** FLOP *** [2d 9d 8s]
48a73798: bets $0.72
5007c72: folds
Uncalled bet ($0.72) returned to 48a73798
*** SHOWDOWN ***
48a73798 collected $2.08 from pot
*** SUMMARY ***
Total pot $2.18 | Rake $0.1 | Jackpot $0 | Bingo $0 | Fortune $0
Board [2d 9d 8s]
Seat 1: 3253ee1d (button) folded before Flop (didn't bet)
Seat 2: 48a73798 (small blind) won ($2.08)
Seat 3: 5f896732 (big blind) folded before Flop
Seat 4: 5007c72 folded on the Flop
Seat 5: 670bced2 folded before Flop (didn't bet)
Seat 6: Hero folded before Flop (didn't bet)


Poker Hand #RC1433268579: Hold'em No Limit  ($0.05/$0.1) - 2023/03/27 18:41:40
Table 'RushAndCash28153839' 6-max Seat #1 is the button
Seat 1: Hero ($26.2 in chips)
Seat 2: 44156054 ($20.7 in chips)
Seat 3: 5dd9770d ($32.37 in chips)
Seat 4: 5b06e1bc ($16.12 in chips)
Seat 5: 5fcb3ba4 ($11.75 in chips)
Seat 6: 9dcd0fe9 ($36.12 in chips)
44156054: posts small blind $0.05
5dd9770d: posts big blind $0.1
*** HOLE CARDS ***
Dealt to Hero [Kd Jc]
Dealt to 44156054 
Dealt to 5dd9770d 
Dealt to 5b06e1bc 
Dealt to 5fcb3ba4 
Dealt to 9dcd0fe9 
5b06e1bc: folds
5fcb3ba4: raises $0.1 to $0.2
9dcd0fe9: folds
Hero: folds
44156054: folds
5dd9770d: folds
Uncalled bet ($0.1) returned to 5fcb3ba4
*** SHOWDOWN ***
5fcb3ba4 collected $0.25 from pot
*** SUMMARY ***
Total pot $0.25 | Rake $0 | Jackpot $0 | Bingo $0 | Fortune $0
Seat 1: Hero (button) folded before Flop (didn't bet)
Seat 2: 44156054 (small blind) folded before Flop
Seat 3: 5dd9770d (big blind) folded before Flop
Seat 4: 5b06e1bc folded before Flop (didn't bet)
Seat 5: 5fcb3ba4 collected ($0.25)
Seat 6: 9dcd0fe9 folded before Flop (didn't bet)


Poker Hand #RC1433268551: Hold'em No Limit  ($0.05/$0.1) - 2023/03/27 18:41:36
Table 'RushAndCash28153811' 6-max Seat #1 is the button
Seat 1: 20fa71b8 ($4.74 in chips)
Seat 2: 86d2dc67 ($13.4 in chips)
Seat 3: efa98784 ($10.15 in chips)
Seat 4: Hero ($26.2 in chips)
Seat 5: abbd078a ($10.66 in chips)
Seat 6: 163e919 ($33.5 in chips)
86d2dc67: posts small blind $0.05
efa98784: posts big blind $0.1
*** HOLE CARDS ***
Dealt to 20fa71b8 
Dealt to 86d2dc67 
Dealt to efa98784 
Dealt to Hero [Kd 8d]
Dealt to abbd078a 
Dealt to 163e919 
Hero: folds
abbd078a: raises $0.12 to $0.22
163e919: folds
20fa71b8: folds
86d2dc67: folds
efa98784: calls $0.12
*** FLOP *** [9c 7s 8c]
efa98784: checks
abbd078a: checks
*** TURN *** [9c 7s 8c] [Ah]
efa98784: checks
abbd078a: bets $0.25
efa98784: folds
Uncalled bet ($0.25) returned to abbd078a
*** SHOWDOWN ***
abbd078a collected $0.47 from pot
*** SUMMARY ***
Total pot $0.49 | Rake $0.02 | Jackpot $0 | Bingo $0 | Fortune $0
Board [9c 7s 8c Ah]
Seat 1: 20fa71b8 (button) folded before Flop (didn't bet)
Seat 2: 86d2dc67 (small blind) folded before Flop
Seat 3: efa98784 (big blind) folded on the Turn
Seat 4: Hero folded before Flop (didn't bet)
Seat 5: abbd078a won ($0.47)
Seat 6: 163e919 folded before Flop (didn't bet)


Poker Hand #RC1433267881: Hold'em No Limit  ($0.05/$0.1) - 2023/03/27 18:40:09
Table 'RushAndCash28153141' 6-max Seat #1 is the button
Seat 1: 86d2dc67 ($13.93 in chips)
Seat 2: c484d447 ($10.03 in chips)
Seat 3: Hero ($25.67 in chips)
Seat 4: 59a09a3b ($12.38 in chips)
Seat 5: 8494623e ($19.35 in chips)
Seat 6: 50908537 ($9.6 in chips)
c484d447: posts small blind $0.05
Hero: posts big blind $0.1
*** HOLE CARDS ***
Dealt to 86d2dc67 
Dealt to c484d447 
Dealt to Hero [7h 7d]
Dealt to 59a09a3b 
Dealt to 8494623e 
Dealt to 50908537 
59a09a3b: folds
8494623e: folds
50908537: folds
86d2dc67: raises $0.15 to $0.25
c484d447: folds
Hero: calls $0.15
*** FLOP *** [2c 3h Qd]
Hero: bets $0.28
86d2dc67: calls $0.28
*** TURN *** [2c 3h Qd] [4h]
Hero: checks
86d2dc67: checks
*** RIVER *** [2c 3h Qd 4h] [7s]
Hero: bets $0.94
86d2dc67: folds
Uncalled bet ($0.94) returned to Hero
*** SHOWDOWN ***
Hero collected $1.06 from pot
*** SUMMARY ***
Total pot $1.11 | Rake $0.05 | Jackpot $0 | Bingo $0 | Fortune $0
Board [2c 3h Qd 4h 7s]
Seat 1: 86d2dc67 (button) folded on the River
Seat 2: c484d447 (small blind) folded before Flop
Seat 3: Hero (big blind) won ($1.06)
Seat 4: 59a09a3b folded before Flop (didn't bet)
Seat 5: 8494623e folded before Flop (didn't bet)
Seat 6: 50908537 folded before Flop (didn't bet)


Poker Hand #RC1433267846: Hold'em No Limit  ($0.05/$0.1) - 2023/03/27 18:40:04
Table 'RushAndCash28153106' 6-max Seat #1 is the button
Seat 1: 2a6d0d46 ($10 in chips)
Seat 2: dd1c31ee ($10.35 in chips)
Seat 3: c484d447 ($10.13 in chips)
Seat 4: a15484c ($9.97 in chips)
Seat 5: 33763c07 ($10 in chips)
Seat 6: Hero ($25.67 in chips)
dd1c31ee: posts small blind $0.05
c484d447: posts big blind $0.1
*** HOLE CARDS ***
Dealt to 2a6d0d46 
Dealt to dd1c31ee 
Dealt to c484d447 
Dealt to a15484c 
Dealt to 33763c07 
Dealt to Hero [Tc 3c]
a15484c: raises $0.2 to $0.3
33763c07: folds
Hero: folds
2a6d0d46: folds
dd1c31ee: calls $0.25
c484d447: folds
*** FLOP *** [Td 7h Kc]
dd1c31ee: checks
a15484c: bets $0.53
dd1c31ee: raises $1.47 to $2
a15484c: calls $1.47
*** TURN *** [Td 7h Kc] [Kd]
dd1c31ee: bets $1.56
a15484c: calls $1.56
*** RIVER *** [Td 7h Kc Kd] [Qh]
dd1c31ee: bets $6.49 and is all-in
a15484c: folds
Uncalled bet ($6.49) returned to dd1c31ee
*** SHOWDOWN ***
dd1c31ee collected $7.37 from pot
*** SUMMARY ***
Total pot $7.82 | Rake $0.3 | Jackpot $0.15 | Bingo $0 | Fortune $0
Board [Td 7h Kc Kd Qh]
Seat 1: 2a6d0d46 (button) folded before Flop (didn't bet)
Seat 2: dd1c31ee (small blind) won ($7.37)
Seat 3: c484d447 (big blind) folded before Flop
Seat 4: a15484c folded on the River
Seat 5: 33763c07 folded before Flop (didn't bet)
Seat 6: Hero folded before Flop (didn't bet)


Poker Hand #RC1433267671: Hold'em No Limit  ($0.05/$0.1) - 2023/03/27 18:39:41
Table 'RushAndCash28152931' 6-max Seat #1 is the button
Seat 1: Hero ($25.67 in chips)
Seat 2: 2ac8e9fd ($11.49 in chips)
Seat 3: 620684c1 ($12.5 in chips)
Seat 4: add1dbe6 ($39.55 in chips)
Seat 5: 62a6e7b5 ($8.24 in chips)
Seat 6: acb4af56 ($10 in chips)
2ac8e9fd: posts small blind $0.05
620684c1: posts big blind $0.1
*** HOLE CARDS ***
Dealt to Hero [4s 7c]
Dealt to 2ac8e9fd 
Dealt to 620684c1 
Dealt to add1dbe6 
Dealt to 62a6e7b5 
Dealt to acb4af56 
add1dbe6: folds
62a6e7b5: folds
acb4af56: raises $0.1 to $0.2
Hero: folds
2ac8e9fd: folds
620684c1: folds
Uncalled bet ($0.1) returned to acb4af56
*** SHOWDOWN ***
acb4af56 collected $0.25 from pot
*** SUMMARY ***
Total pot $0.25 | Rake $0 | Jackpot $0 | Bingo $0 | Fortune $0
Seat 1: Hero (button) folded before Flop (didn't bet)
Seat 2: 2ac8e9fd (small blind) folded before Flop
Seat 3: 620684c1 (big blind) folded before Flop
Seat 4: add1dbe6 folded before Flop (didn't bet)
Seat 5: 62a6e7b5 folded before Flop (didn't bet)
Seat 6: acb4af56 collected ($0.25)


Poker Hand #RC1433267603: Hold'em No Limit  ($0.05/$0.1) - 2023/03/27 18:39:31
Table 'RushAndCash28152863' 6-max Seat #1 is the button
Seat 1: 6a909d3f ($10 in chips)
Seat 2: e453ebdb ($21.3 in chips)
Seat 3: Hero ($25.62 in chips)
Seat 4: 843e9f67 ($20.45 in chips)
Seat 5: dc2f4d92 ($36.73 in chips)
Seat 6: 409d9b29 ($16.21 in chips)
e453ebdb: posts small blind $0.05
Hero: posts big blind $0.1
*** HOLE CARDS ***
Dealt to 6a909d3f 
Dealt to e453ebdb 
Dealt to Hero [2d Tc]
Dealt to 843e9f67 
Dealt to dc2f4d92 
Dealt to 409d9b29 
843e9f67: folds
dc2f4d92: folds
409d9b29: folds
6a909d3f: folds
e453ebdb: folds
Uncalled bet ($0.05) returned to Hero
*** SHOWDOWN ***
Hero collected $0.1 from pot
*** SUMMARY ***
Total pot $0.1 | Rake $0 | Jackpot $0 | Bingo $0 | Fortune $0
Seat 1: 6a909d3f (button) folded before Flop (didn't bet)
Seat 2: e453ebdb (small blind) folded before Flop
Seat 3: Hero (big blind) collected ($0.1)
Seat 4: 843e9f67 folded before Flop (didn't bet)
Seat 5: dc2f4d92 folded before Flop (didn't bet)
Seat 6: 409d9b29 folded before Flop (didn't bet)


Poker Hand #RC1433267574: Hold'em No Limit  ($0.05/$0.1) - 2023/03/27 18:39:27
Table 'RushAndCash28152834' 6-max Seat #1 is the button
Seat 1: a8ba070c ($13.58 in chips)
Seat 2: Hero ($25.67 in chips)
Seat 3: 81b58653 ($11.18 in chips)
Seat 4: 543bc9d6 ($10 in chips)
Seat 5: 986ab8a3 ($15.74 in chips)
Seat 6: b6ccf254 ($17.4 in chips)
Hero: posts small blind $0.05
81b58653: posts big blind $0.1
*** HOLE CARDS ***
Dealt to a8ba070c 
Dealt to Hero [Qc 5d]
Dealt to 81b58653 
Dealt to 543bc9d6 
Dealt to 986ab8a3 
Dealt to b6ccf254 
543bc9d6: raises $0.15 to $0.25
986ab8a3: folds
b6ccf254: calls $0.25
a8ba070c: folds
Hero: folds
81b58653: folds
*** FLOP *** [8h 8s Jc]
543bc9d6: checks
b6ccf254: bets $0.49
543bc9d6: calls $0.49
*** TURN *** [8h 8s Jc] [3c]
543bc9d6: checks
b6ccf254: bets $1.23
543bc9d6: calls $1.23
*** RIVER *** [8h 8s Jc 3c] [Jd]
543bc9d6: bets $3.07
b6ccf254: folds
Uncalled bet ($3.07) returned to 543bc9d6
*** SHOWDOWN ***
543bc9d6 collected $3.75 from pot
*** SUMMARY ***
Total pot $4.09 | Rake $0.19 | Jackpot $0.15 | Bingo $0 | Fortune $0
Board [8h 8s Jc 3c Jd]
Seat 1: a8ba070c (button) folded before Flop (didn't bet)
Seat 2: Hero (small blind) folded before Flop
Seat 3: 81b58653 (big blind) folded before Flop
Seat 4: 543bc9d6 won ($3.75)
Seat 5: 986ab8a3 folded before Flop (didn't bet)
Seat 6: b6ccf254 folded on the River


Poker Hand #RC1433267476: Hold'em No Limit  ($0.05/$0.1) - 2023/03/27 18:39:15
Table 'RushAndCash28152736' 6-max Seat #1 is the button
Seat 1: Hero ($25.67 in chips)
Seat 2: 5ae041e4 ($10.43 in chips)
Seat 3: cff7f2dd ($11.05 in chips)
Seat 4: 29e9d928 ($10.1 in chips)
Seat 5: 72e78d5 ($10.42 in chips)
Seat 6: 670bced2 ($17.04 in chips)
5ae041e4: posts small blind $0.05
cff7f2dd: posts big blind $0.1
*** HOLE CARDS ***
Dealt to Hero [4d Td]
Dealt to 5ae041e4 
Dealt to cff7f2dd 
Dealt to 29e9d928 
Dealt to 72e78d5 
Dealt to 670bced2 
29e9d928: folds
72e78d5: folds
670bced2: folds
Hero: folds
5ae041e4: folds
Uncalled bet ($0.05) returned to cff7f2dd
*** SHOWDOWN ***
cff7f2dd collected $0.1 from pot
*** SUMMARY ***
Total pot $0.1 | Rake $0 | Jackpot $0 | Bingo $0 | Fortune $0
Seat 1: Hero (button) folded before Flop (didn't bet)
Seat 2: 5ae041e4 (small blind) folded before Flop
Seat 3: cff7f2dd (big blind) collected ($0.1)
Seat 4: 29e9d928 folded before Flop (didn't bet)
Seat 5: 72e78d5 folded before Flop (didn't bet)
Seat 6: 670bced2 folded before Flop (didn't bet)


Poker Hand #RC1433267019: Hold'em No Limit  ($0.05/$0.1) - 2023/03/27 18:38:17
Table 'RushAndCash28152279' 6-max Seat #1 is the button
Seat 1: 44156054 ($21.13 in chips)
Seat 2: b0e08892 ($13.07 in chips)
Seat 3: 47b44bb0 ($13.87 in chips)
Seat 4: 65cb23ac ($10.49 in chips)
Seat 5: a954c345 ($14.22 in chips)
Seat 6: Hero ($25.3 in chips)
b0e08892: posts small blind $0.05
47b44bb0: posts big blind $0.1
*** HOLE CARDS ***
Dealt to 44156054 
Dealt to b0e08892 
Dealt to 47b44bb0 
Dealt to 65cb23ac 
Dealt to a954c345 
Dealt to Hero [As Kh]
65cb23ac: folds
a954c345: folds
Hero: raises $0.15 to $0.25
44156054: calls $0.25
b0e08892: folds
47b44bb0: folds
*** FLOP *** [6s 3d Qs]
Hero: checks
44156054: checks
*** TURN *** [6s 3d Qs] [3c]
Hero: checks
44156054: checks
*** RIVER *** [6s 3d Qs 3c] [7d]
Hero: checks
44156054: checks
Hero: shows [As Kh] (Pair of Treys)
44156054: shows [Jd Ah] (Pair of Treys)
*** SHOWDOWN ***
Hero collected $0.62 from pot
*** SUMMARY ***
Total pot $0.65 | Rake $0.03 | Jackpot $0 | Bingo $0 | Fortune $0
Board [6s 3d Qs 3c 7d]
Seat 1: 44156054 (button) showed [Jd Ah] and lost with Pair of Treys
Seat 2: b0e08892 (small blind) folded before Flop
Seat 3: 47b44bb0 (big blind) folded before Flop
Seat 4: 65cb23ac folded before Flop (didn't bet)
Seat 5: a954c345 folded before Flop (didn't bet)
Seat 6: Hero showed [As Kh] and won ($0.62) with Pair of Treys


Poker Hand #RC1433266214: Hold'em No Limit  ($0.05/$0.1) - 2023/03/27 18:36:28
Table 'RushAndCash28151474' 6-max Seat #1 is the button
Seat 1: Hero ($24.89 in chips)
Seat 2: effd7574 ($35.03 in chips)
Seat 3: 44156054 ($21.53 in chips)
Seat 4: 963763b6 ($11.71 in chips)
Seat 5: 42dea2bf ($12.37 in chips)
Seat 6: 568c68c ($9.55 in chips)
effd7574: posts small blind $0.05
44156054: posts big blind $0.1
*** HOLE CARDS ***
Dealt to Hero [Qd Jc]
Dealt to effd7574 
Dealt to 44156054 
Dealt to 963763b6 
Dealt to 42dea2bf 
Dealt to 568c68c 
963763b6: folds
42dea2bf: folds
568c68c: folds
Hero: raises $0.15 to $0.25
effd7574: folds
44156054: calls $0.15
*** FLOP *** [8s 2s 8d]
44156054: checks
Hero: bets $0.15
44156054: calls $0.15
*** TURN *** [8s 2s 8d] [4c]
44156054: checks
Hero: checks
*** RIVER *** [8s 2s 8d 4c] [8h]
44156054: checks
Hero: bets $0.3
44156054: folds
Uncalled bet ($0.3) returned to Hero
*** SHOWDOWN ***
Hero collected $0.81 from pot
*** SUMMARY ***
Total pot $0.85 | Rake $0.04 | Jackpot $0 | Bingo $0 | Fortune $0
Board [8s 2s 8d 4c 8h]
Seat 1: Hero (button) won ($0.81)
Seat 2: effd7574 (small blind) folded before Flop
Seat 3: 44156054 (big blind) folded on the River
Seat 4: 963763b6 folded before Flop (didn't bet)
Seat 5: 42dea2bf folded before Flop (didn't bet)
Seat 6: 568c68c folded before Flop (didn't bet)


Poker Hand #RC1433266119: Hold'em No Limit  ($0.05/$0.1) - 2023/03/27 18:36:14
Table 'RushAndCash28151379' 6-max Seat #1 is the button
Seat 1: f9e90856 ($20.94 in chips)
Seat 2: 8077ec64 ($10.86 in chips)
Seat 3: e88398c4 ($17.07 in chips)
Seat 4: a15484c ($10.6 in chips)
Seat 5: c20fb006 ($21 in chips)
Seat 6: Hero ($24.89 in chips)
8077ec64: posts small blind $0.05
e88398c4: posts big blind $0.1
*** HOLE CARDS ***
Dealt to f9e90856 
Dealt to 8077ec64 
Dealt to e88398c4 
Dealt to a15484c 
Dealt to c20fb006 
Dealt to Hero [8h Qs]
a15484c: folds
c20fb006: folds
Hero: folds
f9e90856: folds
8077ec64: raises $0.25 to $0.35
e88398c4: folds
Uncalled bet ($0.25) returned to 8077ec64
*** SHOWDOWN ***
8077ec64 collected $0.2 from pot
*** SUMMARY ***
Total pot $0.2 | Rake $0 | Jackpot $0 | Bingo $0 | Fortune $0
Seat 1: f9e90856 (button) folded before Flop (didn't bet)
Seat 2: 8077ec64 (small blind) collected ($0.2)
Seat 3: e88398c4 (big blind) folded before Flop
Seat 4: a15484c folded before Flop (didn't bet)
Seat 5: c20fb006 folded before Flop (didn't bet)
Seat 6: Hero folded before Flop (didn't bet)


Poker Hand #RC1433265818: Hold'em No Limit  ($0.05/$0.1) - 2023/03/27 18:35:33
Table 'RushAndCash28151078' 6-max Seat #1 is the button
Seat 1: e88398c4 ($16.79 in chips)
Seat 2: 3154ee9b ($9.42 in chips)
Seat 3: Hero ($25.14 in chips)
Seat 4: 7f54c683 ($10.65 in chips)
Seat 5: 6ff9bbe9 ($14.72 in chips)
Seat 6: 682e00a ($12.26 in chips)
3154ee9b: posts small blind $0.05
Hero: posts big blind $0.1
*** HOLE CARDS ***
Dealt to e88398c4 
Dealt to 3154ee9b 
Dealt to Hero [6c 5c]
Dealt to 7f54c683 
Dealt to 6ff9bbe9 
Dealt to 682e00a 
7f54c683: folds
6ff9bbe9: folds
682e00a: folds
e88398c4: raises $0.15 to $0.25
3154ee9b: folds
Hero: calls $0.15
*** FLOP *** [4d 9c Js]
Hero: checks
e88398c4: bets $0.28
Hero: folds
Uncalled bet ($0.28) returned to e88398c4
*** SHOWDOWN ***
e88398c4 collected $0.53 from pot
*** SUMMARY ***
Total pot $0.55 | Rake $0.02 | Jackpot $0 | Bingo $0 | Fortune $0
Board [4d 9c Js]
Seat 1: e88398c4 (button) won ($0.53)
Seat 2: 3154ee9b (small blind) folded before Flop
Seat 3: Hero (big blind) folded on the Flop
Seat 4: 7f54c683 folded before Flop (didn't bet)
Seat 5: 6ff9bbe9 folded before Flop (didn't bet)
Seat 6: 682e00a folded before Flop (didn't bet)


Poker Hand #RC1433265626: Hold'em No Limit  ($0.05/$0.1) - 2023/03/27 18:35:09
Table 'RushAndCash28150886' 6-max Seat #1 is the button
Seat 1: 8494623e ($17.02 in chips)
Seat 2: Hero ($25.44 in chips)
Seat 3: 3154ee9b ($9.15 in chips)
Seat 4: 55f575da ($9.7 in chips)
Seat 5: b5cbf2d2 ($10.27 in chips)
Seat 6: 1d97ada9 ($10.26 in chips)
Hero: posts small blind $0.05
3154ee9b: posts big blind $0.1
*** HOLE CARDS ***
Dealt to 8494623e 
Dealt to Hero [Ah 4h]
Dealt to 3154ee9b 
Dealt to 55f575da 
Dealt to b5cbf2d2 
Dealt to 1d97ada9 
55f575da: folds
b5cbf2d2: folds
1d97ada9: folds
8494623e: folds
Hero: raises $0.2 to $0.3
3154ee9b: raises $0.7 to $1
Hero: folds
Uncalled bet ($0.7) returned to 3154ee9b
*** SHOWDOWN ***
3154ee9b collected $0.57 from pot
*** SUMMARY ***
Total pot $0.6 | Rake $0.03 | Jackpot $0 | Bingo $0 | Fortune $0
Seat 1: 8494623e (button) folded before Flop (didn't bet)
Seat 2: Hero (small blind) folded before Flop
Seat 3: 3154ee9b (big blind) collected ($0.57)
Seat 4: 55f575da folded before Flop (didn't bet)
Seat 5: b5cbf2d2 folded before Flop (didn't bet)
Seat 6: 1d97ada9 folded before Flop (didn't bet)


Poker Hand #RC1433265597: Hold'em No Limit  ($0.05/$0.1) - 2023/03/27 18:35:05
Table 'RushAndCash28150857' 6-max Seat #1 is the button
Seat 1: 1587e770 ($10.49 in chips)
Seat 2: 6b369bcd ($10 in chips)
Seat 3: c8f4c42c ($19.32 in chips)
Seat 4: ec3bebf3 ($24.48 in chips)
Seat 5: 375ea40e ($10.47 in chips)
Seat 6: Hero ($25.44 in chips)
6b369bcd: posts small blind $0.05
c8f4c42c: posts big blind $0.1
*** HOLE CARDS ***
Dealt to 1587e770 
Dealt to 6b369bcd 
Dealt to c8f4c42c 
Dealt to ec3bebf3 
Dealt to 375ea40e 
Dealt to Hero [2d 5c]
ec3bebf3: folds
375ea40e: raises $0.1 to $0.2
Hero: folds
1587e770: folds
6b369bcd: raises $0.75 to $0.95
c8f4c42c: folds
375ea40e: folds
Uncalled bet ($0.75) returned to 6b369bcd
*** SHOWDOWN ***
6b369bcd collected $0.48 from pot
*** SUMMARY ***
Total pot $0.5 | Rake $0.02 | Jackpot $0 | Bingo $0 | Fortune $0
Seat 1: 1587e770 (button) folded before Flop (didn't bet)
Seat 2: 6b369bcd (small blind) collected ($0.48)
Seat 3: c8f4c42c (big blind) folded before Flop
Seat 4: ec3bebf3 folded before Flop (didn't bet)
Seat 5: 375ea40e folded before Flop
Seat 6: Hero folded before Flop (didn't bet)


Poker Hand #RC1433265218: Hold'em No Limit  ($0.05/$0.1) - 2023/03/27 18:34:14
Table 'RushAndCash28150478' 6-max Seat #1 is the button
Seat 1: a56d2470 ($19.33 in chips)
Seat 2: ccd6c208 ($12.05 in chips)
Seat 3: Hero ($25.64 in chips)
Seat 4: 4f8b60ce ($30.23 in chips)
Seat 5: 375ea40e ($10.24 in chips)
Seat 6: 7ea7764 ($28.67 in chips)
ccd6c208: posts small blind $0.05
Hero: posts big blind $0.1
*** HOLE CARDS ***
Dealt to a56d2470 
Dealt to ccd6c208 
Dealt to Hero [Tc 9h]
Dealt to 4f8b60ce 
Dealt to 375ea40e 
Dealt to 7ea7764 
4f8b60ce: folds
375ea40e: raises $0.1 to $0.2
7ea7764: folds
a56d2470: folds
ccd6c208: folds
Hero: calls $0.1
*** FLOP *** [4d Jh 2s]
Hero: checks
375ea40e: bets $0.34
Hero: folds
Uncalled bet ($0.34) returned to 375ea40e
*** SHOWDOWN ***
375ea40e collected $0.43 from pot
*** SUMMARY ***
Total pot $0.45 | Rake $0.02 | Jackpot $0 | Bingo $0 | Fortune $0
Board [4d Jh 2s]
Seat 1: a56d2470 (button) folded before Flop (didn't bet)
Seat 2: ccd6c208 (small blind) folded before Flop
Seat 3: Hero (big blind) folded on the Flop
Seat 4: 4f8b60ce folded before Flop (didn't bet)
Seat 5: 375ea40e won ($0.43)
Seat 6: 7ea7764 folded before Flop (didn't bet)


Poker Hand #RC1433265172: Hold'em No Limit  ($0.05/$0.1) - 2023/03/27 18:34:09
Table 'RushAndCash28150432' 6-max Seat #1 is the button
Seat 1: 52b257ab ($19.25 in chips)
Seat 2: 700f7810 ($3.26 in chips)
Seat 3: 3211b28b ($10.2 in chips)
Seat 4: Hero ($25.64 in chips)
Seat 5: ff6a0806 ($12.17 in chips)
Seat 6: 46d00ae5 ($13.78 in chips)
700f7810: posts small blind $0.05
3211b28b: posts big blind $0.1
*** HOLE CARDS ***
Dealt to 52b257ab 
Dealt to 700f7810 
Dealt to 3211b28b 
Dealt to Hero [9d 7d]
Dealt to ff6a0806 
Dealt to 46d00ae5 
Hero: folds
ff6a0806: raises $0.15 to $0.25
46d00ae5: folds
52b257ab: folds
700f7810: folds
3211b28b: calls $0.15
*** FLOP *** [2h 2d 6s]
3211b28b: checks
ff6a0806: bets $0.19
3211b28b: raises $0.47 to $0.66
ff6a0806: calls $0.47
*** TURN *** [2h 2d 6s] [4h]
3211b28b: bets $0.94
ff6a0806: calls $0.94
*** RIVER *** [2h 2d 6s 4h] [7c]
3211b28b: bets $1.24
ff6a0806: calls $1.24
3211b28b: shows [8c 9c] (Pair of Twos)
ff6a0806: shows [8h 8d] (Pair of Eights and Pair of Twos)
*** SHOWDOWN ***
ff6a0806 collected $5.78 from pot
*** SUMMARY ***
Total pot $6.23 | Rake $0.3 | Jackpot $0.15 | Bingo $0 | Fortune $0
Board [2h 2d 6s 4h 7c]
Seat 1: 52b257ab (button) folded before Flop (didn't bet)
Seat 2: 700f7810 (small blind) folded before Flop
Seat 3: 3211b28b (big blind) showed [8c 9c] and lost with Pair of Twos
Seat 4: Hero folded before Flop (didn't bet)
Seat 5: ff6a0806 showed [8h 8d] and won ($5.78) with Pair of Eights and Pair of Twos
Seat 6: 46d00ae5 folded before Flop (didn't bet)


Poker Hand #RC1433264998: Hold'em No Limit  ($0.05/$0.1) - 2023/03/27 18:33:47
Table 'RushAndCash28150258' 6-max Seat #1 is the button
Seat 1: bcd85a42 ($4.4 in chips)
Seat 2: 241361cf ($10.05 in chips)
Seat 3: 700f7810 ($2.98 in chips)
Seat 4: Hero ($25.89 in chips)
Seat 5: 5b464716 ($22.96 in chips)
Seat 6: 2fc5a3ee ($13.2 in chips)
241361cf: posts small blind $0.05
700f7810: posts big blind $0.1
*** HOLE CARDS ***
Dealt to bcd85a42 
Dealt to 241361cf 
Dealt to 700f7810 
Dealt to Hero [Js Kd]
Dealt to 5b464716 
Dealt to 2fc5a3ee 
Hero: raises $0.15 to $0.25
5b464716: folds
2fc5a3ee: folds
bcd85a42: folds
241361cf: folds
700f7810: raises $2.73 to $2.98 and is all-in
Hero: folds
Uncalled bet ($2.73) returned to 700f7810
*** SHOWDOWN ***
700f7810 collected $0.53 from pot
*** SUMMARY ***
Total pot $0.55 | Rake $0.02 | Jackpot $0 | Bingo $0 | Fortune $0
Seat 1: bcd85a42 (button) folded before Flop (didn't bet)
Seat 2: 241361cf (small blind) folded before Flop
Seat 3: 700f7810 (big blind) collected ($0.53)
Seat 4: Hero folded before Flop
Seat 5: 5b464716 folded before Flop (didn't bet)
Seat 6: 2fc5a3ee folded before Flop (didn't bet)


Poker Hand #RC1433264946: Hold'em No Limit  ($0.05/$0.1) - 2023/03/27 18:33:41
Table 'RushAndCash28150206' 6-max Seat #1 is the button
Seat 1: be7a93ef ($10.63 in chips)
Seat 2: 8e2d4a82 ($22.62 in chips)
Seat 3: 42db2570 ($10.2 in chips)
Seat 4: Hero ($25.89 in chips)
Seat 5: 5152ef00 ($9.65 in chips)
Seat 6: 38232ace ($10.15 in chips)
8e2d4a82: posts small blind $0.05
42db2570: posts big blind $0.1
*** HOLE CARDS ***
Dealt to be7a93ef 
Dealt to 8e2d4a82 
Dealt to 42db2570 
Dealt to Hero [6c 9h]
Dealt to 5152ef00 
Dealt to 38232ace 
Hero: folds
5152ef00: folds
38232ace: folds
be7a93ef: folds
8e2d4a82: folds
Uncalled bet ($0.05) returned to 42db2570
*** SHOWDOWN ***
42db2570 collected $0.1 from pot
*** SUMMARY ***
Total pot $0.1 | Rake $0 | Jackpot $0 | Bingo $0 | Fortune $0
Seat 1: be7a93ef (button) folded before Flop (didn't bet)
Seat 2: 8e2d4a82 (small blind) folded before Flop
Seat 3: 42db2570 (big blind) collected ($0.1)
Seat 4: Hero folded before Flop (didn't bet)
Seat 5: 5152ef00 folded before Flop (didn't bet)
Seat 6: 38232ace folded before Flop (didn't bet)


Poker Hand #RC1433264908: Hold'em No Limit  ($0.05/$0.1) - 2023/03/27 18:33:35
Table 'RushAndCash28150168' 6-max Seat #1 is the button
Seat 1: 58e76cf2 ($10.76 in chips)
Seat 2: Hero ($25.94 in chips)
Seat 3: 3154ee9b ($8.98 in chips)
Seat 4: 8ca218b4 ($10 in chips)
Seat 5: 1625034d ($3.63 in chips)
Seat 6: c3bde2ae ($41.08 in chips)
Hero: posts small blind $0.05
3154ee9b: posts big blind $0.1
*** HOLE CARDS ***
Dealt to 58e76cf2 
Dealt to Hero [7s Kd]
Dealt to 3154ee9b 
Dealt to 8ca218b4 
Dealt to 1625034d 
Dealt to c3bde2ae 
8ca218b4: folds
1625034d: folds
c3bde2ae: raises $0.15 to $0.25
58e76cf2: folds
Hero: folds
3154ee9b: folds
Uncalled bet ($0.15) returned to c3bde2ae
*** SHOWDOWN ***
c3bde2ae collected $0.25 from pot
*** SUMMARY ***
Total pot $0.25 | Rake $0 | Jackpot $0 | Bingo $0 | Fortune $0
Seat 1: 58e76cf2 (button) folded before Flop (didn't bet)
Seat 2: Hero (small blind) folded before Flop
Seat 3: 3154ee9b (big blind) folded before Flop
Seat 4: 8ca218b4 folded before Flop (didn't bet)
Seat 5: 1625034d folded before Flop (didn't bet)
Seat 6: c3bde2ae collected ($0.25)


Poker Hand #RC1433264863: Hold'em No Limit  ($0.05/$0.1) - 2023/03/27 18:33:29
Table 'RushAndCash28150123' 6-max Seat #1 is the button
Seat 1: 2fc5a3ee ($13.25 in chips)
Seat 2: 482db284 ($13.98 in chips)
Seat 3: 67c31758 ($12.17 in chips)
Seat 4: d6e94453 ($14.98 in chips)
Seat 5: Hero ($25.94 in chips)
Seat 6: cab27a75 ($5.35 in chips)
482db284: posts small blind $0.05
67c31758: posts big blind $0.1
*** HOLE CARDS ***
Dealt to 2fc5a3ee 
Dealt to 482db284 
Dealt to 67c31758 
Dealt to d6e94453 
Dealt to Hero [9h 5h]
Dealt to cab27a75 
d6e94453: folds
Hero: folds
cab27a75: folds
2fc5a3ee: folds
482db284: raises $0.2 to $0.3
67c31758: folds
Uncalled bet ($0.2) returned to 482db284
*** SHOWDOWN ***
482db284 collected $0.2 from pot
*** SUMMARY ***
Total pot $0.2 | Rake $0 | Jackpot $0 | Bingo $0 | Fortune $0
Seat 1: 2fc5a3ee (button) folded before Flop (didn't bet)
Seat 2: 482db284 (small blind) collected ($0.2)
Seat 3: 67c31758 (big blind) folded before Flop
Seat 4: d6e94453 folded before Flop (didn't bet)
Seat 5: Hero folded before Flop (didn't bet)
Seat 6: cab27a75 folded before Flop (didn't bet)


Poker Hand #RC1433223576: Hold'em No Limit  ($0.05/$0.1) - 2023/03/27 18:30:44
Table 'RushAndCash28148836' 6-max Seat #1 is the button
Seat 1: 37361ef0 ($11.76 in chips)
Seat 2: b6ccf254 ($16.37 in chips)
Seat 3: 6dbf05b0 ($10 in chips)
Seat 4: b59f0022 ($12.88 in chips)
Seat 5: bbd1f29e ($13.35 in chips)
Seat 6: Hero ($28.04 in chips)
b6ccf254: posts small blind $0.05
6dbf05b0: posts big blind $0.1
*** HOLE CARDS ***
Dealt to 37361ef0 
Dealt to b6ccf254 
Dealt to 6dbf05b0 
Dealt to b59f0022 
Dealt to bbd1f29e 
Dealt to Hero [Kc As]
b59f0022: folds
bbd1f29e: folds
Hero: raises $0.15 to $0.25
37361ef0: folds
b6ccf254: raises $0.6 to $0.85
6dbf05b0: folds
Hero: raises $1.25 to $2.1
b6ccf254: calls $1.25
*** FLOP *** [2h Qc 8h]
b6ccf254: checks
Hero: checks
*** TURN *** [2h Qc 8h] [5s]
b6ccf254: bets $2
Hero: folds
Uncalled bet ($2) returned to b6ccf254
*** SHOWDOWN ***
b6ccf254 collected $3.95 from pot
*** SUMMARY ***
Total pot $4.3 | Rake $0.2 | Jackpot $0.15 | Bingo $0 | Fortune $0
Board [2h Qc 8h 5s]
Seat 1: 37361ef0 (button) folded before Flop (didn't bet)
Seat 2: b6ccf254 (small blind) won ($3.95)
Seat 3: 6dbf05b0 (big blind) folded before Flop
Seat 4: b59f0022 folded before Flop (didn't bet)
Seat 5: bbd1f29e folded before Flop (didn't bet)
Seat 6: Hero folded on the Turn


Poker Hand #RC1433223399: Hold'em No Limit  ($0.05/$0.1) - 2023/03/27 18:30:22
Table 'RushAndCash28148659' 6-max Seat #1 is the button
Seat 1: b00730bf ($9.62 in chips)
Seat 2: e37c7354 ($18.16 in chips)
Seat 3: add1dbe6 ($43.47 in chips)
Seat 4: c6c26a1e ($10.85 in chips)
Seat 5: 5dd9770d ($24.83 in chips)
Seat 6: Hero ($28.04 in chips)
e37c7354: posts small blind $0.05
add1dbe6: posts big blind $0.1
*** HOLE CARDS ***
Dealt to b00730bf 
Dealt to e37c7354 
Dealt to add1dbe6 
Dealt to c6c26a1e 
Dealt to 5dd9770d 
Dealt to Hero [3s 4h]
c6c26a1e: folds
5dd9770d: folds
Hero: folds
b00730bf: folds
e37c7354: folds
Uncalled bet ($0.05) returned to add1dbe6
*** SHOWDOWN ***
add1dbe6 collected $0.1 from pot
*** SUMMARY ***
Total pot $0.1 | Rake $0 | Jackpot $0 | Bingo $0 | Fortune $0
Seat 1: b00730bf (button) folded before Flop (didn't bet)
Seat 2: e37c7354 (small blind) folded before Flop
Seat 3: add1dbe6 (big blind) collected ($0.1)
Seat 4: c6c26a1e folded before Flop (didn't bet)
Seat 5: 5dd9770d folded before Flop (didn't bet)
Seat 6: Hero folded before Flop (didn't bet)


Poker Hand #RC1433223251: Hold'em No Limit  ($0.05/$0.1) - 2023/03/27 18:30:03
Table 'RushAndCash28148511' 6-max Seat #1 is the button
Seat 1: 25295a38 ($63.8 in chips)
Seat 2: 4637b2c8 ($9.45 in chips)
Seat 3: ca1d00e3 ($9.98 in chips)
Seat 4: Hero ($28.29 in chips)
Seat 5: b00730bf ($9.25 in chips)
Seat 6: b3003039 ($9.36 in chips)
4637b2c8: posts small blind $0.05
ca1d00e3: posts big blind $0.1
*** HOLE CARDS ***
Dealt to 25295a38 
Dealt to 4637b2c8 
Dealt to ca1d00e3 
Dealt to Hero [As 5s]
Dealt to b00730bf 
Dealt to b3003039 
Hero: raises $0.15 to $0.25
b00730bf: raises $0.49 to $0.74
b3003039: folds
25295a38: folds
4637b2c8: folds
ca1d00e3: folds
Hero: folds
Uncalled bet ($0.49) returned to b00730bf
*** SHOWDOWN ***
b00730bf collected $0.62 from pot
*** SUMMARY ***
Total pot $0.65 | Rake $0.03 | Jackpot $0 | Bingo $0 | Fortune $0
Seat 1: 25295a38 (button) folded before Flop (didn't bet)
Seat 2: 4637b2c8 (small blind) folded before Flop
Seat 3: ca1d00e3 (big blind) folded before Flop
Seat 4: Hero folded before Flop
Seat 5: b00730bf collected ($0.62)
Seat 6: b3003039 folded before Flop (didn't bet)


Poker Hand #RC1433223219: Hold'em No Limit  ($0.05/$0.1) - 2023/03/27 18:29:59
Table 'RushAndCash28148479' 6-max Seat #1 is the button
Seat 1: Hero ($28.29 in chips)
Seat 2: 93199e39 ($10.72 in chips)
Seat 3: 843e9f67 ($18.63 in chips)
Seat 4: e9e25e5e ($16.58 in chips)
Seat 5: 4637b2c8 ($9.45 in chips)
Seat 6: ccb2aecd ($10.01 in chips)
93199e39: posts small blind $0.05
843e9f67: posts big blind $0.1
*** HOLE CARDS ***
Dealt to Hero [7h 2h]
Dealt to 93199e39 
Dealt to 843e9f67 
Dealt to e9e25e5e 
Dealt to 4637b2c8 
Dealt to ccb2aecd 
e9e25e5e: raises $0.2 to $0.3
4637b2c8: folds
ccb2aecd: folds
Hero: folds
93199e39: folds
843e9f67: folds
Uncalled bet ($0.2) returned to e9e25e5e
*** SHOWDOWN ***
e9e25e5e collected $0.25 from pot
*** SUMMARY ***
Total pot $0.25 | Rake $0 | Jackpot $0 | Bingo $0 | Fortune $0
Seat 1: Hero (button) folded before Flop (didn't bet)
Seat 2: 93199e39 (small blind) folded before Flop
Seat 3: 843e9f67 (big blind) folded before Flop
Seat 4: e9e25e5e collected ($0.25)
Seat 5: 4637b2c8 folded before Flop (didn't bet)
Seat 6: ccb2aecd folded before Flop (didn't bet)


Poker Hand #RC1433223050: Hold'em No Limit  ($0.05/$0.1) - 2023/03/27 18:29:38
Table 'RushAndCash28148310' 6-max Seat #1 is the button
Seat 1: 88e8a46e ($15.27 in chips)
Seat 2: Hero ($28.34 in chips)
Seat 3: 39852c3c ($10.3 in chips)
Seat 4: 1d2db680 ($18.62 in chips)
Seat 5: c20fb006 ($26.91 in chips)
Seat 6: f73707ab ($27.13 in chips)
Hero: posts small blind $0.05
39852c3c: posts big blind $0.1
*** HOLE CARDS ***
Dealt to 88e8a46e 
Dealt to Hero [4d Kd]
Dealt to 39852c3c 
Dealt to 1d2db680 
Dealt to c20fb006 
Dealt to f73707ab 
1d2db680: raises $0.12 to $0.22
c20fb006: folds
f73707ab: folds
88e8a46e: folds
Hero: folds
39852c3c: folds
Uncalled bet ($0.12) returned to 1d2db680
*** SHOWDOWN ***
1d2db680 collected $0.25 from pot
*** SUMMARY ***
Total pot $0.25 | Rake $0 | Jackpot $0 | Bingo $0 | Fortune $0
Seat 1: 88e8a46e (button) folded before Flop (didn't bet)
Seat 2: Hero (small blind) folded before Flop
Seat 3: 39852c3c (big blind) folded before Flop
Seat 4: 1d2db680 collected ($0.25)
Seat 5: c20fb006 folded before Flop (didn't bet)
Seat 6: f73707ab folded before Flop (didn't bet)


Poker Hand #RC1433222893: Hold'em No Limit  ($0.05/$0.1) - 2023/03/27 18:29:17
Table 'RushAndCash28148153' 6-max Seat #1 is the button
Seat 1: 3658c188 ($22.3 in chips)
Seat 2: 963763b6 ($10.86 in chips)
Seat 3: Hero ($28.44 in chips)
Seat 4: 148182f6 ($27.02 in chips)
Seat 5: 65af4f69 ($15.66 in chips)
Seat 6: bb15fd2f ($21.48 in chips)
963763b6: posts small blind $0.05
Hero: posts big blind $0.1
*** HOLE CARDS ***
Dealt to 3658c188 
Dealt to 963763b6 
Dealt to Hero [9d Jc]
Dealt to 148182f6 
Dealt to 65af4f69 
Dealt to bb15fd2f 
148182f6: folds
65af4f69: raises $0.15 to $0.25
bb15fd2f: raises $0.51 to $0.76
3658c188: folds
963763b6: folds
Hero: folds
65af4f69: raises $1.34 to $2.1
bb15fd2f: folds
Uncalled bet ($1.34) returned to 65af4f69
*** SHOWDOWN ***
65af4f69 collected $1.59 from pot
*** SUMMARY ***
Total pot $1.67 | Rake $0.08 | Jackpot $0 | Bingo $0 | Fortune $0
Seat 1: 3658c188 (button) folded before Flop (didn't bet)
Seat 2: 963763b6 (small blind) folded before Flop
Seat 3: Hero (big blind) folded before Flop
Seat 4: 148182f6 folded before Flop (didn't bet)
Seat 5: 65af4f69 collected ($1.59)
Seat 6: bb15fd2f folded before Flop


Poker Hand #RC1433222830: Hold'em No Limit  ($0.05/$0.1) - 2023/03/27 18:29:10
Table 'RushAndCash28148090' 6-max Seat #1 is the button
Seat 1: Hero ($28.44 in chips)
Seat 2: e9e25e5e ($16.58 in chips)
Seat 3: 76c4bafb ($22.81 in chips)
Seat 4: effd7574 ($36.29 in chips)
Seat 5: 682e00a ($13.48 in chips)
Seat 6: fe84cc4f ($10.75 in chips)
e9e25e5e: posts small blind $0.05
76c4bafb: posts big blind $0.1
*** HOLE CARDS ***
Dealt to Hero [6s Tc]
Dealt to e9e25e5e 
Dealt to 76c4bafb 
Dealt to effd7574 
Dealt to 682e00a 
Dealt to fe84cc4f 
effd7574: folds
682e00a: folds
fe84cc4f: folds
Hero: folds
e9e25e5e: raises $0.1 to $0.2
76c4bafb: folds
Uncalled bet ($0.1) returned to e9e25e5e
*** SHOWDOWN ***
e9e25e5e collected $0.2 from pot
*** SUMMARY ***
Total pot $0.2 | Rake $0 | Jackpot $0 | Bingo $0 | Fortune $0
Seat 1: Hero (button) folded before Flop (didn't bet)
Seat 2: e9e25e5e (small blind) collected ($0.2)
Seat 3: 76c4bafb (big blind) folded before Flop
Seat 4: effd7574 folded before Flop (didn't bet)
Seat 5: 682e00a folded before Flop (didn't bet)
Seat 6: fe84cc4f folded before Flop (didn't bet)


Poker Hand #RC1433222571: Hold'em No Limit  ($0.05/$0.1) - 2023/03/27 18:28:38
Table 'RushAndCash28147831' 6-max Seat #1 is the button
Seat 1: 4530b24e ($6.08 in chips)
Seat 2: dd1c31ee ($10 in chips)
Seat 3: 682e00a ($13.73 in chips)
Seat 4: Hero ($28.16 in chips)
Seat 5: ef42e992 ($10.03 in chips)
Seat 6: 91f3952f ($18.53 in chips)
dd1c31ee: posts small blind $0.05
682e00a: posts big blind $0.1
*** HOLE CARDS ***
Dealt to 4530b24e 
Dealt to dd1c31ee 
Dealt to 682e00a 
Dealt to Hero [As 2s]
Dealt to ef42e992 
Dealt to 91f3952f 
Hero: raises $0.15 to $0.25
ef42e992: folds
91f3952f: folds
4530b24e: folds
dd1c31ee: folds
682e00a: calls $0.15
*** FLOP *** [Qh 3d 4d]
682e00a: checks
Hero: bets $0.19
682e00a: folds
Uncalled bet ($0.19) returned to Hero
*** SHOWDOWN ***
Hero collected $0.53 from pot
*** SUMMARY ***
Total pot $0.55 | Rake $0.02 | Jackpot $0 | Bingo $0 | Fortune $0
Board [Qh 3d 4d]
Seat 1: 4530b24e (button) folded before Flop (didn't bet)
Seat 2: dd1c31ee (small blind) folded before Flop
Seat 3: 682e00a (big blind) folded on the Flop
Seat 4: Hero won ($0.53)
Seat 5: ef42e992 folded before Flop (didn't bet)
Seat 6: 91f3952f folded before Flop (didn't bet)


Poker Hand #RC1433222531: Hold'em No Limit  ($0.05/$0.1) - 2023/03/27 18:28:33
Table 'RushAndCash28147791' 6-max Seat #1 is the button
Seat 1: 126c704e ($23.41 in chips)
Seat 2: 11e8a420 ($17.07 in chips)
Seat 3: 4f40769d ($15.19 in chips)
Seat 4: Hero ($28.16 in chips)
Seat 5: 2e73d77 ($10 in chips)
Seat 6: 264e99f ($8.19 in chips)
11e8a420: posts small blind $0.05
4f40769d: posts big blind $0.1
*** HOLE CARDS ***
Dealt to 126c704e 
Dealt to 11e8a420 
Dealt to 4f40769d 
Dealt to Hero [8c Qh]
Dealt to 2e73d77 
Dealt to 264e99f 
Hero: folds
2e73d77: raises $0.15 to $0.25
264e99f: folds
126c704e: folds
11e8a420: calls $0.2
4f40769d: raises $0.57 to $0.82
2e73d77: calls $0.57
11e8a420: folds
*** FLOP *** [7h 8d Jd]
4f40769d: bets $0.95
2e73d77: folds
Uncalled bet ($0.95) returned to 4f40769d
*** SHOWDOWN ***
4f40769d collected $1.8 from pot
*** SUMMARY ***
Total pot $1.89 | Rake $0.09 | Jackpot $0 | Bingo $0 | Fortune $0
Board [7h 8d Jd]
Seat 1: 126c704e (button) folded before Flop (didn't bet)
Seat 2: 11e8a420 (small blind) folded before Flop
Seat 3: 4f40769d (big blind) won ($1.8)
Seat 4: Hero folded before Flop (didn't bet)
Seat 5: 2e73d77 folded on the Flop
Seat 6: 264e99f folded before Flop (didn't bet)


Poker Hand #RC1433222470: Hold'em No Limit  ($0.05/$0.1) - 2023/03/27 18:28:26
Table 'RushAndCash28147730' 6-max Seat #1 is the button
Seat 1: dd1c31ee ($10 in chips)
Seat 2: bb4dcf9b ($28.09 in chips)
Seat 3: a4010134 ($12.26 in chips)
Seat 4: cd70c4fa ($9.12 in chips)
Seat 5: Hero ($28.16 in chips)
Seat 6: 58414790 ($10 in chips)
bb4dcf9b: posts small blind $0.05
a4010134: posts big blind $0.1
*** HOLE CARDS ***
Dealt to dd1c31ee 
Dealt to bb4dcf9b 
Dealt to a4010134 
Dealt to cd70c4fa 
Dealt to Hero [7c 4c]
Dealt to 58414790 
cd70c4fa: folds
Hero: folds
58414790: folds
dd1c31ee: folds
bb4dcf9b: raises $0.2 to $0.3
a4010134: calls $0.2
*** FLOP *** [8c 2s 5h]
bb4dcf9b: bets $0.2
a4010134: calls $0.2
*** TURN *** [8c 2s 5h] [3h]
bb4dcf9b: bets $0.5
a4010134: folds
Uncalled bet ($0.5) returned to bb4dcf9b
*** SHOWDOWN ***
bb4dcf9b collected $0.95 from pot
*** SUMMARY ***
Total pot $1 | Rake $0.05 | Jackpot $0 | Bingo $0 | Fortune $0
Board [8c 2s 5h 3h]
Seat 1: dd1c31ee (button) folded before Flop (didn't bet)
Seat 2: bb4dcf9b (small blind) won ($0.95)
Seat 3: a4010134 (big blind) folded on the Turn
Seat 4: cd70c4fa folded before Flop (didn't bet)
Seat 5: Hero folded before Flop (didn't bet)
Seat 6: 58414790 folded before Flop (didn't bet)


Poker Hand #RC1433221789: Hold'em No Limit  ($0.05/$0.1) - 2023/03/27 18:27:00
Table 'RushAndCash28147049' 6-max Seat #1 is the button
Seat 1: cd70c4fa ($9.85 in chips)
Seat 2: a4010134 ($10 in chips)
Seat 3: Hero ($28.89 in chips)
Seat 4: 54371fed ($14.89 in chips)
Seat 5: 6e3bd1de ($11.08 in chips)
Seat 6: bab67c12 ($10.94 in chips)
Cash Drop to Pot : total $1 
a4010134: posts small blind $0.05
Hero: posts big blind $0.1
*** HOLE CARDS ***
Dealt to cd70c4fa 
Dealt to a4010134 
Dealt to Hero [3c 7h]
Dealt to 54371fed 
Dealt to 6e3bd1de 
Dealt to bab67c12 
54371fed: calls $0.1
6e3bd1de: folds
bab67c12: folds
cd70c4fa: calls $0.1
a4010134: calls $0.05
Hero: checks
*** FLOP *** [As 4h Ac]
a4010134: bets $0.1
Hero: raises $0.53 to $0.63
54371fed: folds
cd70c4fa: calls $0.63
a4010134: calls $0.53
*** TURN *** [As 4h Ac] [Jc]
a4010134: checks
Hero: checks
cd70c4fa: checks
*** RIVER *** [As 4h Ac Jc] [Qh]
a4010134: checks
Hero: checks
cd70c4fa: checks
a4010134: shows [Ah 6s] (Three Aces)
Hero: shows [3c 7h] (Pair of Aces)
cd70c4fa: shows [5c 5s] (Pair of Aces and Pair of Fives)
*** SHOWDOWN ***
a4010134 collected $2.99 from pot
*** SUMMARY ***
Total pot $3.29 | Rake $0.15 | Jackpot $0.15 | Bingo $0 | Fortune $0
Board [As 4h Ac Jc Qh]
Seat 1: cd70c4fa (button) showed [5c 5s] and lost with Pair of Aces and Pair of Fives
Seat 2: a4010134 (small blind) showed [Ah 6s] and won ($2.99) with Three Aces
Seat 3: Hero (big blind) showed [3c 7h] and lost with Pair of Aces
Seat 4: 54371fed folded on the Flop
Seat 5: 6e3bd1de folded before Flop (didn't bet)
Seat 6: bab67c12 folded before Flop (didn't bet)


Poker Hand #RC1433221758: Hold'em No Limit  ($0.05/$0.1) - 2023/03/27 18:26:56
Table 'RushAndCash28147018' 6-max Seat #1 is the button
Seat 1: ef42e992 ($10.63 in chips)
Seat 2: 80545bf8 ($25.24 in chips)
Seat 3: 5880cfee ($8.6 in chips)
Seat 4: 4a0f6018 ($10 in chips)
Seat 5: dc2f4d92 ($35.25 in chips)
Seat 6: Hero ($28.89 in chips)
80545bf8: posts small blind $0.05
5880cfee: posts big blind $0.1
*** HOLE CARDS ***
Dealt to ef42e992 
Dealt to 80545bf8 
Dealt to 5880cfee 
Dealt to 4a0f6018 
Dealt to dc2f4d92 
Dealt to Hero [8s Qd]
4a0f6018: folds
dc2f4d92: folds
Hero: folds
ef42e992: folds
80545bf8: folds
Uncalled bet ($0.05) returned to 5880cfee
*** SHOWDOWN ***
5880cfee collected $0.1 from pot
*** SUMMARY ***
Total pot $0.1 | Rake $0 | Jackpot $0 | Bingo $0 | Fortune $0
Seat 1: ef42e992 (button) folded before Flop (didn't bet)
Seat 2: 80545bf8 (small blind) folded before Flop
Seat 3: 5880cfee (big blind) collected ($0.1)
Seat 4: 4a0f6018 folded before Flop (didn't bet)
Seat 5: dc2f4d92 folded before Flop (didn't bet)
Seat 6: Hero folded before Flop (didn't bet)


Poker Hand #RC1433221635: Hold'em No Limit  ($0.05/$0.1) - 2023/03/27 18:26:41
Table 'RushAndCash28146895' 6-max Seat #1 is the button
Seat 1: 492bd702 ($12.22 in chips)
Seat 2: Hero ($28.79 in chips)
Seat 3: 2ade479b ($15.4 in chips)
Seat 4: 6ff9bbe9 ($10 in chips)
Seat 5: 5fcb3ba4 ($10 in chips)
Seat 6: 3413b85 ($10.37 in chips)
Hero: posts small blind $0.05
2ade479b: posts big blind $0.1
*** HOLE CARDS ***
Dealt to 492bd702 
Dealt to Hero [Ac 8d]
Dealt to 2ade479b 
Dealt to 6ff9bbe9 
Dealt to 5fcb3ba4 
Dealt to 3413b85 
6ff9bbe9: folds
5fcb3ba4: folds
3413b85: folds
492bd702: folds
Hero: raises $0.2 to $0.3
2ade479b: folds
Uncalled bet ($0.2) returned to Hero
*** SHOWDOWN ***
Hero collected $0.2 from pot
*** SUMMARY ***
Total pot $0.2 | Rake $0 | Jackpot $0 | Bingo $0 | Fortune $0
Seat 1: 492bd702 (button) folded before Flop (didn't bet)
Seat 2: Hero (small blind) collected ($0.2)
Seat 3: 2ade479b (big blind) folded before Flop
Seat 4: 6ff9bbe9 folded before Flop (didn't bet)
Seat 5: 5fcb3ba4 folded before Flop (didn't bet)
Seat 6: 3413b85 folded before Flop (didn't bet)


Poker Hand #RC1433221496: Hold'em No Limit  ($0.05/$0.1) - 2023/03/27 18:26:25
Table 'RushAndCash28146756' 6-max Seat #1 is the button
Seat 1: ca538a4e ($21.41 in chips)
Seat 2: b7aefb17 ($12.02 in chips)
Seat 3: cb91e079 ($16.91 in chips)
Seat 4: Hero ($28.64 in chips)
Seat 5: bff96a97 ($10.83 in chips)
Seat 6: b5079972 ($24.64 in chips)
b7aefb17: posts small blind $0.05
cb91e079: posts big blind $0.1
*** HOLE CARDS ***
Dealt to ca538a4e 
Dealt to b7aefb17 
Dealt to cb91e079 
Dealt to Hero [8h 9h]
Dealt to bff96a97 
Dealt to b5079972 
Hero: raises $0.15 to $0.25
bff96a97: folds
b5079972: folds
ca538a4e: folds
b7aefb17: folds
cb91e079: folds
Uncalled bet ($0.15) returned to Hero
*** SHOWDOWN ***
Hero collected $0.25 from pot
*** SUMMARY ***
Total pot $0.25 | Rake $0 | Jackpot $0 | Bingo $0 | Fortune $0
Seat 1: ca538a4e (button) folded before Flop (didn't bet)
Seat 2: b7aefb17 (small blind) folded before Flop
Seat 3: cb91e079 (big blind) folded before Flop
Seat 4: Hero collected ($0.25)
Seat 5: bff96a97 folded before Flop (didn't bet)
Seat 6: b5079972 folded before Flop (didn't bet)


Poker Hand #RC1433221354: Hold'em No Limit  ($0.05/$0.1) - 2023/03/27 18:26:09
Table 'RushAndCash28146614' 6-max Seat #1 is the button
Seat 1: e0f23917 ($10 in chips)
Seat 2: Hero ($28.69 in chips)
Seat 3: 1148c754 ($10 in chips)
Seat 4: 72e78d5 ($5.49 in chips)
Seat 5: 3ac5f7e3 ($19.69 in chips)
Seat 6: edef39dd ($10.15 in chips)
Hero: posts small blind $0.05
1148c754: posts big blind $0.1
*** HOLE CARDS ***
Dealt to e0f23917 
Dealt to Hero [8d Qd]
Dealt to 1148c754 
Dealt to 72e78d5 
Dealt to 3ac5f7e3 
Dealt to edef39dd 
72e78d5: folds
3ac5f7e3: raises $0.12 to $0.22
edef39dd: raises $0.5 to $0.72
e0f23917: folds
Hero: folds
1148c754: folds
3ac5f7e3: calls $0.5
*** FLOP *** [4h 5s Qs]
3ac5f7e3: checks
edef39dd: bets $0.63
3ac5f7e3: calls $0.63
*** TURN *** [4h 5s Qs] [Tc]
3ac5f7e3: checks
edef39dd: bets $1.47
3ac5f7e3: folds
Uncalled bet ($1.47) returned to edef39dd
*** SHOWDOWN ***
edef39dd collected $2.71 from pot
*** SUMMARY ***
Total pot $2.85 | Rake $0.14 | Jackpot $0 | Bingo $0 | Fortune $0
Board [4h 5s Qs Tc]
Seat 1: e0f23917 (button) folded before Flop (didn't bet)
Seat 2: Hero (small blind) folded before Flop
Seat 3: 1148c754 (big blind) folded before Flop
Seat 4: 72e78d5 folded before Flop (didn't bet)
Seat 5: 3ac5f7e3 folded on the Turn
Seat 6: edef39dd won ($2.71)


Poker Hand #RC1433221311: Hold'em No Limit  ($0.05/$0.1) - 2023/03/27 18:26:05
Table 'RushAndCash28146571' 6-max Seat #1 is the button
Seat 1: 670bced2 ($18.27 in chips)
Seat 2: f05ac3b2 ($22.68 in chips)
Seat 3: 65af4f69 ($12.37 in chips)
Seat 4: ff082cd5 ($12.02 in chips)
Seat 5: 279b639a ($11.15 in chips)
Seat 6: Hero ($28.69 in chips)
f05ac3b2: posts small blind $0.05
65af4f69: posts big blind $0.1
*** HOLE CARDS ***
Dealt to 670bced2 
Dealt to f05ac3b2 
Dealt to 65af4f69 
Dealt to ff082cd5 
Dealt to 279b639a 
Dealt to Hero [5d 9h]
ff082cd5: folds
279b639a: folds
Hero: folds
670bced2: raises $0.13 to $0.23
f05ac3b2: folds
65af4f69: folds
Uncalled bet ($0.13) returned to 670bced2
*** SHOWDOWN ***
670bced2 collected $0.25 from pot
*** SUMMARY ***
Total pot $0.25 | Rake $0 | Jackpot $0 | Bingo $0 | Fortune $0
Seat 1: 670bced2 (button) collected ($0.25)
Seat 2: f05ac3b2 (small blind) folded before Flop
Seat 3: 65af4f69 (big blind) folded before Flop
Seat 4: ff082cd5 folded before Flop (didn't bet)
Seat 5: 279b639a folded before Flop (didn't bet)
Seat 6: Hero folded before Flop (didn't bet)


Poker Hand #RC1433221269: Hold'em No Limit  ($0.05/$0.1) - 2023/03/27 18:25:59
Table 'RushAndCash28146529' 6-max Seat #1 is the button
Seat 1: 9d85cd52 ($10 in chips)
Seat 2: 4ca0ce36 ($16.08 in chips)
Seat 3: 4bcd0a2f ($21.58 in chips)
Seat 4: 9aa683e6 ($9.7 in chips)
Seat 5: Hero ($28.54 in chips)
Seat 6: ffef94f8 ($10.32 in chips)
4ca0ce36: posts small blind $0.05
4bcd0a2f: posts big blind $0.1
*** HOLE CARDS ***
Dealt to 9d85cd52 
Dealt to 4ca0ce36 
Dealt to 4bcd0a2f 
Dealt to 9aa683e6 
Dealt to Hero [3s Qs]
Dealt to ffef94f8 
9aa683e6: folds
Hero: folds
ffef94f8: folds
9d85cd52: raises $0.14 to $0.24
4ca0ce36: folds
4bcd0a2f: raises $0.8 to $1.04
9d85cd52: folds
Uncalled bet ($0.8) returned to 4bcd0a2f
*** SHOWDOWN ***
4bcd0a2f collected $0.51 from pot
*** SUMMARY ***
Total pot $0.53 | Rake $0.02 | Jackpot $0 | Bingo $0 | Fortune $0
Seat 1: 9d85cd52 (button) folded before Flop
Seat 2: 4ca0ce36 (small blind) folded before Flop
Seat 3: 4bcd0a2f (big blind) collected ($0.51)
Seat 4: 9aa683e6 folded before Flop (didn't bet)
Seat 5: Hero folded before Flop (didn't bet)
Seat 6: ffef94f8 folded before Flop (didn't bet)


Poker Hand #RC1433221226: Hold'em No Limit  ($0.05/$0.1) - 2023/03/27 18:25:54
Table 'RushAndCash28146486' 6-max Seat #1 is the button
Seat 1: 59a09a3b ($10.64 in chips)
Seat 2: 70cb77a1 ($13.42 in chips)
Seat 3: 7465263d ($57.32 in chips)
Seat 4: 6d9935e3 ($26.47 in chips)
Seat 5: Hero ($28.54 in chips)
Seat 6: a4a16240 ($10.11 in chips)
70cb77a1: posts small blind $0.05
7465263d: posts big blind $0.1
*** HOLE CARDS ***
Dealt to 59a09a3b 
Dealt to 70cb77a1 
Dealt to 7465263d 
Dealt to 6d9935e3 
Dealt to Hero [5c Jh]
Dealt to a4a16240 
6d9935e3: folds
Hero: folds
a4a16240: folds
59a09a3b: folds
70cb77a1: raises $0.18 to $0.28
7465263d: folds
Uncalled bet ($0.18) returned to 70cb77a1
*** SHOWDOWN ***
70cb77a1 collected $0.2 from pot
*** SUMMARY ***
Total pot $0.2 | Rake $0 | Jackpot $0 | Bingo $0 | Fortune $0
Seat 1: 59a09a3b (button) folded before Flop (didn't bet)
Seat 2: 70cb77a1 (small blind) collected ($0.2)
Seat 3: 7465263d (big blind) folded before Flop
Seat 4: 6d9935e3 folded before Flop (didn't bet)
Seat 5: Hero folded before Flop (didn't bet)
Seat 6: a4a16240 folded before Flop (didn't bet)


Poker Hand #RC1433221120: Hold'em No Limit  ($0.05/$0.1) - 2023/03/27 18:25:41
Table 'RushAndCash28146380' 6-max Seat #1 is the button
Seat 1: 1f96c8a9 ($10.77 in chips)
Seat 2: 60843529 ($19.89 in chips)
Seat 3: Hero ($28.64 in chips)
Seat 4: 415a76d1 ($4.89 in chips)
Seat 5: 375ea40e ($11.17 in chips)
Seat 6: ccb2aecd ($10.11 in chips)
60843529: posts small blind $0.05
Hero: posts big blind $0.1
*** HOLE CARDS ***
Dealt to 1f96c8a9 
Dealt to 60843529 
Dealt to Hero [9d 6d]
Dealt to 415a76d1 
Dealt to 375ea40e 
Dealt to ccb2aecd 
415a76d1: folds
375ea40e: folds
ccb2aecd: folds
1f96c8a9: folds
60843529: folds
Uncalled bet ($0.05) returned to Hero
*** SHOWDOWN ***
Hero collected $0.1 from pot
*** SUMMARY ***
Total pot $0.1 | Rake $0 | Jackpot $0 | Bingo $0 | Fortune $0
Seat 1: 1f96c8a9 (button) folded before Flop (didn't bet)
Seat 2: 60843529 (small blind) folded before Flop
Seat 3: Hero (big blind) collected ($0.1)
Seat 4: 415a76d1 folded before Flop (didn't bet)
Seat 5: 375ea40e folded before Flop (didn't bet)
Seat 6: ccb2aecd folded before Flop (didn't bet)


Poker Hand #RC1433221092: Hold'em No Limit  ($0.05/$0.1) - 2023/03/27 18:25:37
Table 'RushAndCash28146352' 6-max Seat #1 is the button
Seat 1: e35a4307 ($43.14 in chips)
Seat 2: b122e2a5 ($10 in chips)
Seat 3: 35dc15e6 ($23.68 in chips)
Seat 4: 66017d6f ($10.05 in chips)
Seat 5: 1c31ab5b ($9.06 in chips)
Seat 6: Hero ($28.64 in chips)
b122e2a5: posts small blind $0.05
35dc15e6: posts big blind $0.1
*** HOLE CARDS ***
Dealt to e35a4307 
Dealt to b122e2a5 
Dealt to 35dc15e6 
Dealt to 66017d6f 
Dealt to 1c31ab5b 
Dealt to Hero [3c 6c]
66017d6f: folds
1c31ab5b: folds
Hero: folds
e35a4307: raises $0.2 to $0.3
b122e2a5: folds
35dc15e6: calls $0.2
*** FLOP *** [8d Ts 5d]
35dc15e6: checks
e35a4307: checks
*** TURN *** [8d Ts 5d] [6d]
35dc15e6: bets $0.33
e35a4307: folds
Uncalled bet ($0.33) returned to 35dc15e6
*** SHOWDOWN ***
35dc15e6 collected $0.62 from pot
*** SUMMARY ***
Total pot $0.65 | Rake $0.03 | Jackpot $0 | Bingo $0 | Fortune $0
Board [8d Ts 5d 6d]
Seat 1: e35a4307 (button) folded on the Turn
Seat 2: b122e2a5 (small blind) folded before Flop
Seat 3: 35dc15e6 (big blind) won ($0.62)
Seat 4: 66017d6f folded before Flop (didn't bet)
Seat 5: 1c31ab5b folded before Flop (didn't bet)
Seat 6: Hero folded before Flop (didn't bet)


Poker Hand #RC1433221003: Hold'em No Limit  ($0.05/$0.1) - 2023/03/27 18:25:25
Table 'RushAndCash28146263' 6-max Seat #1 is the button
Seat 1: Hero ($28.64 in chips)
Seat 2: ab3ed362 ($10.3 in chips)
Seat 3: c20fb006 ($25.88 in chips)
Seat 4: f21c7deb ($10.61 in chips)
Seat 5: 4cc4a2f3 ($10.44 in chips)
Seat 6: 738bac7e ($10 in chips)
ab3ed362: posts small blind $0.05
c20fb006: posts big blind $0.1
*** HOLE CARDS ***
Dealt to Hero [3h 4s]
Dealt to ab3ed362 
Dealt to c20fb006 
Dealt to f21c7deb 
Dealt to 4cc4a2f3 
Dealt to 738bac7e 
f21c7deb: folds
4cc4a2f3: folds
738bac7e: folds
Hero: folds
ab3ed362: folds
Uncalled bet ($0.05) returned to c20fb006
*** SHOWDOWN ***
c20fb006 collected $0.1 from pot
*** SUMMARY ***
Total pot $0.1 | Rake $0 | Jackpot $0 | Bingo $0 | Fortune $0
Seat 1: Hero (button) folded before Flop (didn't bet)
Seat 2: ab3ed362 (small blind) folded before Flop
Seat 3: c20fb006 (big blind) collected ($0.1)
Seat 4: f21c7deb folded before Flop (didn't bet)
Seat 5: 4cc4a2f3 folded before Flop (didn't bet)
Seat 6: 738bac7e folded before Flop (didn't bet)


Poker Hand #RC1433220786: Hold'em No Limit  ($0.05/$0.1) - 2023/03/27 18:24:58
Table 'RushAndCash28146046' 6-max Seat #1 is the button
Seat 1: f3de17dc ($19.16 in chips)
Seat 2: Hero ($28.55 in chips)
Seat 3: bcd85a42 ($10.59 in chips)
Seat 4: 4d2c2eac ($11.5 in chips)
Seat 5: dd1c31ee ($11.85 in chips)
Seat 6: 4a41eab5 ($12.25 in chips)
Hero: posts small blind $0.05
bcd85a42: posts big blind $0.1
*** HOLE CARDS ***
Dealt to f3de17dc 
Dealt to Hero [5c 9d]
Dealt to bcd85a42 
Dealt to 4d2c2eac 
Dealt to dd1c31ee 
Dealt to 4a41eab5 
4d2c2eac: folds
dd1c31ee: folds
4a41eab5: folds
f3de17dc: folds
Hero: calls $0.05
bcd85a42: checks
*** FLOP *** [Ks 7d Tc]
Hero: checks
bcd85a42: checks
*** TURN *** [Ks 7d Tc] [9h]
Hero: bets $0.1
bcd85a42: folds
Uncalled bet ($0.1) returned to Hero
*** SHOWDOWN ***
Hero collected $0.19 from pot
*** SUMMARY ***
Total pot $0.2 | Rake $0.01 | Jackpot $0 | Bingo $0 | Fortune $0
Board [Ks 7d Tc 9h]
Seat 1: f3de17dc (button) folded before Flop (didn't bet)
Seat 2: Hero (small blind) won ($0.19)
Seat 3: bcd85a42 (big blind) folded on the Turn
Seat 4: 4d2c2eac folded before Flop (didn't bet)
Seat 5: dd1c31ee folded before Flop (didn't bet)
Seat 6: 4a41eab5 folded before Flop (didn't bet)


Poker Hand #RC1433220474: Hold'em No Limit  ($0.05/$0.1) - 2023/03/27 18:24:16
Table 'RushAndCash28145734' 6-max Seat #1 is the button
Seat 1: e8004c2c ($15.57 in chips)
Seat 2: 4d2c2eac ($12.05 in chips)
Seat 3: Hero ($28.05 in chips)
Seat 4: a8ba070c ($12.88 in chips)
Seat 5: 941036e5 ($12.93 in chips)
Seat 6: 2ea7aaad ($10 in chips)
4d2c2eac: posts small blind $0.05
Hero: posts big blind $0.1
*** HOLE CARDS ***
Dealt to e8004c2c 
Dealt to 4d2c2eac 
Dealt to Hero [Ad Ac]
Dealt to a8ba070c 
Dealt to 941036e5 
Dealt to 2ea7aaad 
a8ba070c: folds
941036e5: folds
2ea7aaad: folds
e8004c2c: folds
4d2c2eac: raises $0.1 to $0.2
Hero: raises $0.35 to $0.55
4d2c2eac: calls $0.35
*** FLOP *** [4d Qd 7d]
4d2c2eac: checks
Hero: bets $0.55
4d2c2eac: folds
Uncalled bet ($0.55) returned to Hero
*** SHOWDOWN ***
Hero collected $1.05 from pot
*** SUMMARY ***
Total pot $1.1 | Rake $0.05 | Jackpot $0 | Bingo $0 | Fortune $0
Board [4d Qd 7d]
Seat 1: e8004c2c (button) folded before Flop (didn't bet)
Seat 2: 4d2c2eac (small blind) folded on the Flop
Seat 3: Hero (big blind) won ($1.05)
Seat 4: a8ba070c folded before Flop (didn't bet)
Seat 5: 941036e5 folded before Flop (didn't bet)
Seat 6: 2ea7aaad folded before Flop (didn't bet)


Poker Hand #RC1433220438: Hold'em No Limit  ($0.05/$0.1) - 2023/03/27 18:24:12
Table 'RushAndCash28145698' 6-max Seat #1 is the button
Seat 1: 80545bf8 ($22.94 in chips)
Seat 2: d3a652d6 ($13.99 in chips)
Seat 3: 68f01335 ($10.42 in chips)
Seat 4: Hero ($28.05 in chips)
Seat 5: c4379e9a ($29.46 in chips)
Seat 6: bb7e8808 ($13.69 in chips)
d3a652d6: posts small blind $0.05
68f01335: posts big blind $0.1
*** HOLE CARDS ***
Dealt to 80545bf8 
Dealt to d3a652d6 
Dealt to 68f01335 
Dealt to Hero [Jc 7s]
Dealt to c4379e9a 
Dealt to bb7e8808 
Hero: folds
c4379e9a: folds
bb7e8808: raises $0.15 to $0.25
80545bf8: raises $0.49 to $0.74
d3a652d6: folds
68f01335: folds
bb7e8808: folds
Uncalled bet ($0.49) returned to 80545bf8
*** SHOWDOWN ***
80545bf8 collected $0.62 from pot
*** SUMMARY ***
Total pot $0.65 | Rake $0.03 | Jackpot $0 | Bingo $0 | Fortune $0
Seat 1: 80545bf8 (button) collected ($0.62)
Seat 2: d3a652d6 (small blind) folded before Flop
Seat 3: 68f01335 (big blind) folded before Flop
Seat 4: Hero folded before Flop (didn't bet)
Seat 5: c4379e9a folded before Flop (didn't bet)
Seat 6: bb7e8808 folded before Flop


Poker Hand #RC1433220316: Hold'em No Limit  ($0.05/$0.1) - 2023/03/27 18:23:56
Table 'RushAndCash28145576' 6-max Seat #1 is the button
Seat 1: a954c345 ($13.66 in chips)
Seat 2: 5332610a ($10.77 in chips)
Seat 3: 3cae567c ($14.17 in chips)
Seat 4: 6a909d3f ($12.16 in chips)
Seat 5: 74e66867 ($10 in chips)
Seat 6: Hero ($28.05 in chips)
5332610a: posts small blind $0.05
3cae567c: posts big blind $0.1
*** HOLE CARDS ***
Dealt to a954c345 
Dealt to 5332610a 
Dealt to 3cae567c 
Dealt to 6a909d3f 
Dealt to 74e66867 
Dealt to Hero [6h Qd]
6a909d3f: raises $0.15 to $0.25
74e66867: folds
Hero: folds
a954c345: folds
5332610a: folds
3cae567c: calls $0.15
*** FLOP *** [Tc Th 9c]
3cae567c: checks
6a909d3f: bets $0.19
3cae567c: folds
Uncalled bet ($0.19) returned to 6a909d3f
*** SHOWDOWN ***
6a909d3f collected $0.53 from pot
*** SUMMARY ***
Total pot $0.55 | Rake $0.02 | Jackpot $0 | Bingo $0 | Fortune $0
Board [Tc Th 9c]
Seat 1: a954c345 (button) folded before Flop (didn't bet)
Seat 2: 5332610a (small blind) folded before Flop
Seat 3: 3cae567c (big blind) folded on the Flop
Seat 4: 6a909d3f won ($0.53)
Seat 5: 74e66867 folded before Flop (didn't bet)
Seat 6: Hero folded before Flop (didn't bet)


Poker Hand #RC1433220257: Hold'em No Limit  ($0.05/$0.1) - 2023/03/27 18:23:49
Table 'RushAndCash28145517' 6-max Seat #1 is the button
Seat 1: Hero ($28.05 in chips)
Seat 2: 77c2df7d ($10 in chips)
Seat 3: 5c072d71 ($13.33 in chips)
Seat 4: 25b5673d ($14.68 in chips)
Seat 5: 6c9f5065 ($4.25 in chips)
Seat 6: 42ab78a ($37.21 in chips)
77c2df7d: posts small blind $0.05
5c072d71: posts big blind $0.1
*** HOLE CARDS ***
Dealt to Hero [8c Jh]
Dealt to 77c2df7d 
Dealt to 5c072d71 
Dealt to 25b5673d 
Dealt to 6c9f5065 
Dealt to 42ab78a 
25b5673d: folds
6c9f5065: folds
42ab78a: folds
Hero: folds
77c2df7d: raises $0.2 to $0.3
5c072d71: folds
Uncalled bet ($0.2) returned to 77c2df7d
*** SHOWDOWN ***
77c2df7d collected $0.2 from pot
*** SUMMARY ***
Total pot $0.2 | Rake $0 | Jackpot $0 | Bingo $0 | Fortune $0
Seat 1: Hero (button) folded before Flop (didn't bet)
Seat 2: 77c2df7d (small blind) collected ($0.2)
Seat 3: 5c072d71 (big blind) folded before Flop
Seat 4: 25b5673d folded before Flop (didn't bet)
Seat 5: 6c9f5065 folded before Flop (didn't bet)
Seat 6: 42ab78a folded before Flop (didn't bet)


Poker Hand #RC1433220209: Hold'em No Limit  ($0.05/$0.1) - 2023/03/27 18:23:42
Table 'RushAndCash28145469' 6-max Seat #1 is the button
Seat 1: 39852c3c ($11.24 in chips)
Seat 2: ae7b5bca ($10.22 in chips)
Seat 3: Hero ($28 in chips)
Seat 4: e0bcb3ba ($5.18 in chips)
Seat 5: a029993d ($9.67 in chips)
Seat 6: b59f0022 ($11.03 in chips)
ae7b5bca: posts small blind $0.05
Hero: posts big blind $0.1
*** HOLE CARDS ***
Dealt to 39852c3c 
Dealt to ae7b5bca 
Dealt to Hero [2s Tc]
Dealt to e0bcb3ba 
Dealt to a029993d 
Dealt to b59f0022 
e0bcb3ba: folds
a029993d: folds
b59f0022: folds
39852c3c: folds
ae7b5bca: folds
Uncalled bet ($0.05) returned to Hero
*** SHOWDOWN ***
Hero collected $0.1 from pot
*** SUMMARY ***
Total pot $0.1 | Rake $0 | Jackpot $0 | Bingo $0 | Fortune $0
Seat 1: 39852c3c (button) folded before Flop (didn't bet)
Seat 2: ae7b5bca (small blind) folded before Flop
Seat 3: Hero (big blind) collected ($0.1)
Seat 4: e0bcb3ba folded before Flop (didn't bet)
Seat 5: a029993d folded before Flop (didn't bet)
Seat 6: b59f0022 folded before Flop (didn't bet)


Poker Hand #RC1433220176: Hold'em No Limit  ($0.05/$0.1) - 2023/03/27 18:23:38
Table 'RushAndCash28145436' 6-max Seat #1 is the button
Seat 1: Hero ($28 in chips)
Seat 2: 1fddc5cb ($10.05 in chips)
Seat 3: 678d9df5 ($10 in chips)
Seat 4: 77496f84 ($46.16 in chips)
Seat 5: 4cc4a2f3 ($10.79 in chips)
Seat 6: 8115e527 ($24.54 in chips)
1fddc5cb: posts small blind $0.05
678d9df5: posts big blind $0.1
*** HOLE CARDS ***
Dealt to Hero [6c 7h]
Dealt to 1fddc5cb 
Dealt to 678d9df5 
Dealt to 77496f84 
Dealt to 4cc4a2f3 
Dealt to 8115e527 
77496f84: folds
4cc4a2f3: folds
8115e527: folds
Hero: folds
1fddc5cb: folds
Uncalled bet ($0.05) returned to 678d9df5
*** SHOWDOWN ***
678d9df5 collected $0.1 from pot
*** SUMMARY ***
Total pot $0.1 | Rake $0 | Jackpot $0 | Bingo $0 | Fortune $0
Seat 1: Hero (button) folded before Flop (didn't bet)
Seat 2: 1fddc5cb (small blind) folded before Flop
Seat 3: 678d9df5 (big blind) collected ($0.1)
Seat 4: 77496f84 folded before Flop (didn't bet)
Seat 5: 4cc4a2f3 folded before Flop (didn't bet)
Seat 6: 8115e527 folded before Flop (didn't bet)


Poker Hand #RC1433220041: Hold'em No Limit  ($0.05/$0.1) - 2023/03/27 18:23:21
Table 'RushAndCash28145301' 6-max Seat #1 is the button
Seat 1: f4f4089c ($9.85 in chips)
Seat 2: Hero ($28.05 in chips)
Seat 3: 5007c72 ($16.89 in chips)
Seat 4: 97f50981 ($9.37 in chips)
Seat 5: 6e3bd1de ($10 in chips)
Seat 6: d26270f7 ($22.83 in chips)
Hero: posts small blind $0.05
5007c72: posts big blind $0.1
*** HOLE CARDS ***
Dealt to f4f4089c 
Dealt to Hero [Kh 4c]
Dealt to 5007c72 
Dealt to 97f50981 
Dealt to 6e3bd1de 
Dealt to d26270f7 
97f50981: folds
6e3bd1de: folds
d26270f7: raises $0.11 to $0.21
f4f4089c: calls $0.21
Hero: folds
5007c72: calls $0.11
*** FLOP *** [2c 7h 9d]
5007c72: checks
d26270f7: checks
f4f4089c: checks
*** TURN *** [2c 7h 9d] [As]
5007c72: checks
d26270f7: bets $0.22
f4f4089c: folds
5007c72: folds
Uncalled bet ($0.22) returned to d26270f7
5007c72: shows [7d] (Pair of Sevens)
*** SHOWDOWN ***
d26270f7 collected $0.65 from pot
*** SUMMARY ***
Total pot $0.68 | Rake $0.03 | Jackpot $0 | Bingo $0 | Fortune $0
Board [2c 7h 9d As]
Seat 1: f4f4089c (button) folded on the Turn
Seat 2: Hero (small blind) folded before Flop
Seat 3: 5007c72 (big blind) folded on the Turn
Seat 4: 97f50981 folded before Flop (didn't bet)
Seat 5: 6e3bd1de folded before Flop (didn't bet)
Seat 6: d26270f7 won ($0.65)


Poker Hand #RC1433219985: Hold'em No Limit  ($0.05/$0.1) - 2023/03/27 18:23:14
Table 'RushAndCash28145245' 6-max Seat #1 is the button
Seat 1: b8a87c32 ($18.29 in chips)
Seat 2: 662b9b07 ($12.9 in chips)
Seat 3: 5f48ef4c ($10.41 in chips)
Seat 4: 2b0a83ca ($10.15 in chips)
Seat 5: Hero ($28.05 in chips)
Seat 6: a725b62e ($12.25 in chips)
662b9b07: posts small blind $0.05
5f48ef4c: posts big blind $0.1
*** HOLE CARDS ***
Dealt to b8a87c32 
Dealt to 662b9b07 
Dealt to 5f48ef4c 
Dealt to 2b0a83ca 
Dealt to Hero [2s 9c]
Dealt to a725b62e 
2b0a83ca: folds
Hero: folds
a725b62e: folds
b8a87c32: folds
662b9b07: raises $0.2 to $0.3
5f48ef4c: calls $0.2
*** FLOP *** [9s Jc As]
662b9b07: checks
5f48ef4c: checks
*** TURN *** [9s Jc As] [9d]
662b9b07: bets $0.34
5f48ef4c: calls $0.34
*** RIVER *** [9s Jc As 9d] [Ts]
662b9b07: bets $1.13
5f48ef4c: folds
Uncalled bet ($1.13) returned to 662b9b07
*** SHOWDOWN ***
662b9b07 collected $1.22 from pot
*** SUMMARY ***
Total pot $1.28 | Rake $0.06 | Jackpot $0 | Bingo $0 | Fortune $0
Board [9s Jc As 9d Ts]
Seat 1: b8a87c32 (button) folded before Flop (didn't bet)
Seat 2: 662b9b07 (small blind) won ($1.22)
Seat 3: 5f48ef4c (big blind) folded on the River
Seat 4: 2b0a83ca folded before Flop (didn't bet)
Seat 5: Hero folded before Flop (didn't bet)
Seat 6: a725b62e folded before Flop (didn't bet)


Poker Hand #RC1433219752: Hold'em No Limit  ($0.05/$0.1) - 2023/03/27 18:22:47
Table 'RushAndCash28145012' 6-max Seat #1 is the button
Seat 1: f9e90856 ($10 in chips)
Seat 2: 58ee3d06 ($12.28 in chips)
Seat 3: cf224d9 ($10 in chips)
Seat 4: 4271d829 ($20.18 in chips)
Seat 5: Hero ($28.05 in chips)
Seat 6: 36216ab ($19.96 in chips)
58ee3d06: posts small blind $0.05
cf224d9: posts big blind $0.1
*** HOLE CARDS ***
Dealt to f9e90856 
Dealt to 58ee3d06 
Dealt to cf224d9 
Dealt to 4271d829 
Dealt to Hero [Ks 5s]
Dealt to 36216ab 
4271d829: folds
Hero: folds
36216ab: raises $0.15 to $0.25
f9e90856: folds
58ee3d06: folds
cf224d9: folds
Uncalled bet ($0.15) returned to 36216ab
*** SHOWDOWN ***
36216ab collected $0.25 from pot
*** SUMMARY ***
Total pot $0.25 | Rake $0 | Jackpot $0 | Bingo $0 | Fortune $0
Seat 1: f9e90856 (button) folded before Flop (didn't bet)
Seat 2: 58ee3d06 (small blind) folded before Flop
Seat 3: cf224d9 (big blind) folded before Flop
Seat 4: 4271d829 folded before Flop (didn't bet)
Seat 5: Hero folded before Flop (didn't bet)
Seat 6: 36216ab collected ($0.25)


Poker Hand #RC1433219689: Hold'em No Limit  ($0.05/$0.1) - 2023/03/27 18:22:39
Table 'RushAndCash28144949' 6-max Seat #1 is the button
Seat 1: 1e1faffc ($15.48 in chips)
Seat 2: 5298b1c3 ($10 in chips)
Seat 3: 7ea7764 ($20.56 in chips)
Seat 4: Hero ($28.05 in chips)
Seat 5: df97d1f2 ($10.06 in chips)
Seat 6: e6131d94 ($10.86 in chips)
5298b1c3: posts small blind $0.05
7ea7764: posts big blind $0.1
*** HOLE CARDS ***
Dealt to 1e1faffc 
Dealt to 5298b1c3 
Dealt to 7ea7764 
Dealt to Hero [3s 5s]
Dealt to df97d1f2 
Dealt to e6131d94 
Hero: folds
df97d1f2: raises $0.15 to $0.25
e6131d94: folds
1e1faffc: calls $0.25
5298b1c3: folds
7ea7764: raises $0.8 to $1.05
df97d1f2: calls $0.8
1e1faffc: calls $0.8
*** FLOP *** [Ad Qc 2c]
7ea7764: bets $1.6
df97d1f2: folds
1e1faffc: folds
Uncalled bet ($1.6) returned to 7ea7764
*** SHOWDOWN ***
7ea7764 collected $2.9 from pot
*** SUMMARY ***
Total pot $3.2 | Rake $0.15 | Jackpot $0.15 | Bingo $0 | Fortune $0
Board [Ad Qc 2c]
Seat 1: 1e1faffc (button) folded on the Flop
Seat 2: 5298b1c3 (small blind) folded before Flop
Seat 3: 7ea7764 (big blind) won ($2.9)
Seat 4: Hero folded before Flop (didn't bet)
Seat 5: df97d1f2 folded on the Flop
Seat 6: e6131d94 folded before Flop (didn't bet)


Poker Hand #RC1433219638: Hold'em No Limit  ($0.05/$0.1) - 2023/03/27 18:22:34
Table 'RushAndCash28144898' 6-max Seat #1 is the button
Seat 1: e5dcc498 ($10.06 in chips)
Seat 2: e5f5ed29 ($11.02 in chips)
Seat 3: befa88de ($10 in chips)
Seat 4: Hero ($28.05 in chips)
Seat 5: 725f7e50 ($10.79 in chips)
Seat 6: 90f63f70 ($10.85 in chips)
e5f5ed29: posts small blind $0.05
befa88de: posts big blind $0.1
*** HOLE CARDS ***
Dealt to e5dcc498 
Dealt to e5f5ed29 
Dealt to befa88de 
Dealt to Hero [3h Ac]
Dealt to 725f7e50 
Dealt to 90f63f70 
Hero: folds
725f7e50: folds
90f63f70: folds
e5dcc498: raises $0.15 to $0.25
e5f5ed29: folds
befa88de: calls $0.15
*** FLOP *** [5d 6d 9c]
befa88de: checks
e5dcc498: checks
*** TURN *** [5d 6d 9c] [Jh]
befa88de: checks
e5dcc498: bets $0.42
befa88de: calls $0.42
*** RIVER *** [5d 6d 9c Jh] [Ts]
befa88de: checks
e5dcc498: bets $0.46
befa88de: folds
Uncalled bet ($0.46) returned to e5dcc498
*** SHOWDOWN ***
e5dcc498 collected $1.32 from pot
*** SUMMARY ***
Total pot $1.39 | Rake $0.07 | Jackpot $0 | Bingo $0 | Fortune $0
Board [5d 6d 9c Jh Ts]
Seat 1: e5dcc498 (button) won ($1.32)
Seat 2: e5f5ed29 (small blind) folded before Flop
Seat 3: befa88de (big blind) folded on the River
Seat 4: Hero folded before Flop (didn't bet)
Seat 5: 725f7e50 folded before Flop (didn't bet)
Seat 6: 90f63f70 folded before Flop (didn't bet)


Poker Hand #RC1433219545: Hold'em No Limit  ($0.05/$0.1) - 2023/03/27 18:22:23
Table 'RushAndCash28144805' 6-max Seat #1 is the button
Seat 1: 8cc96d93 ($23.58 in chips)
Seat 2: 46b46620 ($18.78 in chips)
Seat 3: 463d2ce5 ($13.38 in chips)
Seat 4: feca46e2 ($8.78 in chips)
Seat 5: 725f7e50 ($10.79 in chips)
Seat 6: Hero ($28.05 in chips)
46b46620: posts small blind $0.05
463d2ce5: posts big blind $0.1
*** HOLE CARDS ***
Dealt to 8cc96d93 
Dealt to 46b46620 
Dealt to 463d2ce5 
Dealt to feca46e2 
Dealt to 725f7e50 
Dealt to Hero [Js 4h]
feca46e2: folds
725f7e50: folds
Hero: folds
8cc96d93: folds
46b46620: folds
Uncalled bet ($0.05) returned to 463d2ce5
*** SHOWDOWN ***
463d2ce5 collected $0.1 from pot
*** SUMMARY ***
Total pot $0.1 | Rake $0 | Jackpot $0 | Bingo $0 | Fortune $0
Seat 1: 8cc96d93 (button) folded before Flop (didn't bet)
Seat 2: 46b46620 (small blind) folded before Flop
Seat 3: 463d2ce5 (big blind) collected ($0.1)
Seat 4: feca46e2 folded before Flop (didn't bet)
Seat 5: 725f7e50 folded before Flop (didn't bet)
Seat 6: Hero folded before Flop (didn't bet)


Poker Hand #RC1433219426: Hold'em No Limit  ($0.05/$0.1) - 2023/03/27 18:22:08
Table 'RushAndCash28144686' 6-max Seat #1 is the button
Seat 1: 264e99f ($20.83 in chips)
Seat 2: Hero ($28.1 in chips)
Seat 3: 7eba02ca ($10.46 in chips)
Seat 4: cc1ce1be ($11.21 in chips)
Seat 5: 9ea17a48 ($8.9 in chips)
Seat 6: c1cbc2c2 ($11.14 in chips)
Hero: posts small blind $0.05
7eba02ca: posts big blind $0.1
*** HOLE CARDS ***
Dealt to 264e99f 
Dealt to Hero [7s Js]
Dealt to 7eba02ca 
Dealt to cc1ce1be 
Dealt to 9ea17a48 
Dealt to c1cbc2c2 
cc1ce1be: folds
9ea17a48: raises $0.2 to $0.3
c1cbc2c2: raises $0.57 to $0.87
264e99f: folds
Hero: folds
7eba02ca: folds
9ea17a48: calls $0.57
*** FLOP *** [6d Ts 7h]
9ea17a48: checks
c1cbc2c2: bets $0.95
9ea17a48: calls $0.95
*** TURN *** [6d Ts 7h] [Tc]
9ea17a48: checks
c1cbc2c2: checks
*** RIVER *** [6d Ts 7h Tc] [Kc]
9ea17a48: checks
c1cbc2c2: checks
9ea17a48: shows [8s 8c] (Pair of Tens and Pair of Eights)
c1cbc2c2: shows [As Jc] (Pair of Tens)
*** SHOWDOWN ***
9ea17a48 collected $3.46 from pot
*** SUMMARY ***
Total pot $3.79 | Rake $0.18 | Jackpot $0.15 | Bingo $0 | Fortune $0
Board [6d Ts 7h Tc Kc]
Seat 1: 264e99f (button) folded before Flop (didn't bet)
Seat 2: Hero (small blind) folded before Flop
Seat 3: 7eba02ca (big blind) folded before Flop
Seat 4: cc1ce1be folded before Flop (didn't bet)
Seat 5: 9ea17a48 showed [8s 8c] and won ($3.46) with Pair of Tens and Pair of Eights
Seat 6: c1cbc2c2 showed [As Jc] and lost with Pair of Tens


Poker Hand #RC1433219341: Hold'em No Limit  ($0.05/$0.1) - 2023/03/27 18:21:56
Table 'RushAndCash28144601' 6-max Seat #1 is the button
Seat 1: 819631cf ($11.5 in chips)
Seat 2: 6dba827f ($12.98 in chips)
Seat 3: Hero ($28.05 in chips)
Seat 4: 1ef2413 ($4.82 in chips)
Seat 5: a029993d ($9.36 in chips)
Seat 6: 25f73bab ($11.89 in chips)
6dba827f: posts small blind $0.05
Hero: posts big blind $0.1
*** HOLE CARDS ***
Dealt to 819631cf 
Dealt to 6dba827f 
Dealt to Hero [Kc Kh]
Dealt to 1ef2413 
Dealt to a029993d 
Dealt to 25f73bab 
1ef2413: folds
a029993d: folds
25f73bab: folds
819631cf: folds
6dba827f: folds
Uncalled bet ($0.05) returned to Hero
*** SHOWDOWN ***
Hero collected $0.1 from pot
*** SUMMARY ***
Total pot $0.1 | Rake $0 | Jackpot $0 | Bingo $0 | Fortune $0
Seat 1: 819631cf (button) folded before Flop (didn't bet)
Seat 2: 6dba827f (small blind) folded before Flop
Seat 3: Hero (big blind) collected ($0.1)
Seat 4: 1ef2413 folded before Flop (didn't bet)
Seat 5: a029993d folded before Flop (didn't bet)
Seat 6: 25f73bab folded before Flop (didn't bet)


Poker Hand #RC1433219255: Hold'em No Limit  ($0.05/$0.1) - 2023/03/27 18:21:45
Table 'RushAndCash28144515' 6-max Seat #1 is the button
Seat 1: 6891f83f ($14.66 in chips)
Seat 2: 25b5673d ($12.11 in chips)
Seat 3: 9a8c658e ($7.48 in chips)
Seat 4: 7e36cfc0 ($10.2 in chips)
Seat 5: Hero ($28.05 in chips)
Seat 6: 947b43c2 ($11.28 in chips)
25b5673d: posts small blind $0.05
9a8c658e: posts big blind $0.1
*** HOLE CARDS ***
Dealt to 6891f83f 
Dealt to 25b5673d 
Dealt to 9a8c658e 
Dealt to 7e36cfc0 
Dealt to Hero [Qs 7c]
Dealt to 947b43c2 
7e36cfc0: raises $0.15 to $0.25
Hero: folds
947b43c2: folds
6891f83f: folds
25b5673d: raises $0.72 to $0.97
9a8c658e: folds
7e36cfc0: calls $0.72
*** FLOP *** [6h 2c 5h]
25b5673d: bets $1.64
7e36cfc0: calls $1.64
*** TURN *** [6h 2c 5h] [4d]
25b5673d: bets $9.4
7e36cfc0: folds
Uncalled bet ($9.4) returned to 25b5673d
*** SHOWDOWN ***
25b5673d collected $4.92 from pot
*** SUMMARY ***
Total pot $5.32 | Rake $0.25 | Jackpot $0.15 | Bingo $0 | Fortune $0
Board [6h 2c 5h 4d]
Seat 1: 6891f83f (button) folded before Flop (didn't bet)
Seat 2: 25b5673d (small blind) won ($4.92)
Seat 3: 9a8c658e (big blind) folded before Flop
Seat 4: 7e36cfc0 folded on the Turn
Seat 5: Hero folded before Flop (didn't bet)
Seat 6: 947b43c2 folded before Flop (didn't bet)


Poker Hand #RC1433219195: Hold'em No Limit  ($0.05/$0.1) - 2023/03/27 18:21:37
Table 'RushAndCash28144455' 6-max Seat #1 is the button
Seat 1: Hero ($28.05 in chips)
Seat 2: c1cbc2c2 ($11.29 in chips)
Seat 3: b48a4c0d ($10.7 in chips)
Seat 4: ad917d4c ($10.15 in chips)
Seat 5: c1e76cbc ($11.53 in chips)
Seat 6: 5d3ecf20 ($23.86 in chips)
c1cbc2c2: posts small blind $0.05
b48a4c0d: posts big blind $0.1
*** HOLE CARDS ***
Dealt to Hero [7h Ts]
Dealt to c1cbc2c2 
Dealt to b48a4c0d 
Dealt to ad917d4c 
Dealt to c1e76cbc 
Dealt to 5d3ecf20 
ad917d4c: folds
c1e76cbc: folds
5d3ecf20: folds
Hero: folds
c1cbc2c2: folds
Uncalled bet ($0.05) returned to b48a4c0d
*** SHOWDOWN ***
b48a4c0d collected $0.1 from pot
*** SUMMARY ***
Total pot $0.1 | Rake $0 | Jackpot $0 | Bingo $0 | Fortune $0
Seat 1: Hero (button) folded before Flop (didn't bet)
Seat 2: c1cbc2c2 (small blind) folded before Flop
Seat 3: b48a4c0d (big blind) collected ($0.1)
Seat 4: ad917d4c folded before Flop (didn't bet)
Seat 5: c1e76cbc folded before Flop (didn't bet)
Seat 6: 5d3ecf20 folded before Flop (didn't bet)


Poker Hand #RC1433219156: Hold'em No Limit  ($0.05/$0.1) - 2023/03/27 18:21:33
Table 'RushAndCash28144416' 6-max Seat #1 is the button
Seat 1: 19bab26f ($38.08 in chips)
Seat 2: 5aa8835f ($13.59 in chips)
Seat 3: f88250e1 ($10.42 in chips)
Seat 4: Hero ($28.05 in chips)
Seat 5: 7e36cfc0 ($10.2 in chips)
Seat 6: e88398c4 ($14.73 in chips)
5aa8835f: posts small blind $0.05
f88250e1: posts big blind $0.1
*** HOLE CARDS ***
Dealt to 19bab26f 
Dealt to 5aa8835f 
Dealt to f88250e1 
Dealt to Hero [5c 2d]
Dealt to 7e36cfc0 
Dealt to e88398c4 
Hero: folds
7e36cfc0: folds
e88398c4: folds
19bab26f: folds
5aa8835f: folds
Uncalled bet ($0.05) returned to f88250e1
*** SHOWDOWN ***
f88250e1 collected $0.1 from pot
*** SUMMARY ***
Total pot $0.1 | Rake $0 | Jackpot $0 | Bingo $0 | Fortune $0
Seat 1: 19bab26f (button) folded before Flop (didn't bet)
Seat 2: 5aa8835f (small blind) folded before Flop
Seat 3: f88250e1 (big blind) collected ($0.1)
Seat 4: Hero folded before Flop (didn't bet)
Seat 5: 7e36cfc0 folded before Flop (didn't bet)
Seat 6: e88398c4 folded before Flop (didn't bet)


Poker Hand #RC1433218877: Hold'em No Limit  ($0.05/$0.1) - 2023/03/27 18:20:58
Table 'RushAndCash28144137' 6-max Seat #1 is the button
Seat 1: 492bd702 ($13.21 in chips)
Seat 2: Hero ($27.75 in chips)
Seat 3: f98d6493 ($10.15 in chips)
Seat 4: f031b695 ($12.33 in chips)
Seat 5: a4319f01 ($14.22 in chips)
Seat 6: 2eeaefd9 ($17.8 in chips)
Hero: posts small blind $0.05
f98d6493: posts big blind $0.1
*** HOLE CARDS ***
Dealt to 492bd702 
Dealt to Hero [Ks Kc]
Dealt to f98d6493 
Dealt to f031b695 
Dealt to a4319f01 
Dealt to 2eeaefd9 
f031b695: folds
a4319f01: folds
2eeaefd9: folds
492bd702: raises $0.12 to $0.22
Hero: raises $0.71 to $0.93
f98d6493: folds
492bd702: folds
Uncalled bet ($0.71) returned to Hero
*** SHOWDOWN ***
Hero collected $0.52 from pot
*** SUMMARY ***
Total pot $0.54 | Rake $0.02 | Jackpot $0 | Bingo $0 | Fortune $0
Seat 1: 492bd702 (button) folded before Flop
Seat 2: Hero (small blind) collected ($0.52)
Seat 3: f98d6493 (big blind) folded before Flop
Seat 4: f031b695 folded before Flop (didn't bet)
Seat 5: a4319f01 folded before Flop (didn't bet)
Seat 6: 2eeaefd9 folded before Flop (didn't bet)


Poker Hand #RC1433218834: Hold'em No Limit  ($0.05/$0.1) - 2023/03/27 18:20:54
Table 'RushAndCash28144094' 6-max Seat #1 is the button
Seat 1: Hero ($27.75 in chips)
Seat 2: 66e6c542 ($13.96 in chips)
Seat 3: b084e457 ($5.38 in chips)
Seat 4: 8daee31f ($11.44 in chips)
Seat 5: e6f4a5b9 ($10.72 in chips)
Seat 6: 1c38a6d ($10 in chips)
66e6c542: posts small blind $0.05
b084e457: posts big blind $0.1
*** HOLE CARDS ***
Dealt to Hero [4c Ah]
Dealt to 66e6c542 
Dealt to b084e457 
Dealt to 8daee31f 
Dealt to e6f4a5b9 
Dealt to 1c38a6d 
8daee31f: folds
e6f4a5b9: folds
1c38a6d: folds
Hero: folds
66e6c542: folds
Uncalled bet ($0.05) returned to b084e457
*** SHOWDOWN ***
b084e457 collected $0.1 from pot
*** SUMMARY ***
Total pot $0.1 | Rake $0 | Jackpot $0 | Bingo $0 | Fortune $0
Seat 1: Hero (button) folded before Flop (didn't bet)
Seat 2: 66e6c542 (small blind) folded before Flop
Seat 3: b084e457 (big blind) collected ($0.1)
Seat 4: 8daee31f folded before Flop (didn't bet)
Seat 5: e6f4a5b9 folded before Flop (didn't bet)
Seat 6: 1c38a6d folded before Flop (didn't bet)


Poker Hand #RC1433218777: Hold'em No Limit  ($0.05/$0.1) - 2023/03/27 18:20:48
Table 'RushAndCash28144037' 6-max Seat #1 is the button
Seat 1: fa09b0fd ($10 in chips)
Seat 2: 32d03af5 ($9.36 in chips)
Seat 3: Hero ($27.85 in chips)
Seat 4: f98d6493 ($10.15 in chips)
Seat 5: 35dc15e6 ($23.45 in chips)
Seat 6: b77410f ($10 in chips)
32d03af5: posts small blind $0.05
Hero: posts big blind $0.1
*** HOLE CARDS ***
Dealt to fa09b0fd 
Dealt to 32d03af5 
Dealt to Hero [Qd 2s]
Dealt to f98d6493 
Dealt to 35dc15e6 
Dealt to b77410f 
f98d6493: folds
35dc15e6: folds
b77410f: folds
fa09b0fd: folds
32d03af5: raises $0.2 to $0.3
Hero: folds
Uncalled bet ($0.2) returned to 32d03af5
*** SHOWDOWN ***
32d03af5 collected $0.2 from pot
*** SUMMARY ***
Total pot $0.2 | Rake $0 | Jackpot $0 | Bingo $0 | Fortune $0
Seat 1: fa09b0fd (button) folded before Flop (didn't bet)
Seat 2: 32d03af5 (small blind) collected ($0.2)
Seat 3: Hero (big blind) folded before Flop
Seat 4: f98d6493 folded before Flop (didn't bet)
Seat 5: 35dc15e6 folded before Flop (didn't bet)
Seat 6: b77410f folded before Flop (didn't bet)


Poker Hand #RC1433218735: Hold'em No Limit  ($0.05/$0.1) - 2023/03/27 18:20:44
Table 'RushAndCash28143995' 6-max Seat #1 is the button
Seat 1: 40599498 ($10.22 in chips)
Seat 2: 74b29a97 ($37.52 in chips)
Seat 3: 86bc2e8f ($10.63 in chips)
Seat 4: Hero ($27.85 in chips)
Seat 5: 66ef94b6 ($12.8 in chips)
Seat 6: 7a82bf2 ($36.91 in chips)
74b29a97: posts small blind $0.05
86bc2e8f: posts big blind $0.1
*** HOLE CARDS ***
Dealt to 40599498 
Dealt to 74b29a97 
Dealt to 86bc2e8f 
Dealt to Hero [2d Jc]
Dealt to 66ef94b6 
Dealt to 7a82bf2 
Hero: folds
66ef94b6: raises $0.3 to $0.4
7a82bf2: calls $0.4
40599498: calls $0.4
74b29a97: folds
86bc2e8f: folds
*** FLOP *** [9h 7s 9s]
66ef94b6: bets $0.45
7a82bf2: folds
40599498: calls $0.45
*** TURN *** [9h 7s 9s] [7h]
66ef94b6: checks
40599498: checks
*** RIVER *** [9h 7s 9s 7h] [5s]
66ef94b6: bets $1.69
40599498: calls $1.69
66ef94b6: shows [Qh Qd] (Pair of Queens and Pair of Nines)
40599498: shows [8d 8h] (Pair of Nines and Pair of Eights)
*** SHOWDOWN ***
66ef94b6 collected $5.21 from pot
*** SUMMARY ***
Total pot $5.63 | Rake $0.27 | Jackpot $0.15 | Bingo $0 | Fortune $0
Board [9h 7s 9s 7h 5s]
Seat 1: 40599498 (button) showed [8d 8h] and lost with Pair of Nines and Pair of Eights
Seat 2: 74b29a97 (small blind) folded before Flop
Seat 3: 86bc2e8f (big blind) folded before Flop
Seat 4: Hero folded before Flop (didn't bet)
Seat 5: 66ef94b6 showed [Qh Qd] and won ($5.21) with Pair of Queens and Pair of Nines
Seat 6: 7a82bf2 folded on the Flop


Poker Hand #RC1433218681: Hold'em No Limit  ($0.05/$0.1) - 2023/03/27 18:20:37
Table 'RushAndCash28143941' 6-max Seat #1 is the button
Seat 1: d5cdf349 ($14.81 in chips)
Seat 2: 375ea40e ($11.52 in chips)
Seat 3: c7c40f98 ($29.35 in chips)
Seat 4: Hero ($27.85 in chips)
Seat 5: effd7574 ($39.57 in chips)
Seat 6: e51a3115 ($21.79 in chips)
375ea40e: posts small blind $0.05
c7c40f98: posts big blind $0.1
*** HOLE CARDS ***
Dealt to d5cdf349 
Dealt to 375ea40e 
Dealt to c7c40f98 
Dealt to Hero [3d Jd]
Dealt to effd7574 
Dealt to e51a3115 
Hero: folds
effd7574: folds
e51a3115: folds
d5cdf349: raises $0.15 to $0.25
375ea40e: folds
c7c40f98: calls $0.15
*** FLOP *** [As 9d Ah]
c7c40f98: checks
d5cdf349: checks
*** TURN *** [As 9d Ah] [3c]
c7c40f98: checks
d5cdf349: bets $0.19
c7c40f98: folds
Uncalled bet ($0.19) returned to d5cdf349
*** SHOWDOWN ***
d5cdf349 collected $0.53 from pot
*** SUMMARY ***
Total pot $0.55 | Rake $0.02 | Jackpot $0 | Bingo $0 | Fortune $0
Board [As 9d Ah 3c]
Seat 1: d5cdf349 (button) won ($0.53)
Seat 2: 375ea40e (small blind) folded before Flop
Seat 3: c7c40f98 (big blind) folded on the Turn
Seat 4: Hero folded before Flop (didn't bet)
Seat 5: effd7574 folded before Flop (didn't bet)
Seat 6: e51a3115 folded before Flop (didn't bet)


Poker Hand #RC1433218574: Hold'em No Limit  ($0.05/$0.1) - 2023/03/27 18:20:25
Table 'RushAndCash28143834' 6-max Seat #1 is the button
Seat 1: Hero ($27.85 in chips)
Seat 2: 74aeaadc ($12.36 in chips)
Seat 3: 5174df53 ($10.88 in chips)
Seat 4: 6d9935e3 ($13.36 in chips)
Seat 5: f031b695 ($12.28 in chips)
Seat 6: cebcd22f ($22.66 in chips)
74aeaadc: posts small blind $0.05
5174df53: posts big blind $0.1
*** HOLE CARDS ***
Dealt to Hero [6h Qh]
Dealt to 74aeaadc 
Dealt to 5174df53 
Dealt to 6d9935e3 
Dealt to f031b695 
Dealt to cebcd22f 
6d9935e3: folds
f031b695: folds
cebcd22f: folds
Hero: folds
74aeaadc: folds
Uncalled bet ($0.05) returned to 5174df53
*** SHOWDOWN ***
5174df53 collected $0.1 from pot
*** SUMMARY ***
Total pot $0.1 | Rake $0 | Jackpot $0 | Bingo $0 | Fortune $0
Seat 1: Hero (button) folded before Flop (didn't bet)
Seat 2: 74aeaadc (small blind) folded before Flop
Seat 3: 5174df53 (big blind) collected ($0.1)
Seat 4: 6d9935e3 folded before Flop (didn't bet)
Seat 5: f031b695 folded before Flop (didn't bet)
Seat 6: cebcd22f folded before Flop (didn't bet)


Poker Hand #RC1433218538: Hold'em No Limit  ($0.05/$0.1) - 2023/03/27 18:20:21
Table 'RushAndCash28143798' 6-max Seat #1 is the button
Seat 1: 91fac4db ($14.87 in chips)
Seat 2: Hero ($27.75 in chips)
Seat 3: b77410f ($10 in chips)
Seat 4: bb4dcf9b ($27.58 in chips)
Seat 5: 74aeaadc ($12.36 in chips)
Seat 6: a18501e2 ($12.42 in chips)
Hero: posts small blind $0.05
b77410f: posts big blind $0.1
*** HOLE CARDS ***
Dealt to 91fac4db 
Dealt to Hero [4d Qs]
Dealt to b77410f 
Dealt to bb4dcf9b 
Dealt to 74aeaadc 
Dealt to a18501e2 
bb4dcf9b: raises $0.1 to $0.2
74aeaadc: folds
a18501e2: calls $0.2
91fac4db: folds
Hero: folds
b77410f: folds
*** FLOP *** [Ah Qc 3h]
bb4dcf9b: checks
a18501e2: checks
*** TURN *** [Ah Qc 3h] [9c]
bb4dcf9b: bets $0.3
a18501e2: folds
Uncalled bet ($0.3) returned to bb4dcf9b
*** SHOWDOWN ***
bb4dcf9b collected $0.53 from pot
*** SUMMARY ***
Total pot $0.55 | Rake $0.02 | Jackpot $0 | Bingo $0 | Fortune $0
Board [Ah Qc 3h 9c]
Seat 1: 91fac4db (button) folded before Flop (didn't bet)
Seat 2: Hero (small blind) folded before Flop
Seat 3: b77410f (big blind) folded before Flop
Seat 4: bb4dcf9b won ($0.53)
Seat 5: 74aeaadc folded before Flop (didn't bet)
Seat 6: a18501e2 folded on the Turn


Poker Hand #RC1433218494: Hold'em No Limit  ($0.05/$0.1) - 2023/03/27 18:20:17
Table 'RushAndCash28143754' 6-max Seat #1 is the button
Seat 1: 42db2570 ($10 in chips)
Seat 2: f92a7a14 ($15.92 in chips)
Seat 3: Hero ($27.85 in chips)
Seat 4: 4d2c2eac ($14.76 in chips)
Seat 5: eb24fb36 ($12.8 in chips)
Seat 6: e1e67d9 ($18.69 in chips)
f92a7a14: posts small blind $0.05
Hero: posts big blind $0.1
*** HOLE CARDS ***
Dealt to 42db2570 
Dealt to f92a7a14 
Dealt to Hero [9c 7s]
Dealt to 4d2c2eac 
Dealt to eb24fb36 
Dealt to e1e67d9 
4d2c2eac: folds
eb24fb36: folds
e1e67d9: folds
42db2570: folds
f92a7a14: folds
Uncalled bet ($0.05) returned to Hero
*** SHOWDOWN ***
Hero collected $0.1 from pot
*** SUMMARY ***
Total pot $0.1 | Rake $0 | Jackpot $0 | Bingo $0 | Fortune $0
Seat 1: 42db2570 (button) folded before Flop (didn't bet)
Seat 2: f92a7a14 (small blind) folded before Flop
Seat 3: Hero (big blind) collected ($0.1)
Seat 4: 4d2c2eac folded before Flop (didn't bet)
Seat 5: eb24fb36 folded before Flop (didn't bet)
Seat 6: e1e67d9 folded before Flop (didn't bet)


Poker Hand #RC1433218436: Hold'em No Limit  ($0.05/$0.1) - 2023/03/27 18:20:10
Table 'RushAndCash28143696' 6-max Seat #1 is the button
Seat 1: 928a8131 ($20.84 in chips)
Seat 2: 4cc4a2f3 ($10.92 in chips)
Seat 3: ce3598ea ($7.1 in chips)
Seat 4: 2eeaefd9 ($17.65 in chips)
Seat 5: Hero ($27.85 in chips)
Seat 6: 23dec6a2 ($13.8 in chips)
4cc4a2f3: posts small blind $0.05
ce3598ea: posts big blind $0.1
*** HOLE CARDS ***
Dealt to 928a8131 
Dealt to 4cc4a2f3 
Dealt to ce3598ea 
Dealt to 2eeaefd9 
Dealt to Hero [8c 2c]
Dealt to 23dec6a2 
2eeaefd9: folds
Hero: folds
23dec6a2: folds
928a8131: folds
4cc4a2f3: raises $0.2 to $0.3
ce3598ea: calls $0.2
*** FLOP *** [7s Js Qh]
4cc4a2f3: bets $0.53
ce3598ea: folds
Uncalled bet ($0.53) returned to 4cc4a2f3
*** SHOWDOWN ***
4cc4a2f3 collected $0.57 from pot
*** SUMMARY ***
Total pot $0.6 | Rake $0.03 | Jackpot $0 | Bingo $0 | Fortune $0
Board [7s Js Qh]
Seat 1: 928a8131 (button) folded before Flop (didn't bet)
Seat 2: 4cc4a2f3 (small blind) won ($0.57)
Seat 3: ce3598ea (big blind) folded on the Flop
Seat 4: 2eeaefd9 folded before Flop (didn't bet)
Seat 5: Hero folded before Flop (didn't bet)
Seat 6: 23dec6a2 folded before Flop (didn't bet)


Poker Hand #RC1433218387: Hold'em No Limit  ($0.05/$0.1) - 2023/03/27 18:20:04
Table 'RushAndCash28143647' 6-max Seat #1 is the button
Seat 1: 68daf55d ($10.4 in chips)
Seat 2: ee0f8176 ($19.61 in chips)
Seat 3: 341e7fd1 ($13 in chips)
Seat 4: edbbcb2d ($16.4 in chips)
Seat 5: Hero ($27.85 in chips)
Seat 6: cc9e00b3 ($21.98 in chips)
ee0f8176: posts small blind $0.05
341e7fd1: posts big blind $0.1
*** HOLE CARDS ***
Dealt to 68daf55d 
Dealt to ee0f8176 
Dealt to 341e7fd1 
Dealt to edbbcb2d 
Dealt to Hero [4h 6d]
Dealt to cc9e00b3 
edbbcb2d: folds
Hero: folds
cc9e00b3: folds
68daf55d: folds
ee0f8176: folds
Uncalled bet ($0.05) returned to 341e7fd1
*** SHOWDOWN ***
341e7fd1 collected $0.1 from pot
*** SUMMARY ***
Total pot $0.1 | Rake $0 | Jackpot $0 | Bingo $0 | Fortune $0
Seat 1: 68daf55d (button) folded before Flop (didn't bet)
Seat 2: ee0f8176 (small blind) folded before Flop
Seat 3: 341e7fd1 (big blind) collected ($0.1)
Seat 4: edbbcb2d folded before Flop (didn't bet)
Seat 5: Hero folded before Flop (didn't bet)
Seat 6: cc9e00b3 folded before Flop (didn't bet)


Poker Hand #RC1433218344: Hold'em No Limit  ($0.05/$0.1) - 2023/03/27 18:20:00
Table 'RushAndCash28143604' 6-max Seat #1 is the button
Seat 1: e9259e36 ($9.9 in chips)
Seat 2: 5de9e938 ($10 in chips)
Seat 3: cf224d9 ($10.32 in chips)
Seat 4: Hero ($27.85 in chips)
Seat 5: a9528b53 ($13.33 in chips)
Seat 6: 47b44bb0 ($16.11 in chips)
5de9e938: posts small blind $0.05
cf224d9: posts big blind $0.1
*** HOLE CARDS ***
Dealt to e9259e36 
Dealt to 5de9e938 
Dealt to cf224d9 
Dealt to Hero [5h Jh]
Dealt to a9528b53 
Dealt to 47b44bb0 
Hero: folds
a9528b53: raises $0.12 to $0.22
47b44bb0: folds
e9259e36: folds
5de9e938: folds
cf224d9: folds
Uncalled bet ($0.12) returned to a9528b53
*** SHOWDOWN ***
a9528b53 collected $0.25 from pot
*** SUMMARY ***
Total pot $0.25 | Rake $0 | Jackpot $0 | Bingo $0 | Fortune $0
Seat 1: e9259e36 (button) folded before Flop (didn't bet)
Seat 2: 5de9e938 (small blind) folded before Flop
Seat 3: cf224d9 (big blind) folded before Flop
Seat 4: Hero folded before Flop (didn't bet)
Seat 5: a9528b53 collected ($0.25)
Seat 6: 47b44bb0 folded before Flop (didn't bet)


Poker Hand #RC1433218288: Hold'em No Limit  ($0.05/$0.1) - 2023/03/27 18:19:53
Table 'RushAndCash28143548' 6-max Seat #1 is the button
Seat 1: 61c00c39 ($9.03 in chips)
Seat 2: 32d03af5 ($9.61 in chips)
Seat 3: 1c38a6d ($10 in chips)
Seat 4: Hero ($27.85 in chips)
Seat 5: ddd727bd ($12.75 in chips)
Seat 6: ce5b6a02 ($10.69 in chips)
32d03af5: posts small blind $0.05
1c38a6d: posts big blind $0.1
*** HOLE CARDS ***
Dealt to 61c00c39 
Dealt to 32d03af5 
Dealt to 1c38a6d 
Dealt to Hero [Jc 6s]
Dealt to ddd727bd 
Dealt to ce5b6a02 
Hero: folds
ddd727bd: raises $0.15 to $0.25
ce5b6a02: folds
61c00c39: folds
32d03af5: folds
1c38a6d: folds
Uncalled bet ($0.15) returned to ddd727bd
*** SHOWDOWN ***
ddd727bd collected $0.25 from pot
*** SUMMARY ***
Total pot $0.25 | Rake $0 | Jackpot $0 | Bingo $0 | Fortune $0
Seat 1: 61c00c39 (button) folded before Flop (didn't bet)
Seat 2: 32d03af5 (small blind) folded before Flop
Seat 3: 1c38a6d (big blind) folded before Flop
Seat 4: Hero folded before Flop (didn't bet)
Seat 5: ddd727bd collected ($0.25)
Seat 6: ce5b6a02 folded before Flop (didn't bet)


Poker Hand #RC1433218086: Hold'em No Limit  ($0.05/$0.1) - 2023/03/27 18:19:29
Table 'RushAndCash28143346' 6-max Seat #1 is the button
Seat 1: 73df5e8e ($19.18 in chips)
Seat 2: ce5b6a02 ($10.37 in chips)
Seat 3: 207c229f ($10.34 in chips)
Seat 4: f7b4d343 ($10.15 in chips)
Seat 5: 4cc658cf ($7.8 in chips)
Seat 6: Hero ($28.1 in chips)
ce5b6a02: posts small blind $0.05
207c229f: posts big blind $0.1
*** HOLE CARDS ***
Dealt to 73df5e8e 
Dealt to ce5b6a02 
Dealt to 207c229f 
Dealt to f7b4d343 
Dealt to 4cc658cf 
Dealt to Hero [Kd 8d]
f7b4d343: folds
4cc658cf: folds
Hero: raises $0.15 to $0.25
73df5e8e: folds
ce5b6a02: raises $0.75 to $1
207c229f: folds
Hero: folds
Uncalled bet ($0.75) returned to ce5b6a02
*** SHOWDOWN ***
ce5b6a02 collected $0.57 from pot
*** SUMMARY ***
Total pot $0.6 | Rake $0.03 | Jackpot $0 | Bingo $0 | Fortune $0
Seat 1: 73df5e8e (button) folded before Flop (didn't bet)
Seat 2: ce5b6a02 (small blind) collected ($0.57)
Seat 3: 207c229f (big blind) folded before Flop
Seat 4: f7b4d343 folded before Flop (didn't bet)
Seat 5: 4cc658cf folded before Flop (didn't bet)
Seat 6: Hero folded before Flop


Poker Hand #RC1433217939: Hold'em No Limit  ($0.05/$0.1) - 2023/03/27 18:19:11
Table 'RushAndCash28143199' 6-max Seat #1 is the button
Seat 1: c74e8a84 ($9.51 in chips)
Seat 2: Hero ($28 in chips)
Seat 3: a4319f01 ($15.94 in chips)
Seat 4: 90f63f70 ($11.55 in chips)
Seat 5: 58e76cf2 ($12.06 in chips)
Seat 6: 2bfb9581 ($9.42 in chips)
Hero: posts small blind $0.05
a4319f01: posts big blind $0.1
*** HOLE CARDS ***
Dealt to c74e8a84 
Dealt to Hero [4s As]
Dealt to a4319f01 
Dealt to 90f63f70 
Dealt to 58e76cf2 
Dealt to 2bfb9581 
90f63f70: folds
58e76cf2: folds
2bfb9581: folds
c74e8a84: folds
Hero: raises $0.2 to $0.3
a4319f01: folds
Uncalled bet ($0.2) returned to Hero
*** SHOWDOWN ***
Hero collected $0.2 from pot
*** SUMMARY ***
Total pot $0.2 | Rake $0 | Jackpot $0 | Bingo $0 | Fortune $0
Seat 1: c74e8a84 (button) folded before Flop (didn't bet)
Seat 2: Hero (small blind) collected ($0.2)
Seat 3: a4319f01 (big blind) folded before Flop
Seat 4: 90f63f70 folded before Flop (didn't bet)
Seat 5: 58e76cf2 folded before Flop (didn't bet)
Seat 6: 2bfb9581 folded before Flop (didn't bet)


Poker Hand #RC1433176239: Hold'em No Limit  ($0.05/$0.1) - 2023/03/27 17:56:12
Table 'RushAndCash28131499' 6-max Seat #1 is the button
Seat 1: 5b06e1bc ($14.87 in chips)
Seat 2: 42ab78a ($34.9 in chips)
Seat 3: Hero ($17.26 in chips)
Seat 4: c0cda744 ($10 in chips)
Seat 5: 54ffc667 ($11.14 in chips)
Seat 6: 39254f48 ($14.06 in chips)
42ab78a: posts small blind $0.05
Hero: posts big blind $0.1
*** HOLE CARDS ***
Dealt to 5b06e1bc 
Dealt to 42ab78a 
Dealt to Hero [Ks Ac]
Dealt to c0cda744 
Dealt to 54ffc667 
Dealt to 39254f48 
c0cda744: folds
54ffc667: raises $0.1 to $0.2
39254f48: folds
5b06e1bc: folds
42ab78a: folds
Hero: raises $0.6 to $0.8
54ffc667: calls $0.6
*** FLOP *** [5s 9s Ts]
Hero: bets $0.83
54ffc667: calls $0.83
*** TURN *** [5s 9s Ts] [Js]
Hero: checks
54ffc667: checks
*** RIVER *** [5s 9s Ts Js] [5d]
Hero: bets $1.66
54ffc667: raises $7.85 to $9.51 and is all-in
Hero: calls $7.85
54ffc667: shows [Jd Qd] (Pair of Jacks and Pair of Fives)
Hero: shows [Ks Ac] (King High Flush)
*** SHOWDOWN ***
Hero collected $21.88 from pot
*** SUMMARY ***
Total pot $22.33 | Rake $0.3 | Jackpot $0.15 | Bingo $0 | Fortune $0
Board [5s 9s Ts Js 5d]
Seat 1: 5b06e1bc (button) folded before Flop (didn't bet)
Seat 2: 42ab78a (small blind) folded before Flop
Seat 3: Hero (big blind) showed [Ks Ac] and won ($21.88) with King High Flush
Seat 4: c0cda744 folded before Flop (didn't bet)
Seat 5: 54ffc667 showed [Jd Qd] and lost with Pair of Jacks and Pair of Fives
Seat 6: 39254f48 folded before Flop (didn't bet)


Poker Hand #RC1433176200: Hold'em No Limit  ($0.05/$0.1) - 2023/03/27 17:56:07
Table 'RushAndCash28131460' 6-max Seat #1 is the button
Seat 1: Hero ($17.26 in chips)
Seat 2: aad8733a ($10 in chips)
Seat 3: 6d395697 ($9.82 in chips)
Seat 4: 6c78e848 ($5.25 in chips)
Seat 5: e88c8126 ($11.4 in chips)
Seat 6: 74aeaadc ($11.76 in chips)
aad8733a: posts small blind $0.05
6d395697: posts big blind $0.1
*** HOLE CARDS ***
Dealt to Hero [Ks 7h]
Dealt to aad8733a 
Dealt to 6d395697 
Dealt to 6c78e848 
Dealt to e88c8126 
Dealt to 74aeaadc 
6c78e848: folds
e88c8126: raises $0.15 to $0.25
74aeaadc: raises $0.49 to $0.74
Hero: folds
aad8733a: folds
6d395697: folds
e88c8126: raises $1.36 to $2.1
74aeaadc: calls $1.36
*** FLOP *** [Qs 3s 8s]
e88c8126: bets $1.35
74aeaadc: folds
Uncalled bet ($1.35) returned to e88c8126
*** SHOWDOWN ***
e88c8126 collected $3.99 from pot
*** SUMMARY ***
Total pot $4.35 | Rake $0.21 | Jackpot $0.15 | Bingo $0 | Fortune $0
Board [Qs 3s 8s]
Seat 1: Hero (button) folded before Flop (didn't bet)
Seat 2: aad8733a (small blind) folded before Flop
Seat 3: 6d395697 (big blind) folded before Flop
Seat 4: 6c78e848 folded before Flop (didn't bet)
Seat 5: e88c8126 won ($3.99)
Seat 6: 74aeaadc folded on the Flop


Poker Hand #RC1433176098: Hold'em No Limit  ($0.05/$0.1) - 2023/03/27 17:55:56
Table 'RushAndCash28131358' 6-max Seat #1 is the button
Seat 1: 71eea5bb ($7.66 in chips)
Seat 2: 81b34ae ($14.6 in chips)
Seat 3: 8cc96d93 ($12.96 in chips)
Seat 4: c20fb006 ($28.78 in chips)
Seat 5: Hero ($17.11 in chips)
Seat 6: 29bd2bd8 ($36.29 in chips)
81b34ae: posts small blind $0.05
8cc96d93: posts big blind $0.1
*** HOLE CARDS ***
Dealt to 71eea5bb 
Dealt to 81b34ae 
Dealt to 8cc96d93 
Dealt to c20fb006 
Dealt to Hero [Ts Qs]
Dealt to 29bd2bd8 
c20fb006: folds
Hero: raises $0.15 to $0.25
29bd2bd8: folds
71eea5bb: folds
81b34ae: folds
8cc96d93: folds
Uncalled bet ($0.15) returned to Hero
*** SHOWDOWN ***
Hero collected $0.25 from pot
*** SUMMARY ***
Total pot $0.25 | Rake $0 | Jackpot $0 | Bingo $0 | Fortune $0
Seat 1: 71eea5bb (button) folded before Flop (didn't bet)
Seat 2: 81b34ae (small blind) folded before Flop
Seat 3: 8cc96d93 (big blind) folded before Flop
Seat 4: c20fb006 folded before Flop (didn't bet)
Seat 5: Hero collected ($0.25)
Seat 6: 29bd2bd8 folded before Flop (didn't bet)


Poker Hand #RC1433176058: Hold'em No Limit  ($0.05/$0.1) - 2023/03/27 17:55:51
Table 'RushAndCash28131318' 6-max Seat #1 is the button
Seat 1: 57b58395 ($17.69 in chips)
Seat 2: 4dc2c775 ($11.12 in chips)
Seat 3: eecb8ec7 ($10 in chips)
Seat 4: 88441121 ($10.25 in chips)
Seat 5: Hero ($17.11 in chips)
Seat 6: 931ff56 ($7.81 in chips)
4dc2c775: posts small blind $0.05
eecb8ec7: posts big blind $0.1
*** HOLE CARDS ***
Dealt to 57b58395 
Dealt to 4dc2c775 
Dealt to eecb8ec7 
Dealt to 88441121 
Dealt to Hero [2c 4d]
Dealt to 931ff56 
88441121: folds
Hero: folds
931ff56: folds
57b58395: folds
4dc2c775: raises $0.2 to $0.3
eecb8ec7: calls $0.2
*** FLOP *** [Td Ks 5h]
4dc2c775: bets $0.75
eecb8ec7: folds
Uncalled bet ($0.75) returned to 4dc2c775
*** SHOWDOWN ***
4dc2c775 collected $0.57 from pot
*** SUMMARY ***
Total pot $0.6 | Rake $0.03 | Jackpot $0 | Bingo $0 | Fortune $0
Board [Td Ks 5h]
Seat 1: 57b58395 (button) folded before Flop (didn't bet)
Seat 2: 4dc2c775 (small blind) won ($0.57)
Seat 3: eecb8ec7 (big blind) folded on the Flop
Seat 4: 88441121 folded before Flop (didn't bet)
Seat 5: Hero folded before Flop (didn't bet)
Seat 6: 931ff56 folded before Flop (didn't bet)


Poker Hand #RC1433175759: Hold'em No Limit  ($0.05/$0.1) - 2023/03/27 17:55:18
Table 'RushAndCash28131019' 6-max Seat #1 is the button
Seat 1: 36216ab ($10.3 in chips)
Seat 2: Hero ($16.64 in chips)
Seat 3: ff0e64c3 ($17.75 in chips)
Seat 4: 2571688c ($10 in chips)
Seat 5: f92a7a14 ($20.71 in chips)
Seat 6: 980ed466 ($10.2 in chips)
Hero: posts small blind $0.05
ff0e64c3: posts big blind $0.1
*** HOLE CARDS ***
Dealt to 36216ab 
Dealt to Hero [As Qs]
Dealt to ff0e64c3 
Dealt to 2571688c 
Dealt to f92a7a14 
Dealt to 980ed466 
2571688c: folds
f92a7a14: folds
980ed466: folds
36216ab: raises $0.15 to $0.25
Hero: raises $0.75 to $1
ff0e64c3: folds
36216ab: folds
Uncalled bet ($0.75) returned to Hero
*** SHOWDOWN ***
Hero collected $0.57 from pot
*** SUMMARY ***
Total pot $0.6 | Rake $0.03 | Jackpot $0 | Bingo $0 | Fortune $0
Seat 1: 36216ab (button) folded before Flop
Seat 2: Hero (small blind) collected ($0.57)
Seat 3: ff0e64c3 (big blind) folded before Flop
Seat 4: 2571688c folded before Flop (didn't bet)
Seat 5: f92a7a14 folded before Flop (didn't bet)
Seat 6: 980ed466 folded before Flop (didn't bet)


Poker Hand #RC1433175726: Hold'em No Limit  ($0.05/$0.1) - 2023/03/27 17:55:15
Table 'RushAndCash28130986' 6-max Seat #1 is the button
Seat 1: d56d903d ($10.08 in chips)
Seat 2: 35dc15e6 ($10 in chips)
Seat 3: 9354db4d ($13.65 in chips)
Seat 4: b347eb60 ($10.32 in chips)
Seat 5: Hero ($16.64 in chips)
Seat 6: 6891f83f ($10 in chips)
35dc15e6: posts small blind $0.05
9354db4d: posts big blind $0.1
*** HOLE CARDS ***
Dealt to d56d903d 
Dealt to 35dc15e6 
Dealt to 9354db4d 
Dealt to b347eb60 
Dealt to Hero [3c 2d]
Dealt to 6891f83f 
b347eb60: folds
Hero: folds
6891f83f: folds
d56d903d: folds
35dc15e6: folds
Uncalled bet ($0.05) returned to 9354db4d
*** SHOWDOWN ***
9354db4d collected $0.1 from pot
*** SUMMARY ***
Total pot $0.1 | Rake $0 | Jackpot $0 | Bingo $0 | Fortune $0
Seat 1: d56d903d (button) folded before Flop (didn't bet)
Seat 2: 35dc15e6 (small blind) folded before Flop
Seat 3: 9354db4d (big blind) collected ($0.1)
Seat 4: b347eb60 folded before Flop (didn't bet)
Seat 5: Hero folded before Flop (didn't bet)
Seat 6: 6891f83f folded before Flop (didn't bet)


Poker Hand #RC1433175662: Hold'em No Limit  ($0.05/$0.1) - 2023/03/27 17:55:08
Table 'RushAndCash28130922' 6-max Seat #1 is the button
Seat 1: dea12a41 ($7.38 in chips)
Seat 2: 43194f47 ($10.2 in chips)
Seat 3: Hero ($16.74 in chips)
Seat 4: cabd6397 ($10 in chips)
Seat 5: 53b27a3b ($10.05 in chips)
Seat 6: bab3fbdd ($10.8 in chips)
43194f47: posts small blind $0.05
Hero: posts big blind $0.1
*** HOLE CARDS ***
Dealt to dea12a41 
Dealt to 43194f47 
Dealt to Hero [Jh 2c]
Dealt to cabd6397 
Dealt to 53b27a3b 
Dealt to bab3fbdd 
cabd6397: folds
53b27a3b: folds
bab3fbdd: folds
dea12a41: folds
43194f47: folds
Uncalled bet ($0.05) returned to Hero
*** SHOWDOWN ***
Hero collected $0.1 from pot
*** SUMMARY ***
Total pot $0.1 | Rake $0 | Jackpot $0 | Bingo $0 | Fortune $0
Seat 1: dea12a41 (button) folded before Flop (didn't bet)
Seat 2: 43194f47 (small blind) folded before Flop
Seat 3: Hero (big blind) collected ($0.1)
Seat 4: cabd6397 folded before Flop (didn't bet)
Seat 5: 53b27a3b folded before Flop (didn't bet)
Seat 6: bab3fbdd folded before Flop (didn't bet)


Poker Hand #RC1433175606: Hold'em No Limit  ($0.05/$0.1) - 2023/03/27 17:55:02
Table 'RushAndCash28130866' 6-max Seat #1 is the button
Seat 1: Hero ($16.74 in chips)
Seat 2: b95c5a94 ($12.18 in chips)
Seat 3: f2fbc5c6 ($10 in chips)
Seat 4: 2ea7aaad ($13.24 in chips)
Seat 5: e48b4e93 ($22.4 in chips)
Seat 6: be66a3a4 ($27.65 in chips)
b95c5a94: posts small blind $0.05
f2fbc5c6: posts big blind $0.1
*** HOLE CARDS ***
Dealt to Hero [5d 7s]
Dealt to b95c5a94 
Dealt to f2fbc5c6 
Dealt to 2ea7aaad 
Dealt to e48b4e93 
Dealt to be66a3a4 
2ea7aaad: folds
e48b4e93: folds
be66a3a4: raises $0.11 to $0.21
Hero: folds
b95c5a94: folds
f2fbc5c6: folds
Uncalled bet ($0.11) returned to be66a3a4
*** SHOWDOWN ***
be66a3a4 collected $0.25 from pot
*** SUMMARY ***
Total pot $0.25 | Rake $0 | Jackpot $0 | Bingo $0 | Fortune $0
Seat 1: Hero (button) folded before Flop (didn't bet)
Seat 2: b95c5a94 (small blind) folded before Flop
Seat 3: f2fbc5c6 (big blind) folded before Flop
Seat 4: 2ea7aaad folded before Flop (didn't bet)
Seat 5: e48b4e93 folded before Flop (didn't bet)
Seat 6: be66a3a4 collected ($0.25)


Poker Hand #RC1433175537: Hold'em No Limit  ($0.05/$0.1) - 2023/03/27 17:54:54
Table 'RushAndCash28130797' 6-max Seat #1 is the button
Seat 1: 4c00ad42 ($10 in chips)
Seat 2: f339aff1 ($11.61 in chips)
Seat 3: e6fdf44d ($8.95 in chips)
Seat 4: 42cff9c ($10.56 in chips)
Seat 5: 55975109 ($26.2 in chips)
Seat 6: Hero ($16.74 in chips)
f339aff1: posts small blind $0.05
e6fdf44d: posts big blind $0.1
*** HOLE CARDS ***
Dealt to 4c00ad42 
Dealt to f339aff1 
Dealt to e6fdf44d 
Dealt to 42cff9c 
Dealt to 55975109 
Dealt to Hero [Th 3c]
42cff9c: folds
55975109: raises $0.15 to $0.25
Hero: folds
4c00ad42: folds
f339aff1: folds
e6fdf44d: folds
Uncalled bet ($0.15) returned to 55975109
*** SHOWDOWN ***
55975109 collected $0.25 from pot
*** SUMMARY ***
Total pot $0.25 | Rake $0 | Jackpot $0 | Bingo $0 | Fortune $0
Seat 1: 4c00ad42 (button) folded before Flop (didn't bet)
Seat 2: f339aff1 (small blind) folded before Flop
Seat 3: e6fdf44d (big blind) folded before Flop
Seat 4: 42cff9c folded before Flop (didn't bet)
Seat 5: 55975109 collected ($0.25)
Seat 6: Hero folded before Flop (didn't bet)


Poker Hand #RC1433175501: Hold'em No Limit  ($0.05/$0.1) - 2023/03/27 17:54:50
Table 'RushAndCash28130761' 6-max Seat #1 is the button
Seat 1: 5570e924 ($15.89 in chips)
Seat 2: 6ad74666 ($11.79 in chips)
Seat 3: Hero ($16.84 in chips)
Seat 4: 51b0d0e2 ($22.71 in chips)
Seat 5: 32f38d69 ($9.95 in chips)
Seat 6: 3facd135 ($10.15 in chips)
6ad74666: posts small blind $0.05
Hero: posts big blind $0.1
*** HOLE CARDS ***
Dealt to 5570e924 
Dealt to 6ad74666 
Dealt to Hero [3h Jh]
Dealt to 51b0d0e2 
Dealt to 32f38d69 
Dealt to 3facd135 
51b0d0e2: folds
32f38d69: folds
3facd135: folds
5570e924: raises $0.15 to $0.25
6ad74666: folds
Hero: folds
Uncalled bet ($0.15) returned to 5570e924
*** SHOWDOWN ***
5570e924 collected $0.25 from pot
*** SUMMARY ***
Total pot $0.25 | Rake $0 | Jackpot $0 | Bingo $0 | Fortune $0
Seat 1: 5570e924 (button) collected ($0.25)
Seat 2: 6ad74666 (small blind) folded before Flop
Seat 3: Hero (big blind) folded before Flop
Seat 4: 51b0d0e2 folded before Flop (didn't bet)
Seat 5: 32f38d69 folded before Flop (didn't bet)
Seat 6: 3facd135 folded before Flop (didn't bet)


Poker Hand #RC1433175467: Hold'em No Limit  ($0.05/$0.1) - 2023/03/27 17:54:46
Table 'RushAndCash28130727' 6-max Seat #1 is the button
Seat 1: f7b4d343 ($20.09 in chips)
Seat 2: Hero ($16.89 in chips)
Seat 3: 965688bc ($21.56 in chips)
Seat 4: 47a87bfb ($23.72 in chips)
Seat 5: 32d5bd3a ($11.8 in chips)
Seat 6: d336af97 ($14.42 in chips)
Hero: posts small blind $0.05
965688bc: posts big blind $0.1
*** HOLE CARDS ***
Dealt to f7b4d343 
Dealt to Hero [5c 7d]
Dealt to 965688bc 
Dealt to 47a87bfb 
Dealt to 32d5bd3a 
Dealt to d336af97 
47a87bfb: folds
32d5bd3a: raises $0.15 to $0.25
d336af97: folds
f7b4d343: folds
Hero: folds
965688bc: folds
Uncalled bet ($0.15) returned to 32d5bd3a
*** SHOWDOWN ***
32d5bd3a collected $0.25 from pot
*** SUMMARY ***
Total pot $0.25 | Rake $0 | Jackpot $0 | Bingo $0 | Fortune $0
Seat 1: f7b4d343 (button) folded before Flop (didn't bet)
Seat 2: Hero (small blind) folded before Flop
Seat 3: 965688bc (big blind) folded before Flop
Seat 4: 47a87bfb folded before Flop (didn't bet)
Seat 5: 32d5bd3a collected ($0.25)
Seat 6: d336af97 folded before Flop (didn't bet)


Poker Hand #RC1433175107: Hold'em No Limit  ($0.05/$0.1) - 2023/03/27 17:54:07
Table 'RushAndCash28130367' 6-max Seat #1 is the button
Seat 1: 39254f48 ($13.21 in chips)
Seat 2: 74f93df ($10.05 in chips)
Seat 3: 5a244e55 ($13.63 in chips)
Seat 4: 58069cc9 ($10 in chips)
Seat 5: Hero ($16.02 in chips)
Seat 6: 68df9e8 ($10.49 in chips)
74f93df: posts small blind $0.05
5a244e55: posts big blind $0.1
*** HOLE CARDS ***
Dealt to 39254f48 
Dealt to 74f93df 
Dealt to 5a244e55 
Dealt to 58069cc9 
Dealt to Hero [Qh Qc]
Dealt to 68df9e8 
58069cc9: folds
Hero: raises $0.15 to $0.25
68df9e8: raises $0.55 to $0.8
39254f48: folds
74f93df: folds
5a244e55: folds
Hero: raises $1.35 to $2.15
68df9e8: folds
Uncalled bet ($1.35) returned to Hero
*** SHOWDOWN ***
Hero collected $1.67 from pot
*** SUMMARY ***
Total pot $1.75 | Rake $0.08 | Jackpot $0 | Bingo $0 | Fortune $0
Seat 1: 39254f48 (button) folded before Flop (didn't bet)
Seat 2: 74f93df (small blind) folded before Flop
Seat 3: 5a244e55 (big blind) folded before Flop
Seat 4: 58069cc9 folded before Flop (didn't bet)
Seat 5: Hero collected ($1.67)
Seat 6: 68df9e8 folded before Flop


Poker Hand #RC1433175020: Hold'em No Limit  ($0.05/$0.1) - 2023/03/27 17:53:57
Table 'RushAndCash28130280' 6-max Seat #1 is the button
Seat 1: Hero ($16.02 in chips)
Seat 2: 23baaa67 ($10.58 in chips)
Seat 3: c30d67aa ($10.95 in chips)
Seat 4: c8f4c42c ($7.66 in chips)
Seat 5: b2858157 ($18.64 in chips)
Seat 6: 68764012 ($10.61 in chips)
23baaa67: posts small blind $0.05
c30d67aa: posts big blind $0.1
*** HOLE CARDS ***
Dealt to Hero [7h 2h]
Dealt to 23baaa67 
Dealt to c30d67aa 
Dealt to c8f4c42c 
Dealt to b2858157 
Dealt to 68764012 
c8f4c42c: folds
b2858157: folds
68764012: folds
Hero: folds
23baaa67: raises $0.2 to $0.3
c30d67aa: calls $0.2
*** FLOP *** [2d 4h Ad]
23baaa67: checks
c30d67aa: bets $0.3
23baaa67: folds
Uncalled bet ($0.3) returned to c30d67aa
*** SHOWDOWN ***
c30d67aa collected $0.57 from pot
*** SUMMARY ***
Total pot $0.6 | Rake $0.03 | Jackpot $0 | Bingo $0 | Fortune $0
Board [2d 4h Ad]
Seat 1: Hero (button) folded before Flop (didn't bet)
Seat 2: 23baaa67 (small blind) folded on the Flop
Seat 3: c30d67aa (big blind) won ($0.57)
Seat 4: c8f4c42c folded before Flop (didn't bet)
Seat 5: b2858157 folded before Flop (didn't bet)
Seat 6: 68764012 folded before Flop (didn't bet)


Poker Hand #RC1433174924: Hold'em No Limit  ($0.05/$0.1) - 2023/03/27 17:53:46
Table 'RushAndCash28130184' 6-max Seat #1 is the button
Seat 1: 3512847a ($10.81 in chips)
Seat 2: Hero ($16.07 in chips)
Seat 3: e88c8126 ($12.8 in chips)
Seat 4: f09c363f ($10.86 in chips)
Seat 5: 35dc15e6 ($10.83 in chips)
Seat 6: e86420e9 ($10.48 in chips)
Hero: posts small blind $0.05
e88c8126: posts big blind $0.1
*** HOLE CARDS ***
Dealt to 3512847a 
Dealt to Hero [Qs 3h]
Dealt to e88c8126 
Dealt to f09c363f 
Dealt to 35dc15e6 
Dealt to e86420e9 
f09c363f: folds
35dc15e6: folds
e86420e9: folds
3512847a: folds
Hero: folds
Uncalled bet ($0.05) returned to e88c8126
*** SHOWDOWN ***
e88c8126 collected $0.1 from pot
*** SUMMARY ***
Total pot $0.1 | Rake $0 | Jackpot $0 | Bingo $0 | Fortune $0
Seat 1: 3512847a (button) folded before Flop (didn't bet)
Seat 2: Hero (small blind) folded before Flop
Seat 3: e88c8126 (big blind) collected ($0.1)
Seat 4: f09c363f folded before Flop (didn't bet)
Seat 5: 35dc15e6 folded before Flop (didn't bet)
Seat 6: e86420e9 folded before Flop (didn't bet)


Poker Hand #RC1433174884: Hold'em No Limit  ($0.05/$0.1) - 2023/03/27 17:53:42
Table 'RushAndCash28130144' 6-max Seat #1 is the button
Seat 1: f4d7bf00 ($5.63 in chips)
Seat 2: 81f25d0a ($10.91 in chips)
Seat 3: e6fdf44d ($10 in chips)
Seat 4: 2bfb9581 ($10.7 in chips)
Seat 5: d28c992e ($11.28 in chips)
Seat 6: Hero ($16.07 in chips)
81f25d0a: posts small blind $0.05
e6fdf44d: posts big blind $0.1
*** HOLE CARDS ***
Dealt to f4d7bf00 
Dealt to 81f25d0a 
Dealt to e6fdf44d 
Dealt to 2bfb9581 
Dealt to d28c992e 
Dealt to Hero [Qc 3d]
2bfb9581: folds
d28c992e: folds
Hero: folds
f4d7bf00: folds
81f25d0a: raises $0.2 to $0.3
e6fdf44d: calls $0.2
*** FLOP *** [9c Jc 5h]
81f25d0a: bets $0.2
e6fdf44d: calls $0.2
*** TURN *** [9c Jc 5h] [8c]
81f25d0a: checks
e6fdf44d: bets $0.5
81f25d0a: calls $0.5
*** RIVER *** [9c Jc 5h 8c] [2s]
81f25d0a: checks
e6fdf44d: checks
81f25d0a: shows [Ts 9d] (Pair of Nines)
e6fdf44d: shows [3h 4h] (Jack-High)
*** SHOWDOWN ***
81f25d0a collected $1.9 from pot
*** SUMMARY ***
Total pot $2 | Rake $0.1 | Jackpot $0 | Bingo $0 | Fortune $0
Board [9c Jc 5h 8c 2s]
Seat 1: f4d7bf00 (button) folded before Flop (didn't bet)
Seat 2: 81f25d0a (small blind) showed [Ts 9d] and won ($1.9) with Pair of Nines
Seat 3: e6fdf44d (big blind) showed [3h 4h] and lost with Jack-High
Seat 4: 2bfb9581 folded before Flop (didn't bet)
Seat 5: d28c992e folded before Flop (didn't bet)
Seat 6: Hero folded before Flop (didn't bet)


Poker Hand #RC1433174791: Hold'em No Limit  ($0.05/$0.1) - 2023/03/27 17:53:32
Table 'RushAndCash28130051' 6-max Seat #1 is the button
Seat 1: 702ccf8c ($16.42 in chips)
Seat 2: f88b0115 ($9.78 in chips)
Seat 3: 81f25d0a ($11.01 in chips)
Seat 4: Hero ($16.07 in chips)
Seat 5: d299f891 ($3.95 in chips)
Seat 6: 46ea30a ($10.54 in chips)
f88b0115: posts small blind $0.05
81f25d0a: posts big blind $0.1
*** HOLE CARDS ***
Dealt to 702ccf8c 
Dealt to f88b0115 
Dealt to 81f25d0a 
Dealt to Hero [9s 2d]
Dealt to d299f891 
Dealt to 46ea30a 
Hero: folds
d299f891: folds
46ea30a: folds
702ccf8c: folds
f88b0115: raises $0.1 to $0.2
81f25d0a: folds
Uncalled bet ($0.1) returned to f88b0115
*** SHOWDOWN ***
f88b0115 collected $0.2 from pot
*** SUMMARY ***
Total pot $0.2 | Rake $0 | Jackpot $0 | Bingo $0 | Fortune $0
Seat 1: 702ccf8c (button) folded before Flop (didn't bet)
Seat 2: f88b0115 (small blind) collected ($0.2)
Seat 3: 81f25d0a (big blind) folded before Flop
Seat 4: Hero folded before Flop (didn't bet)
Seat 5: d299f891 folded before Flop (didn't bet)
Seat 6: 46ea30a folded before Flop (didn't bet)


Poker Hand #RC1433134499: Hold'em No Limit  ($0.05/$0.1) - 2023/03/27 17:53:00
Table 'RushAndCash28129759' 6-max Seat #1 is the button
Seat 1: 29ca6eb4 ($10.9 in chips)
Seat 2: 411dad88 ($10.46 in chips)
Seat 3: b95c5a94 ($12.06 in chips)
Seat 4: 81f25d0a ($10.15 in chips)
Seat 5: 341053d6 ($37.93 in chips)
Seat 6: Hero ($16.86 in chips)
411dad88: posts small blind $0.05
b95c5a94: posts big blind $0.1
*** HOLE CARDS ***
Dealt to 29ca6eb4 
Dealt to 411dad88 
Dealt to b95c5a94 
Dealt to 81f25d0a 
Dealt to 341053d6 
Dealt to Hero [Qh Ah]
81f25d0a: raises $0.15 to $0.25
341053d6: folds
Hero: raises $0.54 to $0.79
29ca6eb4: folds
411dad88: folds
b95c5a94: folds
81f25d0a: raises $1.51 to $2.3
Hero: folds
Uncalled bet ($1.51) returned to 81f25d0a
*** SHOWDOWN ***
81f25d0a collected $1.65 from pot
*** SUMMARY ***
Total pot $1.73 | Rake $0.08 | Jackpot $0 | Bingo $0 | Fortune $0
Seat 1: 29ca6eb4 (button) folded before Flop (didn't bet)
Seat 2: 411dad88 (small blind) folded before Flop
Seat 3: b95c5a94 (big blind) folded before Flop
Seat 4: 81f25d0a collected ($1.65)
Seat 5: 341053d6 folded before Flop (didn't bet)
Seat 6: Hero folded before Flop


Poker Hand #RC1433134449: Hold'em No Limit  ($0.05/$0.1) - 2023/03/27 17:52:54
Table 'RushAndCash28129709' 6-max Seat #1 is the button
Seat 1: a4319f01 ($15.08 in chips)
Seat 2: bd10ae58 ($14.11 in chips)
Seat 3: 1164692a ($14.27 in chips)
Seat 4: 905cc229 ($11.26 in chips)
Seat 5: Hero ($16.86 in chips)
Seat 6: c7b34af4 ($11.47 in chips)
bd10ae58: posts small blind $0.05
1164692a: posts big blind $0.1
*** HOLE CARDS ***
Dealt to a4319f01 
Dealt to bd10ae58 
Dealt to 1164692a 
Dealt to 905cc229 
Dealt to Hero [Qc 4d]
Dealt to c7b34af4 
905cc229: folds
Hero: folds
c7b34af4: folds
a4319f01: folds
bd10ae58: folds
Uncalled bet ($0.05) returned to 1164692a
*** SHOWDOWN ***
1164692a collected $0.1 from pot
*** SUMMARY ***
Total pot $0.1 | Rake $0 | Jackpot $0 | Bingo $0 | Fortune $0
Seat 1: a4319f01 (button) folded before Flop (didn't bet)
Seat 2: bd10ae58 (small blind) folded before Flop
Seat 3: 1164692a (big blind) collected ($0.1)
Seat 4: 905cc229 folded before Flop (didn't bet)
Seat 5: Hero folded before Flop (didn't bet)
Seat 6: c7b34af4 folded before Flop (didn't bet)


Poker Hand #RC1433134412: Hold'em No Limit  ($0.05/$0.1) - 2023/03/27 17:52:50
Table 'RushAndCash28129672' 6-max Seat #1 is the button
Seat 1: Hero ($16.86 in chips)
Seat 2: 73a81be2 ($12.69 in chips)
Seat 3: 9577b869 ($11.65 in chips)
Seat 4: ead60f34 ($16.65 in chips)
Seat 5: ca40a3e7 ($12.27 in chips)
Seat 6: 87ba4b09 ($9 in chips)
73a81be2: posts small blind $0.05
9577b869: posts big blind $0.1
*** HOLE CARDS ***
Dealt to Hero [2d Td]
Dealt to 73a81be2 
Dealt to 9577b869 
Dealt to ead60f34 
Dealt to ca40a3e7 
Dealt to 87ba4b09 
ead60f34: folds
ca40a3e7: raises $0.15 to $0.25
87ba4b09: calls $0.25
Hero: folds
73a81be2: folds
9577b869: folds
*** FLOP *** [9c Jh Kd]
ca40a3e7: checks
87ba4b09: checks
*** TURN *** [9c Jh Kd] [7s]
ca40a3e7: checks
87ba4b09: checks
*** RIVER *** [9c Jh Kd 7s] [8d]
ca40a3e7: checks
87ba4b09: checks
ca40a3e7: shows [7c Ac] (Pair of Sevens)
87ba4b09: shows [8s 9s] (Pair of Nines and Pair of Eights)
*** SHOWDOWN ***
87ba4b09 collected $0.62 from pot
*** SUMMARY ***
Total pot $0.65 | Rake $0.03 | Jackpot $0 | Bingo $0 | Fortune $0
Board [9c Jh Kd 7s 8d]
Seat 1: Hero (button) folded before Flop (didn't bet)
Seat 2: 73a81be2 (small blind) folded before Flop
Seat 3: 9577b869 (big blind) folded before Flop
Seat 4: ead60f34 folded before Flop (didn't bet)
Seat 5: ca40a3e7 showed [7c Ac] and lost with Pair of Sevens
Seat 6: 87ba4b09 showed [8s 9s] and won ($0.62) with Pair of Nines and Pair of Eights


Poker Hand #RC1433134155: Hold'em No Limit  ($0.05/$0.1) - 2023/03/27 17:52:18
Table 'RushAndCash28129415' 6-max Seat #1 is the button
Seat 1: be7a93ef ($10 in chips)
Seat 2: 6d395697 ($10.15 in chips)
Seat 3: Hero ($16.58 in chips)
Seat 4: 656b40d8 ($11.85 in chips)
Seat 5: 8b6521f4 ($16.19 in chips)
Seat 6: 5d498a4c ($10 in chips)
6d395697: posts small blind $0.05
Hero: posts big blind $0.1
*** HOLE CARDS ***
Dealt to be7a93ef 
Dealt to 6d395697 
Dealt to Hero [Th Ks]
Dealt to 656b40d8 
Dealt to 8b6521f4 
Dealt to 5d498a4c 
656b40d8: folds
8b6521f4: folds
5d498a4c: folds
be7a93ef: raises $0.15 to $0.25
6d395697: folds
Hero: calls $0.15
*** FLOP *** [Jh 5h 8h]
Hero: bets $0.28
be7a93ef: folds
Uncalled bet ($0.28) returned to Hero
*** SHOWDOWN ***
Hero collected $0.53 from pot
*** SUMMARY ***
Total pot $0.55 | Rake $0.02 | Jackpot $0 | Bingo $0 | Fortune $0
Board [Jh 5h 8h]
Seat 1: be7a93ef (button) folded on the Flop
Seat 2: 6d395697 (small blind) folded before Flop
Seat 3: Hero (big blind) won ($0.53)
Seat 4: 656b40d8 folded before Flop (didn't bet)
Seat 5: 8b6521f4 folded before Flop (didn't bet)
Seat 6: 5d498a4c folded before Flop (didn't bet)


Poker Hand #RC1433134115: Hold'em No Limit  ($0.05/$0.1) - 2023/03/27 17:52:13
Table 'RushAndCash28129375' 6-max Seat #1 is the button
Seat 1: 8dca8fda ($10.56 in chips)
Seat 2: 1bfc0c36 ($11.77 in chips)
Seat 3: 361a9d1e ($10 in chips)
Seat 4: 1a5a0ac4 ($10.06 in chips)
Seat 5: Hero ($16.58 in chips)
Seat 6: c3bde2ae ($37.35 in chips)
1bfc0c36: posts small blind $0.05
361a9d1e: posts big blind $0.1
*** HOLE CARDS ***
Dealt to 8dca8fda 
Dealt to 1bfc0c36 
Dealt to 361a9d1e 
Dealt to 1a5a0ac4 
Dealt to Hero [6s Jd]
Dealt to c3bde2ae 
1a5a0ac4: raises $0.12 to $0.22
Hero: folds
c3bde2ae: folds
8dca8fda: folds
1bfc0c36: folds
361a9d1e: folds
Uncalled bet ($0.12) returned to 1a5a0ac4
*** SHOWDOWN ***
1a5a0ac4 collected $0.25 from pot
*** SUMMARY ***
Total pot $0.25 | Rake $0 | Jackpot $0 | Bingo $0 | Fortune $0
Seat 1: 8dca8fda (button) folded before Flop (didn't bet)
Seat 2: 1bfc0c36 (small blind) folded before Flop
Seat 3: 361a9d1e (big blind) folded before Flop
Seat 4: 1a5a0ac4 collected ($0.25)
Seat 5: Hero folded before Flop (didn't bet)
Seat 6: c3bde2ae folded before Flop (didn't bet)


Poker Hand #RC1433134082: Hold'em No Limit  ($0.05/$0.1) - 2023/03/27 17:52:10
Table 'RushAndCash28129342' 6-max Seat #1 is the button
Seat 1: 5f0f3415 ($18.37 in chips)
Seat 2: Hero ($16.63 in chips)
Seat 3: 36216ab ($10.87 in chips)
Seat 4: f0bd7b9f ($9.6 in chips)
Seat 5: 25b884e3 ($11.62 in chips)
Seat 6: 294ff24a ($13.23 in chips)
Hero: posts small blind $0.05
36216ab: posts big blind $0.1
*** HOLE CARDS ***
Dealt to 5f0f3415 
Dealt to Hero [6s Th]
Dealt to 36216ab 
Dealt to f0bd7b9f 
Dealt to 25b884e3 
Dealt to 294ff24a 
f0bd7b9f: folds
25b884e3: raises $0.15 to $0.25
294ff24a: folds
5f0f3415: folds
Hero: folds
36216ab: folds
Uncalled bet ($0.15) returned to 25b884e3
*** SHOWDOWN ***
25b884e3 collected $0.25 from pot
*** SUMMARY ***
Total pot $0.25 | Rake $0 | Jackpot $0 | Bingo $0 | Fortune $0
Seat 1: 5f0f3415 (button) folded before Flop (didn't bet)
Seat 2: Hero (small blind) folded before Flop
Seat 3: 36216ab (big blind) folded before Flop
Seat 4: f0bd7b9f folded before Flop (didn't bet)
Seat 5: 25b884e3 collected ($0.25)
Seat 6: 294ff24a folded before Flop (didn't bet)


Poker Hand #RC1433134027: Hold'em No Limit  ($0.05/$0.1) - 2023/03/27 17:52:04
Table 'RushAndCash28129287' 6-max Seat #1 is the button
Seat 1: 8ac32706 ($6.63 in chips)
Seat 2: 17414218 ($10.82 in chips)
Seat 3: af13cca4 ($4.5 in chips)
Seat 4: d8be016b ($12.57 in chips)
Seat 5: Hero ($16.63 in chips)
Seat 6: 93df6bb4 ($21.48 in chips)
17414218: posts small blind $0.05
af13cca4: posts big blind $0.1
*** HOLE CARDS ***
Dealt to 8ac32706 
Dealt to 17414218 
Dealt to af13cca4 
Dealt to d8be016b 
Dealt to Hero [2d 3c]
Dealt to 93df6bb4 
d8be016b: folds
Hero: folds
93df6bb4: folds
8ac32706: folds
17414218: folds
Uncalled bet ($0.05) returned to af13cca4
*** SHOWDOWN ***
af13cca4 collected $0.1 from pot
*** SUMMARY ***
Total pot $0.1 | Rake $0 | Jackpot $0 | Bingo $0 | Fortune $0
Seat 1: 8ac32706 (button) folded before Flop (didn't bet)
Seat 2: 17414218 (small blind) folded before Flop
Seat 3: af13cca4 (big blind) collected ($0.1)
Seat 4: d8be016b folded before Flop (didn't bet)
Seat 5: Hero folded before Flop (didn't bet)
Seat 6: 93df6bb4 folded before Flop (didn't bet)


Poker Hand #RC1433133930: Hold'em No Limit  ($0.05/$0.1) - 2023/03/27 17:51:53
Table 'RushAndCash28129190' 6-max Seat #1 is the button
Seat 1: 897f9a4 ($9.53 in chips)
Seat 2: 9577b869 ($11.7 in chips)
Seat 3: Hero ($16.73 in chips)
Seat 4: 37c28f74 ($24.14 in chips)
Seat 5: 4cc658cf ($12.04 in chips)
Seat 6: 3b976095 ($41.14 in chips)
9577b869: posts small blind $0.05
Hero: posts big blind $0.1
*** HOLE CARDS ***
Dealt to 897f9a4 
Dealt to 9577b869 
Dealt to Hero [8c 4d]
Dealt to 37c28f74 
Dealt to 4cc658cf 
Dealt to 3b976095 
37c28f74: raises $0.15 to $0.25
4cc658cf: folds
3b976095: folds
897f9a4: raises $0.6 to $0.85
9577b869: folds
Hero: folds
37c28f74: calls $0.6
*** FLOP *** [8s 8d Jd]
37c28f74: checks
897f9a4: checks
*** TURN *** [8s 8d Jd] [Jh]
37c28f74: bets $0.93
897f9a4: calls $0.93
*** RIVER *** [8s 8d Jd Jh] [6c]
37c28f74: bets $3.9
897f9a4: folds
Uncalled bet ($3.9) returned to 37c28f74
*** SHOWDOWN ***
37c28f74 collected $3.39 from pot
*** SUMMARY ***
Total pot $3.71 | Rake $0.17 | Jackpot $0.15 | Bingo $0 | Fortune $0
Board [8s 8d Jd Jh 6c]
Seat 1: 897f9a4 (button) folded on the River
Seat 2: 9577b869 (small blind) folded before Flop
Seat 3: Hero (big blind) folded before Flop
Seat 4: 37c28f74 won ($3.39)
Seat 5: 4cc658cf folded before Flop (didn't bet)
Seat 6: 3b976095 folded before Flop (didn't bet)


Poker Hand #RC1433133882: Hold'em No Limit  ($0.05/$0.1) - 2023/03/27 17:51:47
Table 'RushAndCash28129142' 6-max Seat #1 is the button
Seat 1: 768361a2 ($9.95 in chips)
Seat 2: 6ed9ee3c ($4.99 in chips)
Seat 3: d9ab3b7 ($8.85 in chips)
Seat 4: 528b986a ($4.99 in chips)
Seat 5: Hero ($16.73 in chips)
Seat 6: 6386b260 ($10.72 in chips)
6ed9ee3c: posts small blind $0.05
d9ab3b7: posts big blind $0.1
*** HOLE CARDS ***
Dealt to 768361a2 
Dealt to 6ed9ee3c 
Dealt to d9ab3b7 
Dealt to 528b986a 
Dealt to Hero [8s 6h]
Dealt to 6386b260 
528b986a: folds
Hero: folds
6386b260: folds
768361a2: raises $0.15 to $0.25
6ed9ee3c: folds
d9ab3b7: folds
Uncalled bet ($0.15) returned to 768361a2
*** SHOWDOWN ***
768361a2 collected $0.25 from pot
*** SUMMARY ***
Total pot $0.25 | Rake $0 | Jackpot $0 | Bingo $0 | Fortune $0
Seat 1: 768361a2 (button) collected ($0.25)
Seat 2: 6ed9ee3c (small blind) folded before Flop
Seat 3: d9ab3b7 (big blind) folded before Flop
Seat 4: 528b986a folded before Flop (didn't bet)
Seat 5: Hero folded before Flop (didn't bet)
Seat 6: 6386b260 folded before Flop (didn't bet)


Poker Hand #RC1433133732: Hold'em No Limit  ($0.05/$0.1) - 2023/03/27 17:51:30
Table 'RushAndCash28128992' 6-max Seat #1 is the button
Seat 1: Hero ($16.58 in chips)
Seat 2: 7c5641ca ($10.05 in chips)
Seat 3: cbd5f4f9 ($11.73 in chips)
Seat 4: e11cfd5e ($24.26 in chips)
Seat 5: 1c767002 ($10.3 in chips)
Seat 6: 7c707199 ($4.98 in chips)
7c5641ca: posts small blind $0.05
cbd5f4f9: posts big blind $0.1
*** HOLE CARDS ***
Dealt to Hero [Ks Jh]
Dealt to 7c5641ca 
Dealt to cbd5f4f9 
Dealt to e11cfd5e 
Dealt to 1c767002 
Dealt to 7c707199 
e11cfd5e: folds
1c767002: folds
7c707199: folds
Hero: raises $0.15 to $0.25
7c5641ca: folds
cbd5f4f9: folds
Uncalled bet ($0.15) returned to Hero
*** SHOWDOWN ***
Hero collected $0.25 from pot
*** SUMMARY ***
Total pot $0.25 | Rake $0 | Jackpot $0 | Bingo $0 | Fortune $0
Seat 1: Hero (button) collected ($0.25)
Seat 2: 7c5641ca (small blind) folded before Flop
Seat 3: cbd5f4f9 (big blind) folded before Flop
Seat 4: e11cfd5e folded before Flop (didn't bet)
Seat 5: 1c767002 folded before Flop (didn't bet)
Seat 6: 7c707199 folded before Flop (didn't bet)


Poker Hand #RC1433133672: Hold'em No Limit  ($0.05/$0.1) - 2023/03/27 17:51:24
Table 'RushAndCash28128932' 6-max Seat #1 is the button
Seat 1: 35dc15e6 ($10.71 in chips)
Seat 2: 768361a2 ($9.95 in chips)
Seat 3: 1eb31ab3 ($4.54 in chips)
Seat 4: 4865703f ($26.43 in chips)
Seat 5: Hero ($16.58 in chips)
Seat 6: ebfa8cda ($36.7 in chips)
768361a2: posts small blind $0.05
1eb31ab3: posts big blind $0.1
*** HOLE CARDS ***
Dealt to 35dc15e6 
Dealt to 768361a2 
Dealt to 1eb31ab3 
Dealt to 4865703f 
Dealt to Hero [Kc 6d]
Dealt to ebfa8cda 
4865703f: folds
Hero: folds
ebfa8cda: raises $0.15 to $0.25
35dc15e6: folds
768361a2: folds
1eb31ab3: calls $0.15
*** FLOP *** [Tc Jd 9s]
1eb31ab3: checks
ebfa8cda: bets $0.28
1eb31ab3: folds
Uncalled bet ($0.28) returned to ebfa8cda
*** SHOWDOWN ***
ebfa8cda collected $0.53 from pot
*** SUMMARY ***
Total pot $0.55 | Rake $0.02 | Jackpot $0 | Bingo $0 | Fortune $0
Board [Tc Jd 9s]
Seat 1: 35dc15e6 (button) folded before Flop (didn't bet)
Seat 2: 768361a2 (small blind) folded before Flop
Seat 3: 1eb31ab3 (big blind) folded on the Flop
Seat 4: 4865703f folded before Flop (didn't bet)
Seat 5: Hero folded before Flop (didn't bet)
Seat 6: ebfa8cda won ($0.53)


Poker Hand #RC1433133599: Hold'em No Limit  ($0.05/$0.1) - 2023/03/27 17:51:15
Table 'RushAndCash28128859' 6-max Seat #1 is the button
Seat 1: 17470a0e ($10.13 in chips)
Seat 2: 8947f368 ($11.73 in chips)
Seat 3: 937b740 ($60.19 in chips)
Seat 4: 6c1c848d ($10.21 in chips)
Seat 5: Hero ($16.58 in chips)
Seat 6: e3929a8d ($22.5 in chips)
8947f368: posts small blind $0.05
937b740: posts big blind $0.1
*** HOLE CARDS ***
Dealt to 17470a0e 
Dealt to 8947f368 
Dealt to 937b740 
Dealt to 6c1c848d 
Dealt to Hero [4h 7s]
Dealt to e3929a8d 
6c1c848d: raises $0.13 to $0.23
Hero: folds
e3929a8d: folds
17470a0e: folds
8947f368: calls $0.18
937b740: calls $0.13
*** FLOP *** [Qs 5s 8d]
8947f368: checks
937b740: checks
6c1c848d: bets $0.52
8947f368: raises $0.98 to $1.5
937b740: folds
6c1c848d: calls $0.98
*** TURN *** [Qs 5s 8d] [7d]
8947f368: bets $2.2
6c1c848d: calls $2.2
*** RIVER *** [Qs 5s 8d 7d] [Qh]
8947f368: bets $7.8 and is all-in
6c1c848d: calls $6.28 and is all-in
Uncalled bet ($1.52) returned to 8947f368
8947f368: shows [8s 8c] (Eights Full over Queens)
6c1c848d: shows [Qc Ac] (Three Queens)
*** SHOWDOWN ***
8947f368 collected $20.2 from pot
*** SUMMARY ***
Total pot $20.65 | Rake $0.3 | Jackpot $0.15 | Bingo $0 | Fortune $0
Board [Qs 5s 8d 7d Qh]
Seat 1: 17470a0e (button) folded before Flop (didn't bet)
Seat 2: 8947f368 (small blind) showed [8s 8c] and won ($20.2) with Eights Full over Queens
Seat 3: 937b740 (big blind) folded on the Flop
Seat 4: 6c1c848d showed [Qc Ac] and lost with Three Queens
Seat 5: Hero folded before Flop (didn't bet)
Seat 6: e3929a8d folded before Flop (didn't bet)


Poker Hand #RC1433133500: Hold'em No Limit  ($0.05/$0.1) - 2023/03/27 17:51:04
Table 'RushAndCash28128760' 6-max Seat #1 is the button
Seat 1: f73707ab ($12.47 in chips)
Seat 2: Hero ($16.63 in chips)
Seat 3: 7eba02ca ($10 in chips)
Seat 4: 919ea81e ($4.97 in chips)
Seat 5: e88398c4 ($10.51 in chips)
Seat 6: 1501b457 ($18 in chips)
Hero: posts small blind $0.05
7eba02ca: posts big blind $0.1
*** HOLE CARDS ***
Dealt to f73707ab 
Dealt to Hero [Js 5d]
Dealt to 7eba02ca 
Dealt to 919ea81e 
Dealt to e88398c4 
Dealt to 1501b457 
919ea81e: raises $0.2 to $0.3
e88398c4: folds
1501b457: raises $0.6 to $0.9
f73707ab: folds
Hero: folds
7eba02ca: folds
919ea81e: folds
Uncalled bet ($0.6) returned to 1501b457
*** SHOWDOWN ***
1501b457 collected $0.72 from pot
*** SUMMARY ***
Total pot $0.75 | Rake $0.03 | Jackpot $0 | Bingo $0 | Fortune $0
Seat 1: f73707ab (button) folded before Flop (didn't bet)
Seat 2: Hero (small blind) folded before Flop
Seat 3: 7eba02ca (big blind) folded before Flop
Seat 4: 919ea81e folded before Flop
Seat 5: e88398c4 folded before Flop (didn't bet)
Seat 6: 1501b457 collected ($0.72)


Poker Hand #RC1433132989: Hold'em No Limit  ($0.05/$0.1) - 2023/03/27 17:50:03
Table 'RushAndCash28128249' 6-max Seat #1 is the button
Seat 1: Hero ($16.04 in chips)
Seat 2: 919ea81e ($5.52 in chips)
Seat 3: bf98819d ($11.42 in chips)
Seat 4: 1e54a29e ($12.35 in chips)
Seat 5: aa5ba7d2 ($15.78 in chips)
Seat 6: 1c6559ab ($12.33 in chips)
919ea81e: posts small blind $0.05
bf98819d: posts big blind $0.1
*** HOLE CARDS ***
Dealt to Hero [Td Qh]
Dealt to 919ea81e 
Dealt to bf98819d 
Dealt to 1e54a29e 
Dealt to aa5ba7d2 
Dealt to 1c6559ab 
1e54a29e: folds
aa5ba7d2: folds
1c6559ab: folds
Hero: raises $0.15 to $0.25
919ea81e: calls $0.2
bf98819d: folds
*** FLOP *** [2c Qd 8h]
919ea81e: checks
Hero: bets $0.3
919ea81e: calls $0.3
*** TURN *** [2c Qd 8h] [4h]
919ea81e: checks
Hero: bets $0.6
919ea81e: folds
Uncalled bet ($0.6) returned to Hero
*** SHOWDOWN ***
Hero collected $1.14 from pot
*** SUMMARY ***
Total pot $1.2 | Rake $0.06 | Jackpot $0 | Bingo $0 | Fortune $0
Board [2c Qd 8h 4h]
Seat 1: Hero (button) won ($1.14)
Seat 2: 919ea81e (small blind) folded on the Turn
Seat 3: bf98819d (big blind) folded before Flop
Seat 4: 1e54a29e folded before Flop (didn't bet)
Seat 5: aa5ba7d2 folded before Flop (didn't bet)
Seat 6: 1c6559ab folded before Flop (didn't bet)


Poker Hand #RC1433132896: Hold'em No Limit  ($0.05/$0.1) - 2023/03/27 17:49:52
Table 'RushAndCash28128156' 6-max Seat #1 is the button
Seat 1: 4aed5ffa ($10.29 in chips)
Seat 2: 5b91610e ($14.59 in chips)
Seat 3: Hero ($15.99 in chips)
Seat 4: 40d98fa9 ($12.25 in chips)
Seat 5: 3facd135 ($9.85 in chips)
Seat 6: 2b301960 ($10 in chips)
5b91610e: posts small blind $0.05
Hero: posts big blind $0.1
*** HOLE CARDS ***
Dealt to 4aed5ffa 
Dealt to 5b91610e 
Dealt to Hero [2c Qd]
Dealt to 40d98fa9 
Dealt to 3facd135 
Dealt to 2b301960 
40d98fa9: folds
3facd135: folds
2b301960: folds
4aed5ffa: folds
5b91610e: folds
Uncalled bet ($0.05) returned to Hero
*** SHOWDOWN ***
Hero collected $0.1 from pot
*** SUMMARY ***
Total pot $0.1 | Rake $0 | Jackpot $0 | Bingo $0 | Fortune $0
Seat 1: 4aed5ffa (button) folded before Flop (didn't bet)
Seat 2: 5b91610e (small blind) folded before Flop
Seat 3: Hero (big blind) collected ($0.1)
Seat 4: 40d98fa9 folded before Flop (didn't bet)
Seat 5: 3facd135 folded before Flop (didn't bet)
Seat 6: 2b301960 folded before Flop (didn't bet)


Poker Hand #RC1433132766: Hold'em No Limit  ($0.05/$0.1) - 2023/03/27 17:49:38
Table 'RushAndCash28128026' 6-max Seat #1 is the button
Seat 1: 2dcca2ff ($20.81 in chips)
Seat 2: dea12a41 ($7.14 in chips)
Seat 3: 8297795f ($9.26 in chips)
Seat 4: 5d3ecf20 ($23.71 in chips)
Seat 5: Hero ($15.84 in chips)
Seat 6: 77c2df7d ($10.76 in chips)
dea12a41: posts small blind $0.05
8297795f: posts big blind $0.1
*** HOLE CARDS ***
Dealt to 2dcca2ff 
Dealt to dea12a41 
Dealt to 8297795f 
Dealt to 5d3ecf20 
Dealt to Hero [Ah Tc]
Dealt to 77c2df7d 
5d3ecf20: folds
Hero: raises $0.15 to $0.25
77c2df7d: folds
2dcca2ff: folds
dea12a41: folds
8297795f: folds
Uncalled bet ($0.15) returned to Hero
*** SHOWDOWN ***
Hero collected $0.25 from pot
*** SUMMARY ***
Total pot $0.25 | Rake $0 | Jackpot $0 | Bingo $0 | Fortune $0
Seat 1: 2dcca2ff (button) folded before Flop (didn't bet)
Seat 2: dea12a41 (small blind) folded before Flop
Seat 3: 8297795f (big blind) folded before Flop
Seat 4: 5d3ecf20 folded before Flop (didn't bet)
Seat 5: Hero collected ($0.25)
Seat 6: 77c2df7d folded before Flop (didn't bet)


Poker Hand #RC1433132733: Hold'em No Limit  ($0.05/$0.1) - 2023/03/27 17:49:34
Table 'RushAndCash28127993' 6-max Seat #1 is the button
Seat 1: 4271d829 ($20.22 in chips)
Seat 2: Hero ($15.89 in chips)
Seat 3: 23baaa67 ($14.54 in chips)
Seat 4: 1501b457 ($19.3 in chips)
Seat 5: cab27a75 ($8.22 in chips)
Seat 6: cc9e00b3 ($10.53 in chips)
Hero: posts small blind $0.05
23baaa67: posts big blind $0.1
*** HOLE CARDS ***
Dealt to 4271d829 
Dealt to Hero [7h 2s]
Dealt to 23baaa67 
Dealt to 1501b457 
Dealt to cab27a75 
Dealt to cc9e00b3 
1501b457: folds
cab27a75: folds
cc9e00b3: folds
4271d829: folds
Hero: folds
Uncalled bet ($0.05) returned to 23baaa67
*** SHOWDOWN ***
23baaa67 collected $0.1 from pot
*** SUMMARY ***
Total pot $0.1 | Rake $0 | Jackpot $0 | Bingo $0 | Fortune $0
Seat 1: 4271d829 (button) folded before Flop (didn't bet)
Seat 2: Hero (small blind) folded before Flop
Seat 3: 23baaa67 (big blind) collected ($0.1)
Seat 4: 1501b457 folded before Flop (didn't bet)
Seat 5: cab27a75 folded before Flop (didn't bet)
Seat 6: cc9e00b3 folded before Flop (didn't bet)


Poker Hand #RC1433132698: Hold'em No Limit  ($0.05/$0.1) - 2023/03/27 17:49:31
Table 'RushAndCash28127958' 6-max Seat #1 is the button
Seat 1: 768361a2 ($10.41 in chips)
Seat 2: 40376670 ($10.88 in chips)
Seat 3: 62ee250e ($3.4 in chips)
Seat 4: Hero ($15.89 in chips)
Seat 5: 72bff1a ($13.75 in chips)
Seat 6: cc9e00b3 ($10.53 in chips)
40376670: posts small blind $0.05
62ee250e: posts big blind $0.1
*** HOLE CARDS ***
Dealt to 768361a2 
Dealt to 40376670 
Dealt to 62ee250e 
Dealt to Hero [Ac 3d]
Dealt to 72bff1a 
Dealt to cc9e00b3 
Hero: folds
72bff1a: raises $0.1 to $0.2
cc9e00b3: folds
768361a2: folds
40376670: folds
62ee250e: folds
Uncalled bet ($0.1) returned to 72bff1a
*** SHOWDOWN ***
72bff1a collected $0.25 from pot
*** SUMMARY ***
Total pot $0.25 | Rake $0 | Jackpot $0 | Bingo $0 | Fortune $0
Seat 1: 768361a2 (button) folded before Flop (didn't bet)
Seat 2: 40376670 (small blind) folded before Flop
Seat 3: 62ee250e (big blind) folded before Flop
Seat 4: Hero folded before Flop (didn't bet)
Seat 5: 72bff1a collected ($0.25)
Seat 6: cc9e00b3 folded before Flop (didn't bet)


Poker Hand #RC1433132592: Hold'em No Limit  ($0.05/$0.1) - 2023/03/27 17:49:19
Table 'RushAndCash28127852' 6-max Seat #1 is the button
Seat 1: 26faa500 ($26.77 in chips)
Seat 2: f1fcc540 ($10.5 in chips)
Seat 3: Hero ($15.99 in chips)
Seat 4: 8494623e ($14.77 in chips)
Seat 5: c7c40f98 ($16.04 in chips)
Seat 6: cc12cdb9 ($10.15 in chips)
f1fcc540: posts small blind $0.05
Hero: posts big blind $0.1
*** HOLE CARDS ***
Dealt to 26faa500 
Dealt to f1fcc540 
Dealt to Hero [Jh 4h]
Dealt to 8494623e 
Dealt to c7c40f98 
Dealt to cc12cdb9 
8494623e: folds
c7c40f98: folds
cc12cdb9: raises $0.15 to $0.25
26faa500: folds
f1fcc540: folds
Hero: folds
Uncalled bet ($0.15) returned to cc12cdb9
*** SHOWDOWN ***
cc12cdb9 collected $0.25 from pot
*** SUMMARY ***
Total pot $0.25 | Rake $0 | Jackpot $0 | Bingo $0 | Fortune $0
Seat 1: 26faa500 (button) folded before Flop (didn't bet)
Seat 2: f1fcc540 (small blind) folded before Flop
Seat 3: Hero (big blind) folded before Flop
Seat 4: 8494623e folded before Flop (didn't bet)
Seat 5: c7c40f98 folded before Flop (didn't bet)
Seat 6: cc12cdb9 collected ($0.25)


Poker Hand #RC1433132543: Hold'em No Limit  ($0.05/$0.1) - 2023/03/27 17:49:14
Table 'RushAndCash28127803' 6-max Seat #1 is the button
Seat 1: c200a9e4 ($14.51 in chips)
Seat 2: 756cc0eb ($16.34 in chips)
Seat 3: 967fa10d ($12.58 in chips)
Seat 4: 9577b869 ($11.77 in chips)
Seat 5: 4c0fb4a0 ($22.12 in chips)
Seat 6: Hero ($15.99 in chips)
756cc0eb: posts small blind $0.05
967fa10d: posts big blind $0.1
*** HOLE CARDS ***
Dealt to c200a9e4 
Dealt to 756cc0eb 
Dealt to 967fa10d 
Dealt to 9577b869 
Dealt to 4c0fb4a0 
Dealt to Hero [9c 3c]
9577b869: folds
4c0fb4a0: folds
Hero: folds
c200a9e4: folds
756cc0eb: raises $0.2 to $0.3
967fa10d: folds
Uncalled bet ($0.2) returned to 756cc0eb
*** SHOWDOWN ***
756cc0eb collected $0.2 from pot
*** SUMMARY ***
Total pot $0.2 | Rake $0 | Jackpot $0 | Bingo $0 | Fortune $0
Seat 1: c200a9e4 (button) folded before Flop (didn't bet)
Seat 2: 756cc0eb (small blind) collected ($0.2)
Seat 3: 967fa10d (big blind) folded before Flop
Seat 4: 9577b869 folded before Flop (didn't bet)
Seat 5: 4c0fb4a0 folded before Flop (didn't bet)
Seat 6: Hero folded before Flop (didn't bet)


Poker Hand #RC1433132016: Hold'em No Limit  ($0.05/$0.1) - 2023/03/27 17:48:13
Table 'RushAndCash28127276' 6-max Seat #1 is the button
Seat 1: 72bff1a ($13.24 in chips)
Seat 2: 38a579e9 ($15.77 in chips)
Seat 3: 2e819afe ($10.16 in chips)
Seat 4: Hero ($15.84 in chips)
Seat 5: 42db2570 ($10 in chips)
Seat 6: dc097dc1 ($20.9 in chips)
38a579e9: posts small blind $0.05
2e819afe: posts big blind $0.1
*** HOLE CARDS ***
Dealt to 72bff1a 
Dealt to 38a579e9 
Dealt to 2e819afe 
Dealt to Hero [5d 5c]
Dealt to 42db2570 
Dealt to dc097dc1 
Hero: raises $0.15 to $0.25
42db2570: folds
dc097dc1: folds
72bff1a: folds
38a579e9: folds
2e819afe: folds
Uncalled bet ($0.15) returned to Hero
*** SHOWDOWN ***
Hero collected $0.25 from pot
*** SUMMARY ***
Total pot $0.25 | Rake $0 | Jackpot $0 | Bingo $0 | Fortune $0
Seat 1: 72bff1a (button) folded before Flop (didn't bet)
Seat 2: 38a579e9 (small blind) folded before Flop
Seat 3: 2e819afe (big blind) folded before Flop
Seat 4: Hero collected ($0.25)
Seat 5: 42db2570 folded before Flop (didn't bet)
Seat 6: dc097dc1 folded before Flop (didn't bet)


Poker Hand #RC1433131944: Hold'em No Limit  ($0.05/$0.1) - 2023/03/27 17:48:05
Table 'RushAndCash28127204' 6-max Seat #1 is the button
Seat 1: Hero ($15.84 in chips)
Seat 2: c28b191d ($10 in chips)
Seat 3: 2b301960 ($10 in chips)
Seat 4: d72b2e64 ($9.69 in chips)
Seat 5: bd0c9e13 ($11.61 in chips)
Seat 6: 8b6521f4 ($15.95 in chips)
c28b191d: posts small blind $0.05
2b301960: posts big blind $0.1
*** HOLE CARDS ***
Dealt to Hero [5c 2d]
Dealt to c28b191d 
Dealt to 2b301960 
Dealt to d72b2e64 
Dealt to bd0c9e13 
Dealt to 8b6521f4 
d72b2e64: raises $0.1 to $0.2
bd0c9e13: raises $0.5 to $0.7
8b6521f4: folds
Hero: folds
c28b191d: folds
2b301960: folds
d72b2e64: folds
Uncalled bet ($0.5) returned to bd0c9e13
*** SHOWDOWN ***
bd0c9e13 collected $0.53 from pot
*** SUMMARY ***
Total pot $0.55 | Rake $0.02 | Jackpot $0 | Bingo $0 | Fortune $0
Seat 1: Hero (button) folded before Flop (didn't bet)
Seat 2: c28b191d (small blind) folded before Flop
Seat 3: 2b301960 (big blind) folded before Flop
Seat 4: d72b2e64 folded before Flop
Seat 5: bd0c9e13 collected ($0.53)
Seat 6: 8b6521f4 folded before Flop (didn't bet)


Poker Hand #RC1433131889: Hold'em No Limit  ($0.05/$0.1) - 2023/03/27 17:47:59
Table 'RushAndCash28127149' 6-max Seat #1 is the button
Seat 1: e8d2edfb ($9.99 in chips)
Seat 2: 286b15b5 ($21.59 in chips)
Seat 3: 59a09a3b ($10.62 in chips)
Seat 4: 91126514 ($2.77 in chips)
Seat 5: Hero ($15.84 in chips)
Seat 6: 2358adf ($70.32 in chips)
286b15b5: posts small blind $0.05
59a09a3b: posts big blind $0.1
*** HOLE CARDS ***
Dealt to e8d2edfb 
Dealt to 286b15b5 
Dealt to 59a09a3b 
Dealt to 91126514 
Dealt to Hero [5h 7s]
Dealt to 2358adf 
91126514: raises $0.1 to $0.2
Hero: folds
2358adf: folds
e8d2edfb: folds
286b15b5: folds
59a09a3b: calls $0.1
*** FLOP *** [6d 3s Tc]
59a09a3b: checks
91126514: bets $0.15
59a09a3b: folds
Uncalled bet ($0.15) returned to 91126514
*** SHOWDOWN ***
91126514 collected $0.43 from pot
*** SUMMARY ***
Total pot $0.45 | Rake $0.02 | Jackpot $0 | Bingo $0 | Fortune $0
Board [6d 3s Tc]
Seat 1: e8d2edfb (button) folded before Flop (didn't bet)
Seat 2: 286b15b5 (small blind) folded before Flop
Seat 3: 59a09a3b (big blind) folded on the Flop
Seat 4: 91126514 won ($0.43)
Seat 5: Hero folded before Flop (didn't bet)
Seat 6: 2358adf folded before Flop (didn't bet)


Poker Hand #RC1433130484: Hold'em No Limit  ($0.05/$0.1) - 2023/03/27 17:45:20
Table 'RushAndCash28125744' 6-max Seat #1 is the button
Seat 1: a29e312f ($11.97 in chips)
Seat 2: 5c8be07b ($17.29 in chips)
Seat 3: Hero ($11.44 in chips)
Seat 4: 3d17b963 ($11.02 in chips)
Seat 5: e1e67d9 ($10.17 in chips)
Seat 6: f129c72 ($11.06 in chips)
5c8be07b: posts small blind $0.05
Hero: posts big blind $0.1
*** HOLE CARDS ***
Dealt to a29e312f 
Dealt to 5c8be07b 
Dealt to Hero [Js Ks]
Dealt to 3d17b963 
Dealt to e1e67d9 
Dealt to f129c72 
3d17b963: folds
e1e67d9: raises $0.15 to $0.25
f129c72: folds
a29e312f: raises $0.22 to $0.47
5c8be07b: folds
Hero: raises $0.63 to $1.1
e1e67d9: folds
a29e312f: calls $0.63
*** FLOP *** [Ts 6h 3s]
Hero: bets $1.25
a29e312f: calls $1.25
*** TURN *** [Ts 6h 3s] [6s]
Hero: bets $2.2
a29e312f: calls $2.2
*** RIVER *** [Ts 6h 3s 6s] [Th]
Hero: bets $4.25
a29e312f: folds
Uncalled bet ($4.25) returned to Hero
*** SHOWDOWN ***
Hero collected $8.95 from pot
*** SUMMARY ***
Total pot $9.4 | Rake $0.3 | Jackpot $0.15 | Bingo $0 | Fortune $0
Board [Ts 6h 3s 6s Th]
Seat 1: a29e312f (button) folded on the River
Seat 2: 5c8be07b (small blind) folded before Flop
Seat 3: Hero (big blind) won ($8.95)
Seat 4: 3d17b963 folded before Flop (didn't bet)
Seat 5: e1e67d9 folded before Flop
Seat 6: f129c72 folded before Flop (didn't bet)


Poker Hand #RC1433129950: Hold'em No Limit  ($0.05/$0.1) - 2023/03/27 17:44:20
Table 'RushAndCash28125210' 6-max Seat #1 is the button
Seat 1: a9a61ad7 ($22.66 in chips)
Seat 2: 415ff11e ($0.69 in chips)
Seat 3: f3ba7b19 ($13.94 in chips)
Seat 4: ead60f34 ($16.42 in chips)
Seat 5: Hero ($11.44 in chips)
Seat 6: bd10ae58 ($11.33 in chips)
415ff11e: posts small blind $0.05
f3ba7b19: posts big blind $0.1
*** HOLE CARDS ***
Dealt to a9a61ad7 
Dealt to 415ff11e 
Dealt to f3ba7b19 
Dealt to ead60f34 
Dealt to Hero [Kh 6s]
Dealt to bd10ae58 
ead60f34: folds
Hero: folds
bd10ae58: folds
a9a61ad7: raises $0.15 to $0.25
415ff11e: folds
f3ba7b19: folds
Uncalled bet ($0.15) returned to a9a61ad7
*** SHOWDOWN ***
a9a61ad7 collected $0.25 from pot
*** SUMMARY ***
Total pot $0.25 | Rake $0 | Jackpot $0 | Bingo $0 | Fortune $0
Seat 1: a9a61ad7 (button) collected ($0.25)
Seat 2: 415ff11e (small blind) folded before Flop
Seat 3: f3ba7b19 (big blind) folded before Flop
Seat 4: ead60f34 folded before Flop (didn't bet)
Seat 5: Hero folded before Flop (didn't bet)
Seat 6: bd10ae58 folded before Flop (didn't bet)


Poker Hand #RC1433129294: Hold'em No Limit  ($0.05/$0.1) - 2023/03/27 17:43:03
Table 'RushAndCash28124554' 6-max Seat #1 is the button
Seat 1: 415ff11e ($6.56 in chips)
Seat 2: 73a70200 ($18.47 in chips)
Seat 3: 6cfb3ca0 ($9.91 in chips)
Seat 4: Hero ($5.87 in chips)
Seat 5: b3f12672 ($34.43 in chips)
Seat 6: c0a9cb81 ($7.89 in chips)
73a70200: posts small blind $0.05
6cfb3ca0: posts big blind $0.1
*** HOLE CARDS ***
Dealt to 415ff11e 
Dealt to 73a70200 
Dealt to 6cfb3ca0 
Dealt to Hero [Ah As]
Dealt to b3f12672 
Dealt to c0a9cb81 
Hero: raises $0.15 to $0.25
b3f12672: folds
c0a9cb81: folds
415ff11e: calls $0.25
73a70200: folds
6cfb3ca0: folds
*** FLOP *** [3c Td 5h]
Hero: bets $0.33
415ff11e: calls $0.33
*** TURN *** [3c Td 5h] [Js]
Hero: bets $0.66
415ff11e: calls $0.66
*** RIVER *** [3c Td 5h Js] [5d]
Hero: bets $1.32
415ff11e: raises $4 to $5.32 and is all-in
Hero: calls $3.31 and is all-in
Uncalled bet ($0.69) returned to 415ff11e
415ff11e: shows [Jd 7d] (Pair of Jacks and Pair of Fives)
Hero: shows [Ah As] (Pair of Aces and Pair of Fives)
*** SHOWDOWN ***
Hero collected $11.44 from pot
*** SUMMARY ***
Total pot $11.89 | Rake $0.3 | Jackpot $0.15 | Bingo $0 | Fortune $0
Board [3c Td 5h Js 5d]
Seat 1: 415ff11e (button) showed [Jd 7d] and lost with Pair of Jacks and Pair of Fives
Seat 2: 73a70200 (small blind) folded before Flop
Seat 3: 6cfb3ca0 (big blind) folded before Flop
Seat 4: Hero showed [Ah As] and won ($11.44) with Pair of Aces and Pair of Fives
Seat 5: b3f12672 folded before Flop (didn't bet)
Seat 6: c0a9cb81 folded before Flop (didn't bet)


Poker Hand #RC1433128934: Hold'em No Limit  ($0.05/$0.1) - 2023/03/27 17:42:22
Table 'RushAndCash28124194' 6-max Seat #1 is the button
Seat 1: Hero ($6.32 in chips)
Seat 2: 967fa10d ($13.25 in chips)
Seat 3: d4d1ee92 ($14.4 in chips)
Seat 4: 2ea7aaad ($10.2 in chips)
Seat 5: 9ec5168d ($11.68 in chips)
Seat 6: c0a9cb81 ($7.33 in chips)
967fa10d: posts small blind $0.05
d4d1ee92: posts big blind $0.1
*** HOLE CARDS ***
Dealt to Hero [3c 3h]
Dealt to 967fa10d 
Dealt to d4d1ee92 
Dealt to 2ea7aaad 
Dealt to 9ec5168d 
Dealt to c0a9cb81 
2ea7aaad: folds
9ec5168d: folds
c0a9cb81: raises $0.2 to $0.3
Hero: calls $0.3
967fa10d: folds
d4d1ee92: folds
*** FLOP *** [Qc Qs 4s]
c0a9cb81: checks
Hero: bets $0.15
c0a9cb81: calls $0.15
*** TURN *** [Qc Qs 4s] [Ah]
c0a9cb81: bets $0.53
Hero: folds
Uncalled bet ($0.53) returned to c0a9cb81
*** SHOWDOWN ***
c0a9cb81 collected $1.01 from pot
*** SUMMARY ***
Total pot $1.05 | Rake $0.04 | Jackpot $0 | Bingo $0 | Fortune $0
Board [Qc Qs 4s Ah]
Seat 1: Hero (button) folded on the Turn
Seat 2: 967fa10d (small blind) folded before Flop
Seat 3: d4d1ee92 (big blind) folded before Flop
Seat 4: 2ea7aaad folded before Flop (didn't bet)
Seat 5: 9ec5168d folded before Flop (didn't bet)
Seat 6: c0a9cb81 won ($1.01)


Poker Hand #RC1433128893: Hold'em No Limit  ($0.05/$0.1) - 2023/03/27 17:42:17
Table 'RushAndCash28124153' 6-max Seat #1 is the button
Seat 1: 551dd415 ($12.39 in chips)
Seat 2: ec3bebf3 ($28.22 in chips)
Seat 3: e75bf2bf ($10.66 in chips)
Seat 4: Hero ($6.32 in chips)
Seat 5: b2858157 ($19.04 in chips)
Seat 6: 2ec58e7e ($11.87 in chips)
ec3bebf3: posts small blind $0.05
e75bf2bf: posts big blind $0.1
*** HOLE CARDS ***
Dealt to 551dd415 
Dealt to ec3bebf3 
Dealt to e75bf2bf 
Dealt to Hero [3c 8c]
Dealt to b2858157 
Dealt to 2ec58e7e 
Hero: folds
b2858157: folds
2ec58e7e: folds
551dd415: folds
ec3bebf3: raises $0.2 to $0.3
e75bf2bf: calls $0.2
*** FLOP *** [7d 2h Ts]
ec3bebf3: bets $0.2
e75bf2bf: folds
Uncalled bet ($0.2) returned to ec3bebf3
*** SHOWDOWN ***
ec3bebf3 collected $0.57 from pot
*** SUMMARY ***
Total pot $0.6 | Rake $0.03 | Jackpot $0 | Bingo $0 | Fortune $0
Board [7d 2h Ts]
Seat 1: 551dd415 (button) folded before Flop (didn't bet)
Seat 2: ec3bebf3 (small blind) won ($0.57)
Seat 3: e75bf2bf (big blind) folded on the Flop
Seat 4: Hero folded before Flop (didn't bet)
Seat 5: b2858157 folded before Flop (didn't bet)
Seat 6: 2ec58e7e folded before Flop (didn't bet)


Poker Hand #RC1433128793: Hold'em No Limit  ($0.05/$0.1) - 2023/03/27 17:42:06
Table 'RushAndCash28124053' 6-max Seat #1 is the button
Seat 1: c5efeb ($10 in chips)
Seat 2: Hero ($6.37 in chips)
Seat 3: 77496f84 ($51.86 in chips)
Seat 4: 5d498a4c ($10.7 in chips)
Seat 5: 411be59e ($10.6 in chips)
Seat 6: e75bf2bf ($10.66 in chips)
Hero: posts small blind $0.05
77496f84: posts big blind $0.1
*** HOLE CARDS ***
Dealt to c5efeb 
Dealt to Hero [8s Kd]
Dealt to 77496f84 
Dealt to 5d498a4c 
Dealt to 411be59e 
Dealt to e75bf2bf 
5d498a4c: folds
411be59e: folds
e75bf2bf: folds
c5efeb: raises $0.15 to $0.25
Hero: folds
77496f84: calls $0.15
*** FLOP *** [9h Td 4h]
77496f84: checks
c5efeb: bets $0.32
77496f84: raises $0.98 to $1.3
c5efeb: calls $0.98
*** TURN *** [9h Td 4h] [5d]
77496f84: bets $2.24
c5efeb: raises $6.21 to $8.45 and is all-in
77496f84: folds
Uncalled bet ($6.21) returned to c5efeb
*** SHOWDOWN ***
c5efeb collected $7.18 from pot
*** SUMMARY ***
Total pot $7.63 | Rake $0.3 | Jackpot $0.15 | Bingo $0 | Fortune $0
Board [9h Td 4h 5d]
Seat 1: c5efeb (button) won ($7.18)
Seat 2: Hero (small blind) folded before Flop
Seat 3: 77496f84 (big blind) folded on the Turn
Seat 4: 5d498a4c folded before Flop (didn't bet)
Seat 5: 411be59e folded before Flop (didn't bet)
Seat 6: e75bf2bf folded before Flop (didn't bet)


Poker Hand #RC1433128753: Hold'em No Limit  ($0.05/$0.1) - 2023/03/27 17:42:01
Table 'RushAndCash28124013' 6-max Seat #1 is the button
Seat 1: 5ecd5e22 ($7.95 in chips)
Seat 2: b40a573c ($10.03 in chips)
Seat 3: e88c8126 ($13.25 in chips)
Seat 4: 77496f84 ($51.86 in chips)
Seat 5: a1832e ($11.04 in chips)
Seat 6: Hero ($6.37 in chips)
b40a573c: posts small blind $0.05
e88c8126: posts big blind $0.1
*** HOLE CARDS ***
Dealt to 5ecd5e22 
Dealt to b40a573c 
Dealt to e88c8126 
Dealt to 77496f84 
Dealt to a1832e 
Dealt to Hero [9d 8s]
77496f84: folds
a1832e: folds
Hero: folds
5ecd5e22: raises $0.2 to $0.3
b40a573c: folds
e88c8126: calls $0.2
*** FLOP *** [4h Jc As]
e88c8126: checks
5ecd5e22: bets $0.2
e88c8126: calls $0.2
*** TURN *** [4h Jc As] [6h]
e88c8126: checks
5ecd5e22: checks
*** RIVER *** [4h Jc As 6h] [8d]
e88c8126: bets $0.53
5ecd5e22: folds
Uncalled bet ($0.53) returned to e88c8126
*** SHOWDOWN ***
e88c8126 collected $1 from pot
*** SUMMARY ***
Total pot $1.05 | Rake $0.05 | Jackpot $0 | Bingo $0 | Fortune $0
Board [4h Jc As 6h 8d]
Seat 1: 5ecd5e22 (button) folded on the River
Seat 2: b40a573c (small blind) folded before Flop
Seat 3: e88c8126 (big blind) won ($1)
Seat 4: 77496f84 folded before Flop (didn't bet)
Seat 5: a1832e folded before Flop (didn't bet)
Seat 6: Hero folded before Flop (didn't bet)


Poker Hand #RC1433128604: Hold'em No Limit  ($0.05/$0.1) - 2023/03/27 17:41:45
Table 'RushAndCash28123864' 6-max Seat #1 is the button
Seat 1: 725f7e50 ($15.49 in chips)
Seat 2: 3600e543 ($31.16 in chips)
Seat 3: Hero ($6.47 in chips)
Seat 4: f3ba7b19 ($12.89 in chips)
Seat 5: 82f55d8c ($3.55 in chips)
Seat 6: 905cc229 ($11.65 in chips)
3600e543: posts small blind $0.05
Hero: posts big blind $0.1
*** HOLE CARDS ***
Dealt to 725f7e50 
Dealt to 3600e543 
Dealt to Hero [Ts 8s]
Dealt to f3ba7b19 
Dealt to 82f55d8c 
Dealt to 905cc229 
f3ba7b19: folds
82f55d8c: folds
905cc229: raises $0.15 to $0.25
725f7e50: folds
3600e543: folds
Hero: folds
Uncalled bet ($0.15) returned to 905cc229
*** SHOWDOWN ***
905cc229 collected $0.25 from pot
*** SUMMARY ***
Total pot $0.25 | Rake $0 | Jackpot $0 | Bingo $0 | Fortune $0
Seat 1: 725f7e50 (button) folded before Flop (didn't bet)
Seat 2: 3600e543 (small blind) folded before Flop
Seat 3: Hero (big blind) folded before Flop
Seat 4: f3ba7b19 folded before Flop (didn't bet)
Seat 5: 82f55d8c folded before Flop (didn't bet)
Seat 6: 905cc229 collected ($0.25)


Poker Hand #RC1433128545: Hold'em No Limit  ($0.05/$0.1) - 2023/03/27 17:41:39
Table 'RushAndCash28123805' 6-max Seat #1 is the button
Seat 1: b1015539 ($8.17 in chips)
Seat 2: 121b58f ($8.26 in chips)
Seat 3: acf3740f ($9.8 in chips)
Seat 4: ddd727bd ($10.08 in chips)
Seat 5: 4f08b426 ($27.24 in chips)
Seat 6: Hero ($6.47 in chips)
121b58f: posts small blind $0.05
acf3740f: posts big blind $0.1
*** HOLE CARDS ***
Dealt to b1015539 
Dealt to 121b58f 
Dealt to acf3740f 
Dealt to ddd727bd 
Dealt to 4f08b426 
Dealt to Hero [Qd 4s]
ddd727bd: folds
4f08b426: folds
Hero: folds
b1015539: folds
121b58f: folds
Uncalled bet ($0.05) returned to acf3740f
*** SHOWDOWN ***
acf3740f collected $0.1 from pot
*** SUMMARY ***
Total pot $0.1 | Rake $0 | Jackpot $0 | Bingo $0 | Fortune $0
Seat 1: b1015539 (button) folded before Flop (didn't bet)
Seat 2: 121b58f (small blind) folded before Flop
Seat 3: acf3740f (big blind) collected ($0.1)
Seat 4: ddd727bd folded before Flop (didn't bet)
Seat 5: 4f08b426 folded before Flop (didn't bet)
Seat 6: Hero folded before Flop (didn't bet)


Poker Hand #RC1433128443: Hold'em No Limit  ($0.05/$0.1) - 2023/03/27 17:41:26
Table 'RushAndCash28123703' 6-max Seat #1 is the button
Seat 1: Hero ($6.32 in chips)
Seat 2: d601e59c ($20.68 in chips)
Seat 3: fda07b55 ($10 in chips)
Seat 4: 7199e0d7 ($10.47 in chips)
Seat 5: edbbcb2d ($17.02 in chips)
Seat 6: 2358adf ($70.84 in chips)
d601e59c: posts small blind $0.05
fda07b55: posts big blind $0.1
*** HOLE CARDS ***
Dealt to Hero [8c 7s]
Dealt to d601e59c 
Dealt to fda07b55 
Dealt to 7199e0d7 
Dealt to edbbcb2d 
Dealt to 2358adf 
7199e0d7: folds
edbbcb2d: folds
2358adf: folds
Hero: raises $0.15 to $0.25
d601e59c: folds
fda07b55: folds
Uncalled bet ($0.15) returned to Hero
*** SHOWDOWN ***
Hero collected $0.25 from pot
*** SUMMARY ***
Total pot $0.25 | Rake $0 | Jackpot $0 | Bingo $0 | Fortune $0
Seat 1: Hero (button) collected ($0.25)
Seat 2: d601e59c (small blind) folded before Flop
Seat 3: fda07b55 (big blind) folded before Flop
Seat 4: 7199e0d7 folded before Flop (didn't bet)
Seat 5: edbbcb2d folded before Flop (didn't bet)
Seat 6: 2358adf folded before Flop (didn't bet)


Poker Hand #RC1433128388: Hold'em No Limit  ($0.05/$0.1) - 2023/03/27 17:41:20
Table 'RushAndCash28123648' 6-max Seat #1 is the button
Seat 1: f2136409 ($25.24 in chips)
Seat 2: Hero ($6.37 in chips)
Seat 3: 3c28055b ($10 in chips)
Seat 4: 87de27cc ($9.16 in chips)
Seat 5: cebcd22f ($14.17 in chips)
Seat 6: 8b91b070 ($16.52 in chips)
Hero: posts small blind $0.05
3c28055b: posts big blind $0.1
*** HOLE CARDS ***
Dealt to f2136409 
Dealt to Hero [3c Kh]
Dealt to 3c28055b 
Dealt to 87de27cc 
Dealt to cebcd22f 
Dealt to 8b91b070 
87de27cc: raises $0.15 to $0.25
cebcd22f: folds
8b91b070: calls $0.25
f2136409: folds
Hero: folds
3c28055b: calls $0.15
*** FLOP *** [Qd Ks Jd]
3c28055b: checks
87de27cc: checks
8b91b070: checks
*** TURN *** [Qd Ks Jd] [8h]
3c28055b: checks
87de27cc: checks
8b91b070: checks
*** RIVER *** [Qd Ks Jd 8h] [4s]
3c28055b: checks
87de27cc: checks
8b91b070: checks
3c28055b: shows [3h 2h] (King-High)
87de27cc: shows [Js Ac] (Pair of Jacks)
8b91b070: shows [As 8s] (Pair of Eights)
*** SHOWDOWN ***
87de27cc collected $0.76 from pot
*** SUMMARY ***
Total pot $0.8 | Rake $0.04 | Jackpot $0 | Bingo $0 | Fortune $0
Board [Qd Ks Jd 8h 4s]
Seat 1: f2136409 (button) folded before Flop (didn't bet)
Seat 2: Hero (small blind) folded before Flop
Seat 3: 3c28055b (big blind) showed [3h 2h] and lost with King-High
Seat 4: 87de27cc showed [Js Ac] and won ($0.76) with Pair of Jacks
Seat 5: cebcd22f folded before Flop (didn't bet)
Seat 6: 8b91b070 showed [As 8s] and lost with Pair of Eights


Poker Hand #RC1433128355: Hold'em No Limit  ($0.05/$0.1) - 2023/03/27 17:41:16
Table 'RushAndCash28123615' 6-max Seat #1 is the button
Seat 1: 4c6bd865 ($10.31 in chips)
Seat 2: dc2a50ef ($15.43 in chips)
Seat 3: 6d3e2b64 ($10.15 in chips)
Seat 4: Hero ($6.37 in chips)
Seat 5: c3a1d2e5 ($11.44 in chips)
Seat 6: 1ef2413 ($5.34 in chips)
dc2a50ef: posts small blind $0.05
6d3e2b64: posts big blind $0.1
*** HOLE CARDS ***
Dealt to 4c6bd865 
Dealt to dc2a50ef 
Dealt to 6d3e2b64 
Dealt to Hero [7d Jh]
Dealt to c3a1d2e5 
Dealt to 1ef2413 
Hero: folds
c3a1d2e5: folds
1ef2413: folds
4c6bd865: folds
dc2a50ef: folds
Uncalled bet ($0.05) returned to 6d3e2b64
*** SHOWDOWN ***
6d3e2b64 collected $0.1 from pot
*** SUMMARY ***
Total pot $0.1 | Rake $0 | Jackpot $0 | Bingo $0 | Fortune $0
Seat 1: 4c6bd865 (button) folded before Flop (didn't bet)
Seat 2: dc2a50ef (small blind) folded before Flop
Seat 3: 6d3e2b64 (big blind) collected ($0.1)
Seat 4: Hero folded before Flop (didn't bet)
Seat 5: c3a1d2e5 folded before Flop (didn't bet)
Seat 6: 1ef2413 folded before Flop (didn't bet)


Poker Hand #RC1433128310: Hold'em No Limit  ($0.05/$0.1) - 2023/03/27 17:41:11
Table 'RushAndCash28123570' 6-max Seat #1 is the button
Seat 1: 919ea81e ($3.87 in chips)
Seat 2: cd5c6a84 ($9.77 in chips)
Seat 3: 921a7c70 ($11.31 in chips)
Seat 4: 361cd508 ($1.34 in chips)
Seat 5: Hero ($6.37 in chips)
Seat 6: 415ff11e ($6.33 in chips)
cd5c6a84: posts small blind $0.05
921a7c70: posts big blind $0.1
*** HOLE CARDS ***
Dealt to 919ea81e 
Dealt to cd5c6a84 
Dealt to 921a7c70 
Dealt to 361cd508 
Dealt to Hero [Js 5s]
Dealt to 415ff11e 
361cd508: folds
Hero: folds
415ff11e: folds
919ea81e: folds
cd5c6a84: calls $0.05
921a7c70: raises $0.1 to $0.2
cd5c6a84: calls $0.1
*** FLOP *** [Td 9d Tc]
cd5c6a84: checks
921a7c70: bets $0.14
cd5c6a84: folds
Uncalled bet ($0.14) returned to 921a7c70
*** SHOWDOWN ***
921a7c70 collected $0.38 from pot
*** SUMMARY ***
Total pot $0.4 | Rake $0.02 | Jackpot $0 | Bingo $0 | Fortune $0
Board [Td 9d Tc]
Seat 1: 919ea81e (button) folded before Flop (didn't bet)
Seat 2: cd5c6a84 (small blind) folded on the Flop
Seat 3: 921a7c70 (big blind) won ($0.38)
Seat 4: 361cd508 folded before Flop (didn't bet)
Seat 5: Hero folded before Flop (didn't bet)
Seat 6: 415ff11e folded before Flop (didn't bet)


Poker Hand #RC1433128140: Hold'em No Limit  ($0.05/$0.1) - 2023/03/27 17:40:51
Table 'RushAndCash28123400' 6-max Seat #1 is the button
Seat 1: f4377ade ($15.6 in chips)
Seat 2: d26b2103 ($10 in chips)
Seat 3: Hero ($6.47 in chips)
Seat 4: 742267d6 ($12.48 in chips)
Seat 5: 68122cd7 ($7.9 in chips)
Seat 6: be5aebaa ($10.85 in chips)
d26b2103: posts small blind $0.05
Hero: posts big blind $0.1
*** HOLE CARDS ***
Dealt to f4377ade 
Dealt to d26b2103 
Dealt to Hero [8d Qs]
Dealt to 742267d6 
Dealt to 68122cd7 
Dealt to be5aebaa 
742267d6: folds
68122cd7: folds
be5aebaa: raises $0.15 to $0.25
f4377ade: folds
d26b2103: folds
Hero: folds
Uncalled bet ($0.15) returned to be5aebaa
*** SHOWDOWN ***
be5aebaa collected $0.25 from pot
*** SUMMARY ***
Total pot $0.25 | Rake $0 | Jackpot $0 | Bingo $0 | Fortune $0
Seat 1: f4377ade (button) folded before Flop (didn't bet)
Seat 2: d26b2103 (small blind) folded before Flop
Seat 3: Hero (big blind) folded before Flop
Seat 4: 742267d6 folded before Flop (didn't bet)
Seat 5: 68122cd7 folded before Flop (didn't bet)
Seat 6: be5aebaa collected ($0.25)


Poker Hand #RC1433128067: Hold'em No Limit  ($0.05/$0.1) - 2023/03/27 17:40:42
Table 'RushAndCash28123327' 6-max Seat #1 is the button
Seat 1: dc097dc1 ($21.97 in chips)
Seat 2: 650f2c1d ($11.16 in chips)
Seat 3: 577b1209 ($7.99 in chips)
Seat 4: 1c91c82f ($10 in chips)
Seat 5: Hero ($6.47 in chips)
Seat 6: 95b929f5 ($28.28 in chips)
650f2c1d: posts small blind $0.05
577b1209: posts big blind $0.1
*** HOLE CARDS ***
Dealt to dc097dc1 
Dealt to 650f2c1d 
Dealt to 577b1209 
Dealt to 1c91c82f 
Dealt to Hero [Qc 9s]
Dealt to 95b929f5 
1c91c82f: folds
Hero: folds
95b929f5: folds
dc097dc1: raises $0.1 to $0.2
650f2c1d: folds
577b1209: folds
Uncalled bet ($0.1) returned to dc097dc1
*** SHOWDOWN ***
dc097dc1 collected $0.25 from pot
*** SUMMARY ***
Total pot $0.25 | Rake $0 | Jackpot $0 | Bingo $0 | Fortune $0
Seat 1: dc097dc1 (button) collected ($0.25)
Seat 2: 650f2c1d (small blind) folded before Flop
Seat 3: 577b1209 (big blind) folded before Flop
Seat 4: 1c91c82f folded before Flop (didn't bet)
Seat 5: Hero folded before Flop (didn't bet)
Seat 6: 95b929f5 folded before Flop (didn't bet)


Poker Hand #RC1433128033: Hold'em No Limit  ($0.05/$0.1) - 2023/03/27 17:40:38
Table 'RushAndCash28123293' 6-max Seat #1 is the button
Seat 1: 3f8ae166 ($15.59 in chips)
Seat 2: 577b1209 ($8.04 in chips)
Seat 3: 8947f368 ($10.59 in chips)
Seat 4: Hero ($6.47 in chips)
Seat 5: 6a54928e ($11.7 in chips)
Seat 6: 3b976095 ($20.02 in chips)
577b1209: posts small blind $0.05
8947f368: posts big blind $0.1
*** HOLE CARDS ***
Dealt to 3f8ae166 
Dealt to 577b1209 
Dealt to 8947f368 
Dealt to Hero [Ac 2s]
Dealt to 6a54928e 
Dealt to 3b976095 
Hero: folds
6a54928e: raises $0.11 to $0.21
3b976095: folds
3f8ae166: folds
577b1209: folds
8947f368: calls $0.11
*** FLOP *** [2d 7d 2h]
8947f368: bets $0.2
6a54928e: raises $0.3 to $0.5
8947f368: raises $1.3 to $1.8
6a54928e: folds
Uncalled bet ($1.3) returned to 8947f368
*** SHOWDOWN ***
8947f368 collected $1.4 from pot
*** SUMMARY ***
Total pot $1.47 | Rake $0.07 | Jackpot $0 | Bingo $0 | Fortune $0
Board [2d 7d 2h]
Seat 1: 3f8ae166 (button) folded before Flop (didn't bet)
Seat 2: 577b1209 (small blind) folded before Flop
Seat 3: 8947f368 (big blind) won ($1.4)
Seat 4: Hero folded before Flop (didn't bet)
Seat 5: 6a54928e folded on the Flop
Seat 6: 3b976095 folded before Flop (didn't bet)


Poker Hand #RC1433128000: Hold'em No Limit  ($0.05/$0.1) - 2023/03/27 17:40:34
Table 'RushAndCash28123260' 6-max Seat #1 is the button
Seat 1: Hero ($6.47 in chips)
Seat 2: 62ee250e ($5.51 in chips)
Seat 3: 1b1bb41b ($8.52 in chips)
Seat 4: 668c8580 ($13.81 in chips)
Seat 5: 5c8be07b ($15.09 in chips)
Seat 6: 577b1209 ($8.04 in chips)
62ee250e: posts small blind $0.05
1b1bb41b: posts big blind $0.1
*** HOLE CARDS ***
Dealt to Hero [4h 7d]
Dealt to 62ee250e 
Dealt to 1b1bb41b 
Dealt to 668c8580 
Dealt to 5c8be07b 
Dealt to 577b1209 
668c8580: raises $0.1 to $0.2
5c8be07b: folds
577b1209: folds
Hero: folds
62ee250e: calls $0.15
1b1bb41b: calls $0.1
*** FLOP *** [9d Jh 4d]
62ee250e: checks
1b1bb41b: checks
668c8580: checks
*** TURN *** [9d Jh 4d] [9s]
62ee250e: checks
1b1bb41b: checks
668c8580: checks
*** RIVER *** [9d Jh 4d 9s] [2d]
62ee250e: checks
1b1bb41b: checks
668c8580: checks
62ee250e: shows [6h 7s] (Pair of Nines)
1b1bb41b: shows [As 7h] (Pair of Nines)
668c8580: shows [5h 5s] (Pair of Nines and Pair of Fives)
*** SHOWDOWN ***
668c8580 collected $0.57 from pot
*** SUMMARY ***
Total pot $0.6 | Rake $0.03 | Jackpot $0 | Bingo $0 | Fortune $0
Board [9d Jh 4d 9s 2d]
Seat 1: Hero (button) folded before Flop (didn't bet)
Seat 2: 62ee250e (small blind) showed [6h 7s] and lost with Pair of Nines
Seat 3: 1b1bb41b (big blind) showed [As 7h] and lost with Pair of Nines
Seat 4: 668c8580 showed [5h 5s] and won ($0.57) with Pair of Nines and Pair of Fives
Seat 5: 5c8be07b folded before Flop (didn't bet)
Seat 6: 577b1209 folded before Flop (didn't bet)


Poker Hand #RC1433127970: Hold'em No Limit  ($0.05/$0.1) - 2023/03/27 17:40:30
Table 'RushAndCash28123230' 6-max Seat #1 is the button
Seat 1: 203e7e09 ($9.32 in chips)
Seat 2: Hero ($6.52 in chips)
Seat 3: d2fec13f ($16.36 in chips)
Seat 4: 1845134 ($14.03 in chips)
Seat 5: bd10ae58 ($11.8 in chips)
Seat 6: 6d5b7244 ($10.65 in chips)
Hero: posts small blind $0.05
d2fec13f: posts big blind $0.1
*** HOLE CARDS ***
Dealt to 203e7e09 
Dealt to Hero [8s 4d]
Dealt to d2fec13f 
Dealt to 1845134 
Dealt to bd10ae58 
Dealt to 6d5b7244 
1845134: folds
bd10ae58: raises $0.2 to $0.3
6d5b7244: folds
203e7e09: folds
Hero: folds
d2fec13f: folds
Uncalled bet ($0.2) returned to bd10ae58
*** SHOWDOWN ***
bd10ae58 collected $0.25 from pot
*** SUMMARY ***
Total pot $0.25 | Rake $0 | Jackpot $0 | Bingo $0 | Fortune $0
Seat 1: 203e7e09 (button) folded before Flop (didn't bet)
Seat 2: Hero (small blind) folded before Flop
Seat 3: d2fec13f (big blind) folded before Flop
Seat 4: 1845134 folded before Flop (didn't bet)
Seat 5: bd10ae58 collected ($0.25)
Seat 6: 6d5b7244 folded before Flop (didn't bet)


Poker Hand #RC1433127776: Hold'em No Limit  ($0.05/$0.1) - 2023/03/27 17:40:05
Table 'RushAndCash28123036' 6-max Seat #1 is the button
Seat 1: 6d5b7244 ($10.9 in chips)
Seat 2: Hero ($6.2 in chips)
Seat 3: 82799086 ($11.55 in chips)
Seat 4: b1015539 ($8.23 in chips)
Seat 5: 7d942bfd ($10 in chips)
Seat 6: c200a9e4 ($18.43 in chips)
Hero: posts small blind $0.05
82799086: posts big blind $0.1
*** HOLE CARDS ***
Dealt to 6d5b7244 
Dealt to Hero [As Js]
Dealt to 82799086 
Dealt to b1015539 
Dealt to 7d942bfd 
Dealt to c200a9e4 
b1015539: folds
7d942bfd: folds
c200a9e4: folds
6d5b7244: raises $0.15 to $0.25
Hero: raises $0.75 to $1
82799086: folds
6d5b7244: folds
Uncalled bet ($0.75) returned to Hero
*** SHOWDOWN ***
Hero collected $0.57 from pot
*** SUMMARY ***
Total pot $0.6 | Rake $0.03 | Jackpot $0 | Bingo $0 | Fortune $0
Seat 1: 6d5b7244 (button) folded before Flop
Seat 2: Hero (small blind) collected ($0.57)
Seat 3: 82799086 (big blind) folded before Flop
Seat 4: b1015539 folded before Flop (didn't bet)
Seat 5: 7d942bfd folded before Flop (didn't bet)
Seat 6: c200a9e4 folded before Flop (didn't bet)


Poker Hand #RC1433127663: Hold'em No Limit  ($0.05/$0.1) - 2023/03/27 17:39:51
Table 'RushAndCash28122923' 6-max Seat #1 is the button
Seat 1: 3d409235 ($10 in chips)
Seat 2: 5e8f02b4 ($7.49 in chips)
Seat 3: Hero ($6.3 in chips)
Seat 4: c1ee3d48 ($9.96 in chips)
Seat 5: 68713de1 ($17.74 in chips)
Seat 6: 8947f368 ($10.64 in chips)
5e8f02b4: posts small blind $0.05
Hero: posts big blind $0.1
*** HOLE CARDS ***
Dealt to 3d409235 
Dealt to 5e8f02b4 
Dealt to Hero [5d Js]
Dealt to c1ee3d48 
Dealt to 68713de1 
Dealt to 8947f368 
c1ee3d48: folds
68713de1: raises $0.1 to $0.2
8947f368: folds
3d409235: folds
5e8f02b4: folds
Hero: folds
Uncalled bet ($0.1) returned to 68713de1
*** SHOWDOWN ***
68713de1 collected $0.25 from pot
*** SUMMARY ***
Total pot $0.25 | Rake $0 | Jackpot $0 | Bingo $0 | Fortune $0
Seat 1: 3d409235 (button) folded before Flop (didn't bet)
Seat 2: 5e8f02b4 (small blind) folded before Flop
Seat 3: Hero (big blind) folded before Flop
Seat 4: c1ee3d48 folded before Flop (didn't bet)
Seat 5: 68713de1 collected ($0.25)
Seat 6: 8947f368 folded before Flop (didn't bet)


Poker Hand #RC1433127571: Hold'em No Limit  ($0.05/$0.1) - 2023/03/27 17:39:39
Table 'RushAndCash28122831' 6-max Seat #1 is the button
Seat 1: 39254f48 ($12.11 in chips)
Seat 2: a3c3bfbb ($10.41 in chips)
Seat 3: d3bc2a8b ($11.56 in chips)
Seat 4: Hero ($6.3 in chips)
Seat 5: 5aa8835f ($21.97 in chips)
Seat 6: ff0e64c3 ($15.87 in chips)
a3c3bfbb: posts small blind $0.05
d3bc2a8b: posts big blind $0.1
*** HOLE CARDS ***
Dealt to 39254f48 
Dealt to a3c3bfbb 
Dealt to d3bc2a8b 
Dealt to Hero [9c 5h]
Dealt to 5aa8835f 
Dealt to ff0e64c3 
Hero: folds
5aa8835f: folds
ff0e64c3: raises $0.13 to $0.23
39254f48: folds
a3c3bfbb: folds
d3bc2a8b: folds
Uncalled bet ($0.13) returned to ff0e64c3
*** SHOWDOWN ***
ff0e64c3 collected $0.25 from pot
*** SUMMARY ***
Total pot $0.25 | Rake $0 | Jackpot $0 | Bingo $0 | Fortune $0
Seat 1: 39254f48 (button) folded before Flop (didn't bet)
Seat 2: a3c3bfbb (small blind) folded before Flop
Seat 3: d3bc2a8b (big blind) folded before Flop
Seat 4: Hero folded before Flop (didn't bet)
Seat 5: 5aa8835f folded before Flop (didn't bet)
Seat 6: ff0e64c3 collected ($0.25)


Poker Hand #RC1433127513: Hold'em No Limit  ($0.05/$0.1) - 2023/03/27 17:39:32
Table 'RushAndCash28122773' 6-max Seat #1 is the button
Seat 1: 47d66f63 ($10.15 in chips)
Seat 2: d7243786 ($10.29 in chips)
Seat 3: a56d2470 ($15.93 in chips)
Seat 4: 4e602348 ($10.35 in chips)
Seat 5: Hero ($6.3 in chips)
Seat 6: e9e25e5e ($17.04 in chips)
d7243786: posts small blind $0.05
a56d2470: posts big blind $0.1
*** HOLE CARDS ***
Dealt to 47d66f63 
Dealt to d7243786 
Dealt to a56d2470 
Dealt to 4e602348 
Dealt to Hero [3d 7s]
Dealt to e9e25e5e 
4e602348: raises $0.14 to $0.24
Hero: folds
e9e25e5e: calls $0.24
47d66f63: calls $0.24
d7243786: calls $0.19
a56d2470: folds
*** FLOP *** [3h Jd Qh]
d7243786: checks
4e602348: bets $0.53
e9e25e5e: folds
47d66f63: folds
d7243786: calls $0.53
*** TURN *** [3h Jd Qh] [Qd]
d7243786: checks
4e602348: checks
*** RIVER *** [3h Jd Qh Qd] [4h]
d7243786: bets $1.95
4e602348: folds
Uncalled bet ($1.95) returned to d7243786
*** SHOWDOWN ***
d7243786 collected $2.02 from pot
*** SUMMARY ***
Total pot $2.12 | Rake $0.1 | Jackpot $0 | Bingo $0 | Fortune $0
Board [3h Jd Qh Qd 4h]
Seat 1: 47d66f63 (button) folded on the Flop
Seat 2: d7243786 (small blind) won ($2.02)
Seat 3: a56d2470 (big blind) folded before Flop
Seat 4: 4e602348 folded on the River
Seat 5: Hero folded before Flop (didn't bet)
Seat 6: e9e25e5e folded on the Flop


Poker Hand #RC1433127460: Hold'em No Limit  ($0.05/$0.1) - 2023/03/27 17:39:25
Table 'RushAndCash28122720' 6-max Seat #1 is the button
Seat 1: Hero ($6.3 in chips)
Seat 2: a1832e ($12.17 in chips)
Seat 3: 284a5815 ($12.03 in chips)
Seat 4: 1db41a35 ($10.17 in chips)
Seat 5: 732d871c ($11.75 in chips)
Seat 6: f676b974 ($10.34 in chips)
a1832e: posts small blind $0.05
284a5815: posts big blind $0.1
*** HOLE CARDS ***
Dealt to Hero [Qc 3s]
Dealt to a1832e 
Dealt to 284a5815 
Dealt to 1db41a35 
Dealt to 732d871c 
Dealt to f676b974 
1db41a35: folds
732d871c: folds
f676b974: raises $0.12 to $0.22
Hero: folds
a1832e: folds
284a5815: calls $0.12
*** FLOP *** [9d 8c Jd]
284a5815: checks
f676b974: checks
*** TURN *** [9d 8c Jd] [Ah]
284a5815: checks
f676b974: bets $0.37
284a5815: calls $0.37
*** RIVER *** [9d 8c Jd Ah] [Kh]
284a5815: checks
f676b974: checks
284a5815: shows [Qd 9h] (Pair of Nines)
f676b974: shows [Ad 7d] (Pair of Aces)
*** SHOWDOWN ***
f676b974 collected $1.17 from pot
*** SUMMARY ***
Total pot $1.23 | Rake $0.06 | Jackpot $0 | Bingo $0 | Fortune $0
Board [9d 8c Jd Ah Kh]
Seat 1: Hero (button) folded before Flop (didn't bet)
Seat 2: a1832e (small blind) folded before Flop
Seat 3: 284a5815 (big blind) showed [Qd 9h] and lost with Pair of Nines
Seat 4: 1db41a35 folded before Flop (didn't bet)
Seat 5: 732d871c folded before Flop (didn't bet)
Seat 6: f676b974 showed [Ad 7d] and won ($1.17) with Pair of Aces


Poker Hand #RC1433127194: Hold'em No Limit  ($0.05/$0.1) - 2023/03/27 17:38:55
Table 'RushAndCash28122454' 6-max Seat #1 is the button
Seat 1: Hero ($7.02 in chips)
Seat 2: 2447933f ($35.41 in chips)
Seat 3: 12081c8b ($15.99 in chips)
Seat 4: 6e9952d ($12.4 in chips)
Seat 5: 284a5815 ($11.24 in chips)
Seat 6: 8f4db9fd ($11.02 in chips)
2447933f: posts small blind $0.05
12081c8b: posts big blind $0.1
*** HOLE CARDS ***
Dealt to Hero [Tc Jc]
Dealt to 2447933f 
Dealt to 12081c8b 
Dealt to 6e9952d 
Dealt to 284a5815 
Dealt to 8f4db9fd 
6e9952d: folds
284a5815: raises $0.12 to $0.22
8f4db9fd: folds
Hero: raises $0.5 to $0.72
2447933f: folds
12081c8b: folds
284a5815: raises $1.72 to $2.44
Hero: folds
Uncalled bet ($1.72) returned to 284a5815
*** SHOWDOWN ***
284a5815 collected $1.51 from pot
*** SUMMARY ***
Total pot $1.59 | Rake $0.08 | Jackpot $0 | Bingo $0 | Fortune $0
Seat 1: Hero (button) folded before Flop
Seat 2: 2447933f (small blind) folded before Flop
Seat 3: 12081c8b (big blind) folded before Flop
Seat 4: 6e9952d folded before Flop (didn't bet)
Seat 5: 284a5815 collected ($1.51)
Seat 6: 8f4db9fd folded before Flop (didn't bet)


Poker Hand #RC1433127152: Hold'em No Limit  ($0.05/$0.1) - 2023/03/27 17:38:50
Table 'RushAndCash28122412' 6-max Seat #1 is the button
Seat 1: 203e7e09 ($9.99 in chips)
Seat 2: cbd5f4f9 ($11.78 in chips)
Seat 3: 98e675a9 ($31.18 in chips)
Seat 4: 7ff2ede1 ($12.09 in chips)
Seat 5: Hero ($7.02 in chips)
Seat 6: 8e2a3771 ($10.15 in chips)
cbd5f4f9: posts small blind $0.05
98e675a9: posts big blind $0.1
*** HOLE CARDS ***
Dealt to 203e7e09 
Dealt to cbd5f4f9 
Dealt to 98e675a9 
Dealt to 7ff2ede1 
Dealt to Hero [Qc 5s]
Dealt to 8e2a3771 
7ff2ede1: folds
Hero: folds
8e2a3771: folds
203e7e09: folds
cbd5f4f9: folds
Uncalled bet ($0.05) returned to 98e675a9
*** SHOWDOWN ***
98e675a9 collected $0.1 from pot
*** SUMMARY ***
Total pot $0.1 | Rake $0 | Jackpot $0 | Bingo $0 | Fortune $0
Seat 1: 203e7e09 (button) folded before Flop (didn't bet)
Seat 2: cbd5f4f9 (small blind) folded before Flop
Seat 3: 98e675a9 (big blind) collected ($0.1)
Seat 4: 7ff2ede1 folded before Flop (didn't bet)
Seat 5: Hero folded before Flop (didn't bet)
Seat 6: 8e2a3771 folded before Flop (didn't bet)


Poker Hand #RC1433127086: Hold'em No Limit  ($0.05/$0.1) - 2023/03/27 17:38:44
Table 'RushAndCash28122346' 6-max Seat #1 is the button
Seat 1: bdde3fc4 ($11.19 in chips)
Seat 2: cd380641 ($11.53 in chips)
Seat 3: b8f54584 ($11.19 in chips)
Seat 4: Hero ($6.87 in chips)
Seat 5: d1a4f80f ($10 in chips)
Seat 6: debd1a0a ($13.1 in chips)
cd380641: posts small blind $0.05
b8f54584: posts big blind $0.1
*** HOLE CARDS ***
Dealt to bdde3fc4 
Dealt to cd380641 
Dealt to b8f54584 
Dealt to Hero [6c Tc]
Dealt to d1a4f80f 
Dealt to debd1a0a 
Hero: folds
d1a4f80f: folds
debd1a0a: folds
bdde3fc4: folds
cd380641: raises $0.13 to $0.23
b8f54584: folds
Uncalled bet ($0.13) returned to cd380641
*** SHOWDOWN ***
cd380641 collected $0.2 from pot
*** SUMMARY ***
Total pot $0.2 | Rake $0 | Jackpot $0 | Bingo $0 | Fortune $0
Seat 1: bdde3fc4 (button) folded before Flop (didn't bet)
Seat 2: cd380641 (small blind) collected ($0.2)
Seat 3: b8f54584 (big blind) folded before Flop
Seat 4: Hero folded before Flop (didn't bet)
Seat 5: d1a4f80f folded before Flop (didn't bet)
Seat 6: debd1a0a folded before Flop (didn't bet)


Poker Hand #RC1433126973: Hold'em No Limit  ($0.05/$0.1) - 2023/03/27 17:38:30
Table 'RushAndCash28122233' 6-max Seat #1 is the button
Seat 1: 2fe05c64 ($10.27 in chips)
Seat 2: Hero ($6.92 in chips)
Seat 3: 3acaee01 ($12.64 in chips)
Seat 4: d046ea7d ($9.19 in chips)
Seat 5: e11cfd5e ($24.01 in chips)
Seat 6: 435c6e22 ($28.79 in chips)
Hero: posts small blind $0.05
3acaee01: posts big blind $0.1
*** HOLE CARDS ***
Dealt to 2fe05c64 
Dealt to Hero [7h 8c]
Dealt to 3acaee01 
Dealt to d046ea7d 
Dealt to e11cfd5e 
Dealt to 435c6e22 
d046ea7d: folds
e11cfd5e: folds
435c6e22: folds
2fe05c64: raises $0.15 to $0.25
Hero: folds
3acaee01: calls $0.15
*** FLOP *** [Qd 6c 5d]
3acaee01: checks
2fe05c64: checks
*** TURN *** [Qd 6c 5d] [5c]
3acaee01: checks
2fe05c64: bets $0.3
3acaee01: folds
Uncalled bet ($0.3) returned to 2fe05c64
*** SHOWDOWN ***
2fe05c64 collected $0.53 from pot
*** SUMMARY ***
Total pot $0.55 | Rake $0.02 | Jackpot $0 | Bingo $0 | Fortune $0
Board [Qd 6c 5d 5c]
Seat 1: 2fe05c64 (button) won ($0.53)
Seat 2: Hero (small blind) folded before Flop
Seat 3: 3acaee01 (big blind) folded on the Turn
Seat 4: d046ea7d folded before Flop (didn't bet)
Seat 5: e11cfd5e folded before Flop (didn't bet)
Seat 6: 435c6e22 folded before Flop (didn't bet)


Poker Hand #RC1433126941: Hold'em No Limit  ($0.05/$0.1) - 2023/03/27 17:38:26
Table 'RushAndCash28122201' 6-max Seat #1 is the button
Seat 1: ec659151 ($17.99 in chips)
Seat 2: 650f2c1d ($11.96 in chips)
Seat 3: Hero ($7.02 in chips)
Seat 4: d3a01ac0 ($10 in chips)
Seat 5: a9a61ad7 ($10.1 in chips)
Seat 6: bd0c9e13 ($10.3 in chips)
650f2c1d: posts small blind $0.05
Hero: posts big blind $0.1
*** HOLE CARDS ***
Dealt to ec659151 
Dealt to 650f2c1d 
Dealt to Hero [3d 6s]
Dealt to d3a01ac0 
Dealt to a9a61ad7 
Dealt to bd0c9e13 
d3a01ac0: folds
a9a61ad7: folds
bd0c9e13: folds
ec659151: folds
650f2c1d: folds
Uncalled bet ($0.05) returned to Hero
*** SHOWDOWN ***
Hero collected $0.1 from pot
*** SUMMARY ***
Total pot $0.1 | Rake $0 | Jackpot $0 | Bingo $0 | Fortune $0
Seat 1: ec659151 (button) folded before Flop (didn't bet)
Seat 2: 650f2c1d (small blind) folded before Flop
Seat 3: Hero (big blind) collected ($0.1)
Seat 4: d3a01ac0 folded before Flop (didn't bet)
Seat 5: a9a61ad7 folded before Flop (didn't bet)
Seat 6: bd0c9e13 folded before Flop (didn't bet)


Poker Hand #RC1433126908: Hold'em No Limit  ($0.05/$0.1) - 2023/03/27 17:38:22
Table 'RushAndCash28122168' 6-max Seat #1 is the button
Seat 1: b0bd2b96 ($39.93 in chips)
Seat 2: d1a4f80f ($10.13 in chips)
Seat 3: 23baaa67 ($10.45 in chips)
Seat 4: Hero ($7.02 in chips)
Seat 5: e94eeb11 ($5.78 in chips)
Seat 6: cb1b6565 ($10 in chips)
d1a4f80f: posts small blind $0.05
23baaa67: posts big blind $0.1
*** HOLE CARDS ***
Dealt to b0bd2b96 
Dealt to d1a4f80f 
Dealt to 23baaa67 
Dealt to Hero [Jc 4s]
Dealt to e94eeb11 
Dealt to cb1b6565 
Hero: folds
e94eeb11: folds
cb1b6565: folds
b0bd2b96: folds
d1a4f80f: folds
Uncalled bet ($0.05) returned to 23baaa67
*** SHOWDOWN ***
23baaa67 collected $0.1 from pot
*** SUMMARY ***
Total pot $0.1 | Rake $0 | Jackpot $0 | Bingo $0 | Fortune $0
Seat 1: b0bd2b96 (button) folded before Flop (didn't bet)
Seat 2: d1a4f80f (small blind) folded before Flop
Seat 3: 23baaa67 (big blind) collected ($0.1)
Seat 4: Hero folded before Flop (didn't bet)
Seat 5: e94eeb11 folded before Flop (didn't bet)
Seat 6: cb1b6565 folded before Flop (didn't bet)


Poker Hand #RC1433126557: Hold'em No Limit  ($0.05/$0.1) - 2023/03/27 17:37:41
Table 'RushAndCash28121817' 6-max Seat #1 is the button
Seat 1: e1967842 ($19.42 in chips)
Seat 2: 257e716e ($10.96 in chips)
Seat 3: dc2f4d92 ($23.37 in chips)
Seat 4: 9a2c06fa ($10 in chips)
Seat 5: 54bd9af1 ($9.6 in chips)
Seat 6: Hero ($6.54 in chips)
257e716e: posts small blind $0.05
dc2f4d92: posts big blind $0.1
*** HOLE CARDS ***
Dealt to e1967842 
Dealt to 257e716e 
Dealt to dc2f4d92 
Dealt to 9a2c06fa 
Dealt to 54bd9af1 
Dealt to Hero [Ac Kd]
9a2c06fa: folds
54bd9af1: calls $0.1
Hero: raises $0.27 to $0.37
e1967842: folds
257e716e: folds
dc2f4d92: folds
54bd9af1: calls $0.27
*** FLOP *** [Ks 4d 9h]
54bd9af1: checks
Hero: bets $0.49
54bd9af1: folds
Uncalled bet ($0.49) returned to Hero
*** SHOWDOWN ***
Hero collected $0.85 from pot
*** SUMMARY ***
Total pot $0.89 | Rake $0.04 | Jackpot $0 | Bingo $0 | Fortune $0
Board [Ks 4d 9h]
Seat 1: e1967842 (button) folded before Flop (didn't bet)
Seat 2: 257e716e (small blind) folded before Flop
Seat 3: dc2f4d92 (big blind) folded before Flop
Seat 4: 9a2c06fa folded before Flop (didn't bet)
Seat 5: 54bd9af1 folded on the Flop
Seat 6: Hero won ($0.85)


Poker Hand #RC1433126501: Hold'em No Limit  ($0.05/$0.1) - 2023/03/27 17:37:36
Table 'RushAndCash28121761' 6-max Seat #1 is the button
Seat 1: bc9098f9 ($10 in chips)
Seat 2: Hero ($6.59 in chips)
Seat 3: 29ca6eb4 ($10 in chips)
Seat 4: 92f2ddbf ($11.68 in chips)
Seat 5: dc2f4d92 ($23.37 in chips)
Seat 6: b04ff204 ($10 in chips)
Hero: posts small blind $0.05
29ca6eb4: posts big blind $0.1
*** HOLE CARDS ***
Dealt to bc9098f9 
Dealt to Hero [8d 6s]
Dealt to 29ca6eb4 
Dealt to 92f2ddbf 
Dealt to dc2f4d92 
Dealt to b04ff204 
92f2ddbf: raises $0.1 to $0.2
dc2f4d92: folds
b04ff204: folds
bc9098f9: folds
Hero: folds
29ca6eb4: calls $0.1
*** FLOP *** [Jh Jd Qc]
29ca6eb4: checks
92f2ddbf: bets $0.2
29ca6eb4: folds
Uncalled bet ($0.2) returned to 92f2ddbf
*** SHOWDOWN ***
92f2ddbf collected $0.43 from pot
*** SUMMARY ***
Total pot $0.45 | Rake $0.02 | Jackpot $0 | Bingo $0 | Fortune $0
Board [Jh Jd Qc]
Seat 1: bc9098f9 (button) folded before Flop (didn't bet)
Seat 2: Hero (small blind) folded before Flop
Seat 3: 29ca6eb4 (big blind) folded on the Flop
Seat 4: 92f2ddbf won ($0.43)
Seat 5: dc2f4d92 folded before Flop (didn't bet)
Seat 6: b04ff204 folded before Flop (didn't bet)


Poker Hand #RC1433126403: Hold'em No Limit  ($0.05/$0.1) - 2023/03/27 17:37:25
Table 'RushAndCash28121663' 6-max Seat #1 is the button
Seat 1: 7ff2ede1 ($12.31 in chips)
Seat 2: 945d7391 ($38.61 in chips)
Seat 3: Hero ($6.69 in chips)
Seat 4: 9cfdbc4c ($12.19 in chips)
Seat 5: c9934aa0 ($14.91 in chips)
Seat 6: 25150449 ($10.05 in chips)
945d7391: posts small blind $0.05
Hero: posts big blind $0.1
*** HOLE CARDS ***
Dealt to 7ff2ede1 
Dealt to 945d7391 
Dealt to Hero [Js 8d]
Dealt to 9cfdbc4c 
Dealt to c9934aa0 
Dealt to 25150449 
9cfdbc4c: raises $0.15 to $0.25
c9934aa0: folds
25150449: folds
7ff2ede1: folds
945d7391: folds
Hero: folds
Uncalled bet ($0.15) returned to 9cfdbc4c
*** SHOWDOWN ***
9cfdbc4c collected $0.25 from pot
*** SUMMARY ***
Total pot $0.25 | Rake $0 | Jackpot $0 | Bingo $0 | Fortune $0
Seat 1: 7ff2ede1 (button) folded before Flop (didn't bet)
Seat 2: 945d7391 (small blind) folded before Flop
Seat 3: Hero (big blind) folded before Flop
Seat 4: 9cfdbc4c collected ($0.25)
Seat 5: c9934aa0 folded before Flop (didn't bet)
Seat 6: 25150449 folded before Flop (didn't bet)


Poker Hand #RC1433126357: Hold'em No Limit  ($0.05/$0.1) - 2023/03/27 17:37:20
Table 'RushAndCash28121617' 6-max Seat #1 is the button
Seat 1: Hero ($6.69 in chips)
Seat 2: 54ffc667 ($10.91 in chips)
Seat 3: 734fa3cf ($11.2 in chips)
Seat 4: e33e2fc2 ($8.43 in chips)
Seat 5: ff6a0806 ($16.71 in chips)
Seat 6: bd10ae58 ($11.49 in chips)
54ffc667: posts small blind $0.05
734fa3cf: posts big blind $0.1
*** HOLE CARDS ***
Dealt to Hero [4c Th]
Dealt to 54ffc667 
Dealt to 734fa3cf 
Dealt to e33e2fc2 
Dealt to ff6a0806 
Dealt to bd10ae58 
e33e2fc2: folds
ff6a0806: folds
bd10ae58: raises $0.2 to $0.3
Hero: folds
54ffc667: folds
734fa3cf: folds
Uncalled bet ($0.2) returned to bd10ae58
*** SHOWDOWN ***
bd10ae58 collected $0.25 from pot
*** SUMMARY ***
Total pot $0.25 | Rake $0 | Jackpot $0 | Bingo $0 | Fortune $0
Seat 1: Hero (button) folded before Flop (didn't bet)
Seat 2: 54ffc667 (small blind) folded before Flop
Seat 3: 734fa3cf (big blind) folded before Flop
Seat 4: e33e2fc2 folded before Flop (didn't bet)
Seat 5: ff6a0806 folded before Flop (didn't bet)
Seat 6: bd10ae58 collected ($0.25)


Poker Hand #RC1433126329: Hold'em No Limit  ($0.05/$0.1) - 2023/03/27 17:37:15
Table 'RushAndCash28121589' 6-max Seat #1 is the button
Seat 1: d0669238 ($12.21 in chips)
Seat 2: 24d76e7e ($10.05 in chips)
Seat 3: b9372fb3 ($8.23 in chips)
Seat 4: 473eceac ($34.41 in chips)
Seat 5: Hero ($6.69 in chips)
Seat 6: bd10ae58 ($11.49 in chips)
24d76e7e: posts small blind $0.05
b9372fb3: posts big blind $0.1
*** HOLE CARDS ***
Dealt to d0669238 
Dealt to 24d76e7e 
Dealt to b9372fb3 
Dealt to 473eceac 
Dealt to Hero [Ah 2s]
Dealt to bd10ae58 
473eceac: folds
Hero: folds
bd10ae58: folds
d0669238: folds
24d76e7e: folds
Uncalled bet ($0.05) returned to b9372fb3
*** SHOWDOWN ***
b9372fb3 collected $0.1 from pot
*** SUMMARY ***
Total pot $0.1 | Rake $0 | Jackpot $0 | Bingo $0 | Fortune $0
Seat 1: d0669238 (button) folded before Flop (didn't bet)
Seat 2: 24d76e7e (small blind) folded before Flop
Seat 3: b9372fb3 (big blind) collected ($0.1)
Seat 4: 473eceac folded before Flop (didn't bet)
Seat 5: Hero folded before Flop (didn't bet)
Seat 6: bd10ae58 folded before Flop (didn't bet)


Poker Hand #RC1433126294: Hold'em No Limit  ($0.05/$0.1) - 2023/03/27 17:37:11
Table 'RushAndCash28121554' 6-max Seat #1 is the button
Seat 1: f2fd8dd0 ($8.81 in chips)
Seat 2: 60e2d00 ($9.08 in chips)
Seat 3: 897f9a4 ($10 in chips)
Seat 4: cab27a75 ($8.58 in chips)
Seat 5: Hero ($6.69 in chips)
Seat 6: 92f2ddbf ($11.58 in chips)
60e2d00: posts small blind $0.05
897f9a4: posts big blind $0.1
*** HOLE CARDS ***
Dealt to f2fd8dd0 
Dealt to 60e2d00 
Dealt to 897f9a4 
Dealt to cab27a75 
Dealt to Hero [Tc 5s]
Dealt to 92f2ddbf 
cab27a75: raises $0.15 to $0.25
Hero: folds
92f2ddbf: folds
f2fd8dd0: folds
60e2d00: folds
897f9a4: folds
Uncalled bet ($0.15) returned to cab27a75
*** SHOWDOWN ***
cab27a75 collected $0.25 from pot
*** SUMMARY ***
Total pot $0.25 | Rake $0 | Jackpot $0 | Bingo $0 | Fortune $0
Seat 1: f2fd8dd0 (button) folded before Flop (didn't bet)
Seat 2: 60e2d00 (small blind) folded before Flop
Seat 3: 897f9a4 (big blind) folded before Flop
Seat 4: cab27a75 collected ($0.25)
Seat 5: Hero folded before Flop (didn't bet)
Seat 6: 92f2ddbf folded before Flop (didn't bet)


Poker Hand #RC1433126247: Hold'em No Limit  ($0.05/$0.1) - 2023/03/27 17:37:05
Table 'RushAndCash28121507' 6-max Seat #1 is the button
Seat 1: 46762187 ($11.91 in chips)
Seat 2: 4489359 ($12.01 in chips)
Seat 3: 5063464 ($11.4 in chips)
Seat 4: Hero ($6.69 in chips)
Seat 5: f1fcc540 ($10.74 in chips)
Seat 6: b4780f2d ($14.1 in chips)
4489359: posts small blind $0.05
5063464: posts big blind $0.1
*** HOLE CARDS ***
Dealt to 46762187 
Dealt to 4489359 
Dealt to 5063464 
Dealt to Hero [Kc Td]
Dealt to f1fcc540 
Dealt to b4780f2d 
Hero: folds
f1fcc540: raises $0.13 to $0.23
b4780f2d: folds
46762187: folds
4489359: folds
5063464: folds
Uncalled bet ($0.13) returned to f1fcc540
*** SHOWDOWN ***
f1fcc540 collected $0.25 from pot
*** SUMMARY ***
Total pot $0.25 | Rake $0 | Jackpot $0 | Bingo $0 | Fortune $0
Seat 1: 46762187 (button) folded before Flop (didn't bet)
Seat 2: 4489359 (small blind) folded before Flop
Seat 3: 5063464 (big blind) folded before Flop
Seat 4: Hero folded before Flop (didn't bet)
Seat 5: f1fcc540 collected ($0.25)
Seat 6: b4780f2d folded before Flop (didn't bet)


Poker Hand #RC1433126202: Hold'em No Limit  ($0.05/$0.1) - 2023/03/27 17:37:00
Table 'RushAndCash28121462' 6-max Seat #1 is the button
Seat 1: b8f54584 ($11.42 in chips)
Seat 2: 3ea02a9e ($10.21 in chips)
Seat 3: 6f3db458 ($10 in chips)
Seat 4: b40a573c ($9.9 in chips)
Seat 5: ae7b5bca ($11.56 in chips)
Seat 6: Hero ($6.69 in chips)
3ea02a9e: posts small blind $0.05
6f3db458: posts big blind $0.1
*** HOLE CARDS ***
Dealt to b8f54584 
Dealt to 3ea02a9e 
Dealt to 6f3db458 
Dealt to b40a573c 
Dealt to ae7b5bca 
Dealt to Hero [7c Kd]
b40a573c: folds
ae7b5bca: folds
Hero: folds
b8f54584: raises $0.1 to $0.2
3ea02a9e: raises $0.7 to $0.9
6f3db458: folds
b8f54584: calls $0.7
*** FLOP *** [Ac 2s 2d]
3ea02a9e: bets $1.43
b8f54584: calls $1.43
*** TURN *** [Ac 2s 2d] [Ah]
3ea02a9e: bets $3.57
b8f54584: calls $3.57
*** RIVER *** [Ac 2s 2d Ah] [4h]
3ea02a9e: bets $4.31 and is all-in
b8f54584: calls $4.31
3ea02a9e: shows [As Kc] (Aces Full over Twos)
b8f54584: shows [Qc Ad] (Aces Full over Twos)
*** SHOWDOWN ***
3ea02a9e collected $10.04 from pot
b8f54584 collected $10.03 from pot
*** SUMMARY ***
Total pot $20.52 | Rake $0.3 | Jackpot $0.15 | Bingo $0 | Fortune $0
Board [Ac 2s 2d Ah 4h]
Seat 1: b8f54584 (button) showed [Qc Ad] and won ($10.03) with Aces Full over Twos
Seat 2: 3ea02a9e (small blind) showed [As Kc] and won ($10.04) with Aces Full over Twos
Seat 3: 6f3db458 (big blind) folded before Flop
Seat 4: b40a573c folded before Flop (didn't bet)
Seat 5: ae7b5bca folded before Flop (didn't bet)
Seat 6: Hero folded before Flop (didn't bet)


Poker Hand #RC1433126168: Hold'em No Limit  ($0.05/$0.1) - 2023/03/27 17:36:54
Table 'RushAndCash28121428' 6-max Seat #1 is the button
Seat 1: Hero ($6.69 in chips)
Seat 2: ccca68f1 ($53.01 in chips)
Seat 3: 86596c9e ($10 in chips)
Seat 4: a56d2470 ($16.36 in chips)
Seat 5: 9794e28b ($13.03 in chips)
Seat 6: d26b2103 ($11.05 in chips)
ccca68f1: posts small blind $0.05
86596c9e: posts big blind $0.1
*** HOLE CARDS ***
Dealt to Hero [9s 8h]
Dealt to ccca68f1 
Dealt to 86596c9e 
Dealt to a56d2470 
Dealt to 9794e28b 
Dealt to d26b2103 
a56d2470: folds
9794e28b: raises $0.1 to $0.2
d26b2103: folds
Hero: folds
ccca68f1: folds
86596c9e: calls $0.1
*** FLOP *** [Ts 4h 6s]
86596c9e: bets $0.34
9794e28b: calls $0.34
*** TURN *** [Ts 4h 6s] [6c]
86596c9e: bets $0.85
9794e28b: folds
Uncalled bet ($0.85) returned to 86596c9e
*** SHOWDOWN ***
86596c9e collected $1.08 from pot
*** SUMMARY ***
Total pot $1.13 | Rake $0.05 | Jackpot $0 | Bingo $0 | Fortune $0
Board [Ts 4h 6s 6c]
Seat 1: Hero (button) folded before Flop (didn't bet)
Seat 2: ccca68f1 (small blind) folded before Flop
Seat 3: 86596c9e (big blind) won ($1.08)
Seat 4: a56d2470 folded before Flop (didn't bet)
Seat 5: 9794e28b folded on the Turn
Seat 6: d26b2103 folded before Flop (didn't bet)


Poker Hand #RC1433126121: Hold'em No Limit  ($0.05/$0.1) - 2023/03/27 17:36:48
Table 'RushAndCash28121381' 6-max Seat #1 is the button
Seat 1: 4dd8bf28 ($10 in chips)
Seat 2: 2dafb3c9 ($10 in chips)
Seat 3: Hero ($6.79 in chips)
Seat 4: c4f616e4 ($13.45 in chips)
Seat 5: 1845134 ($12.29 in chips)
Seat 6: edcc8e41 ($10.67 in chips)
2dafb3c9: posts small blind $0.05
Hero: posts big blind $0.1
*** HOLE CARDS ***
Dealt to 4dd8bf28 
Dealt to 2dafb3c9 
Dealt to Hero [4c 9h]
Dealt to c4f616e4 
Dealt to 1845134 
Dealt to edcc8e41 
c4f616e4: folds
1845134: folds
edcc8e41: folds
4dd8bf28: raises $0.15 to $0.25
2dafb3c9: folds
Hero: folds
Uncalled bet ($0.15) returned to 4dd8bf28
*** SHOWDOWN ***
4dd8bf28 collected $0.25 from pot
*** SUMMARY ***
Total pot $0.25 | Rake $0 | Jackpot $0 | Bingo $0 | Fortune $0
Seat 1: 4dd8bf28 (button) collected ($0.25)
Seat 2: 2dafb3c9 (small blind) folded before Flop
Seat 3: Hero (big blind) folded before Flop
Seat 4: c4f616e4 folded before Flop (didn't bet)
Seat 5: 1845134 folded before Flop (didn't bet)
Seat 6: edcc8e41 folded before Flop (didn't bet)


Poker Hand #RC1433125611: Hold'em No Limit  ($0.05/$0.1) - 2023/03/27 17:35:49
Table 'RushAndCash28120871' 6-max Seat #1 is the button
Seat 1: c4f616e4 ($13.5 in chips)
Seat 2: Hero ($6.84 in chips)
Seat 3: 2fe90d90 ($30.34 in chips)
Seat 4: 3ae3c7b0 ($3.92 in chips)
Seat 5: f6ae1c3c ($17.28 in chips)
Seat 6: bc9098f9 ($10.15 in chips)
Hero: posts small blind $0.05
2fe90d90: posts big blind $0.1
*** HOLE CARDS ***
Dealt to c4f616e4 
Dealt to Hero [Ac Kc]
Dealt to 2fe90d90 
Dealt to 3ae3c7b0 
Dealt to f6ae1c3c 
Dealt to bc9098f9 
3ae3c7b0: raises $0.15 to $0.25
f6ae1c3c: folds
bc9098f9: folds
c4f616e4: raises $0.65 to $0.9
Hero: raises $1.5 to $2.4
2fe90d90: folds
3ae3c7b0: folds
c4f616e4: raises $11.1 to $13.5 and is all-in
Hero: calls $4.44 and is all-in
Uncalled bet ($6.66) returned to c4f616e4
c4f616e4: shows [As Kh]
Hero: shows [Ac Kc]
*** FLOP *** [Ts 2d 9h]
*** TURN *** [Ts 2d 9h] [8s]
*** RIVER *** [Ts 2d 9h 8s] [5c]
*** SHOWDOWN ***
c4f616e4 collected $6.79 from pot
Hero collected $6.79 from pot
*** SUMMARY ***
Total pot $14.03 | Rake $0.3 | Jackpot $0.15 | Bingo $0 | Fortune $0
Board [Ts 2d 9h 8s 5c]
Seat 1: c4f616e4 (button) showed [As Kh] and won ($6.79) with Ace-High
Seat 2: Hero (small blind) showed [Ac Kc] and won ($6.79) with Ace-High
Seat 3: 2fe90d90 (big blind) folded before Flop
Seat 4: 3ae3c7b0 folded before Flop
Seat 5: f6ae1c3c folded before Flop (didn't bet)
Seat 6: bc9098f9 folded before Flop (didn't bet)


Poker Hand #RC1433125458: Hold'em No Limit  ($0.05/$0.1) - 2023/03/27 17:35:29
Table 'RushAndCash28120718' 6-max Seat #1 is the button
Seat 1: 2d406ff5 ($10 in chips)
Seat 2: 386be875 ($9.54 in chips)
Seat 3: e33e2fc2 ($9.78 in chips)
Seat 4: ef8a3018 ($10.95 in chips)
Seat 5: f09c363f ($14.59 in chips)
Seat 6: Hero ($7.09 in chips)
386be875: posts small blind $0.05
e33e2fc2: posts big blind $0.1
*** HOLE CARDS ***
Dealt to 2d406ff5 
Dealt to 386be875 
Dealt to e33e2fc2 
Dealt to ef8a3018 
Dealt to f09c363f 
Dealt to Hero [Jh Qh]
ef8a3018: folds
f09c363f: folds
Hero: raises $0.15 to $0.25
2d406ff5: raises $0.55 to $0.8
386be875: calls $0.75
e33e2fc2: folds
Hero: folds
*** FLOP *** [5d 3h 4s]
386be875: bets $0.98
2d406ff5: folds
Uncalled bet ($0.98) returned to 386be875
*** SHOWDOWN ***
386be875 collected $1.86 from pot
*** SUMMARY ***
Total pot $1.95 | Rake $0.09 | Jackpot $0 | Bingo $0 | Fortune $0
Board [5d 3h 4s]
Seat 1: 2d406ff5 (button) folded on the Flop
Seat 2: 386be875 (small blind) won ($1.86)
Seat 3: e33e2fc2 (big blind) folded before Flop
Seat 4: ef8a3018 folded before Flop (didn't bet)
Seat 5: f09c363f folded before Flop (didn't bet)
Seat 6: Hero folded before Flop


Poker Hand #RC1433125424: Hold'em No Limit  ($0.05/$0.1) - 2023/03/27 17:35:25
Table 'RushAndCash28120684' 6-max Seat #1 is the button
Seat 1: b4bad238 ($8.93 in chips)
Seat 2: 14a7b2a5 ($5.35 in chips)
Seat 3: e03636a6 ($10.25 in chips)
Seat 4: Hero ($7.09 in chips)
Seat 5: 921a7c70 ($9.77 in chips)
Seat 6: cebcd22f ($10.58 in chips)
14a7b2a5: posts small blind $0.05
e03636a6: posts big blind $0.1
*** HOLE CARDS ***
Dealt to b4bad238 
Dealt to 14a7b2a5 
Dealt to e03636a6 
Dealt to Hero [Kd 8c]
Dealt to 921a7c70 
Dealt to cebcd22f 
Hero: folds
921a7c70: folds
cebcd22f: raises $0.15 to $0.25
b4bad238: folds
14a7b2a5: folds
e03636a6: folds
Uncalled bet ($0.15) returned to cebcd22f
*** SHOWDOWN ***
cebcd22f collected $0.25 from pot
*** SUMMARY ***
Total pot $0.25 | Rake $0 | Jackpot $0 | Bingo $0 | Fortune $0
Seat 1: b4bad238 (button) folded before Flop (didn't bet)
Seat 2: 14a7b2a5 (small blind) folded before Flop
Seat 3: e03636a6 (big blind) folded before Flop
Seat 4: Hero folded before Flop (didn't bet)
Seat 5: 921a7c70 folded before Flop (didn't bet)
Seat 6: cebcd22f collected ($0.25)


Poker Hand #RC1433125384: Hold'em No Limit  ($0.05/$0.1) - 2023/03/27 17:35:20
Table 'RushAndCash28120644' 6-max Seat #1 is the button
Seat 1: fbe774b4 ($12.86 in chips)
Seat 2: e33e2fc2 ($9.83 in chips)
Seat 3: a1832e ($13.73 in chips)
Seat 4: a5d8af7 ($21.95 in chips)
Seat 5: Hero ($7.09 in chips)
Seat 6: cebcd22f ($10.58 in chips)
e33e2fc2: posts small blind $0.05
a1832e: posts big blind $0.1
*** HOLE CARDS ***
Dealt to fbe774b4 
Dealt to e33e2fc2 
Dealt to a1832e 
Dealt to a5d8af7 
Dealt to Hero [Td 6h]
Dealt to cebcd22f 
a5d8af7: raises $0.15 to $0.25
Hero: folds
cebcd22f: folds
fbe774b4: folds
e33e2fc2: folds
a1832e: calls $0.15
*** FLOP *** [6s 2s Ah]
a1832e: checks
a5d8af7: checks
*** TURN *** [6s 2s Ah] [Jc]
a1832e: bets $0.22
a5d8af7: calls $0.22
*** RIVER *** [6s 2s Ah Jc] [6c]
a1832e: bets $0.8
a5d8af7: calls $0.8
a1832e: shows [8h 7c] (Pair of Sixes)
a5d8af7: shows [Qc Qs] (Pair of Queens and Pair of Sixes)
*** SHOWDOWN ***
a5d8af7 collected $2.46 from pot
*** SUMMARY ***
Total pot $2.59 | Rake $0.13 | Jackpot $0 | Bingo $0 | Fortune $0
Board [6s 2s Ah Jc 6c]
Seat 1: fbe774b4 (button) folded before Flop (didn't bet)
Seat 2: e33e2fc2 (small blind) folded before Flop
Seat 3: a1832e (big blind) showed [8h 7c] and lost with Pair of Sixes
Seat 4: a5d8af7 showed [Qc Qs] and won ($2.46) with Pair of Queens and Pair of Sixes
Seat 5: Hero folded before Flop (didn't bet)
Seat 6: cebcd22f folded before Flop (didn't bet)


Poker Hand #RC1433125339: Hold'em No Limit  ($0.05/$0.1) - 2023/03/27 17:35:15
Table 'RushAndCash28120599' 6-max Seat #1 is the button
Seat 1: Hero ($7.09 in chips)
Seat 2: e151b82a ($10.05 in chips)
Seat 3: e3929a8d ($10.27 in chips)
Seat 4: eb4a09de ($19.27 in chips)
Seat 5: f807cc1f ($20.7 in chips)
Seat 6: c4f616e4 ($13.18 in chips)
e151b82a: posts small blind $0.05
e3929a8d: posts big blind $0.1
*** HOLE CARDS ***
Dealt to Hero [Jc 7c]
Dealt to e151b82a 
Dealt to e3929a8d 
Dealt to eb4a09de 
Dealt to f807cc1f 
Dealt to c4f616e4 
eb4a09de: folds
f807cc1f: folds
c4f616e4: raises $0.15 to $0.25
Hero: folds
e151b82a: calls $0.2
e3929a8d: folds
*** FLOP *** [6h Qh 5h]
e151b82a: checks
c4f616e4: bets $0.3
e151b82a: folds
Uncalled bet ($0.3) returned to c4f616e4
*** SHOWDOWN ***
c4f616e4 collected $0.57 from pot
*** SUMMARY ***
Total pot $0.6 | Rake $0.03 | Jackpot $0 | Bingo $0 | Fortune $0
Board [6h Qh 5h]
Seat 1: Hero (button) folded before Flop (didn't bet)
Seat 2: e151b82a (small blind) folded on the Flop
Seat 3: e3929a8d (big blind) folded before Flop
Seat 4: eb4a09de folded before Flop (didn't bet)
Seat 5: f807cc1f folded before Flop (didn't bet)
Seat 6: c4f616e4 won ($0.57)


Poker Hand #RC1433125201: Hold'em No Limit  ($0.05/$0.1) - 2023/03/27 17:34:58
Table 'RushAndCash28120461' 6-max Seat #1 is the button
Seat 1: 97310630 ($10.36 in chips)
Seat 2: Hero ($7.14 in chips)
Seat 3: d184804a ($10.15 in chips)
Seat 4: b339e987 ($56.68 in chips)
Seat 5: a4ae7ba2 ($12.5 in chips)
Seat 6: 8e2d4a82 ($13.56 in chips)
Hero: posts small blind $0.05
d184804a: posts big blind $0.1
*** HOLE CARDS ***
Dealt to 97310630 
Dealt to Hero [5h 9s]
Dealt to d184804a 
Dealt to b339e987 
Dealt to a4ae7ba2 
Dealt to 8e2d4a82 
b339e987: folds
a4ae7ba2: folds
8e2d4a82: folds
97310630: folds
Hero: folds
Uncalled bet ($0.05) returned to d184804a
*** SHOWDOWN ***
d184804a collected $0.1 from pot
*** SUMMARY ***
Total pot $0.1 | Rake $0 | Jackpot $0 | Bingo $0 | Fortune $0
Seat 1: 97310630 (button) folded before Flop (didn't bet)
Seat 2: Hero (small blind) folded before Flop
Seat 3: d184804a (big blind) collected ($0.1)
Seat 4: b339e987 folded before Flop (didn't bet)
Seat 5: a4ae7ba2 folded before Flop (didn't bet)
Seat 6: 8e2d4a82 folded before Flop (didn't bet)


Poker Hand #RC1433125107: Hold'em No Limit  ($0.05/$0.1) - 2023/03/27 17:34:48
Table 'RushAndCash28120367' 6-max Seat #1 is the button
Seat 1: 17414218 ($9.95 in chips)
Seat 2: dea12a41 ($8.2 in chips)
Seat 3: Hero ($7.09 in chips)
Seat 4: 8d8e9b5a ($13.67 in chips)
Seat 5: 95986455 ($18.65 in chips)
Seat 6: 6d3e2b64 ($10.45 in chips)
dea12a41: posts small blind $0.05
Hero: posts big blind $0.1
*** HOLE CARDS ***
Dealt to 17414218 
Dealt to dea12a41 
Dealt to Hero [5s 5h]
Dealt to 8d8e9b5a 
Dealt to 95986455 
Dealt to 6d3e2b64 
8d8e9b5a: folds
95986455: folds
6d3e2b64: folds
17414218: folds
dea12a41: folds
Uncalled bet ($0.05) returned to Hero
*** SHOWDOWN ***
Hero collected $0.1 from pot
*** SUMMARY ***
Total pot $0.1 | Rake $0 | Jackpot $0 | Bingo $0 | Fortune $0
Seat 1: 17414218 (button) folded before Flop (didn't bet)
Seat 2: dea12a41 (small blind) folded before Flop
Seat 3: Hero (big blind) collected ($0.1)
Seat 4: 8d8e9b5a folded before Flop (didn't bet)
Seat 5: 95986455 folded before Flop (didn't bet)
Seat 6: 6d3e2b64 folded before Flop (didn't bet)


Poker Hand #RC1433125036: Hold'em No Limit  ($0.05/$0.1) - 2023/03/27 17:34:39
Table 'RushAndCash28120296' 6-max Seat #1 is the button
Seat 1: aecbdece ($11.8 in chips)
Seat 2: 9559393 ($10 in chips)
Seat 3: 1ff2a46c ($12.48 in chips)
Seat 4: 5b91610e ($16.08 in chips)
Seat 5: 257e716e ($10.78 in chips)
Seat 6: Hero ($7.09 in chips)
9559393: posts small blind $0.05
1ff2a46c: posts big blind $0.1
*** HOLE CARDS ***
Dealt to aecbdece 
Dealt to 9559393 
Dealt to 1ff2a46c 
Dealt to 5b91610e 
Dealt to 257e716e 
Dealt to Hero [7s 9s]
5b91610e: raises $0.1 to $0.2
257e716e: folds
Hero: folds
aecbdece: folds
9559393: folds
1ff2a46c: calls $0.1
*** FLOP *** [5c 9d 4s]
1ff2a46c: checks
5b91610e: checks
*** TURN *** [5c 9d 4s] [7d]
1ff2a46c: bets $0.23
5b91610e: folds
Uncalled bet ($0.23) returned to 1ff2a46c
*** SHOWDOWN ***
1ff2a46c collected $0.43 from pot
*** SUMMARY ***
Total pot $0.45 | Rake $0.02 | Jackpot $0 | Bingo $0 | Fortune $0
Board [5c 9d 4s 7d]
Seat 1: aecbdece (button) folded before Flop (didn't bet)
Seat 2: 9559393 (small blind) folded before Flop
Seat 3: 1ff2a46c (big blind) won ($0.43)
Seat 4: 5b91610e folded on the Turn
Seat 5: 257e716e folded before Flop (didn't bet)
Seat 6: Hero folded before Flop (didn't bet)


Poker Hand #RC1433124979: Hold'em No Limit  ($0.05/$0.1) - 2023/03/27 17:34:32
Table 'RushAndCash28120239' 6-max Seat #1 is the button
Seat 1: 5570e924 ($10.56 in chips)
Seat 2: 21be48a8 ($5.03 in chips)
Seat 3: 702ccf8c ($13.49 in chips)
Seat 4: 9f9781fb ($16.5 in chips)
Seat 5: 23f8f6f1 ($7.32 in chips)
Seat 6: Hero ($7.09 in chips)
21be48a8: posts small blind $0.05
702ccf8c: posts big blind $0.1
*** HOLE CARDS ***
Dealt to 5570e924 
Dealt to 21be48a8 
Dealt to 702ccf8c 
Dealt to 9f9781fb 
Dealt to 23f8f6f1 
Dealt to Hero [8d 6c]
9f9781fb: folds
23f8f6f1: folds
Hero: folds
5570e924: folds
21be48a8: raises $0.1 to $0.2
702ccf8c: folds
Uncalled bet ($0.1) returned to 21be48a8
*** SHOWDOWN ***
21be48a8 collected $0.2 from pot
*** SUMMARY ***
Total pot $0.2 | Rake $0 | Jackpot $0 | Bingo $0 | Fortune $0
Seat 1: 5570e924 (button) folded before Flop (didn't bet)
Seat 2: 21be48a8 (small blind) collected ($0.2)
Seat 3: 702ccf8c (big blind) folded before Flop
Seat 4: 9f9781fb folded before Flop (didn't bet)
Seat 5: 23f8f6f1 folded before Flop (didn't bet)
Seat 6: Hero folded before Flop (didn't bet)


Poker Hand #RC1433124903: Hold'em No Limit  ($0.05/$0.1) - 2023/03/27 17:34:22
Table 'RushAndCash28120163' 6-max Seat #1 is the button
Seat 1: e1967842 ($17.41 in chips)
Seat 2: f71e2e1a ($17.41 in chips)
Seat 3: afb931fd ($10.25 in chips)
Seat 4: b132dca ($10.38 in chips)
Seat 5: Hero ($7.09 in chips)
Seat 6: 5930677a ($16.87 in chips)
f71e2e1a: posts small blind $0.05
afb931fd: posts big blind $0.1
*** HOLE CARDS ***
Dealt to e1967842 
Dealt to f71e2e1a 
Dealt to afb931fd 
Dealt to b132dca 
Dealt to Hero [4c 7h]
Dealt to 5930677a 
b132dca: folds
Hero: folds
5930677a: folds
e1967842: folds
f71e2e1a: folds
Uncalled bet ($0.05) returned to afb931fd
*** SHOWDOWN ***
afb931fd collected $0.1 from pot
*** SUMMARY ***
Total pot $0.1 | Rake $0 | Jackpot $0 | Bingo $0 | Fortune $0
Seat 1: e1967842 (button) folded before Flop (didn't bet)
Seat 2: f71e2e1a (small blind) folded before Flop
Seat 3: afb931fd (big blind) collected ($0.1)
Seat 4: b132dca folded before Flop (didn't bet)
Seat 5: Hero folded before Flop (didn't bet)
Seat 6: 5930677a folded before Flop (didn't bet)


Poker Hand #RC1433124871: Hold'em No Limit  ($0.05/$0.1) - 2023/03/27 17:34:18
Table 'RushAndCash28120131' 6-max Seat #1 is the button
Seat 1: 2fe90d90 ($30.59 in chips)
Seat 2: Hero ($7.14 in chips)
Seat 3: 1f31458 ($17.1 in chips)
Seat 4: 189f6075 ($11.6 in chips)
Seat 5: b347eb60 ($10.15 in chips)
Seat 6: ca40a3e7 ($10.48 in chips)
Hero: posts small blind $0.05
1f31458: posts big blind $0.1
*** HOLE CARDS ***
Dealt to 2fe90d90 
Dealt to Hero [Th 8d]
Dealt to 1f31458 
Dealt to 189f6075 
Dealt to b347eb60 
Dealt to ca40a3e7 
189f6075: folds
b347eb60: raises $0.1 to $0.2
ca40a3e7: folds
2fe90d90: calls $0.2
Hero: folds
1f31458: raises $0.95 to $1.15
b347eb60: folds
2fe90d90: folds
Uncalled bet ($0.95) returned to 1f31458
*** SHOWDOWN ***
1f31458 collected $0.62 from pot
*** SUMMARY ***
Total pot $0.65 | Rake $0.03 | Jackpot $0 | Bingo $0 | Fortune $0
Seat 1: 2fe90d90 (button) folded before Flop
Seat 2: Hero (small blind) folded before Flop
Seat 3: 1f31458 (big blind) collected ($0.62)
Seat 4: 189f6075 folded before Flop (didn't bet)
Seat 5: b347eb60 folded before Flop
Seat 6: ca40a3e7 folded before Flop (didn't bet)


Poker Hand #RC1433124774: Hold'em No Limit  ($0.05/$0.1) - 2023/03/27 17:34:05
Table 'RushAndCash28120034' 6-max Seat #1 is the button
Seat 1: a930af80 ($10 in chips)
Seat 2: df7f703d ($11.7 in chips)
Seat 3: Hero ($7.09 in chips)
Seat 4: 45dec125 ($26.94 in chips)
Seat 5: d4d1ee92 ($11.87 in chips)
Seat 6: 3ea02a9e ($10.48 in chips)
df7f703d: posts small blind $0.05
Hero: posts big blind $0.1
*** HOLE CARDS ***
Dealt to a930af80 
Dealt to df7f703d 
Dealt to Hero [As Qh]
Dealt to 45dec125 
Dealt to d4d1ee92 
Dealt to 3ea02a9e 
45dec125: folds
d4d1ee92: folds
3ea02a9e: folds
a930af80: folds
df7f703d: folds
Uncalled bet ($0.05) returned to Hero
*** SHOWDOWN ***
Hero collected $0.1 from pot
*** SUMMARY ***
Total pot $0.1 | Rake $0 | Jackpot $0 | Bingo $0 | Fortune $0
Seat 1: a930af80 (button) folded before Flop (didn't bet)
Seat 2: df7f703d (small blind) folded before Flop
Seat 3: Hero (big blind) collected ($0.1)
Seat 4: 45dec125 folded before Flop (didn't bet)
Seat 5: d4d1ee92 folded before Flop (didn't bet)
Seat 6: 3ea02a9e folded before Flop (didn't bet)


Poker Hand #RC1433084594: Hold'em No Limit  ($0.05/$0.1) - 2023/03/27 17:33:43
Table 'RushAndCash28119854' 6-max Seat #1 is the button
Seat 1: Hero ($6.94 in chips)
Seat 2: 756cc0eb ($10.2 in chips)
Seat 3: 5d3ecf20 ($25.97 in chips)
Seat 4: d336af97 ($12.3 in chips)
Seat 5: 2db38382 ($10.1 in chips)
Seat 6: fb831871 ($11.52 in chips)
756cc0eb: posts small blind $0.05
5d3ecf20: posts big blind $0.1
*** HOLE CARDS ***
Dealt to Hero [Jh Jc]
Dealt to 756cc0eb 
Dealt to 5d3ecf20 
Dealt to d336af97 
Dealt to 2db38382 
Dealt to fb831871 
d336af97: folds
2db38382: folds
fb831871: folds
Hero: raises $0.15 to $0.25
756cc0eb: folds
5d3ecf20: folds
Uncalled bet ($0.15) returned to Hero
*** SHOWDOWN ***
Hero collected $0.25 from pot
*** SUMMARY ***
Total pot $0.25 | Rake $0 | Jackpot $0 | Bingo $0 | Fortune $0
Seat 1: Hero (button) collected ($0.25)
Seat 2: 756cc0eb (small blind) folded before Flop
Seat 3: 5d3ecf20 (big blind) folded before Flop
Seat 4: d336af97 folded before Flop (didn't bet)
Seat 5: 2db38382 folded before Flop (didn't bet)
Seat 6: fb831871 folded before Flop (didn't bet)


Poker Hand #RC1433084556: Hold'em No Limit  ($0.05/$0.1) - 2023/03/27 17:33:38
Table 'RushAndCash28119816' 6-max Seat #1 is the button
Seat 1: 2599c943 ($12.51 in chips)
Seat 2: 5b06e1bc ($15.26 in chips)
Seat 3: 48e6a4d7 ($8.43 in chips)
Seat 4: 1c7969e0 ($9.91 in chips)
Seat 5: Hero ($6.94 in chips)
Seat 6: 557ff0c6 ($10 in chips)
5b06e1bc: posts small blind $0.05
48e6a4d7: posts big blind $0.1
*** HOLE CARDS ***
Dealt to 2599c943 
Dealt to 5b06e1bc 
Dealt to 48e6a4d7 
Dealt to 1c7969e0 
Dealt to Hero [2d 2h]
Dealt to 557ff0c6 
1c7969e0: folds
Hero: folds
557ff0c6: folds
2599c943: raises $0.15 to $0.25
5b06e1bc: folds
48e6a4d7: calls $0.15
*** FLOP *** [Jc Th 6d]
48e6a4d7: bets $0.42
2599c943: folds
Uncalled bet ($0.42) returned to 48e6a4d7
*** SHOWDOWN ***
48e6a4d7 collected $0.53 from pot
*** SUMMARY ***
Total pot $0.55 | Rake $0.02 | Jackpot $0 | Bingo $0 | Fortune $0
Board [Jc Th 6d]
Seat 1: 2599c943 (button) folded on the Flop
Seat 2: 5b06e1bc (small blind) folded before Flop
Seat 3: 48e6a4d7 (big blind) won ($0.53)
Seat 4: 1c7969e0 folded before Flop (didn't bet)
Seat 5: Hero folded before Flop (didn't bet)
Seat 6: 557ff0c6 folded before Flop (didn't bet)


Poker Hand #RC1433084515: Hold'em No Limit  ($0.05/$0.1) - 2023/03/27 17:33:33
Table 'RushAndCash28119775' 6-max Seat #1 is the button
Seat 1: 8bb78023 ($10.52 in chips)
Seat 2: c29830b4 ($23.42 in chips)
Seat 3: 5b6ae968 ($13.63 in chips)
Seat 4: aecbdece ($12.05 in chips)
Seat 5: Hero ($6.94 in chips)
Seat 6: 5a244e55 ($13.95 in chips)
c29830b4: posts small blind $0.05
5b6ae968: posts big blind $0.1
*** HOLE CARDS ***
Dealt to 8bb78023 
Dealt to c29830b4 
Dealt to 5b6ae968 
Dealt to aecbdece 
Dealt to Hero [6c 2c]
Dealt to 5a244e55 
aecbdece: folds
Hero: folds
5a244e55: folds
8bb78023: folds
c29830b4: raises $0.2 to $0.3
5b6ae968: folds
Uncalled bet ($0.2) returned to c29830b4
*** SHOWDOWN ***
c29830b4 collected $0.2 from pot
*** SUMMARY ***
Total pot $0.2 | Rake $0 | Jackpot $0 | Bingo $0 | Fortune $0
Seat 1: 8bb78023 (button) folded before Flop (didn't bet)
Seat 2: c29830b4 (small blind) collected ($0.2)
Seat 3: 5b6ae968 (big blind) folded before Flop
Seat 4: aecbdece folded before Flop (didn't bet)
Seat 5: Hero folded before Flop (didn't bet)
Seat 6: 5a244e55 folded before Flop (didn't bet)


Poker Hand #RC1433084469: Hold'em No Limit  ($0.05/$0.1) - 2023/03/27 17:33:28
Table 'RushAndCash28119729' 6-max Seat #1 is the button
Seat 1: fe3ed766 ($26.15 in chips)
Seat 2: f11c009e ($18.12 in chips)
Seat 3: ed5522f4 ($10.66 in chips)
Seat 4: 42ab78a ($25.36 in chips)
Seat 5: Hero ($6.94 in chips)
Seat 6: 5eaf7af1 ($11.17 in chips)
f11c009e: posts small blind $0.05
ed5522f4: posts big blind $0.1
*** HOLE CARDS ***
Dealt to fe3ed766 
Dealt to f11c009e 
Dealt to ed5522f4 
Dealt to 42ab78a 
Dealt to Hero [4s 3h]
Dealt to 5eaf7af1 
42ab78a: folds
Hero: folds
5eaf7af1: folds
fe3ed766: folds
f11c009e: folds
Uncalled bet ($0.05) returned to ed5522f4
*** SHOWDOWN ***
ed5522f4 collected $0.1 from pot
*** SUMMARY ***
Total pot $0.1 | Rake $0 | Jackpot $0 | Bingo $0 | Fortune $0
Seat 1: fe3ed766 (button) folded before Flop (didn't bet)
Seat 2: f11c009e (small blind) folded before Flop
Seat 3: ed5522f4 (big blind) collected ($0.1)
Seat 4: 42ab78a folded before Flop (didn't bet)
Seat 5: Hero folded before Flop (didn't bet)
Seat 6: 5eaf7af1 folded before Flop (didn't bet)


Poker Hand #RC1433084418: Hold'em No Limit  ($0.05/$0.1) - 2023/03/27 17:33:24
Table 'RushAndCash28119678' 6-max Seat #1 is the button
Seat 1: 3a316667 ($15.9 in chips)
Seat 2: 81b34ae ($6.87 in chips)
Seat 3: 3a7a7d7a ($17.98 in chips)
Seat 4: f11c009e ($18.12 in chips)
Seat 5: Hero ($6.94 in chips)
Seat 6: 5a766e01 ($17.96 in chips)
81b34ae: posts small blind $0.05
3a7a7d7a: posts big blind $0.1
*** HOLE CARDS ***
Dealt to 3a316667 
Dealt to 81b34ae 
Dealt to 3a7a7d7a 
Dealt to f11c009e 
Dealt to Hero [Kd 2c]
Dealt to 5a766e01 
f11c009e: folds
Hero: folds
5a766e01: raises $0.1 to $0.2
3a316667: calls $0.2
81b34ae: raises $0.7 to $0.9
3a7a7d7a: folds
5a766e01: calls $0.7
3a316667: folds
*** FLOP *** [5c 4d Js]
81b34ae: checks
5a766e01: checks
*** TURN *** [5c 4d Js] [Td]
81b34ae: bets $1.58
5a766e01: folds
Uncalled bet ($1.58) returned to 81b34ae
*** SHOWDOWN ***
81b34ae collected $2 from pot
*** SUMMARY ***
Total pot $2.1 | Rake $0.1 | Jackpot $0 | Bingo $0 | Fortune $0
Board [5c 4d Js Td]
Seat 1: 3a316667 (button) folded before Flop
Seat 2: 81b34ae (small blind) won ($2)
Seat 3: 3a7a7d7a (big blind) folded before Flop
Seat 4: f11c009e folded before Flop (didn't bet)
Seat 5: Hero folded before Flop (didn't bet)
Seat 6: 5a766e01 folded on the Turn


Poker Hand #RC1433084342: Hold'em No Limit  ($0.05/$0.1) - 2023/03/27 17:33:13
Table 'RushAndCash28119602' 6-max Seat #1 is the button
Seat 1: 7465263d ($56.61 in chips)
Seat 2: Hero ($6.99 in chips)
Seat 3: b2858157 ($20.52 in chips)
Seat 4: e94eeb11 ($8.08 in chips)
Seat 5: 3039fe3a ($10.85 in chips)
Seat 6: cc9e00b3 ($10.9 in chips)
Hero: posts small blind $0.05
b2858157: posts big blind $0.1
*** HOLE CARDS ***
Dealt to 7465263d 
Dealt to Hero [Ks 2s]
Dealt to b2858157 
Dealt to e94eeb11 
Dealt to 3039fe3a 
Dealt to cc9e00b3 
e94eeb11: folds
3039fe3a: raises $0.2 to $0.3
cc9e00b3: folds
7465263d: folds
Hero: folds
b2858157: folds
Uncalled bet ($0.2) returned to 3039fe3a
*** SHOWDOWN ***
3039fe3a collected $0.25 from pot
*** SUMMARY ***
Total pot $0.25 | Rake $0 | Jackpot $0 | Bingo $0 | Fortune $0
Seat 1: 7465263d (button) folded before Flop (didn't bet)
Seat 2: Hero (small blind) folded before Flop
Seat 3: b2858157 (big blind) folded before Flop
Seat 4: e94eeb11 folded before Flop (didn't bet)
Seat 5: 3039fe3a collected ($0.25)
Seat 6: cc9e00b3 folded before Flop (didn't bet)


Poker Hand #RC1433084225: Hold'em No Limit  ($0.05/$0.1) - 2023/03/27 17:32:58
Table 'RushAndCash28119485' 6-max Seat #1 is the button
Seat 1: 7664d98f ($5.07 in chips)
Seat 2: 39254f48 ($11.66 in chips)
Seat 3: Hero ($7.09 in chips)
Seat 4: f2136409 ($22.13 in chips)
Seat 5: 4de4f726 ($10 in chips)
Seat 6: 68ca899f ($13.2 in chips)
39254f48: posts small blind $0.05
Hero: posts big blind $0.1
*** HOLE CARDS ***
Dealt to 7664d98f 
Dealt to 39254f48 
Dealt to Hero [9c Qh]
Dealt to f2136409 
Dealt to 4de4f726 
Dealt to 68ca899f 
f2136409: folds
4de4f726: raises $0.12 to $0.22
68ca899f: raises $0.45 to $0.67
7664d98f: folds
39254f48: folds
Hero: folds
4de4f726: raises $1.13 to $1.8
68ca899f: folds
Uncalled bet ($1.13) returned to 4de4f726
*** SHOWDOWN ***
4de4f726 collected $1.42 from pot
*** SUMMARY ***
Total pot $1.49 | Rake $0.07 | Jackpot $0 | Bingo $0 | Fortune $0
Seat 1: 7664d98f (button) folded before Flop (didn't bet)
Seat 2: 39254f48 (small blind) folded before Flop
Seat 3: Hero (big blind) folded before Flop
Seat 4: f2136409 folded before Flop (didn't bet)
Seat 5: 4de4f726 collected ($1.42)
Seat 6: 68ca899f folded before Flop


Poker Hand #RC1433084167: Hold'em No Limit  ($0.05/$0.1) - 2023/03/27 17:32:52
Table 'RushAndCash28119427' 6-max Seat #1 is the button
Seat 1: 257e716e ($12.13 in chips)
Seat 2: 473eceac ($32.95 in chips)
Seat 3: 74b29a97 ($34.83 in chips)
Seat 4: b6e90dde ($10.53 in chips)
Seat 5: 6ed3eaa3 ($27.8 in chips)
Seat 6: Hero ($7.09 in chips)
473eceac: posts small blind $0.05
74b29a97: posts big blind $0.1
*** HOLE CARDS ***
Dealt to 257e716e 
Dealt to 473eceac 
Dealt to 74b29a97 
Dealt to b6e90dde 
Dealt to 6ed3eaa3 
Dealt to Hero [3d Qc]
b6e90dde: raises $0.15 to $0.25
6ed3eaa3: raises $0.59 to $0.84
Hero: folds
257e716e: folds
473eceac: folds
74b29a97: folds
b6e90dde: calls $0.59
*** FLOP *** [2c Jd Kc]
b6e90dde: checks
6ed3eaa3: bets $1.48
b6e90dde: calls $1.48
*** TURN *** [2c Jd Kc] [3h]
b6e90dde: checks
6ed3eaa3: checks
*** RIVER *** [2c Jd Kc 3h] [9c]
b6e90dde: bets $3.6
6ed3eaa3: folds
Uncalled bet ($3.6) returned to b6e90dde
*** SHOWDOWN ***
b6e90dde collected $4.41 from pot
*** SUMMARY ***
Total pot $4.79 | Rake $0.23 | Jackpot $0.15 | Bingo $0 | Fortune $0
Board [2c Jd Kc 3h 9c]
Seat 1: 257e716e (button) folded before Flop (didn't bet)
Seat 2: 473eceac (small blind) folded before Flop
Seat 3: 74b29a97 (big blind) folded before Flop
Seat 4: b6e90dde won ($4.41)
Seat 5: 6ed3eaa3 folded on the River
Seat 6: Hero folded before Flop (didn't bet)


Poker Hand #RC1433084130: Hold'em No Limit  ($0.05/$0.1) - 2023/03/27 17:32:47
Table 'RushAndCash28119390' 6-max Seat #1 is the button
Seat 1: Hero ($7.09 in chips)
Seat 2: c3bde2ae ($17.6 in chips)
Seat 3: 388c5058 ($8.62 in chips)
Seat 4: 58ee3d06 ($19.19 in chips)
Seat 5: 2e2b67a7 ($9.86 in chips)
Seat 6: 74603b40 ($5.59 in chips)
c3bde2ae: posts small blind $0.05
388c5058: posts big blind $0.1
*** HOLE CARDS ***
Dealt to Hero [Th 4c]
Dealt to c3bde2ae 
Dealt to 388c5058 
Dealt to 58ee3d06 
Dealt to 2e2b67a7 
Dealt to 74603b40 
58ee3d06: raises $0.1 to $0.2
2e2b67a7: calls $0.2
74603b40: folds
Hero: folds
c3bde2ae: folds
388c5058: folds
*** FLOP *** [Td 7s 5s]
58ee3d06: checks
2e2b67a7: checks
*** TURN *** [Td 7s 5s] [4d]
58ee3d06: bets $0.37
2e2b67a7: calls $0.37
*** RIVER *** [Td 7s 5s 4d] [8s]
58ee3d06: bets $0.86
2e2b67a7: calls $0.86
58ee3d06: shows [Qs Qc] (Pair of Queens)
2e2b67a7: shows [3s 3d] (Pair of Treys)
*** SHOWDOWN ***
58ee3d06 collected $2.72 from pot
*** SUMMARY ***
Total pot $3.01 | Rake $0.14 | Jackpot $0.15 | Bingo $0 | Fortune $0
Board [Td 7s 5s 4d 8s]
Seat 1: Hero (button) folded before Flop (didn't bet)
Seat 2: c3bde2ae (small blind) folded before Flop
Seat 3: 388c5058 (big blind) folded before Flop
Seat 4: 58ee3d06 showed [Qs Qc] and won ($2.72) with Pair of Queens
Seat 5: 2e2b67a7 showed [3s 3d] and lost with Pair of Treys
Seat 6: 74603b40 folded before Flop (didn't bet)


Poker Hand #RC1433084024: Hold'em No Limit  ($0.05/$0.1) - 2023/03/27 17:32:35
Table 'RushAndCash28119284' 6-max Seat #1 is the button
Seat 1: Hero ($6.94 in chips)
Seat 2: faa9d389 ($8.71 in chips)
Seat 3: d4475bc5 ($12.52 in chips)
Seat 4: 2fe05c64 ($10.1 in chips)
Seat 5: bd10ae58 ($11.24 in chips)
Seat 6: a761a2ae ($15.62 in chips)
faa9d389: posts small blind $0.05
d4475bc5: posts big blind $0.1
*** HOLE CARDS ***
Dealt to Hero [9d Ac]
Dealt to faa9d389 
Dealt to d4475bc5 
Dealt to 2fe05c64 
Dealt to bd10ae58 
Dealt to a761a2ae 
2fe05c64: folds
bd10ae58: folds
a761a2ae: folds
Hero: raises $0.15 to $0.25
faa9d389: folds
d4475bc5: folds
Uncalled bet ($0.15) returned to Hero
*** SHOWDOWN ***
Hero collected $0.25 from pot
*** SUMMARY ***
Total pot $0.25 | Rake $0 | Jackpot $0 | Bingo $0 | Fortune $0
Seat 1: Hero (button) collected ($0.25)
Seat 2: faa9d389 (small blind) folded before Flop
Seat 3: d4475bc5 (big blind) folded before Flop
Seat 4: 2fe05c64 folded before Flop (didn't bet)
Seat 5: bd10ae58 folded before Flop (didn't bet)
Seat 6: a761a2ae folded before Flop (didn't bet)


Poker Hand #RC1433083894: Hold'em No Limit  ($0.05/$0.1) - 2023/03/27 17:32:20
Table 'RushAndCash28119154' 6-max Seat #1 is the button
Seat 1: f39352a8 ($22.48 in chips)
Seat 2: aaf62778 ($12.06 in chips)
Seat 3: Hero ($7.04 in chips)
Seat 4: cf224d9 ($16.26 in chips)
Seat 5: 36216ab ($10.37 in chips)
Seat 6: 522e6aae ($27.35 in chips)
aaf62778: posts small blind $0.05
Hero: posts big blind $0.1
*** HOLE CARDS ***
Dealt to f39352a8 
Dealt to aaf62778 
Dealt to Hero [5h 8d]
Dealt to cf224d9 
Dealt to 36216ab 
Dealt to 522e6aae 
cf224d9: folds
36216ab: folds
522e6aae: raises $0.12 to $0.22
f39352a8: folds
aaf62778: folds
Hero: folds
Uncalled bet ($0.12) returned to 522e6aae
*** SHOWDOWN ***
522e6aae collected $0.25 from pot
*** SUMMARY ***
Total pot $0.25 | Rake $0 | Jackpot $0 | Bingo $0 | Fortune $0
Seat 1: f39352a8 (button) folded before Flop (didn't bet)
Seat 2: aaf62778 (small blind) folded before Flop
Seat 3: Hero (big blind) folded before Flop
Seat 4: cf224d9 folded before Flop (didn't bet)
Seat 5: 36216ab folded before Flop (didn't bet)
Seat 6: 522e6aae collected ($0.25)


Poker Hand #RC1433083859: Hold'em No Limit  ($0.05/$0.1) - 2023/03/27 17:32:16
Table 'RushAndCash28119119' 6-max Seat #1 is the button
Seat 1: 1284d181 ($11.3 in chips)
Seat 2: b3f12672 ($35.56 in chips)
Seat 3: f59049c9 ($15.36 in chips)
Seat 4: bad1df0e ($10.51 in chips)
Seat 5: Hero ($7.04 in chips)
Seat 6: 7bf5144f ($19.18 in chips)
b3f12672: posts small blind $0.05
f59049c9: posts big blind $0.1
*** HOLE CARDS ***
Dealt to 1284d181 
Dealt to b3f12672 
Dealt to f59049c9 
Dealt to bad1df0e 
Dealt to Hero [2d 8s]
Dealt to 7bf5144f 
bad1df0e: folds
Hero: folds
7bf5144f: folds
1284d181: raises $0.15 to $0.25
b3f12672: folds
f59049c9: folds
Uncalled bet ($0.15) returned to 1284d181
*** SHOWDOWN ***
1284d181 collected $0.25 from pot
*** SUMMARY ***
Total pot $0.25 | Rake $0 | Jackpot $0 | Bingo $0 | Fortune $0
Seat 1: 1284d181 (button) collected ($0.25)
Seat 2: b3f12672 (small blind) folded before Flop
Seat 3: f59049c9 (big blind) folded before Flop
Seat 4: bad1df0e folded before Flop (didn't bet)
Seat 5: Hero folded before Flop (didn't bet)
Seat 6: 7bf5144f folded before Flop (didn't bet)


Poker Hand #RC1433083671: Hold'em No Limit  ($0.05/$0.1) - 2023/03/27 17:31:53
Table 'RushAndCash28118931' 6-max Seat #1 is the button
Seat 1: 921a7c70 ($10.2 in chips)
Seat 2: Hero ($7.09 in chips)
Seat 3: 3c0e3508 ($10 in chips)
Seat 4: c582b1c1 ($10.46 in chips)
Seat 5: fe3ed766 ($26.7 in chips)
Seat 6: a60f7dd6 ($19.39 in chips)
Hero: posts small blind $0.05
3c0e3508: posts big blind $0.1
*** HOLE CARDS ***
Dealt to 921a7c70 
Dealt to Hero [2c 5c]
Dealt to 3c0e3508 
Dealt to c582b1c1 
Dealt to fe3ed766 
Dealt to a60f7dd6 
c582b1c1: folds
fe3ed766: folds
a60f7dd6: folds
921a7c70: raises $0.1 to $0.2
Hero: folds
3c0e3508: calls $0.1
*** FLOP *** [8s 7s Kc]
3c0e3508: checks
921a7c70: checks
*** TURN *** [8s 7s Kc] [4c]
3c0e3508: checks
921a7c70: checks
*** RIVER *** [8s 7s Kc 4c] [3h]
3c0e3508: checks
921a7c70: checks
3c0e3508: shows [Td Ah] (Ace-High)
921a7c70: shows [2d Ad] (Ace-High)
*** SHOWDOWN ***
3c0e3508 collected $0.43 from pot
*** SUMMARY ***
Total pot $0.45 | Rake $0.02 | Jackpot $0 | Bingo $0 | Fortune $0
Board [8s 7s Kc 4c 3h]
Seat 1: 921a7c70 (button) showed [2d Ad] and lost with Ace-High
Seat 2: Hero (small blind) folded before Flop
Seat 3: 3c0e3508 (big blind) showed [Td Ah] and won ($0.43) with Ace-High
Seat 4: c582b1c1 folded before Flop (didn't bet)
Seat 5: fe3ed766 folded before Flop (didn't bet)
Seat 6: a60f7dd6 folded before Flop (didn't bet)


Poker Hand #RC1433083575: Hold'em No Limit  ($0.05/$0.1) - 2023/03/27 17:31:40
Table 'RushAndCash28118835' 6-max Seat #1 is the button
Seat 1: 2ec58e7e ($10.26 in chips)
Seat 2: 2290619f ($22.92 in chips)
Seat 3: 4c6bd865 ($11.22 in chips)
Seat 4: 5aa8835f ($24.74 in chips)
Seat 5: a761a2ae ($15.62 in chips)
Seat 6: Hero ($6.94 in chips)
2290619f: posts small blind $0.05
4c6bd865: posts big blind $0.1
*** HOLE CARDS ***
Dealt to 2ec58e7e 
Dealt to 2290619f 
Dealt to 4c6bd865 
Dealt to 5aa8835f 
Dealt to a761a2ae 
Dealt to Hero [Kh Qd]
5aa8835f: folds
a761a2ae: folds
Hero: raises $0.15 to $0.25
2ec58e7e: folds
2290619f: folds
4c6bd865: folds
Uncalled bet ($0.15) returned to Hero
*** SHOWDOWN ***
Hero collected $0.25 from pot
*** SUMMARY ***
Total pot $0.25 | Rake $0 | Jackpot $0 | Bingo $0 | Fortune $0
Seat 1: 2ec58e7e (button) folded before Flop (didn't bet)
Seat 2: 2290619f (small blind) folded before Flop
Seat 3: 4c6bd865 (big blind) folded before Flop
Seat 4: 5aa8835f folded before Flop (didn't bet)
Seat 5: a761a2ae folded before Flop (didn't bet)
Seat 6: Hero collected ($0.25)


Poker Hand #RC1433083278: Hold'em No Limit  ($0.05/$0.1) - 2023/03/27 17:31:04
Table 'RushAndCash28118538' 6-max Seat #1 is the button
Seat 1: 2290619f ($22.55 in chips)
Seat 2: f562905b ($11.45 in chips)
Seat 3: 928a8131 ($18.32 in chips)
Seat 4: 4f08b426 ($35.01 in chips)
Seat 5: Hero ($7.19 in chips)
Seat 6: ef6d8835 ($10.15 in chips)
f562905b: posts small blind $0.05
928a8131: posts big blind $0.1
*** HOLE CARDS ***
Dealt to 2290619f 
Dealt to f562905b 
Dealt to 928a8131 
Dealt to 4f08b426 
Dealt to Hero [7d Ad]
Dealt to ef6d8835 
4f08b426: folds
Hero: raises $0.15 to $0.25
ef6d8835: folds
2290619f: raises $0.49 to $0.74
f562905b: folds
928a8131: folds
Hero: folds
Uncalled bet ($0.49) returned to 2290619f
*** SHOWDOWN ***
2290619f collected $0.62 from pot
*** SUMMARY ***
Total pot $0.65 | Rake $0.03 | Jackpot $0 | Bingo $0 | Fortune $0
Seat 1: 2290619f (button) collected ($0.62)
Seat 2: f562905b (small blind) folded before Flop
Seat 3: 928a8131 (big blind) folded before Flop
Seat 4: 4f08b426 folded before Flop (didn't bet)
Seat 5: Hero folded before Flop
Seat 6: ef6d8835 folded before Flop (didn't bet)


Poker Hand #RC1433083175: Hold'em No Limit  ($0.05/$0.1) - 2023/03/27 17:30:50
Table 'RushAndCash28118435' 6-max Seat #1 is the button
Seat 1: ed6c7787 ($41.4 in chips)
Seat 2: b22f7c0e ($10.77 in chips)
Seat 3: 89af52a7 ($11.42 in chips)
Seat 4: c6ac98f6 ($23.75 in chips)
Seat 5: 8b8d803b ($10.43 in chips)
Seat 6: Hero ($7.19 in chips)
b22f7c0e: posts small blind $0.05
89af52a7: posts big blind $0.1
*** HOLE CARDS ***
Dealt to ed6c7787 
Dealt to b22f7c0e 
Dealt to 89af52a7 
Dealt to c6ac98f6 
Dealt to 8b8d803b 
Dealt to Hero [7s Qh]
c6ac98f6: folds
8b8d803b: folds
Hero: folds
ed6c7787: folds
b22f7c0e: folds
Uncalled bet ($0.05) returned to 89af52a7
*** SHOWDOWN ***
89af52a7 collected $0.1 from pot
*** SUMMARY ***
Total pot $0.1 | Rake $0 | Jackpot $0 | Bingo $0 | Fortune $0
Seat 1: ed6c7787 (button) folded before Flop (didn't bet)
Seat 2: b22f7c0e (small blind) folded before Flop
Seat 3: 89af52a7 (big blind) collected ($0.1)
Seat 4: c6ac98f6 folded before Flop (didn't bet)
Seat 5: 8b8d803b folded before Flop (didn't bet)
Seat 6: Hero folded before Flop (didn't bet)


Poker Hand #RC1433082966: Hold'em No Limit  ($0.05/$0.1) - 2023/03/27 17:30:24
Table 'RushAndCash28118226' 6-max Seat #1 is the button
Seat 1: 37390712 ($10.23 in chips)
Seat 2: Hero ($6.89 in chips)
Seat 3: 81b34ae ($7.3 in chips)
Seat 4: 774e1277 ($10 in chips)
Seat 5: e5b46bc ($21.94 in chips)
Seat 6: e88c8126 ($10.66 in chips)
Hero: posts small blind $0.05
81b34ae: posts big blind $0.1
*** HOLE CARDS ***
Dealt to 37390712 
Dealt to Hero [Ad Jc]
Dealt to 81b34ae 
Dealt to 774e1277 
Dealt to e5b46bc 
Dealt to e88c8126 
774e1277: raises $0.12 to $0.22
e5b46bc: folds
e88c8126: folds
37390712: folds
Hero: raises $0.68 to $0.9
81b34ae: folds
774e1277: folds
Uncalled bet ($0.68) returned to Hero
*** SHOWDOWN ***
Hero collected $0.52 from pot
*** SUMMARY ***
Total pot $0.54 | Rake $0.02 | Jackpot $0 | Bingo $0 | Fortune $0
Seat 1: 37390712 (button) folded before Flop (didn't bet)
Seat 2: Hero (small blind) collected ($0.52)
Seat 3: 81b34ae (big blind) folded before Flop
Seat 4: 774e1277 folded before Flop
Seat 5: e5b46bc folded before Flop (didn't bet)
Seat 6: e88c8126 folded before Flop (didn't bet)


Poker Hand #RC1433082872: Hold'em No Limit  ($0.05/$0.1) - 2023/03/27 17:30:12
Table 'RushAndCash28118132' 6-max Seat #1 is the button
Seat 1: Hero ($6.89 in chips)
Seat 2: b42a2f79 ($9.9 in chips)
Seat 3: e5b46bc ($22.04 in chips)
Seat 4: c8a3f905 ($25.53 in chips)
Seat 5: 6c77f1aa ($10.42 in chips)
Seat 6: 3039fe3a ($10 in chips)
b42a2f79: posts small blind $0.05
e5b46bc: posts big blind $0.1
*** HOLE CARDS ***
Dealt to Hero [Kh 9h]
Dealt to b42a2f79 
Dealt to e5b46bc 
Dealt to c8a3f905 
Dealt to 6c77f1aa 
Dealt to 3039fe3a 
c8a3f905: folds
6c77f1aa: folds
3039fe3a: raises $0.2 to $0.3
Hero: folds
b42a2f79: folds
e5b46bc: folds
Uncalled bet ($0.2) returned to 3039fe3a
*** SHOWDOWN ***
3039fe3a collected $0.25 from pot
*** SUMMARY ***
Total pot $0.25 | Rake $0 | Jackpot $0 | Bingo $0 | Fortune $0
Seat 1: Hero (button) folded before Flop (didn't bet)
Seat 2: b42a2f79 (small blind) folded before Flop
Seat 3: e5b46bc (big blind) folded before Flop
Seat 4: c8a3f905 folded before Flop (didn't bet)
Seat 5: 6c77f1aa folded before Flop (didn't bet)
Seat 6: 3039fe3a collected ($0.25)


Poker Hand #RC1433082793: Hold'em No Limit  ($0.05/$0.1) - 2023/03/27 17:30:01
Table 'RushAndCash28118053' 6-max Seat #1 is the button
Seat 1: cabb2b81 ($7.19 in chips)
Seat 2: f39352a8 ($22.78 in chips)
Seat 3: 7abbb372 ($4.52 in chips)
Seat 4: cddfbe6c ($13.08 in chips)
Seat 5: 2d406ff5 ($13.68 in chips)
Seat 6: Hero ($6.89 in chips)
f39352a8: posts small blind $0.05
7abbb372: posts big blind $0.1
*** HOLE CARDS ***
Dealt to cabb2b81 
Dealt to f39352a8 
Dealt to 7abbb372 
Dealt to cddfbe6c 
Dealt to 2d406ff5 
Dealt to Hero [9h 2s]
cddfbe6c: folds
2d406ff5: folds
Hero: folds
cabb2b81: folds
f39352a8: folds
Uncalled bet ($0.05) returned to 7abbb372
*** SHOWDOWN ***
7abbb372 collected $0.1 from pot
*** SUMMARY ***
Total pot $0.1 | Rake $0 | Jackpot $0 | Bingo $0 | Fortune $0
Seat 1: cabb2b81 (button) folded before Flop (didn't bet)
Seat 2: f39352a8 (small blind) folded before Flop
Seat 3: 7abbb372 (big blind) collected ($0.1)
Seat 4: cddfbe6c folded before Flop (didn't bet)
Seat 5: 2d406ff5 folded before Flop (didn't bet)
Seat 6: Hero folded before Flop (didn't bet)


Poker Hand #RC1433082723: Hold'em No Limit  ($0.05/$0.1) - 2023/03/27 17:29:52
Table 'RushAndCash28117983' 6-max Seat #1 is the button
Seat 1: b16371ea ($19.35 in chips)
Seat 2: 634823fc ($10 in chips)
Seat 3: Hero ($6.99 in chips)
Seat 4: 3a316667 ($15.4 in chips)
Seat 5: ead60f34 ($30.29 in chips)
Seat 6: 3bfa5da4 ($6.6 in chips)
634823fc: posts small blind $0.05
Hero: posts big blind $0.1
*** HOLE CARDS ***
Dealt to b16371ea 
Dealt to 634823fc 
Dealt to Hero [Tc 5h]
Dealt to 3a316667 
Dealt to ead60f34 
Dealt to 3bfa5da4 
3a316667: calls $0.1
ead60f34: folds
3bfa5da4: raises $0.1 to $0.2
b16371ea: folds
634823fc: folds
Hero: folds
3a316667: calls $0.1
*** FLOP *** [Th 5d 5s]
3a316667: checks
3bfa5da4: bets $0.19
3a316667: folds
Uncalled bet ($0.19) returned to 3bfa5da4
*** SHOWDOWN ***
3bfa5da4 collected $0.53 from pot
*** SUMMARY ***
Total pot $0.55 | Rake $0.02 | Jackpot $0 | Bingo $0 | Fortune $0
Board [Th 5d 5s]
Seat 1: b16371ea (button) folded before Flop (didn't bet)
Seat 2: 634823fc (small blind) folded before Flop
Seat 3: Hero (big blind) folded before Flop
Seat 4: 3a316667 folded on the Flop
Seat 5: ead60f34 folded before Flop (didn't bet)
Seat 6: 3bfa5da4 won ($0.53)


Poker Hand #RC1433082685: Hold'em No Limit  ($0.05/$0.1) - 2023/03/27 17:29:47
Table 'RushAndCash28117945' 6-max Seat #1 is the button
Seat 1: 89af52a7 ($11.87 in chips)
Seat 2: 95b929f5 ($40.43 in chips)
Seat 3: ec8b7888 ($10.18 in chips)
Seat 4: Hero ($6.99 in chips)
Seat 5: 3ac3bff5 ($17.31 in chips)
Seat 6: c664417c ($10.93 in chips)
95b929f5: posts small blind $0.05
ec8b7888: posts big blind $0.1
*** HOLE CARDS ***
Dealt to 89af52a7 
Dealt to 95b929f5 
Dealt to ec8b7888 
Dealt to Hero [7c 9h]
Dealt to 3ac3bff5 
Dealt to c664417c 
Hero: folds
3ac3bff5: folds
c664417c: folds
89af52a7: raises $0.2 to $0.3
95b929f5: raises $0.98 to $1.28
ec8b7888: folds
89af52a7: folds
Uncalled bet ($0.98) returned to 95b929f5
*** SHOWDOWN ***
95b929f5 collected $0.67 from pot
*** SUMMARY ***
Total pot $0.7 | Rake $0.03 | Jackpot $0 | Bingo $0 | Fortune $0
Seat 1: 89af52a7 (button) folded before Flop
Seat 2: 95b929f5 (small blind) collected ($0.67)
Seat 3: ec8b7888 (big blind) folded before Flop
Seat 4: Hero folded before Flop (didn't bet)
Seat 5: 3ac3bff5 folded before Flop (didn't bet)
Seat 6: c664417c folded before Flop (didn't bet)


Poker Hand #RC1433082642: Hold'em No Limit  ($0.05/$0.1) - 2023/03/27 17:29:42
Table 'RushAndCash28117902' 6-max Seat #1 is the button
Seat 1: 5a766e01 ($17.68 in chips)
Seat 2: b61285b8 ($18.04 in chips)
Seat 3: 6cb96036 ($10 in chips)
Seat 4: 921a7c70 ($9.85 in chips)
Seat 5: Hero ($6.99 in chips)
Seat 6: 48e6a4d7 ($8.27 in chips)
b61285b8: posts small blind $0.05
6cb96036: posts big blind $0.1
*** HOLE CARDS ***
Dealt to 5a766e01 
Dealt to b61285b8 
Dealt to 6cb96036 
Dealt to 921a7c70 
Dealt to Hero [9h 3s]
Dealt to 48e6a4d7 
921a7c70: folds
Hero: folds
48e6a4d7: folds
5a766e01: folds
b61285b8: raises $0.2 to $0.3
6cb96036: folds
Uncalled bet ($0.2) returned to b61285b8
*** SHOWDOWN ***
b61285b8 collected $0.2 from pot
*** SUMMARY ***
Total pot $0.2 | Rake $0 | Jackpot $0 | Bingo $0 | Fortune $0
Seat 1: 5a766e01 (button) folded before Flop (didn't bet)
Seat 2: b61285b8 (small blind) collected ($0.2)
Seat 3: 6cb96036 (big blind) folded before Flop
Seat 4: 921a7c70 folded before Flop (didn't bet)
Seat 5: Hero folded before Flop (didn't bet)
Seat 6: 48e6a4d7 folded before Flop (didn't bet)


Poker Hand #RC1433082516: Hold'em No Limit  ($0.05/$0.1) - 2023/03/27 17:29:27
Table 'RushAndCash28117776' 6-max Seat #1 is the button
Seat 1: 3e2b9a67 ($27.62 in chips)
Seat 2: Hero ($7.04 in chips)
Seat 3: 4753f39d ($10.51 in chips)
Seat 4: cd5c6a84 ($12.49 in chips)
Seat 5: ddb34b78 ($11.6 in chips)
Seat 6: cbd5f4f9 ($10.83 in chips)
Hero: posts small blind $0.05
4753f39d: posts big blind $0.1
*** HOLE CARDS ***
Dealt to 3e2b9a67 
Dealt to Hero [8c Jc]
Dealt to 4753f39d 
Dealt to cd5c6a84 
Dealt to ddb34b78 
Dealt to cbd5f4f9 
cd5c6a84: raises $0.1 to $0.2
ddb34b78: folds
cbd5f4f9: folds
3e2b9a67: folds
Hero: folds
4753f39d: calls $0.1
*** FLOP *** [4d 3d 8h]
4753f39d: checks
cd5c6a84: checks
*** TURN *** [4d 3d 8h] [2c]
4753f39d: checks
cd5c6a84: checks
*** RIVER *** [4d 3d 8h 2c] [Jh]
4753f39d: bets $0.34
cd5c6a84: calls $0.34
4753f39d: shows [Td Js] (Pair of Jacks)
cd5c6a84: shows [Ks 5s] (King-High)
*** SHOWDOWN ***
4753f39d collected $1.08 from pot
*** SUMMARY ***
Total pot $1.13 | Rake $0.05 | Jackpot $0 | Bingo $0 | Fortune $0
Board [4d 3d 8h 2c Jh]
Seat 1: 3e2b9a67 (button) folded before Flop (didn't bet)
Seat 2: Hero (small blind) folded before Flop
Seat 3: 4753f39d (big blind) showed [Td Js] and won ($1.08) with Pair of Jacks
Seat 4: cd5c6a84 showed [Ks 5s] and lost with King-High
Seat 5: ddb34b78 folded before Flop (didn't bet)
Seat 6: cbd5f4f9 folded before Flop (didn't bet)


Poker Hand #RC1433082477: Hold'em No Limit  ($0.05/$0.1) - 2023/03/27 17:29:22
Table 'RushAndCash28117737' 6-max Seat #1 is the button
Seat 1: 4e2d663c ($11.81 in chips)
Seat 2: f33fe7e7 ($10.25 in chips)
Seat 3: 5e48c2dc ($11.31 in chips)
Seat 4: 74829e10 ($15.02 in chips)
Seat 5: Hero ($7.04 in chips)
Seat 6: e5b46bc ($22.04 in chips)
f33fe7e7: posts small blind $0.05
5e48c2dc: posts big blind $0.1
*** HOLE CARDS ***
Dealt to 4e2d663c 
Dealt to f33fe7e7 
Dealt to 5e48c2dc 
Dealt to 74829e10 
Dealt to Hero [5h Qc]
Dealt to e5b46bc 
74829e10: folds
Hero: folds
e5b46bc: raises $0.1 to $0.2
4e2d663c: folds
f33fe7e7: folds
5e48c2dc: folds
Uncalled bet ($0.1) returned to e5b46bc
*** SHOWDOWN ***
e5b46bc collected $0.25 from pot
*** SUMMARY ***
Total pot $0.25 | Rake $0 | Jackpot $0 | Bingo $0 | Fortune $0
Seat 1: 4e2d663c (button) folded before Flop (didn't bet)
Seat 2: f33fe7e7 (small blind) folded before Flop
Seat 3: 5e48c2dc (big blind) folded before Flop
Seat 4: 74829e10 folded before Flop (didn't bet)
Seat 5: Hero folded before Flop (didn't bet)
Seat 6: e5b46bc collected ($0.25)


Poker Hand #RC1433082360: Hold'em No Limit  ($0.05/$0.1) - 2023/03/27 17:29:07
Table 'RushAndCash28117620' 6-max Seat #1 is the button
Seat 1: Hero ($6.89 in chips)
Seat 2: 26faa500 ($26.4 in chips)
Seat 3: c7a62b4b ($18.08 in chips)
Seat 4: 64cd462a ($10.37 in chips)
Seat 5: 30af4b6d ($18 in chips)
Seat 6: ea38e6ed ($10.15 in chips)
26faa500: posts small blind $0.05
c7a62b4b: posts big blind $0.1
*** HOLE CARDS ***
Dealt to Hero [2h Kh]
Dealt to 26faa500 
Dealt to c7a62b4b 
Dealt to 64cd462a 
Dealt to 30af4b6d 
Dealt to ea38e6ed 
64cd462a: folds
30af4b6d: raises $0.15 to $0.25
ea38e6ed: folds
Hero: folds
26faa500: folds
c7a62b4b: folds
Uncalled bet ($0.15) returned to 30af4b6d
*** SHOWDOWN ***
30af4b6d collected $0.25 from pot
*** SUMMARY ***
Total pot $0.25 | Rake $0 | Jackpot $0 | Bingo $0 | Fortune $0
Seat 1: Hero (button) folded before Flop (didn't bet)
Seat 2: 26faa500 (small blind) folded before Flop
Seat 3: c7a62b4b (big blind) folded before Flop
Seat 4: 64cd462a folded before Flop (didn't bet)
Seat 5: 30af4b6d collected ($0.25)
Seat 6: ea38e6ed folded before Flop (didn't bet)


Poker Hand #RC1433082310: Hold'em No Limit  ($0.05/$0.1) - 2023/03/27 17:29:01
Table 'RushAndCash28117570' 6-max Seat #1 is the button
Seat 1: c263b8d2 ($13.45 in chips)
Seat 2: 36216ab ($10 in chips)
Seat 3: Hero ($6.99 in chips)
Seat 4: b61285b8 ($17.72 in chips)
Seat 5: 9e22aea0 ($9.65 in chips)
Seat 6: b59f0022 ($10 in chips)
36216ab: posts small blind $0.05
Hero: posts big blind $0.1
*** HOLE CARDS ***
Dealt to c263b8d2 
Dealt to 36216ab 
Dealt to Hero [2s 8s]
Dealt to b61285b8 
Dealt to 9e22aea0 
Dealt to b59f0022 
b61285b8: folds
9e22aea0: folds
b59f0022: folds
c263b8d2: folds
36216ab: folds
Uncalled bet ($0.05) returned to Hero
*** SHOWDOWN ***
Hero collected $0.1 from pot
*** SUMMARY ***
Total pot $0.1 | Rake $0 | Jackpot $0 | Bingo $0 | Fortune $0
Seat 1: c263b8d2 (button) folded before Flop (didn't bet)
Seat 2: 36216ab (small blind) folded before Flop
Seat 3: Hero (big blind) collected ($0.1)
Seat 4: b61285b8 folded before Flop (didn't bet)
Seat 5: 9e22aea0 folded before Flop (didn't bet)
Seat 6: b59f0022 folded before Flop (didn't bet)


Poker Hand #RC1433082221: Hold'em No Limit  ($0.05/$0.1) - 2023/03/27 17:28:51
Table 'RushAndCash28117481' 6-max Seat #1 is the button
Seat 1: 8297795f ($8.4 in chips)
Seat 2: a66b1113 ($10.91 in chips)
Seat 3: db3ad505 ($24.51 in chips)
Seat 4: 18f41552 ($10 in chips)
Seat 5: 77410b95 ($8.57 in chips)
Seat 6: Hero ($6.99 in chips)
a66b1113: posts small blind $0.05
db3ad505: posts big blind $0.1
*** HOLE CARDS ***
Dealt to 8297795f 
Dealt to a66b1113 
Dealt to db3ad505 
Dealt to 18f41552 
Dealt to 77410b95 
Dealt to Hero [9s Qs]
18f41552: folds
77410b95: folds
Hero: folds
8297795f: folds
a66b1113: folds
Uncalled bet ($0.05) returned to db3ad505
*** SHOWDOWN ***
db3ad505 collected $0.1 from pot
*** SUMMARY ***
Total pot $0.1 | Rake $0 | Jackpot $0 | Bingo $0 | Fortune $0
Seat 1: 8297795f (button) folded before Flop (didn't bet)
Seat 2: a66b1113 (small blind) folded before Flop
Seat 3: db3ad505 (big blind) collected ($0.1)
Seat 4: 18f41552 folded before Flop (didn't bet)
Seat 5: 77410b95 folded before Flop (didn't bet)
Seat 6: Hero folded before Flop (didn't bet)


Poker Hand #RC1433082191: Hold'em No Limit  ($0.05/$0.1) - 2023/03/27 17:28:46
Table 'RushAndCash28117451' 6-max Seat #1 is the button
Seat 1: 100cfe44 ($9.7 in chips)
Seat 2: 435c6e22 ($27.19 in chips)
Seat 3: be319e8d ($10 in chips)
Seat 4: 77410b95 ($8.57 in chips)
Seat 5: Hero ($6.99 in chips)
Seat 6: 74aeaadc ($11.9 in chips)
435c6e22: posts small blind $0.05
be319e8d: posts big blind $0.1
*** HOLE CARDS ***
Dealt to 100cfe44 
Dealt to 435c6e22 
Dealt to be319e8d 
Dealt to 77410b95 
Dealt to Hero [7d Kc]
Dealt to 74aeaadc 
77410b95: folds
Hero: folds
74aeaadc: raises $0.1 to $0.2
100cfe44: folds
435c6e22: folds
be319e8d: raises $0.6 to $0.8
74aeaadc: raises $11.1 to $11.9 and is all-in
be319e8d: folds
Uncalled bet ($11.1) returned to 74aeaadc
*** SHOWDOWN ***
74aeaadc collected $1.57 from pot
*** SUMMARY ***
Total pot $1.65 | Rake $0.08 | Jackpot $0 | Bingo $0 | Fortune $0
Seat 1: 100cfe44 (button) folded before Flop (didn't bet)
Seat 2: 435c6e22 (small blind) folded before Flop
Seat 3: be319e8d (big blind) folded before Flop
Seat 4: 77410b95 folded before Flop (didn't bet)
Seat 5: Hero folded before Flop (didn't bet)
Seat 6: 74aeaadc collected ($1.57)


Poker Hand #RC1433081983: Hold'em No Limit  ($0.05/$0.1) - 2023/03/27 17:28:21
Table 'RushAndCash28117243' 6-max Seat #1 is the button
Seat 1: 5063464 ($11.49 in chips)
Seat 2: Hero ($7.04 in chips)
Seat 3: 2b8cd0ed ($9.78 in chips)
Seat 4: 221ae483 ($16.56 in chips)
Seat 5: 26c0a518 ($14.29 in chips)
Seat 6: c1a5302a ($12.95 in chips)
Hero: posts small blind $0.05
2b8cd0ed: posts big blind $0.1
*** HOLE CARDS ***
Dealt to 5063464 
Dealt to Hero [As 6c]
Dealt to 2b8cd0ed 
Dealt to 221ae483 
Dealt to 26c0a518 
Dealt to c1a5302a 
221ae483: folds
26c0a518: folds
c1a5302a: raises $0.15 to $0.25
5063464: raises $0.59 to $0.84
Hero: folds
2b8cd0ed: folds
c1a5302a: raises $1.49 to $2.33
5063464: folds
Uncalled bet ($1.49) returned to c1a5302a
*** SHOWDOWN ***
c1a5302a collected $1.74 from pot
*** SUMMARY ***
Total pot $1.83 | Rake $0.09 | Jackpot $0 | Bingo $0 | Fortune $0
Seat 1: 5063464 (button) folded before Flop
Seat 2: Hero (small blind) folded before Flop
Seat 3: 2b8cd0ed (big blind) folded before Flop
Seat 4: 221ae483 folded before Flop (didn't bet)
Seat 5: 26c0a518 folded before Flop (didn't bet)
Seat 6: c1a5302a collected ($1.74)


Poker Hand #RC1433081867: Hold'em No Limit  ($0.05/$0.1) - 2023/03/27 17:28:07
Table 'RushAndCash28117127' 6-max Seat #1 is the button
Seat 1: 388c5058 ($8.18 in chips)
Seat 2: a95d92b1 ($23.11 in chips)
Seat 3: Hero ($7.14 in chips)
Seat 4: 19d4da35 ($10.67 in chips)
Seat 5: 90f63f70 ($14.36 in chips)
Seat 6: 100cfe44 ($9.85 in chips)
a95d92b1: posts small blind $0.05
Hero: posts big blind $0.1
*** HOLE CARDS ***
Dealt to 388c5058 
Dealt to a95d92b1 
Dealt to Hero [3s Td]
Dealt to 19d4da35 
Dealt to 90f63f70 
Dealt to 100cfe44 
19d4da35: folds
90f63f70: raises $0.15 to $0.25
100cfe44: folds
388c5058: raises $0.49 to $0.74
a95d92b1: folds
Hero: folds
90f63f70: folds
Uncalled bet ($0.49) returned to 388c5058
*** SHOWDOWN ***
388c5058 collected $0.62 from pot
*** SUMMARY ***
Total pot $0.65 | Rake $0.03 | Jackpot $0 | Bingo $0 | Fortune $0
Seat 1: 388c5058 (button) collected ($0.62)
Seat 2: a95d92b1 (small blind) folded before Flop
Seat 3: Hero (big blind) folded before Flop
Seat 4: 19d4da35 folded before Flop (didn't bet)
Seat 5: 90f63f70 folded before Flop
Seat 6: 100cfe44 folded before Flop (didn't bet)


Poker Hand #RC1433081742: Hold'em No Limit  ($0.05/$0.1) - 2023/03/27 17:27:53
Table 'RushAndCash28117002' 6-max Seat #1 is the button
Seat 1: Hero ($7.14 in chips)
Seat 2: 3dae7bec ($16.45 in chips)
Seat 3: b04ff204 ($11.24 in chips)
Seat 4: 2ade479b ($9.09 in chips)
Seat 5: d4d1ee92 ($12.27 in chips)
Seat 6: 386be875 ($8.45 in chips)
3dae7bec: posts small blind $0.05
b04ff204: posts big blind $0.1
*** HOLE CARDS ***
Dealt to Hero [3d 5h]
Dealt to 3dae7bec 
Dealt to b04ff204 
Dealt to 2ade479b 
Dealt to d4d1ee92 
Dealt to 386be875 
2ade479b: folds
d4d1ee92: raises $0.15 to $0.25
386be875: raises $0.65 to $0.9
Hero: folds
3dae7bec: folds
b04ff204: folds
d4d1ee92: folds
Uncalled bet ($0.65) returned to 386be875
*** SHOWDOWN ***
386be875 collected $0.62 from pot
*** SUMMARY ***
Total pot $0.65 | Rake $0.03 | Jackpot $0 | Bingo $0 | Fortune $0
Seat 1: Hero (button) folded before Flop (didn't bet)
Seat 2: 3dae7bec (small blind) folded before Flop
Seat 3: b04ff204 (big blind) folded before Flop
Seat 4: 2ade479b folded before Flop (didn't bet)
Seat 5: d4d1ee92 folded before Flop
Seat 6: 386be875 collected ($0.62)


Poker Hand #RC1433081705: Hold'em No Limit  ($0.05/$0.1) - 2023/03/27 17:27:48
Table 'RushAndCash28116965' 6-max Seat #1 is the button
Seat 1: 80b3e3d5 ($10.84 in chips)
Seat 2: 1e5bbb7c ($10 in chips)
Seat 3: a18501e2 ($11.02 in chips)
Seat 4: b9383651 ($10.47 in chips)
Seat 5: 9fd5dd6d ($26.64 in chips)
Seat 6: Hero ($7.14 in chips)
1e5bbb7c: posts small blind $0.05
a18501e2: posts big blind $0.1
*** HOLE CARDS ***
Dealt to 80b3e3d5 
Dealt to 1e5bbb7c 
Dealt to a18501e2 
Dealt to b9383651 
Dealt to 9fd5dd6d 
Dealt to Hero [4s Jh]
b9383651: folds
9fd5dd6d: folds
Hero: folds
80b3e3d5: folds
1e5bbb7c: folds
Uncalled bet ($0.05) returned to a18501e2
*** SHOWDOWN ***
a18501e2 collected $0.1 from pot
*** SUMMARY ***
Total pot $0.1 | Rake $0 | Jackpot $0 | Bingo $0 | Fortune $0
Seat 1: 80b3e3d5 (button) folded before Flop (didn't bet)
Seat 2: 1e5bbb7c (small blind) folded before Flop
Seat 3: a18501e2 (big blind) collected ($0.1)
Seat 4: b9383651 folded before Flop (didn't bet)
Seat 5: 9fd5dd6d folded before Flop (didn't bet)
Seat 6: Hero folded before Flop (didn't bet)


Poker Hand #RC1433081662: Hold'em No Limit  ($0.05/$0.1) - 2023/03/27 17:27:43
Table 'RushAndCash28116922' 6-max Seat #1 is the button
Seat 1: e9e25e5e ($14.7 in chips)
Seat 2: c1a5302a ($13.1 in chips)
Seat 3: b16371ea ($10.1 in chips)
Seat 4: Hero ($7.14 in chips)
Seat 5: 4c905003 ($20.98 in chips)
Seat 6: 5b06e1bc ($8.75 in chips)
c1a5302a: posts small blind $0.05
b16371ea: posts big blind $0.1
*** HOLE CARDS ***
Dealt to e9e25e5e 
Dealt to c1a5302a 
Dealt to b16371ea 
Dealt to Hero [Kc 2c]
Dealt to 4c905003 
Dealt to 5b06e1bc 
Hero: folds
4c905003: folds
5b06e1bc: folds
e9e25e5e: raises $0.1 to $0.2
c1a5302a: folds
b16371ea: folds
Uncalled bet ($0.1) returned to e9e25e5e
*** SHOWDOWN ***
e9e25e5e collected $0.25 from pot
*** SUMMARY ***
Total pot $0.25 | Rake $0 | Jackpot $0 | Bingo $0 | Fortune $0
Seat 1: e9e25e5e (button) collected ($0.25)
Seat 2: c1a5302a (small blind) folded before Flop
Seat 3: b16371ea (big blind) folded before Flop
Seat 4: Hero folded before Flop (didn't bet)
Seat 5: 4c905003 folded before Flop (didn't bet)
Seat 6: 5b06e1bc folded before Flop (didn't bet)


Poker Hand #RC1433081608: Hold'em No Limit  ($0.05/$0.1) - 2023/03/27 17:27:37
Table 'RushAndCash28116868' 6-max Seat #1 is the button
Seat 1: 73a70200 ($18.36 in chips)
Seat 2: ec3bebf3 ($26.08 in chips)
Seat 3: d0669238 ($10.51 in chips)
Seat 4: 97bdcb3a ($11.62 in chips)
Seat 5: Hero ($7.14 in chips)
Seat 6: cb7941b6 ($12.88 in chips)
ec3bebf3: posts small blind $0.05
d0669238: posts big blind $0.1
*** HOLE CARDS ***
Dealt to 73a70200 
Dealt to ec3bebf3 
Dealt to d0669238 
Dealt to 97bdcb3a 
Dealt to Hero [8d 7h]
Dealt to cb7941b6 
97bdcb3a: folds
Hero: folds
cb7941b6: raises $0.15 to $0.25
73a70200: folds
ec3bebf3: folds
d0669238: folds
Uncalled bet ($0.15) returned to cb7941b6
*** SHOWDOWN ***
cb7941b6 collected $0.25 from pot
*** SUMMARY ***
Total pot $0.25 | Rake $0 | Jackpot $0 | Bingo $0 | Fortune $0
Seat 1: 73a70200 (button) folded before Flop (didn't bet)
Seat 2: ec3bebf3 (small blind) folded before Flop
Seat 3: d0669238 (big blind) folded before Flop
Seat 4: 97bdcb3a folded before Flop (didn't bet)
Seat 5: Hero folded before Flop (didn't bet)
Seat 6: cb7941b6 collected ($0.25)


Poker Hand #RC1433081574: Hold'em No Limit  ($0.05/$0.1) - 2023/03/27 17:27:33
Table 'RushAndCash28116834' 6-max Seat #1 is the button
Seat 1: 3d17b963 ($14.18 in chips)
Seat 2: 9794e28b ($8 in chips)
Seat 3: 967e94e8 ($33 in chips)
Seat 4: d8fc5dfd ($10.15 in chips)
Seat 5: Hero ($7.14 in chips)
Seat 6: 5b06e1bc ($8.85 in chips)
9794e28b: posts small blind $0.05
967e94e8: posts big blind $0.1
*** HOLE CARDS ***
Dealt to 3d17b963 
Dealt to 9794e28b 
Dealt to 967e94e8 
Dealt to d8fc5dfd 
Dealt to Hero [8s Ts]
Dealt to 5b06e1bc 
d8fc5dfd: folds
Hero: folds
5b06e1bc: folds
3d17b963: raises $0.25 to $0.35
9794e28b: folds
967e94e8: raises $0.38 to $0.73
3d17b963: calls $0.38
*** FLOP *** [3d 6d 8h]
967e94e8: bets $0.5
3d17b963: raises $1 to $1.5
967e94e8: calls $1
*** TURN *** [3d 6d 8h] [Th]
967e94e8: checks
3d17b963: bets $3.39
967e94e8: folds
Uncalled bet ($3.39) returned to 3d17b963
*** SHOWDOWN ***
3d17b963 collected $4.15 from pot
*** SUMMARY ***
Total pot $4.51 | Rake $0.21 | Jackpot $0.15 | Bingo $0 | Fortune $0
Board [3d 6d 8h Th]
Seat 1: 3d17b963 (button) won ($4.15)
Seat 2: 9794e28b (small blind) folded before Flop
Seat 3: 967e94e8 (big blind) folded on the Turn
Seat 4: d8fc5dfd folded before Flop (didn't bet)
Seat 5: Hero folded before Flop (didn't bet)
Seat 6: 5b06e1bc folded before Flop (didn't bet)


Poker Hand #RC1433081127: Hold'em No Limit  ($0.05/$0.1) - 2023/03/27 17:26:37
Table 'RushAndCash28116387' 6-max Seat #1 is the button
Seat 1: bad1df0e ($11.1 in chips)
Seat 2: 551485e1 ($10 in chips)
Seat 3: Hero ($7.44 in chips)
Seat 4: 5b06e1bc ($8.53 in chips)
Seat 5: 32bec81d ($11.74 in chips)
Seat 6: a18501e2 ($10.75 in chips)
551485e1: posts small blind $0.05
Hero: posts big blind $0.1
*** HOLE CARDS ***
Dealt to bad1df0e 
Dealt to 551485e1 
Dealt to Hero [Js As]
Dealt to 5b06e1bc 
Dealt to 32bec81d 
Dealt to a18501e2 
5b06e1bc: raises $0.2 to $0.3
32bec81d: folds
a18501e2: folds
bad1df0e: folds
551485e1: folds
Hero: calls $0.2
*** FLOP *** [Kd Qd 9s]
Hero: checks
5b06e1bc: checks
*** TURN *** [Kd Qd 9s] [9c]
Hero: checks
5b06e1bc: bets $0.33
Hero: folds
Uncalled bet ($0.33) returned to 5b06e1bc
*** SHOWDOWN ***
5b06e1bc collected $0.62 from pot
*** SUMMARY ***
Total pot $0.65 | Rake $0.03 | Jackpot $0 | Bingo $0 | Fortune $0
Board [Kd Qd 9s 9c]
Seat 1: bad1df0e (button) folded before Flop (didn't bet)
Seat 2: 551485e1 (small blind) folded before Flop
Seat 3: Hero (big blind) folded on the Turn
Seat 4: 5b06e1bc won ($0.62)
Seat 5: 32bec81d folded before Flop (didn't bet)
Seat 6: a18501e2 folded before Flop (didn't bet)


Poker Hand #RC1433081050: Hold'em No Limit  ($0.05/$0.1) - 2023/03/27 17:26:27
Table 'RushAndCash28116310' 6-max Seat #1 is the button
Seat 1: Hero ($7.44 in chips)
Seat 2: 8ca218b4 ($10.61 in chips)
Seat 3: f2fd8dd0 ($10.31 in chips)
Seat 4: bad1df0e ($11.2 in chips)
Seat 5: 2898f9c2 ($13.75 in chips)
Seat 6: cbd5f4f9 ($12.28 in chips)
8ca218b4: posts small blind $0.05
f2fd8dd0: posts big blind $0.1
*** HOLE CARDS ***
Dealt to Hero [2c 6c]
Dealt to 8ca218b4 
Dealt to f2fd8dd0 
Dealt to bad1df0e 
Dealt to 2898f9c2 
Dealt to cbd5f4f9 
bad1df0e: folds
2898f9c2: folds
cbd5f4f9: folds
Hero: folds
8ca218b4: raises $0.2 to $0.3
f2fd8dd0: folds
Uncalled bet ($0.2) returned to 8ca218b4
*** SHOWDOWN ***
8ca218b4 collected $0.2 from pot
*** SUMMARY ***
Total pot $0.2 | Rake $0 | Jackpot $0 | Bingo $0 | Fortune $0
Seat 1: Hero (button) folded before Flop (didn't bet)
Seat 2: 8ca218b4 (small blind) collected ($0.2)
Seat 3: f2fd8dd0 (big blind) folded before Flop
Seat 4: bad1df0e folded before Flop (didn't bet)
Seat 5: 2898f9c2 folded before Flop (didn't bet)
Seat 6: cbd5f4f9 folded before Flop (didn't bet)


Poker Hand #RC1433080537: Hold'em No Limit  ($0.05/$0.1) - 2023/03/27 17:25:27
Table 'RushAndCash28115797' 6-max Seat #1 is the button
Seat 1: 610e9da5 ($7.2 in chips)
Seat 2: Hero ($8.04 in chips)
Seat 3: 945d7391 ($31.54 in chips)
Seat 4: 86ceec2c ($12.8 in chips)
Seat 5: 6d3e2b64 ($10.3 in chips)
Seat 6: 45dec125 ($26.8 in chips)
Hero: posts small blind $0.05
945d7391: posts big blind $0.1
*** HOLE CARDS ***
Dealt to 610e9da5 
Dealt to Hero [4d Ad]
Dealt to 945d7391 
Dealt to 86ceec2c 
Dealt to 6d3e2b64 
Dealt to 45dec125 
86ceec2c: folds
6d3e2b64: folds
45dec125: folds
610e9da5: folds
Hero: raises $0.2 to $0.3
945d7391: calls $0.2
*** FLOP *** [6c 6h 8c]
Hero: checks
945d7391: bets $0.3
Hero: calls $0.3
*** TURN *** [6c 6h 8c] [Qh]
Hero: checks
945d7391: checks
*** RIVER *** [6c 6h 8c Qh] [8s]
Hero: checks
945d7391: checks
Hero: shows [4d Ad] (Pair of Eights and Pair of Sixes)
945d7391: shows [7h 7c] (Pair of Eights and Pair of Sevens)
*** SHOWDOWN ***
945d7391 collected $1.14 from pot
*** SUMMARY ***
Total pot $1.2 | Rake $0.06 | Jackpot $0 | Bingo $0 | Fortune $0
Board [6c 6h 8c Qh 8s]
Seat 1: 610e9da5 (button) folded before Flop (didn't bet)
Seat 2: Hero (small blind) showed [4d Ad] and lost with Pair of Eights and Pair of Sixes
Seat 3: 945d7391 (big blind) showed [7h 7c] and won ($1.14) with Pair of Eights and Pair of Sevens
Seat 4: 86ceec2c folded before Flop (didn't bet)
Seat 5: 6d3e2b64 folded before Flop (didn't bet)
Seat 6: 45dec125 folded before Flop (didn't bet)


Poker Hand #RC1433080304: Hold'em No Limit  ($0.05/$0.1) - 2023/03/27 17:24:59
Table 'RushAndCash28115564' 6-max Seat #1 is the button
Seat 1: 45dec125 ($26.43 in chips)
Seat 2: b95c5a94 ($14.05 in chips)
Seat 3: 3b976095 ($21.47 in chips)
Seat 4: f562905b ($13.19 in chips)
Seat 5: 2db38382 ($10.16 in chips)
Seat 6: Hero ($8.29 in chips)
b95c5a94: posts small blind $0.05
3b976095: posts big blind $0.1
*** HOLE CARDS ***
Dealt to 45dec125 
Dealt to b95c5a94 
Dealt to 3b976095 
Dealt to f562905b 
Dealt to 2db38382 
Dealt to Hero [Kd Jc]
f562905b: folds
2db38382: folds
Hero: raises $0.15 to $0.25
45dec125: raises $0.35 to $0.6
b95c5a94: folds
3b976095: folds
Hero: folds
Uncalled bet ($0.35) returned to 45dec125
*** SHOWDOWN ***
45dec125 collected $0.62 from pot
*** SUMMARY ***
Total pot $0.65 | Rake $0.03 | Jackpot $0 | Bingo $0 | Fortune $0
Seat 1: 45dec125 (button) collected ($0.62)
Seat 2: b95c5a94 (small blind) folded before Flop
Seat 3: 3b976095 (big blind) folded before Flop
Seat 4: f562905b folded before Flop (didn't bet)
Seat 5: 2db38382 folded before Flop (didn't bet)
Seat 6: Hero folded before Flop


Poker Hand #RC1433080141: Hold'em No Limit  ($0.05/$0.1) - 2023/03/27 17:24:40
Table 'RushAndCash28115401' 6-max Seat #1 is the button
Seat 1: 3c82f802 ($11 in chips)
Seat 2: b879888e ($26.54 in chips)
Seat 3: 2922cf7b ($9.97 in chips)
Seat 4: 388c5058 ($10.36 in chips)
Seat 5: Hero ($8.14 in chips)
Seat 6: 5dd9770d ($19.09 in chips)
b879888e: posts small blind $0.05
2922cf7b: posts big blind $0.1
*** HOLE CARDS ***
Dealt to 3c82f802 
Dealt to b879888e 
Dealt to 2922cf7b 
Dealt to 388c5058 
Dealt to Hero [Kd Qh]
Dealt to 5dd9770d 
388c5058: folds
Hero: raises $0.15 to $0.25
5dd9770d: folds
3c82f802: folds
b879888e: folds
2922cf7b: folds
Uncalled bet ($0.15) returned to Hero
*** SHOWDOWN ***
Hero collected $0.25 from pot
*** SUMMARY ***
Total pot $0.25 | Rake $0 | Jackpot $0 | Bingo $0 | Fortune $0
Seat 1: 3c82f802 (button) folded before Flop (didn't bet)
Seat 2: b879888e (small blind) folded before Flop
Seat 3: 2922cf7b (big blind) folded before Flop
Seat 4: 388c5058 folded before Flop (didn't bet)
Seat 5: Hero collected ($0.25)
Seat 6: 5dd9770d folded before Flop (didn't bet)


Poker Hand #RC1433080051: Hold'em No Limit  ($0.05/$0.1) - 2023/03/27 17:24:31
Table 'RushAndCash28115311' 6-max Seat #1 is the button
Seat 1: Hero ($8.14 in chips)
Seat 2: b4bad238 ($15.9 in chips)
Seat 3: c952c2de ($24.07 in chips)
Seat 4: e94eeb11 ($9.59 in chips)
Seat 5: e11cfd5e ($19.51 in chips)
Seat 6: ca0bae85 ($13.14 in chips)
b4bad238: posts small blind $0.05
c952c2de: posts big blind $0.1
*** HOLE CARDS ***
Dealt to Hero [9d 3c]
Dealt to b4bad238 
Dealt to c952c2de 
Dealt to e94eeb11 
Dealt to e11cfd5e 
Dealt to ca0bae85 
e94eeb11: folds
e11cfd5e: folds
ca0bae85: folds
Hero: folds
b4bad238: folds
Uncalled bet ($0.05) returned to c952c2de
*** SHOWDOWN ***
c952c2de collected $0.1 from pot
*** SUMMARY ***
Total pot $0.1 | Rake $0 | Jackpot $0 | Bingo $0 | Fortune $0
Seat 1: Hero (button) folded before Flop (didn't bet)
Seat 2: b4bad238 (small blind) folded before Flop
Seat 3: c952c2de (big blind) collected ($0.1)
Seat 4: e94eeb11 folded before Flop (didn't bet)
Seat 5: e11cfd5e folded before Flop (didn't bet)
Seat 6: ca0bae85 folded before Flop (didn't bet)


Poker Hand #RC1433080009: Hold'em No Limit  ($0.05/$0.1) - 2023/03/27 17:24:26
Table 'RushAndCash28115269' 6-max Seat #1 is the button
Seat 1: cd380641 ($11.6 in chips)
Seat 2: b526d4d2 ($5.07 in chips)
Seat 3: a9a61ad7 ($9.6 in chips)
Seat 4: Hero ($8.14 in chips)
Seat 5: 4753f39d ($10.15 in chips)
Seat 6: d28c992e ($10 in chips)
b526d4d2: posts small blind $0.05
a9a61ad7: posts big blind $0.1
*** HOLE CARDS ***
Dealt to cd380641 
Dealt to b526d4d2 
Dealt to a9a61ad7 
Dealt to Hero [4s 8c]
Dealt to 4753f39d 
Dealt to d28c992e 
Hero: folds
4753f39d: folds
d28c992e: folds
cd380641: raises $0.13 to $0.23
b526d4d2: calls $0.18
a9a61ad7: folds
*** FLOP *** [9c Th 6d]
b526d4d2: checks
cd380641: bets $0.19
b526d4d2: calls $0.19
*** TURN *** [9c Th 6d] [8d]
b526d4d2: checks
cd380641: checks
*** RIVER *** [9c Th 6d 8d] [Ad]
b526d4d2: checks
cd380641: bets $0.32
b526d4d2: folds
Uncalled bet ($0.32) returned to cd380641
*** SHOWDOWN ***
cd380641 collected $0.9 from pot
*** SUMMARY ***
Total pot $0.94 | Rake $0.04 | Jackpot $0 | Bingo $0 | Fortune $0
Board [9c Th 6d 8d Ad]
Seat 1: cd380641 (button) won ($0.9)
Seat 2: b526d4d2 (small blind) folded on the River
Seat 3: a9a61ad7 (big blind) folded before Flop
Seat 4: Hero folded before Flop (didn't bet)
Seat 5: 4753f39d folded before Flop (didn't bet)
Seat 6: d28c992e folded before Flop (didn't bet)


Poker Hand #RC1433079962: Hold'em No Limit  ($0.05/$0.1) - 2023/03/27 17:24:20
Table 'RushAndCash28115222' 6-max Seat #1 is the button
Seat 1: 3b56e8eb ($10 in chips)
Seat 2: 18f41552 ($10 in chips)
Seat 3: Hero ($8.24 in chips)
Seat 4: 22128092 ($10.05 in chips)
Seat 5: 3d17b963 ($13.37 in chips)
Seat 6: c4f30b99 ($35.33 in chips)
18f41552: posts small blind $0.05
Hero: posts big blind $0.1
*** HOLE CARDS ***
Dealt to 3b56e8eb 
Dealt to 18f41552 
Dealt to Hero [8d 2c]
Dealt to 22128092 
Dealt to 3d17b963 
Dealt to c4f30b99 
22128092: folds
3d17b963: folds
c4f30b99: folds
3b56e8eb: raises $0.15 to $0.25
18f41552: folds
Hero: folds
Uncalled bet ($0.15) returned to 3b56e8eb
*** SHOWDOWN ***
3b56e8eb collected $0.25 from pot
*** SUMMARY ***
Total pot $0.25 | Rake $0 | Jackpot $0 | Bingo $0 | Fortune $0
Seat 1: 3b56e8eb (button) collected ($0.25)
Seat 2: 18f41552 (small blind) folded before Flop
Seat 3: Hero (big blind) folded before Flop
Seat 4: 22128092 folded before Flop (didn't bet)
Seat 5: 3d17b963 folded before Flop (didn't bet)
Seat 6: c4f30b99 folded before Flop (didn't bet)


Poker Hand #RC1433079866: Hold'em No Limit  ($0.05/$0.1) - 2023/03/27 17:24:09
Table 'RushAndCash28115126' 6-max Seat #1 is the button
Seat 1: daf8bf32 ($10.4 in chips)
Seat 2: Hero ($8.29 in chips)
Seat 3: d26b2103 ($14.1 in chips)
Seat 4: cbf3c4aa ($5.46 in chips)
Seat 5: b4780f2d ($14.73 in chips)
Seat 6: e88c8126 ($10.61 in chips)
Hero: posts small blind $0.05
d26b2103: posts big blind $0.1
*** HOLE CARDS ***
Dealt to daf8bf32 
Dealt to Hero [9h Ks]
Dealt to d26b2103 
Dealt to cbf3c4aa 
Dealt to b4780f2d 
Dealt to e88c8126 
cbf3c4aa: folds
b4780f2d: folds
e88c8126: raises $0.15 to $0.25
daf8bf32: folds
Hero: folds
d26b2103: calls $0.15
*** FLOP *** [Kh 3s 4h]
d26b2103: checks
e88c8126: bets $0.35
d26b2103: folds
Uncalled bet ($0.35) returned to e88c8126
*** SHOWDOWN ***
e88c8126 collected $0.53 from pot
*** SUMMARY ***
Total pot $0.55 | Rake $0.02 | Jackpot $0 | Bingo $0 | Fortune $0
Board [Kh 3s 4h]
Seat 1: daf8bf32 (button) folded before Flop (didn't bet)
Seat 2: Hero (small blind) folded before Flop
Seat 3: d26b2103 (big blind) folded on the Flop
Seat 4: cbf3c4aa folded before Flop (didn't bet)
Seat 5: b4780f2d folded before Flop (didn't bet)
Seat 6: e88c8126 won ($0.53)


Poker Hand #RC1433079743: Hold'em No Limit  ($0.05/$0.1) - 2023/03/27 17:23:54
Table 'RushAndCash28115003' 6-max Seat #1 is the button
Seat 1: 31711111 ($10.05 in chips)
Seat 2: 2922cf7b ($10.22 in chips)
Seat 3: a66b1113 ($10.15 in chips)
Seat 4: Hero ($8.29 in chips)
Seat 5: cc9e00b3 ($11.68 in chips)
Seat 6: ff6a0806 ($22.23 in chips)
2922cf7b: posts small blind $0.05
a66b1113: posts big blind $0.1
*** HOLE CARDS ***
Dealt to 31711111 
Dealt to 2922cf7b 
Dealt to a66b1113 
Dealt to Hero [As 7h]
Dealt to cc9e00b3 
Dealt to ff6a0806 
Hero: folds
cc9e00b3: folds
ff6a0806: raises $0.15 to $0.25
31711111: calls $0.25
2922cf7b: calls $0.2
a66b1113: folds
*** FLOP *** [7s 4c 7d]
2922cf7b: checks
ff6a0806: bets $0.43
31711111: calls $0.43
2922cf7b: folds
*** TURN *** [7s 4c 7d] [9c]
ff6a0806: checks
31711111: bets $1.26
ff6a0806: calls $1.26
*** RIVER *** [7s 4c 7d 9c] [Kh]
ff6a0806: checks
31711111: bets $5.5
ff6a0806: folds
Uncalled bet ($5.5) returned to 31711111
*** SHOWDOWN ***
31711111 collected $3.88 from pot
*** SUMMARY ***
Total pot $4.23 | Rake $0.2 | Jackpot $0.15 | Bingo $0 | Fortune $0
Board [7s 4c 7d 9c Kh]
Seat 1: 31711111 (button) won ($3.88)
Seat 2: 2922cf7b (small blind) folded on the Flop
Seat 3: a66b1113 (big blind) folded before Flop
Seat 4: Hero folded before Flop (didn't bet)
Seat 5: cc9e00b3 folded before Flop (didn't bet)
Seat 6: ff6a0806 folded on the River


Poker Hand #RC1433079673: Hold'em No Limit  ($0.05/$0.1) - 2023/03/27 17:23:46
Table 'RushAndCash28114933' 6-max Seat #1 is the button
Seat 1: 945d7391 ($30.25 in chips)
Seat 2: c20fb006 ($35.22 in chips)
Seat 3: effd7574 ($24.99 in chips)
Seat 4: bcf4f43c ($9.64 in chips)
Seat 5: Hero ($8.29 in chips)
Seat 6: aa5ba7d2 ($16.28 in chips)
c20fb006: posts small blind $0.05
effd7574: posts big blind $0.1
*** HOLE CARDS ***
Dealt to 945d7391 
Dealt to c20fb006 
Dealt to effd7574 
Dealt to bcf4f43c 
Dealt to Hero [2d Qd]
Dealt to aa5ba7d2 
bcf4f43c: folds
Hero: folds
aa5ba7d2: folds
945d7391: raises $0.1 to $0.2
c20fb006: calls $0.15
effd7574: folds
*** FLOP *** [5d Kd 2c]
c20fb006: checks
945d7391: checks
*** TURN *** [5d Kd 2c] [8h]
c20fb006: checks
945d7391: checks
*** RIVER *** [5d Kd 2c 8h] [5s]
c20fb006: checks
945d7391: checks
c20fb006: shows [9h 9d] (Pair of Nines and Pair of Fives)
945d7391: shows [Qc Td] (Pair of Fives)
*** SHOWDOWN ***
c20fb006 collected $0.48 from pot
*** SUMMARY ***
Total pot $0.5 | Rake $0.02 | Jackpot $0 | Bingo $0 | Fortune $0
Board [5d Kd 2c 8h 5s]
Seat 1: 945d7391 (button) showed [Qc Td] and lost with Pair of Fives
Seat 2: c20fb006 (small blind) showed [9h 9d] and won ($0.48) with Pair of Nines and Pair of Fives
Seat 3: effd7574 (big blind) folded before Flop
Seat 4: bcf4f43c folded before Flop (didn't bet)
Seat 5: Hero folded before Flop (didn't bet)
Seat 6: aa5ba7d2 folded before Flop (didn't bet)


Poker Hand #RC1433079579: Hold'em No Limit  ($0.05/$0.1) - 2023/03/27 17:23:35
Table 'RushAndCash28114839' 6-max Seat #1 is the button
Seat 1: bc200b82 ($10.82 in chips)
Seat 2: ca40a3e7 ($14.32 in chips)
Seat 3: 8cbe28ff ($11.59 in chips)
Seat 4: f13b0528 ($13 in chips)
Seat 5: 3a7a7d7a ($16.32 in chips)
Seat 6: Hero ($8.29 in chips)
ca40a3e7: posts small blind $0.05
8cbe28ff: posts big blind $0.1
*** HOLE CARDS ***
Dealt to bc200b82 
Dealt to ca40a3e7 
Dealt to 8cbe28ff 
Dealt to f13b0528 
Dealt to 3a7a7d7a 
Dealt to Hero [Ac 6d]
f13b0528: folds
3a7a7d7a: folds
Hero: folds
bc200b82: raises $0.12 to $0.22
ca40a3e7: folds
8cbe28ff: folds
Uncalled bet ($0.12) returned to bc200b82
*** SHOWDOWN ***
bc200b82 collected $0.25 from pot
*** SUMMARY ***
Total pot $0.25 | Rake $0 | Jackpot $0 | Bingo $0 | Fortune $0
Seat 1: bc200b82 (button) collected ($0.25)
Seat 2: ca40a3e7 (small blind) folded before Flop
Seat 3: 8cbe28ff (big blind) folded before Flop
Seat 4: f13b0528 folded before Flop (didn't bet)
Seat 5: 3a7a7d7a folded before Flop (didn't bet)
Seat 6: Hero folded before Flop (didn't bet)


Poker Hand #RC1433079090: Hold'em No Limit  ($0.05/$0.1) - 2023/03/27 17:22:35
Table 'RushAndCash28114350' 6-max Seat #1 is the button
Seat 1: 16e6710f ($22.57 in chips)
Seat 2: 8cbe28ff ($10.6 in chips)
Seat 3: Hero ($9.39 in chips)
Seat 4: b879888e ($25.55 in chips)
Seat 5: 9c4d3948 ($20.14 in chips)
Seat 6: f807cc1f ($22.4 in chips)
8cbe28ff: posts small blind $0.05
Hero: posts big blind $0.1
*** HOLE CARDS ***
Dealt to 16e6710f 
Dealt to 8cbe28ff 
Dealt to Hero [3c Kc]
Dealt to b879888e 
Dealt to 9c4d3948 
Dealt to f807cc1f 
b879888e: folds
9c4d3948: folds
f807cc1f: folds
16e6710f: folds
8cbe28ff: raises $0.15 to $0.25
Hero: calls $0.15
*** FLOP *** [Qh 7c 4c]
8cbe28ff: checks
Hero: bets $0.25
8cbe28ff: calls $0.25
*** TURN *** [Qh 7c 4c] [2s]
8cbe28ff: checks
Hero: bets $0.6
8cbe28ff: calls $0.6
*** RIVER *** [Qh 7c 4c 2s] [6s]
8cbe28ff: checks
Hero: checks
8cbe28ff: shows [Jd Js] (Pair of Jacks)
Hero: shows [3c Kc] (King-High)
*** SHOWDOWN ***
8cbe28ff collected $2.09 from pot
*** SUMMARY ***
Total pot $2.2 | Rake $0.11 | Jackpot $0 | Bingo $0 | Fortune $0
Board [Qh 7c 4c 2s 6s]
Seat 1: 16e6710f (button) folded before Flop (didn't bet)
Seat 2: 8cbe28ff (small blind) showed [Jd Js] and won ($2.09) with Pair of Jacks
Seat 3: Hero (big blind) showed [3c Kc] and lost with King-High
Seat 4: b879888e folded before Flop (didn't bet)
Seat 5: 9c4d3948 folded before Flop (didn't bet)
Seat 6: f807cc1f folded before Flop (didn't bet)


Poker Hand #RC1433078920: Hold'em No Limit  ($0.05/$0.1) - 2023/03/27 17:22:13
Table 'RushAndCash28114180' 6-max Seat #1 is the button
Seat 1: Hero ($9.02 in chips)
Seat 2: 55975109 ($26.37 in chips)
Seat 3: 6ad85f84 ($15.16 in chips)
Seat 4: 672bb697 ($10.94 in chips)
Seat 5: c53e784c ($10 in chips)
Seat 6: 9c4d3948 ($20.39 in chips)
55975109: posts small blind $0.05
6ad85f84: posts big blind $0.1
*** HOLE CARDS ***
Dealt to Hero [Qc Qh]
Dealt to 55975109 
Dealt to 6ad85f84 
Dealt to 672bb697 
Dealt to c53e784c 
Dealt to 9c4d3948 
672bb697: folds
c53e784c: folds
9c4d3948: raises $0.15 to $0.25
Hero: raises $0.54 to $0.79
55975109: folds
6ad85f84: folds
9c4d3948: folds
Uncalled bet ($0.54) returned to Hero
*** SHOWDOWN ***
Hero collected $0.62 from pot
*** SUMMARY ***
Total pot $0.65 | Rake $0.03 | Jackpot $0 | Bingo $0 | Fortune $0
Seat 1: Hero (button) collected ($0.62)
Seat 2: 55975109 (small blind) folded before Flop
Seat 3: 6ad85f84 (big blind) folded before Flop
Seat 4: 672bb697 folded before Flop (didn't bet)
Seat 5: c53e784c folded before Flop (didn't bet)
Seat 6: 9c4d3948 folded before Flop


Poker Hand #RC1433078640: Hold'em No Limit  ($0.05/$0.1) - 2023/03/27 17:21:38
Table 'RushAndCash28113900' 6-max Seat #1 is the button
Seat 1: 2eeaefd9 ($6.38 in chips)
Seat 2: Hero ($8.75 in chips)
Seat 3: aff23c9f ($15.18 in chips)
Seat 4: 522e6aae ($34.57 in chips)
Seat 5: 68713de1 ($19.3 in chips)
Seat 6: 5b6ae968 ($9.67 in chips)
Hero: posts small blind $0.05
aff23c9f: posts big blind $0.1
*** HOLE CARDS ***
Dealt to 2eeaefd9 
Dealt to Hero [Qd Th]
Dealt to aff23c9f 
Dealt to 522e6aae 
Dealt to 68713de1 
Dealt to 5b6ae968 
522e6aae: folds
68713de1: folds
5b6ae968: folds
2eeaefd9: folds
Hero: raises $0.2 to $0.3
aff23c9f: calls $0.2
*** FLOP *** [9c Tc Qs]
Hero: bets $0.3
aff23c9f: folds
Uncalled bet ($0.3) returned to Hero
*** SHOWDOWN ***
Hero collected $0.57 from pot
*** SUMMARY ***
Total pot $0.6 | Rake $0.03 | Jackpot $0 | Bingo $0 | Fortune $0
Board [9c Tc Qs]
Seat 1: 2eeaefd9 (button) folded before Flop (didn't bet)
Seat 2: Hero (small blind) won ($0.57)
Seat 3: aff23c9f (big blind) folded on the Flop
Seat 4: 522e6aae folded before Flop (didn't bet)
Seat 5: 68713de1 folded before Flop (didn't bet)
Seat 6: 5b6ae968 folded before Flop (didn't bet)


Poker Hand #RC1433078577: Hold'em No Limit  ($0.05/$0.1) - 2023/03/27 17:21:30
Table 'RushAndCash28113837' 6-max Seat #1 is the button
Seat 1: ddb34b78 ($10 in chips)
Seat 2: c7b34af4 ($10 in chips)
Seat 3: a954c345 ($14.07 in chips)
Seat 4: 8494623e ($13.26 in chips)
Seat 5: Hero ($8.75 in chips)
Seat 6: d7a7e36e ($1.83 in chips)
c7b34af4: posts small blind $0.05
a954c345: posts big blind $0.1
*** HOLE CARDS ***
Dealt to ddb34b78 
Dealt to c7b34af4 
Dealt to a954c345 
Dealt to 8494623e 
Dealt to Hero [Kh 8s]
Dealt to d7a7e36e 
8494623e: raises $0.12 to $0.22
Hero: folds
d7a7e36e: calls $0.22
ddb34b78: folds
c7b34af4: raises $0.92 to $1.14
a954c345: folds
8494623e: folds
d7a7e36e: folds
Uncalled bet ($0.92) returned to c7b34af4
*** SHOWDOWN ***
c7b34af4 collected $0.73 from pot
*** SUMMARY ***
Total pot $0.76 | Rake $0.03 | Jackpot $0 | Bingo $0 | Fortune $0
Seat 1: ddb34b78 (button) folded before Flop (didn't bet)
Seat 2: c7b34af4 (small blind) collected ($0.73)
Seat 3: a954c345 (big blind) folded before Flop
Seat 4: 8494623e folded before Flop
Seat 5: Hero folded before Flop (didn't bet)
Seat 6: d7a7e36e folded before Flop


Poker Hand #RC1433078549: Hold'em No Limit  ($0.05/$0.1) - 2023/03/27 17:21:26
Table 'RushAndCash28113809' 6-max Seat #1 is the button
Seat 1: d7a7e36e ($1.83 in chips)
Seat 2: 91fc8ccd ($10.02 in chips)
Seat 3: 341053d6 ($21.52 in chips)
Seat 4: Hero ($8.75 in chips)
Seat 5: c3a1d2e5 ($11.22 in chips)
Seat 6: 2bfb9581 ($15.89 in chips)
91fc8ccd: posts small blind $0.05
341053d6: posts big blind $0.1
*** HOLE CARDS ***
Dealt to d7a7e36e 
Dealt to 91fc8ccd 
Dealt to 341053d6 
Dealt to Hero [6s Td]
Dealt to c3a1d2e5 
Dealt to 2bfb9581 
Hero: folds
c3a1d2e5: folds
2bfb9581: raises $0.1 to $0.2
d7a7e36e: folds
91fc8ccd: folds
341053d6: folds
Uncalled bet ($0.1) returned to 2bfb9581
*** SHOWDOWN ***
2bfb9581 collected $0.25 from pot
*** SUMMARY ***
Total pot $0.25 | Rake $0 | Jackpot $0 | Bingo $0 | Fortune $0
Seat 1: d7a7e36e (button) folded before Flop (didn't bet)
Seat 2: 91fc8ccd (small blind) folded before Flop
Seat 3: 341053d6 (big blind) folded before Flop
Seat 4: Hero folded before Flop (didn't bet)
Seat 5: c3a1d2e5 folded before Flop (didn't bet)
Seat 6: 2bfb9581 collected ($0.25)


Poker Hand #RC1433078489: Hold'em No Limit  ($0.05/$0.1) - 2023/03/27 17:21:18
Table 'RushAndCash28113749' 6-max Seat #1 is the button
Seat 1: 93df6bb4 ($10.75 in chips)
Seat 2: c682ccb4 ($11.76 in chips)
Seat 3: 2213b577 ($10.88 in chips)
Seat 4: Hero ($8.75 in chips)
Seat 5: 23d1df40 ($10.81 in chips)
Seat 6: af1584b2 ($10 in chips)
c682ccb4: posts small blind $0.05
2213b577: posts big blind $0.1
*** HOLE CARDS ***
Dealt to 93df6bb4 
Dealt to c682ccb4 
Dealt to 2213b577 
Dealt to Hero [5c Ks]
Dealt to 23d1df40 
Dealt to af1584b2 
Hero: folds
23d1df40: folds
af1584b2: folds
93df6bb4: folds
c682ccb4: raises $0.1 to $0.2
2213b577: calls $0.1
*** FLOP *** [Js 6s Qh]
c682ccb4: checks
2213b577: checks
*** TURN *** [Js 6s Qh] [2d]
c682ccb4: checks
2213b577: bets $0.3
c682ccb4: calls $0.3
*** RIVER *** [Js 6s Qh 2d] [9c]
c682ccb4: checks
2213b577: checks
c682ccb4: shows [9h Th] (Pair of Nines)
2213b577: shows [Kh Qc] (Pair of Queens)
*** SHOWDOWN ***
2213b577 collected $0.95 from pot
*** SUMMARY ***
Total pot $1 | Rake $0.05 | Jackpot $0 | Bingo $0 | Fortune $0
Board [Js 6s Qh 2d 9c]
Seat 1: 93df6bb4 (button) folded before Flop (didn't bet)
Seat 2: c682ccb4 (small blind) showed [9h Th] and lost with Pair of Nines
Seat 3: 2213b577 (big blind) showed [Kh Qc] and won ($0.95) with Pair of Queens
Seat 4: Hero folded before Flop (didn't bet)
Seat 5: 23d1df40 folded before Flop (didn't bet)
Seat 6: af1584b2 folded before Flop (didn't bet)


Poker Hand #RC1433078313: Hold'em No Limit  ($0.05/$0.1) - 2023/03/27 17:20:57
Table 'RushAndCash28113573' 6-max Seat #1 is the button
Seat 1: 17afabc1 ($8.53 in chips)
Seat 2: 3d17b963 ($14.12 in chips)
Seat 3: Hero ($8.85 in chips)
Seat 4: ec43a102 ($10.61 in chips)
Seat 5: f76f0b7 ($10.1 in chips)
Seat 6: 6d095210 ($12.08 in chips)
3d17b963: posts small blind $0.05
Hero: posts big blind $0.1
*** HOLE CARDS ***
Dealt to 17afabc1 
Dealt to 3d17b963 
Dealt to Hero [6c 7s]
Dealt to ec43a102 
Dealt to f76f0b7 
Dealt to 6d095210 
ec43a102: folds
f76f0b7: folds
6d095210: folds
17afabc1: raises $0.9 to $1
3d17b963: folds
Hero: folds
Uncalled bet ($0.9) returned to 17afabc1
*** SHOWDOWN ***
17afabc1 collected $0.25 from pot
*** SUMMARY ***
Total pot $0.25 | Rake $0 | Jackpot $0 | Bingo $0 | Fortune $0
Seat 1: 17afabc1 (button) collected ($0.25)
Seat 2: 3d17b963 (small blind) folded before Flop
Seat 3: Hero (big blind) folded before Flop
Seat 4: ec43a102 folded before Flop (didn't bet)
Seat 5: f76f0b7 folded before Flop (didn't bet)
Seat 6: 6d095210 folded before Flop (didn't bet)


Poker Hand #RC1433077984: Hold'em No Limit  ($0.05/$0.1) - 2023/03/27 17:20:14
Table 'RushAndCash28113244' 6-max Seat #1 is the button
Seat 1: Hero ($8.43 in chips)
Seat 2: c29830b4 ($21.85 in chips)
Seat 3: 9296b17a ($0.61 in chips)
Seat 4: 55975109 ($26.72 in chips)
Seat 5: be884a7d ($10.37 in chips)
Seat 6: ec43a102 ($10.91 in chips)
c29830b4: posts small blind $0.05
9296b17a: posts big blind $0.1
*** HOLE CARDS ***
Dealt to Hero [As Tc]
Dealt to c29830b4 
Dealt to 9296b17a 
Dealt to 55975109 
Dealt to be884a7d 
Dealt to ec43a102 
55975109: folds
be884a7d: folds
ec43a102: raises $0.2 to $0.3
Hero: raises $0.62 to $0.92
c29830b4: folds
9296b17a: folds
ec43a102: folds
Uncalled bet ($0.62) returned to Hero
*** SHOWDOWN ***
Hero collected $0.72 from pot
*** SUMMARY ***
Total pot $0.75 | Rake $0.03 | Jackpot $0 | Bingo $0 | Fortune $0
Seat 1: Hero (button) collected ($0.72)
Seat 2: c29830b4 (small blind) folded before Flop
Seat 3: 9296b17a (big blind) folded before Flop
Seat 4: 55975109 folded before Flop (didn't bet)
Seat 5: be884a7d folded before Flop (didn't bet)
Seat 6: ec43a102 folded before Flop


Poker Hand #RC1433077892: Hold'em No Limit  ($0.05/$0.1) - 2023/03/27 17:20:02
Table 'RushAndCash28113152' 6-max Seat #1 is the button
Seat 1: a88a9939 ($10.62 in chips)
Seat 2: Hero ($8.48 in chips)
Seat 3: 795d43cf ($9.43 in chips)
Seat 4: b6e90dde ($10.38 in chips)
Seat 5: 7eba02ca ($11.93 in chips)
Seat 6: 9d3fd67b ($11.25 in chips)
Hero: posts small blind $0.05
795d43cf: posts big blind $0.1
*** HOLE CARDS ***
Dealt to a88a9939 
Dealt to Hero [7h Ah]
Dealt to 795d43cf 
Dealt to b6e90dde 
Dealt to 7eba02ca 
Dealt to 9d3fd67b 
b6e90dde: folds
7eba02ca: folds
9d3fd67b: raises $0.2 to $0.3
a88a9939: folds
Hero: folds
795d43cf: calls $0.2
*** FLOP *** [Jd 4s 5s]
795d43cf: checks
9d3fd67b: bets $0.43
795d43cf: calls $0.43
*** TURN *** [Jd 4s 5s] [Qs]
795d43cf: bets $0.76
9d3fd67b: calls $0.76
*** RIVER *** [Jd 4s 5s Qs] [9h]
795d43cf: checks
9d3fd67b: checks
795d43cf: shows [2h 2s] (Pair of Twos)
9d3fd67b: shows [Qd Js] (Pair of Queens and Pair of Jacks)
*** SHOWDOWN ***
9d3fd67b collected $2.74 from pot
*** SUMMARY ***
Total pot $3.03 | Rake $0.14 | Jackpot $0.15 | Bingo $0 | Fortune $0
Board [Jd 4s 5s Qs 9h]
Seat 1: a88a9939 (button) folded before Flop (didn't bet)
Seat 2: Hero (small blind) folded before Flop
Seat 3: 795d43cf (big blind) showed [2h 2s] and lost with Pair of Twos
Seat 4: b6e90dde folded before Flop (didn't bet)
Seat 5: 7eba02ca folded before Flop (didn't bet)
Seat 6: 9d3fd67b showed [Qd Js] and won ($2.74) with Pair of Queens and Pair of Jacks


Poker Hand #RC1433077793: Hold'em No Limit  ($0.05/$0.1) - 2023/03/27 17:19:50
Table 'RushAndCash28113053' 6-max Seat #1 is the button
Seat 1: d4475bc5 ($11.42 in chips)
Seat 2: be319e8d ($12.64 in chips)
Seat 3: b339e987 ($57.99 in chips)
Seat 4: c8a3f905 ($24.67 in chips)
Seat 5: 8ca218b4 ($10 in chips)
Seat 6: Hero ($8.48 in chips)
be319e8d: posts small blind $0.05
b339e987: posts big blind $0.1
*** HOLE CARDS ***
Dealt to d4475bc5 
Dealt to be319e8d 
Dealt to b339e987 
Dealt to c8a3f905 
Dealt to 8ca218b4 
Dealt to Hero [Qd 9d]
c8a3f905: folds
8ca218b4: folds
Hero: folds
d4475bc5: raises $0.15 to $0.25
be319e8d: raises $0.5 to $0.75
b339e987: folds
d4475bc5: folds
Uncalled bet ($0.5) returned to be319e8d
*** SHOWDOWN ***
be319e8d collected $0.57 from pot
*** SUMMARY ***
Total pot $0.6 | Rake $0.03 | Jackpot $0 | Bingo $0 | Fortune $0
Seat 1: d4475bc5 (button) folded before Flop
Seat 2: be319e8d (small blind) collected ($0.57)
Seat 3: b339e987 (big blind) folded before Flop
Seat 4: c8a3f905 folded before Flop (didn't bet)
Seat 5: 8ca218b4 folded before Flop (didn't bet)
Seat 6: Hero folded before Flop (didn't bet)


Poker Hand #RC1433077715: Hold'em No Limit  ($0.05/$0.1) - 2023/03/27 17:19:41
Table 'RushAndCash28112975' 6-max Seat #1 is the button
Seat 1: dbd43cdc ($10 in chips)
Seat 2: c936ae1b ($42.46 in chips)
Seat 3: a3c3bfbb ($10.94 in chips)
Seat 4: f807cc1f ($10.3 in chips)
Seat 5: 92f2ddbf ($11.21 in chips)
Seat 6: Hero ($8.48 in chips)
c936ae1b: posts small blind $0.05
a3c3bfbb: posts big blind $0.1
*** HOLE CARDS ***
Dealt to dbd43cdc 
Dealt to c936ae1b 
Dealt to a3c3bfbb 
Dealt to f807cc1f 
Dealt to 92f2ddbf 
Dealt to Hero [Qc 9h]
f807cc1f: folds
92f2ddbf: folds
Hero: folds
dbd43cdc: folds
c936ae1b: raises $0.18 to $0.28
a3c3bfbb: folds
Uncalled bet ($0.18) returned to c936ae1b
*** SHOWDOWN ***
c936ae1b collected $0.2 from pot
*** SUMMARY ***
Total pot $0.2 | Rake $0 | Jackpot $0 | Bingo $0 | Fortune $0
Seat 1: dbd43cdc (button) folded before Flop (didn't bet)
Seat 2: c936ae1b (small blind) collected ($0.2)
Seat 3: a3c3bfbb (big blind) folded before Flop
Seat 4: f807cc1f folded before Flop (didn't bet)
Seat 5: 92f2ddbf folded before Flop (didn't bet)
Seat 6: Hero folded before Flop (didn't bet)


Poker Hand #RC1433077519: Hold'em No Limit  ($0.05/$0.1) - 2023/03/27 17:19:17
Table 'RushAndCash28112779' 6-max Seat #1 is the button
Seat 1: d56289df ($13.13 in chips)
Seat 2: b23948da ($10.86 in chips)
Seat 3: 41fc5db3 ($10 in chips)
Seat 4: 26faa500 ($11.62 in chips)
Seat 5: 4f08b426 ($35.35 in chips)
Seat 6: Hero ($8.48 in chips)
b23948da: posts small blind $0.05
41fc5db3: posts big blind $0.1
*** HOLE CARDS ***
Dealt to d56289df 
Dealt to b23948da 
Dealt to 41fc5db3 
Dealt to 26faa500 
Dealt to 4f08b426 
Dealt to Hero [6c As]
26faa500: folds
4f08b426: folds
Hero: folds
d56289df: folds
b23948da: folds
Uncalled bet ($0.05) returned to 41fc5db3
*** SHOWDOWN ***
41fc5db3 collected $0.1 from pot
*** SUMMARY ***
Total pot $0.1 | Rake $0 | Jackpot $0 | Bingo $0 | Fortune $0
Seat 1: d56289df (button) folded before Flop (didn't bet)
Seat 2: b23948da (small blind) folded before Flop
Seat 3: 41fc5db3 (big blind) collected ($0.1)
Seat 4: 26faa500 folded before Flop (didn't bet)
Seat 5: 4f08b426 folded before Flop (didn't bet)
Seat 6: Hero folded before Flop (didn't bet)


Poker Hand #RC1433076908: Hold'em No Limit  ($0.05/$0.1) - 2023/03/27 17:18:04
Table 'RushAndCash28112168' 6-max Seat #1 is the button
Seat 1: 74829e10 ($20.29 in chips)
Seat 2: 86596c9e ($11.86 in chips)
Seat 3: Hero ($9.18 in chips)
Seat 4: 2cc908a0 ($13.85 in chips)
Seat 5: ea8863e9 ($8.26 in chips)
Seat 6: 2213b577 ($10.02 in chips)
86596c9e: posts small blind $0.05
Hero: posts big blind $0.1
*** HOLE CARDS ***
Dealt to 74829e10 
Dealt to 86596c9e 
Dealt to Hero [Js Ad]
Dealt to 2cc908a0 
Dealt to ea8863e9 
Dealt to 2213b577 
2cc908a0: raises $0.2 to $0.3
ea8863e9: folds
2213b577: folds
74829e10: folds
86596c9e: folds
Hero: calls $0.2
*** FLOP *** [3c Tc 8s]
Hero: checks
2cc908a0: checks
*** TURN *** [3c Tc 8s] [Qc]
Hero: checks
2cc908a0: checks
*** RIVER *** [3c Tc 8s Qc] [Jh]
Hero: bets $0.2
2cc908a0: raises $0.2 to $0.4
Hero: calls $0.2
2cc908a0: shows [Ts Td] (Three Tens)
Hero: shows [Js Ad] (Pair of Jacks)
*** SHOWDOWN ***
2cc908a0 collected $1.38 from pot
*** SUMMARY ***
Total pot $1.45 | Rake $0.07 | Jackpot $0 | Bingo $0 | Fortune $0
Board [3c Tc 8s Qc Jh]
Seat 1: 74829e10 (button) folded before Flop (didn't bet)
Seat 2: 86596c9e (small blind) folded before Flop
Seat 3: Hero (big blind) showed [Js Ad] and lost with Pair of Jacks
Seat 4: 2cc908a0 showed [Ts Td] and won ($1.38) with Three Tens
Seat 5: ea8863e9 folded before Flop (didn't bet)
Seat 6: 2213b577 folded before Flop (didn't bet)


Poker Hand #RC1433076680: Hold'em No Limit  ($0.05/$0.1) - 2023/03/27 17:17:34
Table 'RushAndCash28111940' 6-max Seat #1 is the button
Seat 1: 17afabc1 ($10.46 in chips)
Seat 2: Hero ($9.98 in chips)
Seat 3: ea8863e9 ($7.35 in chips)
Seat 4: 87068284 ($12.64 in chips)
Seat 5: 2213b577 ($10.22 in chips)
Seat 6: f9c5a628 ($11.59 in chips)
Hero: posts small blind $0.05
ea8863e9: posts big blind $0.1
*** HOLE CARDS ***
Dealt to 17afabc1 
Dealt to Hero [9h 9c]
Dealt to ea8863e9 
Dealt to 87068284 
Dealt to 2213b577 
Dealt to f9c5a628 
87068284: folds
2213b577: raises $0.1 to $0.2
f9c5a628: folds
17afabc1: folds
Hero: raises $0.6 to $0.8
ea8863e9: raises $1.8 to $2.6
2213b577: folds
Hero: folds
Uncalled bet ($1.8) returned to ea8863e9
*** SHOWDOWN ***
ea8863e9 collected $1.71 from pot
*** SUMMARY ***
Total pot $1.8 | Rake $0.09 | Jackpot $0 | Bingo $0 | Fortune $0
Seat 1: 17afabc1 (button) folded before Flop (didn't bet)
Seat 2: Hero (small blind) folded before Flop
Seat 3: ea8863e9 (big blind) collected ($1.71)
Seat 4: 87068284 folded before Flop (didn't bet)
Seat 5: 2213b577 folded before Flop
Seat 6: f9c5a628 folded before Flop (didn't bet)


Poker Hand #RC1433076643: Hold'em No Limit  ($0.05/$0.1) - 2023/03/27 17:17:29
Table 'RushAndCash28111903' 6-max Seat #1 is the button
Seat 1: 5690518f ($12.36 in chips)
Seat 2: 947b43c2 ($12.25 in chips)
Seat 3: 8cbe28ff ($10 in chips)
Seat 4: Hero ($9.98 in chips)
Seat 5: 447b92bc ($11.48 in chips)
Seat 6: e11cfd5e ($20.82 in chips)
947b43c2: posts small blind $0.05
8cbe28ff: posts big blind $0.1
*** HOLE CARDS ***
Dealt to 5690518f 
Dealt to 947b43c2 
Dealt to 8cbe28ff 
Dealt to Hero [9s Jh]
Dealt to 447b92bc 
Dealt to e11cfd5e 
Hero: folds
447b92bc: raises $0.1 to $0.2
e11cfd5e: folds
5690518f: folds
947b43c2: folds
8cbe28ff: raises $0.8 to $1
447b92bc: folds
Uncalled bet ($0.8) returned to 8cbe28ff
*** SHOWDOWN ***
8cbe28ff collected $0.43 from pot
*** SUMMARY ***
Total pot $0.45 | Rake $0.02 | Jackpot $0 | Bingo $0 | Fortune $0
Seat 1: 5690518f (button) folded before Flop (didn't bet)
Seat 2: 947b43c2 (small blind) folded before Flop
Seat 3: 8cbe28ff (big blind) collected ($0.43)
Seat 4: Hero folded before Flop (didn't bet)
Seat 5: 447b92bc folded before Flop
Seat 6: e11cfd5e folded before Flop (didn't bet)


Poker Hand #RC1433076419: Hold'em No Limit  ($0.05/$0.1) - 2023/03/27 17:16:57
Table 'RushAndCash28111679' 6-max Seat #1 is the button
Seat 1: cc1ce1be ($17.56 in chips)
Seat 2: 4b6b214d ($10 in chips)
Seat 3: 15e91598 ($13 in chips)
Seat 4: cbd5f4f9 ($18.47 in chips)
Seat 5: Hero ($9.83 in chips)
Seat 6: 9d95e99 ($11.73 in chips)
4b6b214d: posts small blind $0.05
15e91598: posts big blind $0.1
*** HOLE CARDS ***
Dealt to cc1ce1be 
Dealt to 4b6b214d 
Dealt to 15e91598 
Dealt to cbd5f4f9 
Dealt to Hero [Th Ah]
Dealt to 9d95e99 
cbd5f4f9: folds
Hero: raises $0.15 to $0.25
9d95e99: folds
cc1ce1be: folds
4b6b214d: folds
15e91598: folds
Uncalled bet ($0.15) returned to Hero
*** SHOWDOWN ***
Hero collected $0.25 from pot
*** SUMMARY ***
Total pot $0.25 | Rake $0 | Jackpot $0 | Bingo $0 | Fortune $0
Seat 1: cc1ce1be (button) folded before Flop (didn't bet)
Seat 2: 4b6b214d (small blind) folded before Flop
Seat 3: 15e91598 (big blind) folded before Flop
Seat 4: cbd5f4f9 folded before Flop (didn't bet)
Seat 5: Hero collected ($0.25)
Seat 6: 9d95e99 folded before Flop (didn't bet)


Poker Hand #RC1433076325: Hold'em No Limit  ($0.05/$0.1) - 2023/03/27 17:16:46
Table 'RushAndCash28111585' 6-max Seat #1 is the button
Seat 1: Hero ($9.83 in chips)
Seat 2: fa674215 ($4.08 in chips)
Seat 3: 3adf8fbe ($11.36 in chips)
Seat 4: 825fa0d5 ($17.82 in chips)
Seat 5: 903ee6fa ($4.32 in chips)
Seat 6: ff0e64c3 ($8.47 in chips)
fa674215: posts small blind $0.05
3adf8fbe: posts big blind $0.1
*** HOLE CARDS ***
Dealt to Hero [3s 8s]
Dealt to fa674215 
Dealt to 3adf8fbe 
Dealt to 825fa0d5 
Dealt to 903ee6fa 
Dealt to ff0e64c3 
825fa0d5: raises $0.1 to $0.2
903ee6fa: folds
ff0e64c3: folds
Hero: folds
fa674215: calls $0.15
3adf8fbe: calls $0.1
*** FLOP *** [Kd 5d Td]
fa674215: checks
3adf8fbe: checks
825fa0d5: checks
*** TURN *** [Kd 5d Td] [8d]
fa674215: checks
3adf8fbe: checks
825fa0d5: checks
*** RIVER *** [Kd 5d Td 8d] [Ks]
fa674215: checks
3adf8fbe: checks
825fa0d5: checks
fa674215: shows [As Js] (Pair of Kings)
3adf8fbe: shows [9c 6h] (Pair of Kings)
825fa0d5: shows [Qs Th] (Pair of Kings and Pair of Tens)
*** SHOWDOWN ***
825fa0d5 collected $0.57 from pot
*** SUMMARY ***
Total pot $0.6 | Rake $0.03 | Jackpot $0 | Bingo $0 | Fortune $0
Board [Kd 5d Td 8d Ks]
Seat 1: Hero (button) folded before Flop (didn't bet)
Seat 2: fa674215 (small blind) showed [As Js] and lost with Pair of Kings
Seat 3: 3adf8fbe (big blind) showed [9c 6h] and lost with Pair of Kings
Seat 4: 825fa0d5 showed [Qs Th] and won ($0.57) with Pair of Kings and Pair of Tens
Seat 5: 903ee6fa folded before Flop (didn't bet)
Seat 6: ff0e64c3 folded before Flop (didn't bet)


Poker Hand #RC1433076140: Hold'em No Limit  ($0.05/$0.1) - 2023/03/27 17:16:22
Table 'RushAndCash28111400' 6-max Seat #1 is the button
Seat 1: Hero ($9.83 in chips)
Seat 2: fd48da9a ($9.76 in chips)
Seat 3: bc85f946 ($22.95 in chips)
Seat 4: d8fc5dfd ($10 in chips)
Seat 5: 3a2d562c ($11.19 in chips)
Seat 6: 8265a0cd ($10 in chips)
fd48da9a: posts small blind $0.05
bc85f946: posts big blind $0.1
*** HOLE CARDS ***
Dealt to Hero [9d 8h]
Dealt to fd48da9a 
Dealt to bc85f946 
Dealt to d8fc5dfd 
Dealt to 3a2d562c 
Dealt to 8265a0cd 
d8fc5dfd: raises $0.15 to $0.25
3a2d562c: folds
8265a0cd: folds
Hero: folds
fd48da9a: folds
bc85f946: calls $0.15
*** FLOP *** [8s Ks 3d]
bc85f946: checks
d8fc5dfd: bets $0.2
bc85f946: folds
Uncalled bet ($0.2) returned to d8fc5dfd
*** SHOWDOWN ***
d8fc5dfd collected $0.53 from pot
*** SUMMARY ***
Total pot $0.55 | Rake $0.02 | Jackpot $0 | Bingo $0 | Fortune $0
Board [8s Ks 3d]
Seat 1: Hero (button) folded before Flop (didn't bet)
Seat 2: fd48da9a (small blind) folded before Flop
Seat 3: bc85f946 (big blind) folded on the Flop
Seat 4: d8fc5dfd won ($0.53)
Seat 5: 3a2d562c folded before Flop (didn't bet)
Seat 6: 8265a0cd folded before Flop (didn't bet)


Poker Hand #RC1433076056: Hold'em No Limit  ($0.05/$0.1) - 2023/03/27 17:16:12
Table 'RushAndCash28111316' 6-max Seat #1 is the button
Seat 1: 9abcfbbb ($22.85 in chips)
Seat 2: Hero ($9.88 in chips)
Seat 3: 672bb697 ($10 in chips)
Seat 4: a449c38f ($10.29 in chips)
Seat 5: c682ccb4 ($11.06 in chips)
Seat 6: ed5522f4 ($10 in chips)
Hero: posts small blind $0.05
672bb697: posts big blind $0.1
*** HOLE CARDS ***
Dealt to 9abcfbbb 
Dealt to Hero [2h 4s]
Dealt to 672bb697 
Dealt to a449c38f 
Dealt to c682ccb4 
Dealt to ed5522f4 
a449c38f: folds
c682ccb4: raises $0.1 to $0.2
ed5522f4: folds
9abcfbbb: folds
Hero: folds
672bb697: folds
Uncalled bet ($0.1) returned to c682ccb4
*** SHOWDOWN ***
c682ccb4 collected $0.25 from pot
*** SUMMARY ***
Total pot $0.25 | Rake $0 | Jackpot $0 | Bingo $0 | Fortune $0
Seat 1: 9abcfbbb (button) folded before Flop (didn't bet)
Seat 2: Hero (small blind) folded before Flop
Seat 3: 672bb697 (big blind) folded before Flop
Seat 4: a449c38f folded before Flop (didn't bet)
Seat 5: c682ccb4 collected ($0.25)
Seat 6: ed5522f4 folded before Flop (didn't bet)


Poker Hand #RC1433076025: Hold'em No Limit  ($0.05/$0.1) - 2023/03/27 17:16:07
Table 'RushAndCash28111285' 6-max Seat #1 is the button
Seat 1: 34b48288 ($10.1 in chips)
Seat 2: ddd727bd ($12.95 in chips)
Seat 3: c20fb006 ($36.73 in chips)
Seat 4: Hero ($9.88 in chips)
Seat 5: 93df6bb4 ($11.35 in chips)
Seat 6: c221e444 ($10.58 in chips)
ddd727bd: posts small blind $0.05
c20fb006: posts big blind $0.1
*** HOLE CARDS ***
Dealt to 34b48288 
Dealt to ddd727bd 
Dealt to c20fb006 
Dealt to Hero [Kh 2d]
Dealt to 93df6bb4 
Dealt to c221e444 
Hero: folds
93df6bb4: folds
c221e444: folds
34b48288: folds
ddd727bd: raises $0.2 to $0.3
c20fb006: calls $0.2
*** FLOP *** [9d 5h 8s]
ddd727bd: bets $0.2
c20fb006: raises $0.75 to $0.95
ddd727bd: folds
Uncalled bet ($0.75) returned to c20fb006
*** SHOWDOWN ***
c20fb006 collected $0.95 from pot
*** SUMMARY ***
Total pot $1 | Rake $0.05 | Jackpot $0 | Bingo $0 | Fortune $0
Board [9d 5h 8s]
Seat 1: 34b48288 (button) folded before Flop (didn't bet)
Seat 2: ddd727bd (small blind) folded on the Flop
Seat 3: c20fb006 (big blind) won ($0.95)
Seat 4: Hero folded before Flop (didn't bet)
Seat 5: 93df6bb4 folded before Flop (didn't bet)
Seat 6: c221e444 folded before Flop (didn't bet)


Poker Hand #RC1433075954: Hold'em No Limit  ($0.05/$0.1) - 2023/03/27 17:15:58
Table 'RushAndCash28111214' 6-max Seat #1 is the button
Seat 1: f71e2e1a ($10.66 in chips)
Seat 2: 2358adf ($68.35 in chips)
Seat 3: Hero ($9.98 in chips)
Seat 4: bb4dcf9b ($30.13 in chips)
Seat 5: a2f30c1e ($23.54 in chips)
Seat 6: 7c98d056 ($13.29 in chips)
2358adf: posts small blind $0.05
Hero: posts big blind $0.1
*** HOLE CARDS ***
Dealt to f71e2e1a 
Dealt to 2358adf 
Dealt to Hero [2s 4d]
Dealt to bb4dcf9b 
Dealt to a2f30c1e 
Dealt to 7c98d056 
bb4dcf9b: folds
a2f30c1e: folds
7c98d056: raises $0.15 to $0.25
f71e2e1a: folds
2358adf: folds
Hero: folds
Uncalled bet ($0.15) returned to 7c98d056
*** SHOWDOWN ***
7c98d056 collected $0.25 from pot
*** SUMMARY ***
Total pot $0.25 | Rake $0 | Jackpot $0 | Bingo $0 | Fortune $0
Seat 1: f71e2e1a (button) folded before Flop (didn't bet)
Seat 2: 2358adf (small blind) folded before Flop
Seat 3: Hero (big blind) folded before Flop
Seat 4: bb4dcf9b folded before Flop (didn't bet)
Seat 5: a2f30c1e folded before Flop (didn't bet)
Seat 6: 7c98d056 collected ($0.25)


Poker Hand #RC1433075917: Hold'em No Limit  ($0.05/$0.1) - 2023/03/27 17:15:54
Table 'RushAndCash28111177' 6-max Seat #1 is the button
Seat 1: e37c7354 ($10.01 in chips)
Seat 2: 825fa0d5 ($17.92 in chips)
Seat 3: cf7eb818 ($10.78 in chips)
Seat 4: bfa4c993 ($10 in chips)
Seat 5: Hero ($9.98 in chips)
Seat 6: 48e6a4d7 ($9.83 in chips)
825fa0d5: posts small blind $0.05
cf7eb818: posts big blind $0.1
*** HOLE CARDS ***
Dealt to e37c7354 
Dealt to 825fa0d5 
Dealt to cf7eb818 
Dealt to bfa4c993 
Dealt to Hero [2d 5h]
Dealt to 48e6a4d7 
bfa4c993: folds
Hero: folds
48e6a4d7: folds
e37c7354: folds
825fa0d5: raises $0.1 to $0.2
cf7eb818: folds
Uncalled bet ($0.1) returned to 825fa0d5
*** SHOWDOWN ***
825fa0d5 collected $0.2 from pot
*** SUMMARY ***
Total pot $0.2 | Rake $0 | Jackpot $0 | Bingo $0 | Fortune $0
Seat 1: e37c7354 (button) folded before Flop (didn't bet)
Seat 2: 825fa0d5 (small blind) collected ($0.2)
Seat 3: cf7eb818 (big blind) folded before Flop
Seat 4: bfa4c993 folded before Flop (didn't bet)
Seat 5: Hero folded before Flop (didn't bet)
Seat 6: 48e6a4d7 folded before Flop (didn't bet)


Poker Hand #RC1433075879: Hold'em No Limit  ($0.05/$0.1) - 2023/03/27 17:15:50
Table 'RushAndCash28111139' 6-max Seat #1 is the button
Seat 1: ca31ae9d ($18.78 in chips)
Seat 2: cc1dd45b ($10.89 in chips)
Seat 3: 84ca0ee3 ($12.1 in chips)
Seat 4: Hero ($9.98 in chips)
Seat 5: 6d095210 ($9.92 in chips)
Seat 6: 3da72a18 ($11 in chips)
cc1dd45b: posts small blind $0.05
84ca0ee3: posts big blind $0.1
*** HOLE CARDS ***
Dealt to ca31ae9d 
Dealt to cc1dd45b 
Dealt to 84ca0ee3 
Dealt to Hero [Ts 7d]
Dealt to 6d095210 
Dealt to 3da72a18 
Hero: folds
6d095210: raises $0.1 to $0.2
3da72a18: folds
ca31ae9d: folds
cc1dd45b: folds
84ca0ee3: folds
Uncalled bet ($0.1) returned to 6d095210
*** SHOWDOWN ***
6d095210 collected $0.25 from pot
*** SUMMARY ***
Total pot $0.25 | Rake $0 | Jackpot $0 | Bingo $0 | Fortune $0
Seat 1: ca31ae9d (button) folded before Flop (didn't bet)
Seat 2: cc1dd45b (small blind) folded before Flop
Seat 3: 84ca0ee3 (big blind) folded before Flop
Seat 4: Hero folded before Flop (didn't bet)
Seat 5: 6d095210 collected ($0.25)
Seat 6: 3da72a18 folded before Flop (didn't bet)


Poker Hand #RC1433075817: Hold'em No Limit  ($0.05/$0.1) - 2023/03/27 17:15:42
Table 'RushAndCash28111077' 6-max Seat #1 is the button
Seat 1: 543157fb ($10 in chips)
Seat 2: a4ae7ba2 ($10 in chips)
Seat 3: e739d66c ($10.1 in chips)
Seat 4: f11c009e ($10.53 in chips)
Seat 5: ec3bebf3 ($22.46 in chips)
Seat 6: Hero ($9.98 in chips)
a4ae7ba2: posts small blind $0.05
e739d66c: posts big blind $0.1
*** HOLE CARDS ***
Dealt to 543157fb 
Dealt to a4ae7ba2 
Dealt to e739d66c 
Dealt to f11c009e 
Dealt to ec3bebf3 
Dealt to Hero [Qd 9h]
f11c009e: folds
ec3bebf3: folds
Hero: folds
543157fb: raises $0.14 to $0.24
a4ae7ba2: folds
e739d66c: folds
Uncalled bet ($0.14) returned to 543157fb
*** SHOWDOWN ***
543157fb collected $0.25 from pot
*** SUMMARY ***
Total pot $0.25 | Rake $0 | Jackpot $0 | Bingo $0 | Fortune $0
Seat 1: 543157fb (button) collected ($0.25)
Seat 2: a4ae7ba2 (small blind) folded before Flop
Seat 3: e739d66c (big blind) folded before Flop
Seat 4: f11c009e folded before Flop (didn't bet)
Seat 5: ec3bebf3 folded before Flop (didn't bet)
Seat 6: Hero folded before Flop (didn't bet)


Poker Hand #RC1433075607: Hold'em No Limit  ($0.05/$0.1) - 2023/03/27 17:15:15
Table 'RushAndCash28110867' 6-max Seat #1 is the button
Seat 1: Hero ($9.98 in chips)
Seat 2: 2170d934 ($6.24 in chips)
Seat 3: 605a42c5 ($11.92 in chips)
Seat 4: 73a70200 ($9.73 in chips)
Seat 5: 5b91610e ($24.11 in chips)
Seat 6: 5b06e1bc ($9.97 in chips)
2170d934: posts small blind $0.05
605a42c5: posts big blind $0.1
*** HOLE CARDS ***
Dealt to Hero [Ah 5d]
Dealt to 2170d934 
Dealt to 605a42c5 
Dealt to 73a70200 
Dealt to 5b91610e 
Dealt to 5b06e1bc 
73a70200: folds
5b91610e: raises $0.1 to $0.2
5b06e1bc: calls $0.2
Hero: folds
2170d934: folds
605a42c5: folds
*** FLOP *** [3c Qc As]
5b91610e: checks
5b06e1bc: checks
*** TURN *** [3c Qc As] [2c]
5b91610e: checks
5b06e1bc: checks
*** RIVER *** [3c Qc As 2c] [Ac]
5b91610e: checks
5b06e1bc: bets $0.28
5b91610e: folds
Uncalled bet ($0.28) returned to 5b06e1bc
*** SHOWDOWN ***
5b06e1bc collected $0.53 from pot
*** SUMMARY ***
Total pot $0.55 | Rake $0.02 | Jackpot $0 | Bingo $0 | Fortune $0
Board [3c Qc As 2c Ac]
Seat 1: Hero (button) folded before Flop (didn't bet)
Seat 2: 2170d934 (small blind) folded before Flop
Seat 3: 605a42c5 (big blind) folded before Flop
Seat 4: 73a70200 folded before Flop (didn't bet)
Seat 5: 5b91610e folded on the River
Seat 6: 5b06e1bc won ($0.53)


Poker Hand #RC1433075407: Hold'em No Limit  ($0.05/$0.1) - 2023/03/27 17:14:50
Table 'RushAndCash28110667' 6-max Seat #1 is the button
Seat 1: 6924d764 ($43.3 in chips)
Seat 2: Hero ($9.88 in chips)
Seat 3: fc9680e6 ($17.23 in chips)
Seat 4: 7239b0b ($21.6 in chips)
Seat 5: 81b34ae ($10.28 in chips)
Seat 6: 7f1c0438 ($6.52 in chips)
Hero: posts small blind $0.05
fc9680e6: posts big blind $0.1
*** HOLE CARDS ***
Dealt to 6924d764 
Dealt to Hero [6c Jd]
Dealt to fc9680e6 
Dealt to 7239b0b 
Dealt to 81b34ae 
Dealt to 7f1c0438 
7239b0b: folds
81b34ae: folds
7f1c0438: folds
6924d764: folds
Hero: raises $0.15 to $0.25
fc9680e6: folds
Uncalled bet ($0.15) returned to Hero
*** SHOWDOWN ***
Hero collected $0.2 from pot
*** SUMMARY ***
Total pot $0.2 | Rake $0 | Jackpot $0 | Bingo $0 | Fortune $0
Seat 1: 6924d764 (button) folded before Flop (didn't bet)
Seat 2: Hero (small blind) collected ($0.2)
Seat 3: fc9680e6 (big blind) folded before Flop
Seat 4: 7239b0b folded before Flop (didn't bet)
Seat 5: 81b34ae folded before Flop (didn't bet)
Seat 6: 7f1c0438 folded before Flop (didn't bet)


Poker Hand #RC1433075297: Hold'em No Limit  ($0.05/$0.1) - 2023/03/27 17:14:35
Table 'RushAndCash28110557' 6-max Seat #1 is the button
Seat 1: cc9e00b3 ($10.61 in chips)
Seat 2: 6d3e2b64 ($10 in chips)
Seat 3: Hero ($9.98 in chips)
Seat 4: 5a766e01 ($17.52 in chips)
Seat 5: a972f316 ($15.32 in chips)
Seat 6: e11cfd5e ($20.77 in chips)
6d3e2b64: posts small blind $0.05
Hero: posts big blind $0.1
*** HOLE CARDS ***
Dealt to cc9e00b3 
Dealt to 6d3e2b64 
Dealt to Hero [Kd 7h]
Dealt to 5a766e01 
Dealt to a972f316 
Dealt to e11cfd5e 
5a766e01: folds
a972f316: folds
e11cfd5e: raises $0.15 to $0.25
cc9e00b3: folds
6d3e2b64: folds
Hero: folds
Uncalled bet ($0.15) returned to e11cfd5e
*** SHOWDOWN ***
e11cfd5e collected $0.25 from pot
*** SUMMARY ***
Total pot $0.25 | Rake $0 | Jackpot $0 | Bingo $0 | Fortune $0
Seat 1: cc9e00b3 (button) folded before Flop (didn't bet)
Seat 2: 6d3e2b64 (small blind) folded before Flop
Seat 3: Hero (big blind) folded before Flop
Seat 4: 5a766e01 folded before Flop (didn't bet)
Seat 5: a972f316 folded before Flop (didn't bet)
Seat 6: e11cfd5e collected ($0.25)


Poker Hand #RC1433075232: Hold'em No Limit  ($0.05/$0.1) - 2023/03/27 17:14:28
Table 'RushAndCash28110492' 6-max Seat #1 is the button
Seat 1: 26faa500 ($10.78 in chips)
Seat 2: b4bad238 ($16 in chips)
Seat 3: 60ccf792 ($22.84 in chips)
Seat 4: 4a47a2a3 ($10 in chips)
Seat 5: cd1e3612 ($10 in chips)
Seat 6: Hero ($9.98 in chips)
b4bad238: posts small blind $0.05
60ccf792: posts big blind $0.1
*** HOLE CARDS ***
Dealt to 26faa500 
Dealt to b4bad238 
Dealt to 60ccf792 
Dealt to 4a47a2a3 
Dealt to cd1e3612 
Dealt to Hero [3c 3s]
4a47a2a3: folds
cd1e3612: folds
Hero: folds
26faa500: folds
b4bad238: raises $0.2 to $0.3
60ccf792: folds
Uncalled bet ($0.2) returned to b4bad238
*** SHOWDOWN ***
b4bad238 collected $0.2 from pot
*** SUMMARY ***
Total pot $0.2 | Rake $0 | Jackpot $0 | Bingo $0 | Fortune $0
Seat 1: 26faa500 (button) folded before Flop (didn't bet)
Seat 2: b4bad238 (small blind) collected ($0.2)
Seat 3: 60ccf792 (big blind) folded before Flop
Seat 4: 4a47a2a3 folded before Flop (didn't bet)
Seat 5: cd1e3612 folded before Flop (didn't bet)
Seat 6: Hero folded before Flop (didn't bet)


Poker Hand #RC1433075129: Hold'em No Limit  ($0.05/$0.1) - 2023/03/27 17:14:14
Table 'RushAndCash28110389' 6-max Seat #1 is the button
Seat 1: cbd5f4f9 ($20.32 in chips)
Seat 2: ad743f5d ($25.59 in chips)
Seat 3: 224dd9aa ($23.63 in chips)
Seat 4: 668c8580 ($15.79 in chips)
Seat 5: 5a766e01 ($17.57 in chips)
Seat 6: Hero ($9.98 in chips)
ad743f5d: posts small blind $0.05
224dd9aa: posts big blind $0.1
*** HOLE CARDS ***
Dealt to cbd5f4f9 
Dealt to ad743f5d 
Dealt to 224dd9aa 
Dealt to 668c8580 
Dealt to 5a766e01 
Dealt to Hero [Ks 4c]
668c8580: folds
5a766e01: folds
Hero: folds
cbd5f4f9: raises $0.15 to $0.25
ad743f5d: folds
224dd9aa: folds
Uncalled bet ($0.15) returned to cbd5f4f9
*** SHOWDOWN ***
cbd5f4f9 collected $0.25 from pot
*** SUMMARY ***
Total pot $0.25 | Rake $0 | Jackpot $0 | Bingo $0 | Fortune $0
Seat 1: cbd5f4f9 (button) collected ($0.25)
Seat 2: ad743f5d (small blind) folded before Flop
Seat 3: 224dd9aa (big blind) folded before Flop
Seat 4: 668c8580 folded before Flop (didn't bet)
Seat 5: 5a766e01 folded before Flop (didn't bet)
Seat 6: Hero folded before Flop (didn't bet)


Poker Hand #RC1433075042: Hold'em No Limit  ($0.05/$0.1) - 2023/03/27 17:14:03
Table 'RushAndCash28110302' 6-max Seat #1 is the button
Seat 1: b6fc6c61 ($12.25 in chips)
Seat 2: fa417246 ($12.29 in chips)
Seat 3: afb931fd ($12.36 in chips)
Seat 4: 8494623e ($12.43 in chips)
Seat 5: f44e13b5 ($12.05 in chips)
Seat 6: Hero ($9.98 in chips)
fa417246: posts small blind $0.05
afb931fd: posts big blind $0.1
*** HOLE CARDS ***
Dealt to b6fc6c61 
Dealt to fa417246 
Dealt to afb931fd 
Dealt to 8494623e 
Dealt to f44e13b5 
Dealt to Hero [3h Th]
8494623e: folds
f44e13b5: folds
Hero: folds
b6fc6c61: folds
fa417246: folds
Uncalled bet ($0.05) returned to afb931fd
*** SHOWDOWN ***
afb931fd collected $0.1 from pot
*** SUMMARY ***
Total pot $0.1 | Rake $0 | Jackpot $0 | Bingo $0 | Fortune $0
Seat 1: b6fc6c61 (button) folded before Flop (didn't bet)
Seat 2: fa417246 (small blind) folded before Flop
Seat 3: afb931fd (big blind) collected ($0.1)
Seat 4: 8494623e folded before Flop (didn't bet)
Seat 5: f44e13b5 folded before Flop (didn't bet)
Seat 6: Hero folded before Flop (didn't bet)


Poker Hand #RC1433074952: Hold'em No Limit  ($0.05/$0.1) - 2023/03/27 17:13:52
Table 'RushAndCash28110212' 6-max Seat #1 is the button
Seat 1: Hero ($9.98 in chips)
Seat 2: bcf4f43c ($15.31 in chips)
Seat 3: 3adf8fbe ($11.57 in chips)
Seat 4: 5d927a6f ($14.43 in chips)
Seat 5: d6658959 ($9.54 in chips)
Seat 6: 9f9781fb ($16.73 in chips)
bcf4f43c: posts small blind $0.05
3adf8fbe: posts big blind $0.1
*** HOLE CARDS ***
Dealt to Hero [5c 3h]
Dealt to bcf4f43c 
Dealt to 3adf8fbe 
Dealt to 5d927a6f 
Dealt to d6658959 
Dealt to 9f9781fb 
5d927a6f: raises $0.12 to $0.22
d6658959: raises $0.45 to $0.67
9f9781fb: folds
Hero: folds
bcf4f43c: folds
3adf8fbe: folds
5d927a6f: raises $1.43 to $2.1
d6658959: calls $1.43
*** FLOP *** [Qs 3s Td]
5d927a6f: bets $1.1
d6658959: raises $2.17 to $3.27
5d927a6f: folds
Uncalled bet ($2.17) returned to d6658959
*** SHOWDOWN ***
d6658959 collected $6.1 from pot
*** SUMMARY ***
Total pot $6.55 | Rake $0.3 | Jackpot $0.15 | Bingo $0 | Fortune $0
Board [Qs 3s Td]
Seat 1: Hero (button) folded before Flop (didn't bet)
Seat 2: bcf4f43c (small blind) folded before Flop
Seat 3: 3adf8fbe (big blind) folded before Flop
Seat 4: 5d927a6f folded on the Flop
Seat 5: d6658959 won ($6.1)
Seat 6: 9f9781fb folded before Flop (didn't bet)


Poker Hand #RC1433074761: Hold'em No Limit  ($0.05/$0.1) - 2023/03/27 17:13:28
Table 'RushAndCash28110021' 6-max Seat #1 is the button
Seat 1: d7c38fab ($10.75 in chips)
Seat 2: Hero ($10.03 in chips)
Seat 3: f842925 ($9.34 in chips)
Seat 4: c8137c01 ($9.62 in chips)
Seat 5: ac3de593 ($9.58 in chips)
Seat 6: b069c257 ($14.86 in chips)
Hero: posts small blind $0.05
f842925: posts big blind $0.1
*** HOLE CARDS ***
Dealt to d7c38fab 
Dealt to Hero [2c As]
Dealt to f842925 
Dealt to c8137c01 
Dealt to ac3de593 
Dealt to b069c257 
c8137c01: folds
ac3de593: folds
b069c257: folds
d7c38fab: raises $0.25 to $0.35
Hero: folds
f842925: folds
Uncalled bet ($0.25) returned to d7c38fab
*** SHOWDOWN ***
d7c38fab collected $0.25 from pot
*** SUMMARY ***
Total pot $0.25 | Rake $0 | Jackpot $0 | Bingo $0 | Fortune $0
Seat 1: d7c38fab (button) collected ($0.25)
Seat 2: Hero (small blind) folded before Flop
Seat 3: f842925 (big blind) folded before Flop
Seat 4: c8137c01 folded before Flop (didn't bet)
Seat 5: ac3de593 folded before Flop (didn't bet)
Seat 6: b069c257 folded before Flop (didn't bet)


Poker Hand #RC1433014655: Hold'em No Limit  ($0.05/$0.1) - 2023/03/27 17:13:14
Table 'RushAndCash28109915' 6-max Seat #1 is the button
Seat 1: 682e00a ($11.48 in chips)
Seat 2: 9c4d3948 ($20.1 in chips)
Seat 3: Hero ($10.13 in chips)
Seat 4: 5aa8835f ($21.43 in chips)
Seat 5: 1b14adf9 ($12.11 in chips)
Seat 6: b59f0022 ($11.25 in chips)
9c4d3948: posts small blind $0.05
Hero: posts big blind $0.1
*** HOLE CARDS ***
Dealt to 682e00a 
Dealt to 9c4d3948 
Dealt to Hero [9h 4d]
Dealt to 5aa8835f 
Dealt to 1b14adf9 
Dealt to b59f0022 
5aa8835f: raises $0.2 to $0.3
1b14adf9: folds
b59f0022: folds
682e00a: folds
9c4d3948: folds
Hero: folds
Uncalled bet ($0.2) returned to 5aa8835f
*** SHOWDOWN ***
5aa8835f collected $0.25 from pot
*** SUMMARY ***
Total pot $0.25 | Rake $0 | Jackpot $0 | Bingo $0 | Fortune $0
Seat 1: 682e00a (button) folded before Flop (didn't bet)
Seat 2: 9c4d3948 (small blind) folded before Flop
Seat 3: Hero (big blind) folded before Flop
Seat 4: 5aa8835f collected ($0.25)
Seat 5: 1b14adf9 folded before Flop (didn't bet)
Seat 6: b59f0022 folded before Flop (didn't bet)


Poker Hand #RC1433014586: Hold'em No Limit  ($0.05/$0.1) - 2023/03/27 17:13:06
Table 'RushAndCash28109846' 6-max Seat #1 is the button
Seat 1: cb147c87 ($10 in chips)
Seat 2: 405b6ea4 ($11.24 in chips)
Seat 3: 3d24fef0 ($11.88 in chips)
Seat 4: 224dd9aa ($23.13 in chips)
Seat 5: 5d3ecf20 ($25.78 in chips)
Seat 6: Hero ($10.13 in chips)
405b6ea4: posts small blind $0.05
3d24fef0: posts big blind $0.1
*** HOLE CARDS ***
Dealt to cb147c87 
Dealt to 405b6ea4 
Dealt to 3d24fef0 
Dealt to 224dd9aa 
Dealt to 5d3ecf20 
Dealt to Hero [9h Jc]
224dd9aa: folds
5d3ecf20: folds
Hero: folds
cb147c87: raises $0.15 to $0.25
405b6ea4: folds
3d24fef0: folds
Uncalled bet ($0.15) returned to cb147c87
*** SHOWDOWN ***
cb147c87 collected $0.25 from pot
*** SUMMARY ***
Total pot $0.25 | Rake $0 | Jackpot $0 | Bingo $0 | Fortune $0
Seat 1: cb147c87 (button) collected ($0.25)
Seat 2: 405b6ea4 (small blind) folded before Flop
Seat 3: 3d24fef0 (big blind) folded before Flop
Seat 4: 224dd9aa folded before Flop (didn't bet)
Seat 5: 5d3ecf20 folded before Flop (didn't bet)
Seat 6: Hero folded before Flop (didn't bet)


Poker Hand #RC1433014544: Hold'em No Limit  ($0.05/$0.1) - 2023/03/27 17:13:00
Table 'RushAndCash28109804' 6-max Seat #1 is the button
Seat 1: bb7e8808 ($11.14 in chips)
Seat 2: 5930677a ($10.05 in chips)
Seat 3: 4a5b92e8 ($13.57 in chips)
Seat 4: 682e00a ($11.48 in chips)
Seat 5: c1830079 ($17.86 in chips)
Seat 6: Hero ($10.13 in chips)
5930677a: posts small blind $0.05
4a5b92e8: posts big blind $0.1
*** HOLE CARDS ***
Dealt to bb7e8808 
Dealt to 5930677a 
Dealt to 4a5b92e8 
Dealt to 682e00a 
Dealt to c1830079 
Dealt to Hero [Js 7s]
682e00a: folds
c1830079: folds
Hero: folds
bb7e8808: folds
5930677a: raises $0.2 to $0.3
4a5b92e8: folds
Uncalled bet ($0.2) returned to 5930677a
*** SHOWDOWN ***
5930677a collected $0.2 from pot
*** SUMMARY ***
Total pot $0.2 | Rake $0 | Jackpot $0 | Bingo $0 | Fortune $0
Seat 1: bb7e8808 (button) folded before Flop (didn't bet)
Seat 2: 5930677a (small blind) collected ($0.2)
Seat 3: 4a5b92e8 (big blind) folded before Flop
Seat 4: 682e00a folded before Flop (didn't bet)
Seat 5: c1830079 folded before Flop (didn't bet)
Seat 6: Hero folded before Flop (didn't bet)


Poker Hand #RC1433014259: Hold'em No Limit  ($0.05/$0.1) - 2023/03/27 17:12:23
Table 'RushAndCash28109519' 6-max Seat #1 is the button
Seat 1: 4a5b92e8 ($12.19 in chips)
Seat 2: Hero ($10.18 in chips)
Seat 3: d506e51a ($3.45 in chips)
Seat 4: d54222b ($8.1 in chips)
Seat 5: c1830079 ($17.96 in chips)
Seat 6: 44de7607 ($9.41 in chips)
Cash Drop to Pot : total $1 
Hero: posts small blind $0.05
d506e51a: posts big blind $0.1
*** HOLE CARDS ***
Dealt to 4a5b92e8 
Dealt to Hero [4h 5s]
Dealt to d506e51a 
Dealt to d54222b 
Dealt to c1830079 
Dealt to 44de7607 
d54222b: calls $0.1
c1830079: calls $0.1
44de7607: calls $0.1
4a5b92e8: raises $12.09 to $12.19 and is all-in
Hero: folds
d506e51a: folds
d54222b: folds
c1830079: folds
44de7607: folds
Uncalled bet ($12.09) returned to 4a5b92e8
*** SHOWDOWN ***
4a5b92e8 collected $1.48 from pot
*** SUMMARY ***
Total pot $1.55 | Rake $0.07 | Jackpot $0 | Bingo $0 | Fortune $0
Seat 1: 4a5b92e8 (button) collected ($1.48)
Seat 2: Hero (small blind) folded before Flop
Seat 3: d506e51a (big blind) folded before Flop
Seat 4: d54222b folded before Flop
Seat 5: c1830079 folded before Flop
Seat 6: 44de7607 folded before Flop


Poker Hand #RC1433013986: Hold'em No Limit  ($0.05/$0.1) - 2023/03/27 17:11:50
Table 'RushAndCash28109246' 6-max Seat #1 is the button
Seat 1: 62ee250e ($3.99 in chips)
Seat 2: 2213b577 ($10 in chips)
Seat 3: 1671f1bd ($9.53 in chips)
Seat 4: Hero ($9.81 in chips)
Seat 5: 1b6cf177 ($10 in chips)
Seat 6: d7405b43 ($10.65 in chips)
2213b577: posts small blind $0.05
1671f1bd: posts big blind $0.1
*** HOLE CARDS ***
Dealt to 62ee250e 
Dealt to 2213b577 
Dealt to 1671f1bd 
Dealt to Hero [As 4s]
Dealt to 1b6cf177 
Dealt to d7405b43 
Hero: raises $0.15 to $0.25
1b6cf177: folds
d7405b43: folds
62ee250e: calls $0.25
2213b577: folds
1671f1bd: folds
*** FLOP *** [Qs Kd 8h]
Hero: bets $0.33
62ee250e: folds
Uncalled bet ($0.33) returned to Hero
*** SHOWDOWN ***
Hero collected $0.62 from pot
*** SUMMARY ***
Total pot $0.65 | Rake $0.03 | Jackpot $0 | Bingo $0 | Fortune $0
Board [Qs Kd 8h]
Seat 1: 62ee250e (button) folded on the Flop
Seat 2: 2213b577 (small blind) folded before Flop
Seat 3: 1671f1bd (big blind) folded before Flop
Seat 4: Hero won ($0.62)
Seat 5: 1b6cf177 folded before Flop (didn't bet)
Seat 6: d7405b43 folded before Flop (didn't bet)


Poker Hand #RC1433013835: Hold'em No Limit  ($0.05/$0.1) - 2023/03/27 17:11:30
Table 'RushAndCash28109095' 6-max Seat #1 is the button
Seat 1: 8bee910d ($17.69 in chips)
Seat 2: 5c072d71 ($11.86 in chips)
Seat 3: Hero ($9.91 in chips)
Seat 4: 6ff325c4 ($7.08 in chips)
Seat 5: 388c5058 ($9.7 in chips)
Seat 6: 51fd9596 ($7.1 in chips)
5c072d71: posts small blind $0.05
Hero: posts big blind $0.1
*** HOLE CARDS ***
Dealt to 8bee910d 
Dealt to 5c072d71 
Dealt to Hero [2d Qc]
Dealt to 6ff325c4 
Dealt to 388c5058 
Dealt to 51fd9596 
6ff325c4: folds
388c5058: folds
51fd9596: folds
8bee910d: raises $0.15 to $0.25
5c072d71: folds
Hero: folds
Uncalled bet ($0.15) returned to 8bee910d
*** SHOWDOWN ***
8bee910d collected $0.25 from pot
*** SUMMARY ***
Total pot $0.25 | Rake $0 | Jackpot $0 | Bingo $0 | Fortune $0
Seat 1: 8bee910d (button) collected ($0.25)
Seat 2: 5c072d71 (small blind) folded before Flop
Seat 3: Hero (big blind) folded before Flop
Seat 4: 6ff325c4 folded before Flop (didn't bet)
Seat 5: 388c5058 folded before Flop (didn't bet)
Seat 6: 51fd9596 folded before Flop (didn't bet)


Poker Hand #RC1433013685: Hold'em No Limit  ($0.05/$0.1) - 2023/03/27 17:11:09
Table 'RushAndCash28108945' 6-max Seat #1 is the button
Seat 1: Hero ($9.91 in chips)
Seat 2: 473eceac ($22.89 in chips)
Seat 3: 1f99d14b ($10 in chips)
Seat 4: 5f83f91f ($11.6 in chips)
Seat 5: ead60f34 ($14.55 in chips)
Seat 6: c4f30b99 ($33.73 in chips)
473eceac: posts small blind $0.05
1f99d14b: posts big blind $0.1
*** HOLE CARDS ***
Dealt to Hero [4d 9s]
Dealt to 473eceac 
Dealt to 1f99d14b 
Dealt to 5f83f91f 
Dealt to ead60f34 
Dealt to c4f30b99 
5f83f91f: folds
ead60f34: folds
c4f30b99: folds
Hero: folds
473eceac: folds
Uncalled bet ($0.05) returned to 1f99d14b
*** SHOWDOWN ***
1f99d14b collected $0.1 from pot
*** SUMMARY ***
Total pot $0.1 | Rake $0 | Jackpot $0 | Bingo $0 | Fortune $0
Seat 1: Hero (button) folded before Flop (didn't bet)
Seat 2: 473eceac (small blind) folded before Flop
Seat 3: 1f99d14b (big blind) collected ($0.1)
Seat 4: 5f83f91f folded before Flop (didn't bet)
Seat 5: ead60f34 folded before Flop (didn't bet)
Seat 6: c4f30b99 folded before Flop (didn't bet)


Poker Hand #RC1433013607: Hold'em No Limit  ($0.05/$0.1) - 2023/03/27 17:10:59
Table 'RushAndCash28108867' 6-max Seat #1 is the button
Seat 1: 9b3cdb65 ($21.5 in chips)
Seat 2: b4780f2d ($17.48 in chips)
Seat 3: ed8bcfaa ($10.6 in chips)
Seat 4: ff85d43a ($10 in chips)
Seat 5: d54222b ($7.63 in chips)
Seat 6: Hero ($9.91 in chips)
b4780f2d: posts small blind $0.05
ed8bcfaa: posts big blind $0.1
*** HOLE CARDS ***
Dealt to 9b3cdb65 
Dealt to b4780f2d 
Dealt to ed8bcfaa 
Dealt to ff85d43a 
Dealt to d54222b 
Dealt to Hero [Jc Kd]
ff85d43a: folds
d54222b: raises $0.15 to $0.25
Hero: folds
9b3cdb65: folds
b4780f2d: folds
ed8bcfaa: folds
Uncalled bet ($0.15) returned to d54222b
*** SHOWDOWN ***
d54222b collected $0.25 from pot
*** SUMMARY ***
Total pot $0.25 | Rake $0 | Jackpot $0 | Bingo $0 | Fortune $0
Seat 1: 9b3cdb65 (button) folded before Flop (didn't bet)
Seat 2: b4780f2d (small blind) folded before Flop
Seat 3: ed8bcfaa (big blind) folded before Flop
Seat 4: ff85d43a folded before Flop (didn't bet)
Seat 5: d54222b collected ($0.25)
Seat 6: Hero folded before Flop (didn't bet)


Poker Hand #RC1433013523: Hold'em No Limit  ($0.05/$0.1) - 2023/03/27 17:10:48
Table 'RushAndCash28108783' 6-max Seat #1 is the button
Seat 1: 869080f1 ($11.12 in chips)
Seat 2: aad0172b ($10 in chips)
Seat 3: 41348439 ($9.76 in chips)
Seat 4: 40f6ee0e ($11.43 in chips)
Seat 5: Hero ($9.91 in chips)
Seat 6: 68ca899f ($18.99 in chips)
aad0172b: posts small blind $0.05
41348439: posts big blind $0.1
*** HOLE CARDS ***
Dealt to 869080f1 
Dealt to aad0172b 
Dealt to 41348439 
Dealt to 40f6ee0e 
Dealt to Hero [Jd 6c]
Dealt to 68ca899f 
40f6ee0e: raises $0.15 to $0.25
Hero: folds
68ca899f: folds
869080f1: folds
aad0172b: folds
41348439: folds
Uncalled bet ($0.15) returned to 40f6ee0e
*** SHOWDOWN ***
40f6ee0e collected $0.25 from pot
*** SUMMARY ***
Total pot $0.25 | Rake $0 | Jackpot $0 | Bingo $0 | Fortune $0
Seat 1: 869080f1 (button) folded before Flop (didn't bet)
Seat 2: aad0172b (small blind) folded before Flop
Seat 3: 41348439 (big blind) folded before Flop
Seat 4: 40f6ee0e collected ($0.25)
Seat 5: Hero folded before Flop (didn't bet)
Seat 6: 68ca899f folded before Flop (didn't bet)


Poker Hand #RC1433013466: Hold'em No Limit  ($0.05/$0.1) - 2023/03/27 17:10:41
Table 'RushAndCash28108726' 6-max Seat #1 is the button
Seat 1: Hero ($9.91 in chips)
Seat 2: d4d1ee92 ($10.48 in chips)
Seat 3: 3bfa5da4 ($7.88 in chips)
Seat 4: 1164692a ($13.42 in chips)
Seat 5: cebcd22f ($10 in chips)
Seat 6: 7199e0d7 ($14.42 in chips)
d4d1ee92: posts small blind $0.05
3bfa5da4: posts big blind $0.1
*** HOLE CARDS ***
Dealt to Hero [Kd 9h]
Dealt to d4d1ee92 
Dealt to 3bfa5da4 
Dealt to 1164692a 
Dealt to cebcd22f 
Dealt to 7199e0d7 
1164692a: raises $0.15 to $0.25
cebcd22f: folds
7199e0d7: folds
Hero: folds
d4d1ee92: folds
3bfa5da4: calls $0.15
*** FLOP *** [Qh 4s 8s]
3bfa5da4: checks
1164692a: bets $0.19
3bfa5da4: calls $0.19
*** TURN *** [Qh 4s 8s] [Kh]
3bfa5da4: checks
1164692a: checks
*** RIVER *** [Qh 4s 8s Kh] [Td]
3bfa5da4: bets $0.93
1164692a: folds
Uncalled bet ($0.93) returned to 3bfa5da4
*** SHOWDOWN ***
3bfa5da4 collected $0.89 from pot
*** SUMMARY ***
Total pot $0.93 | Rake $0.04 | Jackpot $0 | Bingo $0 | Fortune $0
Board [Qh 4s 8s Kh Td]
Seat 1: Hero (button) folded before Flop (didn't bet)
Seat 2: d4d1ee92 (small blind) folded before Flop
Seat 3: 3bfa5da4 (big blind) won ($0.89)
Seat 4: 1164692a folded on the River
Seat 5: cebcd22f folded before Flop (didn't bet)
Seat 6: 7199e0d7 folded before Flop (didn't bet)


Poker Hand #RC1433013429: Hold'em No Limit  ($0.05/$0.1) - 2023/03/27 17:10:37
Table 'RushAndCash28108689' 6-max Seat #1 is the button
Seat 1: b6e05c2a ($10.11 in chips)
Seat 2: c263b8d2 ($11.06 in chips)
Seat 3: 23d0eaa5 ($19.24 in chips)
Seat 4: b23948da ($10 in chips)
Seat 5: Hero ($9.91 in chips)
Seat 6: 24d8779c ($20.09 in chips)
c263b8d2: posts small blind $0.05
23d0eaa5: posts big blind $0.1
*** HOLE CARDS ***
Dealt to b6e05c2a 
Dealt to c263b8d2 
Dealt to 23d0eaa5 
Dealt to b23948da 
Dealt to Hero [2c Th]
Dealt to 24d8779c 
b23948da: folds
Hero: folds
24d8779c: folds
b6e05c2a: raises $0.1 to $0.2
c263b8d2: folds
23d0eaa5: calls $0.1
*** FLOP *** [7s 6c 5h]
23d0eaa5: checks
b6e05c2a: bets $0.14
23d0eaa5: raises $0.36 to $0.5
b6e05c2a: calls $0.36
*** TURN *** [7s 6c 5h] [6d]
23d0eaa5: bets $0.8
b6e05c2a: calls $0.8
*** RIVER *** [7s 6c 5h 6d] [Td]
23d0eaa5: checks
b6e05c2a: checks
23d0eaa5: shows [7d Ac] (Pair of Sevens and Pair of Sixes)
b6e05c2a: shows [5d Kh] (Pair of Sixes and Pair of Fives)
*** SHOWDOWN ***
23d0eaa5 collected $2.76 from pot
*** SUMMARY ***
Total pot $3.05 | Rake $0.14 | Jackpot $0.15 | Bingo $0 | Fortune $0
Board [7s 6c 5h 6d Td]
Seat 1: b6e05c2a (button) showed [5d Kh] and lost with Pair of Sixes and Pair of Fives
Seat 2: c263b8d2 (small blind) folded before Flop
Seat 3: 23d0eaa5 (big blind) showed [7d Ac] and won ($2.76) with Pair of Sevens and Pair of Sixes
Seat 4: b23948da folded before Flop (didn't bet)
Seat 5: Hero folded before Flop (didn't bet)
Seat 6: 24d8779c folded before Flop (didn't bet)


Poker Hand #RC1433013336: Hold'em No Limit  ($0.05/$0.1) - 2023/03/27 17:10:25
Table 'RushAndCash28108596' 6-max Seat #1 is the button
Seat 1: bc200b82 ($10.1 in chips)
Seat 2: 2114b5f1 ($10 in chips)
Seat 3: Hero ($9.86 in chips)
Seat 4: f6ae1c3c ($15.58 in chips)
Seat 5: 610e9da5 ($4.88 in chips)
Seat 6: c8f4c42c ($10.33 in chips)
2114b5f1: posts small blind $0.05
Hero: posts big blind $0.1
*** HOLE CARDS ***
Dealt to bc200b82 
Dealt to 2114b5f1 
Dealt to Hero [2c 5h]
Dealt to f6ae1c3c 
Dealt to 610e9da5 
Dealt to c8f4c42c 
f6ae1c3c: folds
610e9da5: folds
c8f4c42c: folds
bc200b82: folds
2114b5f1: folds
Uncalled bet ($0.05) returned to Hero
*** SHOWDOWN ***
Hero collected $0.1 from pot
*** SUMMARY ***
Total pot $0.1 | Rake $0 | Jackpot $0 | Bingo $0 | Fortune $0
Seat 1: bc200b82 (button) folded before Flop (didn't bet)
Seat 2: 2114b5f1 (small blind) folded before Flop
Seat 3: Hero (big blind) collected ($0.1)
Seat 4: f6ae1c3c folded before Flop (didn't bet)
Seat 5: 610e9da5 folded before Flop (didn't bet)
Seat 6: c8f4c42c folded before Flop (didn't bet)


Poker Hand #RC1433013242: Hold'em No Limit  ($0.05/$0.1) - 2023/03/27 17:10:14
Table 'RushAndCash28108502' 6-max Seat #1 is the button
Seat 1: d4d1ee92 ($10.33 in chips)
Seat 2: Hero ($9.91 in chips)
Seat 3: c221e444 ($10 in chips)
Seat 4: b45d6a15 ($17.99 in chips)
Seat 5: e88c8126 ($10.15 in chips)
Seat 6: d54222b ($7.93 in chips)
Hero: posts small blind $0.05
c221e444: posts big blind $0.1
*** HOLE CARDS ***
Dealt to d4d1ee92 
Dealt to Hero [Th 3h]
Dealt to c221e444 
Dealt to b45d6a15 
Dealt to e88c8126 
Dealt to d54222b 
b45d6a15: raises $0.13 to $0.23
e88c8126: raises $0.52 to $0.75
d54222b: folds
d4d1ee92: folds
Hero: folds
c221e444: folds
b45d6a15: folds
Uncalled bet ($0.52) returned to e88c8126
*** SHOWDOWN ***
e88c8126 collected $0.58 from pot
*** SUMMARY ***
Total pot $0.61 | Rake $0.03 | Jackpot $0 | Bingo $0 | Fortune $0
Seat 1: d4d1ee92 (button) folded before Flop (didn't bet)
Seat 2: Hero (small blind) folded before Flop
Seat 3: c221e444 (big blind) folded before Flop
Seat 4: b45d6a15 folded before Flop
Seat 5: e88c8126 collected ($0.58)
Seat 6: d54222b folded before Flop (didn't bet)


Poker Hand #RC1433013095: Hold'em No Limit  ($0.05/$0.1) - 2023/03/27 17:09:55
Table 'RushAndCash28108355' 6-max Seat #1 is the button
Seat 1: 3576e8bf ($9.48 in chips)
Seat 2: 64418b20 ($10 in chips)
Seat 3: d54222b ($8.08 in chips)
Seat 4: 3fe19441 ($9.33 in chips)
Seat 5: 95a519be ($10.55 in chips)
Seat 6: Hero ($9.76 in chips)
64418b20: posts small blind $0.05
d54222b: posts big blind $0.1
*** HOLE CARDS ***
Dealt to 3576e8bf 
Dealt to 64418b20 
Dealt to d54222b 
Dealt to 3fe19441 
Dealt to 95a519be 
Dealt to Hero [Ah 7c]
3fe19441: folds
95a519be: folds
Hero: raises $0.15 to $0.25
3576e8bf: folds
64418b20: folds
d54222b: folds
Uncalled bet ($0.15) returned to Hero
*** SHOWDOWN ***
Hero collected $0.25 from pot
*** SUMMARY ***
Total pot $0.25 | Rake $0 | Jackpot $0 | Bingo $0 | Fortune $0
Seat 1: 3576e8bf (button) folded before Flop (didn't bet)
Seat 2: 64418b20 (small blind) folded before Flop
Seat 3: d54222b (big blind) folded before Flop
Seat 4: 3fe19441 folded before Flop (didn't bet)
Seat 5: 95a519be folded before Flop (didn't bet)
Seat 6: Hero collected ($0.25)


Poker Hand #RC1433013063: Hold'em No Limit  ($0.05/$0.1) - 2023/03/27 17:09:51
Table 'RushAndCash28108323' 6-max Seat #1 is the button
Seat 1: e48b4e93 ($19.06 in chips)
Seat 2: 9c4d3948 ($10.33 in chips)
Seat 3: 628d3438 ($35.99 in chips)
Seat 4: Hero ($9.76 in chips)
Seat 5: f39352a8 ($11 in chips)
Seat 6: ccfb5993 ($24.24 in chips)
9c4d3948: posts small blind $0.05
628d3438: posts big blind $0.1
*** HOLE CARDS ***
Dealt to e48b4e93 
Dealt to 9c4d3948 
Dealt to 628d3438 
Dealt to Hero [4s 3h]
Dealt to f39352a8 
Dealt to ccfb5993 
Hero: folds
f39352a8: folds
ccfb5993: folds
e48b4e93: raises $0.15 to $0.25
9c4d3948: folds
628d3438: raises $1.05 to $1.3
e48b4e93: calls $1.05
*** FLOP *** [8h Jh 6d]
628d3438: bets $0.88
e48b4e93: folds
Uncalled bet ($0.88) returned to 628d3438
*** SHOWDOWN ***
628d3438 collected $2.52 from pot
*** SUMMARY ***
Total pot $2.65 | Rake $0.13 | Jackpot $0 | Bingo $0 | Fortune $0
Board [8h Jh 6d]
Seat 1: e48b4e93 (button) folded on the Flop
Seat 2: 9c4d3948 (small blind) folded before Flop
Seat 3: 628d3438 (big blind) won ($2.52)
Seat 4: Hero folded before Flop (didn't bet)
Seat 5: f39352a8 folded before Flop (didn't bet)
Seat 6: ccfb5993 folded before Flop (didn't bet)


Poker Hand #RC1433013029: Hold'em No Limit  ($0.05/$0.1) - 2023/03/27 17:09:47
Table 'RushAndCash28108289' 6-max Seat #1 is the button
Seat 1: Hero ($9.76 in chips)
Seat 2: 39154bcf ($14.61 in chips)
Seat 3: 57b58395 ($10.15 in chips)
Seat 4: c53e784c ($10 in chips)
Seat 5: 721d34b9 ($11.57 in chips)
Seat 6: cf224d9 ($10 in chips)
39154bcf: posts small blind $0.05
57b58395: posts big blind $0.1
*** HOLE CARDS ***
Dealt to Hero [3c 6s]
Dealt to 39154bcf 
Dealt to 57b58395 
Dealt to c53e784c 
Dealt to 721d34b9 
Dealt to cf224d9 
c53e784c: folds
721d34b9: folds
cf224d9: folds
Hero: folds
39154bcf: raises $0.2 to $0.3
57b58395: calls $0.2
*** FLOP *** [Kh 4h 8h]
39154bcf: checks
57b58395: bets $0.2
39154bcf: folds
Uncalled bet ($0.2) returned to 57b58395
*** SHOWDOWN ***
57b58395 collected $0.57 from pot
*** SUMMARY ***
Total pot $0.6 | Rake $0.03 | Jackpot $0 | Bingo $0 | Fortune $0
Board [Kh 4h 8h]
Seat 1: Hero (button) folded before Flop (didn't bet)
Seat 2: 39154bcf (small blind) folded on the Flop
Seat 3: 57b58395 (big blind) won ($0.57)
Seat 4: c53e784c folded before Flop (didn't bet)
Seat 5: 721d34b9 folded before Flop (didn't bet)
Seat 6: cf224d9 folded before Flop (didn't bet)


Poker Hand #RC1433012993: Hold'em No Limit  ($0.05/$0.1) - 2023/03/27 17:09:42
Table 'RushAndCash28108253' 6-max Seat #1 is the button
Seat 1: 4865703f ($10 in chips)
Seat 2: 4212c91f ($18.68 in chips)
Seat 3: 7bf5144f ($11.71 in chips)
Seat 4: 56258a1 ($10.12 in chips)
Seat 5: 6ed3eaa3 ($34.31 in chips)
Seat 6: Hero ($9.76 in chips)
4212c91f: posts small blind $0.05
7bf5144f: posts big blind $0.1
*** HOLE CARDS ***
Dealt to 4865703f 
Dealt to 4212c91f 
Dealt to 7bf5144f 
Dealt to 56258a1 
Dealt to 6ed3eaa3 
Dealt to Hero [7s Jc]
56258a1: raises $0.15 to $0.25
6ed3eaa3: folds
Hero: folds
4865703f: folds
4212c91f: folds
7bf5144f: folds
Uncalled bet ($0.15) returned to 56258a1
*** SHOWDOWN ***
56258a1 collected $0.25 from pot
*** SUMMARY ***
Total pot $0.25 | Rake $0 | Jackpot $0 | Bingo $0 | Fortune $0
Seat 1: 4865703f (button) folded before Flop (didn't bet)
Seat 2: 4212c91f (small blind) folded before Flop
Seat 3: 7bf5144f (big blind) folded before Flop
Seat 4: 56258a1 collected ($0.25)
Seat 5: 6ed3eaa3 folded before Flop (didn't bet)
Seat 6: Hero folded before Flop (didn't bet)


Poker Hand #RC1433012956: Hold'em No Limit  ($0.05/$0.1) - 2023/03/27 17:09:37
Table 'RushAndCash28108216' 6-max Seat #1 is the button
Seat 1: e890b16d ($10.15 in chips)
Seat 2: Hero ($9.81 in chips)
Seat 3: c53e784c ($10.1 in chips)
Seat 4: eddfa7e8 ($12.64 in chips)
Seat 5: d8be016b ($12.32 in chips)
Seat 6: f842925 ($8.79 in chips)
Hero: posts small blind $0.05
c53e784c: posts big blind $0.1
*** HOLE CARDS ***
Dealt to e890b16d 
Dealt to Hero [4h 2c]
Dealt to c53e784c 
Dealt to eddfa7e8 
Dealt to d8be016b 
Dealt to f842925 
eddfa7e8: folds
d8be016b: folds
f842925: folds
e890b16d: raises $0.15 to $0.25
Hero: folds
c53e784c: folds
Uncalled bet ($0.15) returned to e890b16d
*** SHOWDOWN ***
e890b16d collected $0.25 from pot
*** SUMMARY ***
Total pot $0.25 | Rake $0 | Jackpot $0 | Bingo $0 | Fortune $0
Seat 1: e890b16d (button) collected ($0.25)
Seat 2: Hero (small blind) folded before Flop
Seat 3: c53e784c (big blind) folded before Flop
Seat 4: eddfa7e8 folded before Flop (didn't bet)
Seat 5: d8be016b folded before Flop (didn't bet)
Seat 6: f842925 folded before Flop (didn't bet)


Poker Hand #RC1433012907: Hold'em No Limit  ($0.05/$0.1) - 2023/03/27 17:09:31
Table 'RushAndCash28108167' 6-max Seat #1 is the button
Seat 1: a2f30c1e ($23.74 in chips)
Seat 2: 7c84e01d ($10.05 in chips)
Seat 3: Hero ($9.91 in chips)
Seat 4: b4780f2d ($17.68 in chips)
Seat 5: b7465ad8 ($11.14 in chips)
Seat 6: 68ca899f ($20.04 in chips)
7c84e01d: posts small blind $0.05
Hero: posts big blind $0.1
*** HOLE CARDS ***
Dealt to a2f30c1e 
Dealt to 7c84e01d 
Dealt to Hero [Qh 2c]
Dealt to b4780f2d 
Dealt to b7465ad8 
Dealt to 68ca899f 
b4780f2d: raises $0.1 to $0.2
b7465ad8: folds
68ca899f: folds
a2f30c1e: folds
7c84e01d: raises $0.6 to $0.8
Hero: folds
b4780f2d: folds
Uncalled bet ($0.6) returned to 7c84e01d
*** SHOWDOWN ***
7c84e01d collected $0.48 from pot
*** SUMMARY ***
Total pot $0.5 | Rake $0.02 | Jackpot $0 | Bingo $0 | Fortune $0
Seat 1: a2f30c1e (button) folded before Flop (didn't bet)
Seat 2: 7c84e01d (small blind) collected ($0.48)
Seat 3: Hero (big blind) folded before Flop
Seat 4: b4780f2d folded before Flop
Seat 5: b7465ad8 folded before Flop (didn't bet)
Seat 6: 68ca899f folded before Flop (didn't bet)


Poker Hand #RC1433012862: Hold'em No Limit  ($0.05/$0.1) - 2023/03/27 17:09:25
Table 'RushAndCash28108122' 6-max Seat #1 is the button
Seat 1: 21976119 ($11.79 in chips)
Seat 2: c6ac98f6 ($10 in chips)
Seat 3: c5284c98 ($10 in chips)
Seat 4: f44e13b5 ($12.57 in chips)
Seat 5: 1d2db680 ($29.35 in chips)
Seat 6: Hero ($9.91 in chips)
c6ac98f6: posts small blind $0.05
c5284c98: posts big blind $0.1
*** HOLE CARDS ***
Dealt to 21976119 
Dealt to c6ac98f6 
Dealt to c5284c98 
Dealt to f44e13b5 
Dealt to 1d2db680 
Dealt to Hero [2s 8s]
f44e13b5: folds
1d2db680: folds
Hero: folds
21976119: raises $0.15 to $0.25
c6ac98f6: folds
c5284c98: calls $0.15
*** FLOP *** [Qd Td Js]
c5284c98: bets $0.2
21976119: calls $0.2
*** TURN *** [Qd Td Js] [Ah]
c5284c98: bets $0.9
21976119: calls $0.9
*** RIVER *** [Qd Td Js Ah] [2d]
c5284c98: checks
21976119: bets $0.91
c5284c98: calls $0.91
21976119: shows [Kd Ac] (Aces-High Straight)
c5284c98: shows [6h Kc] (Aces-High Straight)
*** SHOWDOWN ***
c5284c98 collected $2.1 from pot
21976119 collected $2.1 from pot
*** SUMMARY ***
Total pot $4.57 | Rake $0.22 | Jackpot $0.15 | Bingo $0 | Fortune $0
Board [Qd Td Js Ah 2d]
Seat 1: 21976119 (button) showed [Kd Ac] and won ($2.1) with Aces-High Straight
Seat 2: c6ac98f6 (small blind) folded before Flop
Seat 3: c5284c98 (big blind) showed [6h Kc] and won ($2.1) with Aces-High Straight
Seat 4: f44e13b5 folded before Flop (didn't bet)
Seat 5: 1d2db680 folded before Flop (didn't bet)
Seat 6: Hero folded before Flop (didn't bet)


Poker Hand #RC1433012734: Hold'em No Limit  ($0.05/$0.1) - 2023/03/27 17:09:09
Table 'RushAndCash28107994' 6-max Seat #1 is the button
Seat 1: 788319b3 ($8.44 in chips)
Seat 2: 1b6cf177 ($10.19 in chips)
Seat 3: 267971e8 ($10.34 in chips)
Seat 4: c263b8d2 ($11.01 in chips)
Seat 5: Hero ($9.91 in chips)
Seat 6: aa5ba7d2 ($13.29 in chips)
1b6cf177: posts small blind $0.05
267971e8: posts big blind $0.1
*** HOLE CARDS ***
Dealt to 788319b3 
Dealt to 1b6cf177 
Dealt to 267971e8 
Dealt to c263b8d2 
Dealt to Hero [Ad 9d]
Dealt to aa5ba7d2 
c263b8d2: raises $0.1 to $0.2
Hero: folds
aa5ba7d2: folds
788319b3: folds
1b6cf177: folds
267971e8: folds
Uncalled bet ($0.1) returned to c263b8d2
*** SHOWDOWN ***
c263b8d2 collected $0.25 from pot
*** SUMMARY ***
Total pot $0.25 | Rake $0 | Jackpot $0 | Bingo $0 | Fortune $0
Seat 1: 788319b3 (button) folded before Flop (didn't bet)
Seat 2: 1b6cf177 (small blind) folded before Flop
Seat 3: 267971e8 (big blind) folded before Flop
Seat 4: c263b8d2 collected ($0.25)
Seat 5: Hero folded before Flop (didn't bet)
Seat 6: aa5ba7d2 folded before Flop (didn't bet)


Poker Hand #RC1433012682: Hold'em No Limit  ($0.05/$0.1) - 2023/03/27 17:09:02
Table 'RushAndCash28107942' 6-max Seat #1 is the button
Seat 1: 4c45e53 ($10 in chips)
Seat 2: 43723a60 ($7.29 in chips)
Seat 3: cf990035 ($10 in chips)
Seat 4: a972f316 ($15.53 in chips)
Seat 5: Hero ($9.91 in chips)
Seat 6: 8be9ecfe ($20.18 in chips)
43723a60: posts small blind $0.05
cf990035: posts big blind $0.1
*** HOLE CARDS ***
Dealt to 4c45e53 
Dealt to 43723a60 
Dealt to cf990035 
Dealt to a972f316 
Dealt to Hero [8c 5c]
Dealt to 8be9ecfe 
a972f316: folds
Hero: folds
8be9ecfe: folds
4c45e53: raises $0.1 to $0.2
43723a60: calls $0.15
cf990035: folds
*** FLOP *** [9s Jd 5d]
43723a60: checks
4c45e53: bets $0.16
43723a60: raises $0.41 to $0.57
4c45e53: calls $0.41
*** TURN *** [9s Jd 5d] [Th]
43723a60: bets $0.82
4c45e53: folds
Uncalled bet ($0.82) returned to 43723a60
*** SHOWDOWN ***
43723a60 collected $1.56 from pot
*** SUMMARY ***
Total pot $1.64 | Rake $0.08 | Jackpot $0 | Bingo $0 | Fortune $0
Board [9s Jd 5d Th]
Seat 1: 4c45e53 (button) folded on the Turn
Seat 2: 43723a60 (small blind) won ($1.56)
Seat 3: cf990035 (big blind) folded before Flop
Seat 4: a972f316 folded before Flop (didn't bet)
Seat 5: Hero folded before Flop (didn't bet)
Seat 6: 8be9ecfe folded before Flop (didn't bet)


Poker Hand #RC1433012244: Hold'em No Limit  ($0.05/$0.1) - 2023/03/27 17:08:01
Table 'RushAndCash28107504' 6-max Seat #1 is the button
Seat 1: 6ff325c4 ($9.14 in chips)
Seat 2: 45dec125 ($24.4 in chips)
Seat 3: a972f316 ($14.72 in chips)
Seat 4: Hero ($10.54 in chips)
Seat 5: 158a04ae ($25.09 in chips)
Seat 6: 83df9674 ($13.9 in chips)
45dec125: posts small blind $0.05
a972f316: posts big blind $0.1
*** HOLE CARDS ***
Dealt to 6ff325c4 
Dealt to 45dec125 
Dealt to a972f316 
Dealt to Hero [8c 8s]
Dealt to 158a04ae 
Dealt to 83df9674 
Hero: raises $0.15 to $0.25
158a04ae: folds
83df9674: folds
6ff325c4: folds
45dec125: calls $0.2
a972f316: calls $0.15
*** FLOP *** [9s Qs Ts]
45dec125: checks
a972f316: checks
Hero: checks
*** TURN *** [9s Qs Ts] [2c]
45dec125: checks
a972f316: bets $0.38
Hero: calls $0.38
45dec125: folds
*** RIVER *** [9s Qs Ts 2c] [Qd]
a972f316: checks
Hero: checks
a972f316: shows [6s 7s] (Queen High Flush)
Hero: shows [8c 8s] (Pair of Queens and Pair of Eights)
*** SHOWDOWN ***
a972f316 collected $1.44 from pot
*** SUMMARY ***
Total pot $1.51 | Rake $0.07 | Jackpot $0 | Bingo $0 | Fortune $0
Board [9s Qs Ts 2c Qd]
Seat 1: 6ff325c4 (button) folded before Flop (didn't bet)
Seat 2: 45dec125 (small blind) folded on the Turn
Seat 3: a972f316 (big blind) showed [6s 7s] and won ($1.44) with Queen High Flush
Seat 4: Hero showed [8c 8s] and lost with Pair of Queens and Pair of Eights
Seat 5: 158a04ae folded before Flop (didn't bet)
Seat 6: 83df9674 folded before Flop (didn't bet)


Poker Hand #RC1433011961: Hold'em No Limit  ($0.05/$0.1) - 2023/03/27 17:07:25
Table 'RushAndCash28107221' 6-max Seat #1 is the button
Seat 1: Hero ($9.22 in chips)
Seat 2: 1346bbb6 ($10.28 in chips)
Seat 3: 20550b2e ($10 in chips)
Seat 4: 56138567 ($11.97 in chips)
Seat 5: d0ca2777 ($10 in chips)
Seat 6: b59f0022 ($9.76 in chips)
Cash Drop to Pot : total $1 
1346bbb6: posts small blind $0.05
20550b2e: posts big blind $0.1
*** HOLE CARDS ***
Dealt to Hero [Th Qs]
Dealt to 1346bbb6 
Dealt to 20550b2e 
Dealt to 56138567 
Dealt to d0ca2777 
Dealt to b59f0022 
56138567: folds
d0ca2777: raises $0.15 to $0.25
b59f0022: folds
Hero: raises $1.25 to $1.5
1346bbb6: folds
20550b2e: folds
d0ca2777: folds
Uncalled bet ($1.25) returned to Hero
*** SHOWDOWN ***
Hero collected $1.57 from pot
*** SUMMARY ***
Total pot $1.65 | Rake $0.08 | Jackpot $0 | Bingo $0 | Fortune $0
Seat 1: Hero (button) collected ($1.57)
Seat 2: 1346bbb6 (small blind) folded before Flop
Seat 3: 20550b2e (big blind) folded before Flop
Seat 4: 56138567 folded before Flop (didn't bet)
Seat 5: d0ca2777 folded before Flop
Seat 6: b59f0022 folded before Flop (didn't bet)


Poker Hand #RC1433011810: Hold'em No Limit  ($0.05/$0.1) - 2023/03/27 17:07:07
Table 'RushAndCash28107070' 6-max Seat #1 is the button
Seat 1: cc9e00b3 ($10.8 in chips)
Seat 2: c53e784c ($10.2 in chips)
Seat 3: Hero ($9.32 in chips)
Seat 4: ff85d43a ($10 in chips)
Seat 5: 79417384 ($13.94 in chips)
Seat 6: 3a7a7d7a ($11.92 in chips)
c53e784c: posts small blind $0.05
Hero: posts big blind $0.1
*** HOLE CARDS ***
Dealt to cc9e00b3 
Dealt to c53e784c 
Dealt to Hero [6s 3s]
Dealt to ff85d43a 
Dealt to 79417384 
Dealt to 3a7a7d7a 
ff85d43a: folds
79417384: folds
3a7a7d7a: raises $0.25 to $0.35
cc9e00b3: folds
c53e784c: folds
Hero: folds
Uncalled bet ($0.25) returned to 3a7a7d7a
*** SHOWDOWN ***
3a7a7d7a collected $0.25 from pot
*** SUMMARY ***
Total pot $0.25 | Rake $0 | Jackpot $0 | Bingo $0 | Fortune $0
Seat 1: cc9e00b3 (button) folded before Flop (didn't bet)
Seat 2: c53e784c (small blind) folded before Flop
Seat 3: Hero (big blind) folded before Flop
Seat 4: ff85d43a folded before Flop (didn't bet)
Seat 5: 79417384 folded before Flop (didn't bet)
Seat 6: 3a7a7d7a collected ($0.25)


Poker Hand #RC1433011679: Hold'em No Limit  ($0.05/$0.1) - 2023/03/27 17:06:50
Table 'RushAndCash28106939' 6-max Seat #1 is the button
Seat 1: 2cac5180 ($23.28 in chips)
Seat 2: Hero ($9.37 in chips)
Seat 3: 1d07ca5a ($5.81 in chips)
Seat 4: d4475bc5 ($10 in chips)
Seat 5: f807cc1f ($9.85 in chips)
Seat 6: dc2f4d92 ($11.35 in chips)
Hero: posts small blind $0.05
1d07ca5a: posts big blind $0.1
*** HOLE CARDS ***
Dealt to 2cac5180 
Dealt to Hero [7h Kc]
Dealt to 1d07ca5a 
Dealt to d4475bc5 
Dealt to f807cc1f 
Dealt to dc2f4d92 
d4475bc5: folds
f807cc1f: raises $0.15 to $0.25
dc2f4d92: folds
2cac5180: folds
Hero: folds
1d07ca5a: folds
Uncalled bet ($0.15) returned to f807cc1f
*** SHOWDOWN ***
f807cc1f collected $0.25 from pot
*** SUMMARY ***
Total pot $0.25 | Rake $0 | Jackpot $0 | Bingo $0 | Fortune $0
Seat 1: 2cac5180 (button) folded before Flop (didn't bet)
Seat 2: Hero (small blind) folded before Flop
Seat 3: 1d07ca5a (big blind) folded before Flop
Seat 4: d4475bc5 folded before Flop (didn't bet)
Seat 5: f807cc1f collected ($0.25)
Seat 6: dc2f4d92 folded before Flop (didn't bet)


Poker Hand #RC1433011587: Hold'em No Limit  ($0.05/$0.1) - 2023/03/27 17:06:38
Table 'RushAndCash28106847' 6-max Seat #1 is the button
Seat 1: 3d17b963 ($10.15 in chips)
Seat 2: f9e3967b ($10.15 in chips)
Seat 3: 6a3783b8 ($20.98 in chips)
Seat 4: 5e9e858 ($10.05 in chips)
Seat 5: Hero ($9.37 in chips)
Seat 6: f807cc1f ($9.85 in chips)
f9e3967b: posts small blind $0.05
6a3783b8: posts big blind $0.1
*** HOLE CARDS ***
Dealt to 3d17b963 
Dealt to f9e3967b 
Dealt to 6a3783b8 
Dealt to 5e9e858 
Dealt to Hero [Ah 7c]
Dealt to f807cc1f 
5e9e858: folds
Hero: folds
f807cc1f: folds
3d17b963: raises $0.25 to $0.35
f9e3967b: folds
6a3783b8: calls $0.25
*** FLOP *** [9s 4h Qc]
6a3783b8: checks
3d17b963: bets $0.25
6a3783b8: folds
Uncalled bet ($0.25) returned to 3d17b963
*** SHOWDOWN ***
3d17b963 collected $0.72 from pot
*** SUMMARY ***
Total pot $0.75 | Rake $0.03 | Jackpot $0 | Bingo $0 | Fortune $0
Board [9s 4h Qc]
Seat 1: 3d17b963 (button) won ($0.72)
Seat 2: f9e3967b (small blind) folded before Flop
Seat 3: 6a3783b8 (big blind) folded on the Flop
Seat 4: 5e9e858 folded before Flop (didn't bet)
Seat 5: Hero folded before Flop (didn't bet)
Seat 6: f807cc1f folded before Flop (didn't bet)


Poker Hand #RC1433011527: Hold'em No Limit  ($0.05/$0.1) - 2023/03/27 17:06:30
Table 'RushAndCash28106787' 6-max Seat #1 is the button
Seat 1: 8fd859c1 ($16.56 in chips)
Seat 2: ab344d4f ($11.87 in chips)
Seat 3: cf58884b ($10.03 in chips)
Seat 4: e453ebdb ($10 in chips)
Seat 5: d781d33d ($10.87 in chips)
Seat 6: Hero ($9.37 in chips)
ab344d4f: posts small blind $0.05
cf58884b: posts big blind $0.1
*** HOLE CARDS ***
Dealt to 8fd859c1 
Dealt to ab344d4f 
Dealt to cf58884b 
Dealt to e453ebdb 
Dealt to d781d33d 
Dealt to Hero [9d 8d]
e453ebdb: folds
d781d33d: raises $0.12 to $0.22
Hero: folds
8fd859c1: raises $0.68 to $0.9
ab344d4f: folds
cf58884b: folds
d781d33d: raises $9.97 to $10.87 and is all-in
8fd859c1: folds
Uncalled bet ($9.97) returned to d781d33d
*** SHOWDOWN ***
d781d33d collected $1.86 from pot
*** SUMMARY ***
Total pot $1.95 | Rake $0.09 | Jackpot $0 | Bingo $0 | Fortune $0
Seat 1: 8fd859c1 (button) folded before Flop
Seat 2: ab344d4f (small blind) folded before Flop
Seat 3: cf58884b (big blind) folded before Flop
Seat 4: e453ebdb folded before Flop (didn't bet)
Seat 5: d781d33d collected ($1.86)
Seat 6: Hero folded before Flop (didn't bet)


Poker Hand #RC1433011401: Hold'em No Limit  ($0.05/$0.1) - 2023/03/27 17:06:15
Table 'RushAndCash28106661' 6-max Seat #1 is the button
Seat 1: Hero ($9.37 in chips)
Seat 2: 2922cf7b ($10.75 in chips)
Seat 3: ef39e077 ($3.15 in chips)
Seat 4: 774e1277 ($10.25 in chips)
Seat 5: 7a377e78 ($9.7 in chips)
Seat 6: 224dd9aa ($21.31 in chips)
2922cf7b: posts small blind $0.05
ef39e077: posts big blind $0.1
*** HOLE CARDS ***
Dealt to Hero [7d Td]
Dealt to 2922cf7b 
Dealt to ef39e077 
Dealt to 774e1277 
Dealt to 7a377e78 
Dealt to 224dd9aa 
774e1277: folds
7a377e78: folds
224dd9aa: raises $0.11 to $0.21
Hero: folds
2922cf7b: folds
ef39e077: calls $0.11
*** FLOP *** [7h Qd 8d]
ef39e077: checks
224dd9aa: bets $0.16
ef39e077: folds
Uncalled bet ($0.16) returned to 224dd9aa
*** SHOWDOWN ***
224dd9aa collected $0.45 from pot
*** SUMMARY ***
Total pot $0.47 | Rake $0.02 | Jackpot $0 | Bingo $0 | Fortune $0
Board [7h Qd 8d]
Seat 1: Hero (button) folded before Flop (didn't bet)
Seat 2: 2922cf7b (small blind) folded before Flop
Seat 3: ef39e077 (big blind) folded on the Flop
Seat 4: 774e1277 folded before Flop (didn't bet)
Seat 5: 7a377e78 folded before Flop (didn't bet)
Seat 6: 224dd9aa won ($0.45)


Poker Hand #RC1433011342: Hold'em No Limit  ($0.05/$0.1) - 2023/03/27 17:06:06
Table 'RushAndCash28106602' 6-max Seat #1 is the button
Seat 1: c4eed54 ($5 in chips)
Seat 2: Hero ($9.42 in chips)
Seat 3: e88c8126 ($10 in chips)
Seat 4: 4d4e0a7f ($10 in chips)
Seat 5: a5d8af7 ($9.95 in chips)
Seat 6: bb993025 ($14.75 in chips)
Hero: posts small blind $0.05
e88c8126: posts big blind $0.1
*** HOLE CARDS ***
Dealt to c4eed54 
Dealt to Hero [Kc 5c]
Dealt to e88c8126 
Dealt to 4d4e0a7f 
Dealt to a5d8af7 
Dealt to bb993025 
4d4e0a7f: folds
a5d8af7: raises $0.15 to $0.25
bb993025: folds
c4eed54: folds
Hero: folds
e88c8126: raises $0.85 to $1.1
a5d8af7: calls $0.85
*** FLOP *** [Td 6c 9h]
e88c8126: bets $0.72
a5d8af7: folds
Uncalled bet ($0.72) returned to e88c8126
*** SHOWDOWN ***
e88c8126 collected $2.14 from pot
*** SUMMARY ***
Total pot $2.25 | Rake $0.11 | Jackpot $0 | Bingo $0 | Fortune $0
Board [Td 6c 9h]
Seat 1: c4eed54 (button) folded before Flop (didn't bet)
Seat 2: Hero (small blind) folded before Flop
Seat 3: e88c8126 (big blind) won ($2.14)
Seat 4: 4d4e0a7f folded before Flop (didn't bet)
Seat 5: a5d8af7 folded on the Flop
Seat 6: bb993025 folded before Flop (didn't bet)


Poker Hand #RC1433011033: Hold'em No Limit  ($0.05/$0.1) - 2023/03/27 17:05:23
Table 'RushAndCash28106293' 6-max Seat #1 is the button
Seat 1: 35b43d8 ($10.1 in chips)
Seat 2: 5e9e858 ($10 in chips)
Seat 3: Hero ($9.14 in chips)
Seat 4: c8c288bd ($34.04 in chips)
Seat 5: 8f00fc89 ($10.45 in chips)
Seat 6: 9f8bb1b0 ($10 in chips)
5e9e858: posts small blind $0.05
Hero: posts big blind $0.1
*** HOLE CARDS ***
Dealt to 35b43d8 
Dealt to 5e9e858 
Dealt to Hero [Ad 5c]
Dealt to c8c288bd 
Dealt to 8f00fc89 
Dealt to 9f8bb1b0 
c8c288bd: folds
8f00fc89: folds
9f8bb1b0: folds
35b43d8: raises $0.15 to $0.25
5e9e858: folds
Hero: calls $0.15
*** FLOP *** [8h Tc Ac]
Hero: checks
35b43d8: checks
*** TURN *** [8h Tc Ac] [6d]
Hero: bets $0.28
35b43d8: folds
Uncalled bet ($0.28) returned to Hero
*** SHOWDOWN ***
Hero collected $0.53 from pot
*** SUMMARY ***
Total pot $0.55 | Rake $0.02 | Jackpot $0 | Bingo $0 | Fortune $0
Board [8h Tc Ac 6d]
Seat 1: 35b43d8 (button) folded on the Turn
Seat 2: 5e9e858 (small blind) folded before Flop
Seat 3: Hero (big blind) won ($0.53)
Seat 4: c8c288bd folded before Flop (didn't bet)
Seat 5: 8f00fc89 folded before Flop (didn't bet)
Seat 6: 9f8bb1b0 folded before Flop (didn't bet)


Poker Hand #RC1433010903: Hold'em No Limit  ($0.05/$0.1) - 2023/03/27 17:05:05
Table 'RushAndCash28106163' 6-max Seat #1 is the button
Seat 1: ac21d5d8 ($14.06 in chips)
Seat 2: a972f316 ($15.96 in chips)
Seat 3: beb24a65 ($8.34 in chips)
Seat 4: a6e8c5fb ($10 in chips)
Seat 5: 33bd2a54 ($11.26 in chips)
Seat 6: Hero ($9.14 in chips)
a972f316: posts small blind $0.05
beb24a65: posts big blind $0.1
*** HOLE CARDS ***
Dealt to ac21d5d8 
Dealt to a972f316 
Dealt to beb24a65 
Dealt to a6e8c5fb 
Dealt to 33bd2a54 
Dealt to Hero [5s Ad]
a6e8c5fb: raises $0.2 to $0.3
33bd2a54: folds
Hero: folds
ac21d5d8: folds
a972f316: folds
beb24a65: calls $0.2
*** FLOP *** [Jh 3c 4d]
beb24a65: checks
a6e8c5fb: checks
*** TURN *** [Jh 3c 4d] [Ah]
beb24a65: bets $0.33
a6e8c5fb: raises $0.87 to $1.2
beb24a65: calls $0.87
*** RIVER *** [Jh 3c 4d Ah] [Kd]
beb24a65: bets $2.29
a6e8c5fb: calls $2.29
beb24a65: shows [8h Qh] (Ace-High)
a6e8c5fb: shows [As 3s] (Pair of Aces and Pair of Treys)
*** SHOWDOWN ***
a6e8c5fb collected $7.18 from pot
*** SUMMARY ***
Total pot $7.63 | Rake $0.3 | Jackpot $0.15 | Bingo $0 | Fortune $0
Board [Jh 3c 4d Ah Kd]
Seat 1: ac21d5d8 (button) folded before Flop (didn't bet)
Seat 2: a972f316 (small blind) folded before Flop
Seat 3: beb24a65 (big blind) showed [8h Qh] and lost with Ace-High
Seat 4: a6e8c5fb showed [As 3s] and won ($7.18) with Pair of Aces and Pair of Treys
Seat 5: 33bd2a54 folded before Flop (didn't bet)
Seat 6: Hero folded before Flop (didn't bet)


Poker Hand #RC1433010864: Hold'em No Limit  ($0.05/$0.1) - 2023/03/27 17:05:00
Table 'RushAndCash28106124' 6-max Seat #1 is the button
Seat 1: f031b695 ($13.76 in chips)
Seat 2: cbd5f4f9 ($10 in chips)
Seat 3: d1084d40 ($9.93 in chips)
Seat 4: 404f3afe ($13.96 in chips)
Seat 5: Hero ($9.14 in chips)
Seat 6: 84b2526d ($10.46 in chips)
cbd5f4f9: posts small blind $0.05
d1084d40: posts big blind $0.1
*** HOLE CARDS ***
Dealt to f031b695 
Dealt to cbd5f4f9 
Dealt to d1084d40 
Dealt to 404f3afe 
Dealt to Hero [Tc 4d]
Dealt to 84b2526d 
404f3afe: folds
Hero: folds
84b2526d: raises $0.15 to $0.25
f031b695: raises $0.49 to $0.74
cbd5f4f9: folds
d1084d40: folds
84b2526d: folds
Uncalled bet ($0.49) returned to f031b695
*** SHOWDOWN ***
f031b695 collected $0.62 from pot
*** SUMMARY ***
Total pot $0.65 | Rake $0.03 | Jackpot $0 | Bingo $0 | Fortune $0
Seat 1: f031b695 (button) collected ($0.62)
Seat 2: cbd5f4f9 (small blind) folded before Flop
Seat 3: d1084d40 (big blind) folded before Flop
Seat 4: 404f3afe folded before Flop (didn't bet)
Seat 5: Hero folded before Flop (didn't bet)
Seat 6: 84b2526d folded before Flop


Poker Hand #RC1433010766: Hold'em No Limit  ($0.05/$0.1) - 2023/03/27 17:04:47
Table 'RushAndCash28106026' 6-max Seat #1 is the button
Seat 1: a579702a ($12.45 in chips)
Seat 2: 6a3783b8 ($22.1 in chips)
Seat 3: f76c760b ($12 in chips)
Seat 4: Hero ($8.99 in chips)
Seat 5: 18b48d6 ($11.18 in chips)
Seat 6: 8bb78023 ($9.92 in chips)
6a3783b8: posts small blind $0.05
f76c760b: posts big blind $0.1
*** HOLE CARDS ***
Dealt to a579702a 
Dealt to 6a3783b8 
Dealt to f76c760b 
Dealt to Hero [Kc Qh]
Dealt to 18b48d6 
Dealt to 8bb78023 
Hero: raises $0.15 to $0.25
18b48d6: folds
8bb78023: folds
a579702a: folds
6a3783b8: folds
f76c760b: folds
Uncalled bet ($0.15) returned to Hero
*** SHOWDOWN ***
Hero collected $0.25 from pot
*** SUMMARY ***
Total pot $0.25 | Rake $0 | Jackpot $0 | Bingo $0 | Fortune $0
Seat 1: a579702a (button) folded before Flop (didn't bet)
Seat 2: 6a3783b8 (small blind) folded before Flop
Seat 3: f76c760b (big blind) folded before Flop
Seat 4: Hero collected ($0.25)
Seat 5: 18b48d6 folded before Flop (didn't bet)
Seat 6: 8bb78023 folded before Flop (didn't bet)


Poker Hand #RC1433010687: Hold'em No Limit  ($0.05/$0.1) - 2023/03/27 17:04:37
Table 'RushAndCash28105947' 6-max Seat #1 is the button
Seat 1: Hero ($8.99 in chips)
Seat 2: 19367f65 ($9.85 in chips)
Seat 3: 79417384 ($13.24 in chips)
Seat 4: b02b9ec1 ($12.2 in chips)
Seat 5: 8be9ecfe ($20.27 in chips)
Seat 6: ca40a3e7 ($11.31 in chips)
19367f65: posts small blind $0.05
79417384: posts big blind $0.1
*** HOLE CARDS ***
Dealt to Hero [7d Qh]
Dealt to 19367f65 
Dealt to 79417384 
Dealt to b02b9ec1 
Dealt to 8be9ecfe 
Dealt to ca40a3e7 
b02b9ec1: folds
8be9ecfe: folds
ca40a3e7: raises $0.15 to $0.25
Hero: folds
19367f65: folds
79417384: raises $0.75 to $1
ca40a3e7: folds
Uncalled bet ($0.75) returned to 79417384
*** SHOWDOWN ***
79417384 collected $0.53 from pot
*** SUMMARY ***
Total pot $0.55 | Rake $0.02 | Jackpot $0 | Bingo $0 | Fortune $0
Seat 1: Hero (button) folded before Flop (didn't bet)
Seat 2: 19367f65 (small blind) folded before Flop
Seat 3: 79417384 (big blind) collected ($0.53)
Seat 4: b02b9ec1 folded before Flop (didn't bet)
Seat 5: 8be9ecfe folded before Flop (didn't bet)
Seat 6: ca40a3e7 folded before Flop


Poker Hand #RC1433010627: Hold'em No Limit  ($0.05/$0.1) - 2023/03/27 17:04:28
Table 'RushAndCash28105887' 6-max Seat #1 is the button
Seat 1: c7b34af4 ($8.33 in chips)
Seat 2: Hero ($9.04 in chips)
Seat 3: 9abcfbbb ($14.08 in chips)
Seat 4: a3406b53 ($16.11 in chips)
Seat 5: 4c905003 ($22.23 in chips)
Seat 6: b3f12672 ($33.53 in chips)
Hero: posts small blind $0.05
9abcfbbb: posts big blind $0.1
*** HOLE CARDS ***
Dealt to c7b34af4 
Dealt to Hero [7d Jd]
Dealt to 9abcfbbb 
Dealt to a3406b53 
Dealt to 4c905003 
Dealt to b3f12672 
a3406b53: folds
4c905003: folds
b3f12672: folds
c7b34af4: raises $0.2 to $0.3
Hero: folds
9abcfbbb: folds
Uncalled bet ($0.2) returned to c7b34af4
*** SHOWDOWN ***
c7b34af4 collected $0.25 from pot
*** SUMMARY ***
Total pot $0.25 | Rake $0 | Jackpot $0 | Bingo $0 | Fortune $0
Seat 1: c7b34af4 (button) collected ($0.25)
Seat 2: Hero (small blind) folded before Flop
Seat 3: 9abcfbbb (big blind) folded before Flop
Seat 4: a3406b53 folded before Flop (didn't bet)
Seat 5: 4c905003 folded before Flop (didn't bet)
Seat 6: b3f12672 folded before Flop (didn't bet)


Poker Hand #RC1433010526: Hold'em No Limit  ($0.05/$0.1) - 2023/03/27 17:04:14
Table 'RushAndCash28105786' 6-max Seat #1 is the button
Seat 1: 4dd8bf28 ($15.32 in chips)
Seat 2: f7381e49 ($9.3 in chips)
Seat 3: Hero ($9.14 in chips)
Seat 4: a144899c ($19.4 in chips)
Seat 5: bcf4f43c ($16.89 in chips)
Seat 6: 19d4da35 ($12.22 in chips)
f7381e49: posts small blind $0.05
Hero: posts big blind $0.1
*** HOLE CARDS ***
Dealt to 4dd8bf28 
Dealt to f7381e49 
Dealt to Hero [7d Qs]
Dealt to a144899c 
Dealt to bcf4f43c 
Dealt to 19d4da35 
a144899c: folds
bcf4f43c: folds
19d4da35: raises $0.17 to $0.27
4dd8bf28: folds
f7381e49: calls $0.22
Hero: folds
*** FLOP *** [8h Kc 5s]
f7381e49: checks
19d4da35: checks
*** TURN *** [8h Kc 5s] [8c]
f7381e49: checks
19d4da35: bets $0.32
f7381e49: folds
Uncalled bet ($0.32) returned to 19d4da35
*** SHOWDOWN ***
19d4da35 collected $0.61 from pot
*** SUMMARY ***
Total pot $0.64 | Rake $0.03 | Jackpot $0 | Bingo $0 | Fortune $0
Board [8h Kc 5s 8c]
Seat 1: 4dd8bf28 (button) folded before Flop (didn't bet)
Seat 2: f7381e49 (small blind) folded on the Turn
Seat 3: Hero (big blind) folded before Flop
Seat 4: a144899c folded before Flop (didn't bet)
Seat 5: bcf4f43c folded before Flop (didn't bet)
Seat 6: 19d4da35 won ($0.61)


Poker Hand #RC1433010367: Hold'em No Limit  ($0.05/$0.1) - 2023/03/27 17:03:49
Table 'RushAndCash28105627' 6-max Seat #1 is the button
Seat 1: d781d33d ($10.25 in chips)
Seat 2: 96b64d62 ($16.46 in chips)
Seat 3: 8be9ecfe ($20.42 in chips)
Seat 4: 725f7e50 ($14 in chips)
Seat 5: 43723a60 ($10.12 in chips)
Seat 6: Hero ($8.99 in chips)
96b64d62: posts small blind $0.05
8be9ecfe: posts big blind $0.1
*** HOLE CARDS ***
Dealt to d781d33d 
Dealt to 96b64d62 
Dealt to 8be9ecfe 
Dealt to 725f7e50 
Dealt to 43723a60 
Dealt to Hero [Qs 9s]
725f7e50: folds
43723a60: folds
Hero: raises $0.15 to $0.25
d781d33d: folds
96b64d62: folds
8be9ecfe: folds
Uncalled bet ($0.15) returned to Hero
*** SHOWDOWN ***
Hero collected $0.25 from pot
*** SUMMARY ***
Total pot $0.25 | Rake $0 | Jackpot $0 | Bingo $0 | Fortune $0
Seat 1: d781d33d (button) folded before Flop (didn't bet)
Seat 2: 96b64d62 (small blind) folded before Flop
Seat 3: 8be9ecfe (big blind) folded before Flop
Seat 4: 725f7e50 folded before Flop (didn't bet)
Seat 5: 43723a60 folded before Flop (didn't bet)
Seat 6: Hero collected ($0.25)


Poker Hand #RC1433010336: Hold'em No Limit  ($0.05/$0.1) - 2023/03/27 17:03:45
Table 'RushAndCash28105596' 6-max Seat #1 is the button
Seat 1: cc79b89e ($10.85 in chips)
Seat 2: 7239b0b ($15.43 in chips)
Seat 3: 3a493ae9 ($18.97 in chips)
Seat 4: Hero ($8.99 in chips)
Seat 5: 30af4b6d ($25.19 in chips)
Seat 6: 8265a0cd ($10.99 in chips)
7239b0b: posts small blind $0.05
3a493ae9: posts big blind $0.1
*** HOLE CARDS ***
Dealt to cc79b89e 
Dealt to 7239b0b 
Dealt to 3a493ae9 
Dealt to Hero [9s 4h]
Dealt to 30af4b6d 
Dealt to 8265a0cd 
Hero: folds
30af4b6d: raises $0.15 to $0.25
8265a0cd: raises $0.49 to $0.74
cc79b89e: folds
7239b0b: folds
3a493ae9: folds
30af4b6d: calls $0.49
*** FLOP *** [Jc 5d 7d]
30af4b6d: checks
8265a0cd: checks
*** TURN *** [Jc 5d 7d] [9c]
30af4b6d: checks
8265a0cd: checks
*** RIVER *** [Jc 5d 7d 9c] [4c]
30af4b6d: checks
8265a0cd: checks
30af4b6d: shows [8h 7h] (Pair of Sevens)
8265a0cd: shows [Ks Ac] (Ace-High)
*** SHOWDOWN ***
30af4b6d collected $1.55 from pot
*** SUMMARY ***
Total pot $1.63 | Rake $0.08 | Jackpot $0 | Bingo $0 | Fortune $0
Board [Jc 5d 7d 9c 4c]
Seat 1: cc79b89e (button) folded before Flop (didn't bet)
Seat 2: 7239b0b (small blind) folded before Flop
Seat 3: 3a493ae9 (big blind) folded before Flop
Seat 4: Hero folded before Flop (didn't bet)
Seat 5: 30af4b6d showed [8h 7h] and won ($1.55) with Pair of Sevens
Seat 6: 8265a0cd showed [Ks Ac] and lost with Ace-High


Poker Hand #RC1433010306: Hold'em No Limit  ($0.05/$0.1) - 2023/03/27 17:03:41
Table 'RushAndCash28105566' 6-max Seat #1 is the button
Seat 1: b02b9ec1 ($12.45 in chips)
Seat 2: a2f30c1e ($23.05 in chips)
Seat 3: 21976119 ($10 in chips)
Seat 4: 2aa61b15 ($11.87 in chips)
Seat 5: 9b3cdb65 ($22.3 in chips)
Seat 6: Hero ($8.99 in chips)
a2f30c1e: posts small blind $0.05
21976119: posts big blind $0.1
*** HOLE CARDS ***
Dealt to b02b9ec1 
Dealt to a2f30c1e 
Dealt to 21976119 
Dealt to 2aa61b15 
Dealt to 9b3cdb65 
Dealt to Hero [6d Kc]
2aa61b15: folds
9b3cdb65: raises $0.15 to $0.25
Hero: folds
b02b9ec1: calls $0.25
a2f30c1e: folds
21976119: calls $0.15
*** FLOP *** [8s 9s 4s]
21976119: checks
9b3cdb65: checks
b02b9ec1: checks
*** TURN *** [8s 9s 4s] [Qd]
21976119: bets $0.27
9b3cdb65: calls $0.27
b02b9ec1: folds
*** RIVER *** [8s 9s 4s Qd] [Td]
21976119: checks
9b3cdb65: checks
21976119: shows [Ks 6c] (King-High)
9b3cdb65: shows [Qc Kd] (Pair of Queens)
*** SHOWDOWN ***
9b3cdb65 collected $1.28 from pot
*** SUMMARY ***
Total pot $1.34 | Rake $0.06 | Jackpot $0 | Bingo $0 | Fortune $0
Board [8s 9s 4s Qd Td]
Seat 1: b02b9ec1 (button) folded on the Turn
Seat 2: a2f30c1e (small blind) folded before Flop
Seat 3: 21976119 (big blind) showed [Ks 6c] and lost with King-High
Seat 4: 2aa61b15 folded before Flop (didn't bet)
Seat 5: 9b3cdb65 showed [Qc Kd] and won ($1.28) with Pair of Queens
Seat 6: Hero folded before Flop (didn't bet)


Poker Hand #RC1433010268: Hold'em No Limit  ($0.05/$0.1) - 2023/03/27 17:03:36
Table 'RushAndCash28105528' 6-max Seat #1 is the button
Seat 1: Hero ($8.84 in chips)
Seat 2: f49afa74 ($16.15 in chips)
Seat 3: 36965014 ($15.6 in chips)
Seat 4: 1c6559ab ($13.8 in chips)
Seat 5: 7630b1cd ($14.55 in chips)
Seat 6: ec3bebf3 ($30.65 in chips)
f49afa74: posts small blind $0.05
36965014: posts big blind $0.1
*** HOLE CARDS ***
Dealt to Hero [4c Qc]
Dealt to f49afa74 
Dealt to 36965014 
Dealt to 1c6559ab 
Dealt to 7630b1cd 
Dealt to ec3bebf3 
1c6559ab: folds
7630b1cd: folds
ec3bebf3: raises $0.15 to $0.25
Hero: folds
f49afa74: folds
36965014: folds
Uncalled bet ($0.15) returned to ec3bebf3
*** SHOWDOWN ***
ec3bebf3 collected $0.25 from pot
*** SUMMARY ***
Total pot $0.25 | Rake $0 | Jackpot $0 | Bingo $0 | Fortune $0
Seat 1: Hero (button) folded before Flop (didn't bet)
Seat 2: f49afa74 (small blind) folded before Flop
Seat 3: 36965014 (big blind) folded before Flop
Seat 4: 1c6559ab folded before Flop (didn't bet)
Seat 5: 7630b1cd folded before Flop (didn't bet)
Seat 6: ec3bebf3 collected ($0.25)


Poker Hand #RC1433010240: Hold'em No Limit  ($0.05/$0.1) - 2023/03/27 17:03:32
Table 'RushAndCash28105500' 6-max Seat #1 is the button
Seat 1: 36965014 ($15.6 in chips)
Seat 2: Hero ($8.89 in chips)
Seat 3: 668c8580 ($16.52 in chips)
Seat 4: d6e65db1 ($24.8 in chips)
Seat 5: ae550f88 ($13.97 in chips)
Seat 6: fa417246 ($15.39 in chips)
Hero: posts small blind $0.05
668c8580: posts big blind $0.1
*** HOLE CARDS ***
Dealt to 36965014 
Dealt to Hero [7h Qc]
Dealt to 668c8580 
Dealt to d6e65db1 
Dealt to ae550f88 
Dealt to fa417246 
d6e65db1: folds
ae550f88: raises $0.1 to $0.2
fa417246: folds
36965014: folds
Hero: folds
668c8580: raises $0.34 to $0.54
ae550f88: folds
Uncalled bet ($0.34) returned to 668c8580
*** SHOWDOWN ***
668c8580 collected $0.43 from pot
*** SUMMARY ***
Total pot $0.45 | Rake $0.02 | Jackpot $0 | Bingo $0 | Fortune $0
Seat 1: 36965014 (button) folded before Flop (didn't bet)
Seat 2: Hero (small blind) folded before Flop
Seat 3: 668c8580 (big blind) collected ($0.43)
Seat 4: d6e65db1 folded before Flop (didn't bet)
Seat 5: ae550f88 folded before Flop
Seat 6: fa417246 folded before Flop (didn't bet)


Poker Hand #RC1433010215: Hold'em No Limit  ($0.05/$0.1) - 2023/03/27 17:03:28
Table 'RushAndCash28105475' 6-max Seat #1 is the button
Seat 1: 610e9da5 ($8.44 in chips)
Seat 2: 57d1ef50 ($10 in chips)
Seat 3: Hero ($8.99 in chips)
Seat 4: 768c7840 ($9.77 in chips)
Seat 5: ab344d4f ($11.6 in chips)
Seat 6: abe9f57a ($16.65 in chips)
57d1ef50: posts small blind $0.05
Hero: posts big blind $0.1
*** HOLE CARDS ***
Dealt to 610e9da5 
Dealt to 57d1ef50 
Dealt to Hero [4s 3c]
Dealt to 768c7840 
Dealt to ab344d4f 
Dealt to abe9f57a 
768c7840: folds
ab344d4f: folds
abe9f57a: folds
610e9da5: folds
57d1ef50: folds
Uncalled bet ($0.05) returned to Hero
*** SHOWDOWN ***
Hero collected $0.1 from pot
*** SUMMARY ***
Total pot $0.1 | Rake $0 | Jackpot $0 | Bingo $0 | Fortune $0
Seat 1: 610e9da5 (button) folded before Flop (didn't bet)
Seat 2: 57d1ef50 (small blind) folded before Flop
Seat 3: Hero (big blind) collected ($0.1)
Seat 4: 768c7840 folded before Flop (didn't bet)
Seat 5: ab344d4f folded before Flop (didn't bet)
Seat 6: abe9f57a folded before Flop (didn't bet)


Poker Hand #RC1433010165: Hold'em No Limit  ($0.05/$0.1) - 2023/03/27 17:03:20
Table 'RushAndCash28105425' 6-max Seat #1 is the button
Seat 1: 5a327a81 ($14.19 in chips)
Seat 2: 286b15b5 ($10 in chips)
Seat 3: 882f6406 ($13.19 in chips)
Seat 4: 5c072d71 ($10 in chips)
Seat 5: Hero ($8.99 in chips)
Seat 6: a88a9939 ($13.04 in chips)
286b15b5: posts small blind $0.05
882f6406: posts big blind $0.1
*** HOLE CARDS ***
Dealt to 5a327a81 
Dealt to 286b15b5 
Dealt to 882f6406 
Dealt to 5c072d71 
Dealt to Hero [4c 5s]
Dealt to a88a9939 
5c072d71: folds
Hero: folds
a88a9939: folds
5a327a81: folds
286b15b5: raises $0.15 to $0.25
882f6406: calls $0.15
*** FLOP *** [Ks 6h Qc]
286b15b5: checks
882f6406: bets $0.38
286b15b5: folds
Uncalled bet ($0.38) returned to 882f6406
*** SHOWDOWN ***
882f6406 collected $0.48 from pot
*** SUMMARY ***
Total pot $0.5 | Rake $0.02 | Jackpot $0 | Bingo $0 | Fortune $0
Board [Ks 6h Qc]
Seat 1: 5a327a81 (button) folded before Flop (didn't bet)
Seat 2: 286b15b5 (small blind) folded on the Flop
Seat 3: 882f6406 (big blind) won ($0.48)
Seat 4: 5c072d71 folded before Flop (didn't bet)
Seat 5: Hero folded before Flop (didn't bet)
Seat 6: a88a9939 folded before Flop (didn't bet)


Poker Hand #RC1433010133: Hold'em No Limit  ($0.05/$0.1) - 2023/03/27 17:03:16
Table 'RushAndCash28105393' 6-max Seat #1 is the button
Seat 1: 96b64d62 ($16.56 in chips)
Seat 2: 839dcae2 ($14.97 in chips)
Seat 3: 3a7a7d7a ($13.01 in chips)
Seat 4: e8d2edfb ($12.72 in chips)
Seat 5: 73df5e8e ($11.98 in chips)
Seat 6: Hero ($8.99 in chips)
839dcae2: posts small blind $0.05
3a7a7d7a: posts big blind $0.1
*** HOLE CARDS ***
Dealt to 96b64d62 
Dealt to 839dcae2 
Dealt to 3a7a7d7a 
Dealt to e8d2edfb 
Dealt to 73df5e8e 
Dealt to Hero [7c Ks]
e8d2edfb: folds
73df5e8e: folds
Hero: folds
96b64d62: folds
839dcae2: folds
Uncalled bet ($0.05) returned to 3a7a7d7a
*** SHOWDOWN ***
3a7a7d7a collected $0.1 from pot
*** SUMMARY ***
Total pot $0.1 | Rake $0 | Jackpot $0 | Bingo $0 | Fortune $0
Seat 1: 96b64d62 (button) folded before Flop (didn't bet)
Seat 2: 839dcae2 (small blind) folded before Flop
Seat 3: 3a7a7d7a (big blind) collected ($0.1)
Seat 4: e8d2edfb folded before Flop (didn't bet)
Seat 5: 73df5e8e folded before Flop (didn't bet)
Seat 6: Hero folded before Flop (didn't bet)


Poker Hand #RC1433010105: Hold'em No Limit  ($0.05/$0.1) - 2023/03/27 17:03:11
Table 'RushAndCash28105365' 6-max Seat #1 is the button
Seat 1: d32a9fdc ($11.12 in chips)
Seat 2: 6e552336 ($8.28 in chips)
Seat 3: bd0c9e13 ($10 in chips)
Seat 4: Hero ($8.99 in chips)
Seat 5: d304eee ($11.23 in chips)
Seat 6: 4b771106 ($12.5 in chips)
6e552336: posts small blind $0.05
bd0c9e13: posts big blind $0.1
*** HOLE CARDS ***
Dealt to d32a9fdc 
Dealt to 6e552336 
Dealt to bd0c9e13 
Dealt to Hero [8c 4d]
Dealt to d304eee 
Dealt to 4b771106 
Hero: folds
d304eee: folds
4b771106: folds
d32a9fdc: raises $0.13 to $0.23
6e552336: folds
bd0c9e13: folds
Uncalled bet ($0.13) returned to d32a9fdc
*** SHOWDOWN ***
d32a9fdc collected $0.25 from pot
*** SUMMARY ***
Total pot $0.25 | Rake $0 | Jackpot $0 | Bingo $0 | Fortune $0
Seat 1: d32a9fdc (button) collected ($0.25)
Seat 2: 6e552336 (small blind) folded before Flop
Seat 3: bd0c9e13 (big blind) folded before Flop
Seat 4: Hero folded before Flop (didn't bet)
Seat 5: d304eee folded before Flop (didn't bet)
Seat 6: 4b771106 folded before Flop (didn't bet)


Poker Hand #RC1433010044: Hold'em No Limit  ($0.05/$0.1) - 2023/03/27 17:03:03
Table 'RushAndCash28105304' 6-max Seat #1 is the button
Seat 1: Hero ($8.99 in chips)
Seat 2: dc2a50ef ($17.79 in chips)
Seat 3: 7a2b4e33 ($19.18 in chips)
Seat 4: b85fb8dd ($17.74 in chips)
Seat 5: 628d3438 ($33.48 in chips)
Seat 6: 68713de1 ($29.34 in chips)
dc2a50ef: posts small blind $0.05
7a2b4e33: posts big blind $0.1
*** HOLE CARDS ***
Dealt to Hero [6c 4s]
Dealt to dc2a50ef 
Dealt to 7a2b4e33 
Dealt to b85fb8dd 
Dealt to 628d3438 
Dealt to 68713de1 
b85fb8dd: folds
628d3438: raises $0.15 to $0.25
68713de1: calls $0.25
Hero: folds
dc2a50ef: folds
7a2b4e33: raises $1.07 to $1.32
628d3438: calls $1.07
68713de1: folds
*** FLOP *** [7h 2d 6h]
7a2b4e33: checks
628d3438: checks
*** TURN *** [7h 2d 6h] [7d]
7a2b4e33: checks
628d3438: bets $0.98
7a2b4e33: folds
Uncalled bet ($0.98) returned to 628d3438
*** SHOWDOWN ***
628d3438 collected $2.8 from pot
*** SUMMARY ***
Total pot $2.94 | Rake $0.14 | Jackpot $0 | Bingo $0 | Fortune $0
Board [7h 2d 6h 7d]
Seat 1: Hero (button) folded before Flop (didn't bet)
Seat 2: dc2a50ef (small blind) folded before Flop
Seat 3: 7a2b4e33 (big blind) folded on the Turn
Seat 4: b85fb8dd folded before Flop (didn't bet)
Seat 5: 628d3438 won ($2.8)
Seat 6: 68713de1 folded before Flop


Poker Hand #RC1433009950: Hold'em No Limit  ($0.05/$0.1) - 2023/03/27 17:02:49
Table 'RushAndCash28105210' 6-max Seat #1 is the button
Seat 1: 3d61df95 ($10 in chips)
Seat 2: Hero ($9.04 in chips)
Seat 3: 7630b1cd ($14.5 in chips)
Seat 4: 12e0bd44 ($10.32 in chips)
Seat 5: d3bc2a8b ($15.48 in chips)
Seat 6: 1609ad33 ($9.66 in chips)
Hero: posts small blind $0.05
7630b1cd: posts big blind $0.1
*** HOLE CARDS ***
Dealt to 3d61df95 
Dealt to Hero [3d Kc]
Dealt to 7630b1cd 
Dealt to 12e0bd44 
Dealt to d3bc2a8b 
Dealt to 1609ad33 
12e0bd44: folds
d3bc2a8b: folds
1609ad33: raises $0.15 to $0.25
3d61df95: folds
Hero: folds
7630b1cd: folds
Uncalled bet ($0.15) returned to 1609ad33
*** SHOWDOWN ***
1609ad33 collected $0.25 from pot
*** SUMMARY ***
Total pot $0.25 | Rake $0 | Jackpot $0 | Bingo $0 | Fortune $0
Seat 1: 3d61df95 (button) folded before Flop (didn't bet)
Seat 2: Hero (small blind) folded before Flop
Seat 3: 7630b1cd (big blind) folded before Flop
Seat 4: 12e0bd44 folded before Flop (didn't bet)
Seat 5: d3bc2a8b folded before Flop (didn't bet)
Seat 6: 1609ad33 collected ($0.25)


Poker Hand #RC1433009831: Hold'em No Limit  ($0.05/$0.1) - 2023/03/27 17:02:32
Table 'RushAndCash28105091' 6-max Seat #1 is the button
Seat 1: b053c24f ($9.95 in chips)
Seat 2: 98c045fa ($10 in chips)
Seat 3: Hero ($9.14 in chips)
Seat 4: c682ccb4 ($19.51 in chips)
Seat 5: e7f10fe6 ($12 in chips)
Seat 6: b2094c5d ($10 in chips)
98c045fa: posts small blind $0.05
Hero: posts big blind $0.1
*** HOLE CARDS ***
Dealt to b053c24f 
Dealt to 98c045fa 
Dealt to Hero [9h 2s]
Dealt to c682ccb4 
Dealt to e7f10fe6 
Dealt to b2094c5d 
c682ccb4: folds
e7f10fe6: raises $0.15 to $0.25
b2094c5d: folds
b053c24f: raises $0.52 to $0.77
98c045fa: folds
Hero: folds
e7f10fe6: folds
Uncalled bet ($0.52) returned to b053c24f
*** SHOWDOWN ***
b053c24f collected $0.62 from pot
*** SUMMARY ***
Total pot $0.65 | Rake $0.03 | Jackpot $0 | Bingo $0 | Fortune $0
Seat 1: b053c24f (button) collected ($0.62)
Seat 2: 98c045fa (small blind) folded before Flop
Seat 3: Hero (big blind) folded before Flop
Seat 4: c682ccb4 folded before Flop (didn't bet)
Seat 5: e7f10fe6 folded before Flop
Seat 6: b2094c5d folded before Flop (didn't bet)


Poker Hand #RC1433009790: Hold'em No Limit  ($0.05/$0.1) - 2023/03/27 17:02:26
Table 'RushAndCash28105050' 6-max Seat #1 is the button
Seat 1: 5a327a81 ($14.94 in chips)
Seat 2: ce9ae27c ($8.28 in chips)
Seat 3: 4107d5d5 ($10 in chips)
Seat 4: 59483bf4 ($11.68 in chips)
Seat 5: Hero ($9.14 in chips)
Seat 6: 882f6406 ($12.87 in chips)
ce9ae27c: posts small blind $0.05
4107d5d5: posts big blind $0.1
*** HOLE CARDS ***
Dealt to 5a327a81 
Dealt to ce9ae27c 
Dealt to 4107d5d5 
Dealt to 59483bf4 
Dealt to Hero [6c 3d]
Dealt to 882f6406 
59483bf4: folds
Hero: folds
882f6406: folds
5a327a81: raises $0.15 to $0.25
ce9ae27c: raises $0.45 to $0.7
4107d5d5: folds
5a327a81: calls $0.45
*** FLOP *** [5s 7h 7s]
ce9ae27c: bets $0.5
5a327a81: folds
Uncalled bet ($0.5) returned to ce9ae27c
*** SHOWDOWN ***
ce9ae27c collected $1.43 from pot
*** SUMMARY ***
Total pot $1.5 | Rake $0.07 | Jackpot $0 | Bingo $0 | Fortune $0
Board [5s 7h 7s]
Seat 1: 5a327a81 (button) folded on the Flop
Seat 2: ce9ae27c (small blind) won ($1.43)
Seat 3: 4107d5d5 (big blind) folded before Flop
Seat 4: 59483bf4 folded before Flop (didn't bet)
Seat 5: Hero folded before Flop (didn't bet)
Seat 6: 882f6406 folded before Flop (didn't bet)


Poker Hand #RC1433009757: Hold'em No Limit  ($0.05/$0.1) - 2023/03/27 17:02:21
Table 'RushAndCash28105017' 6-max Seat #1 is the button
Seat 1: 8494623e ($10 in chips)
Seat 2: 7199e0d7 ($12.89 in chips)
Seat 3: 3600e543 ($16.32 in chips)
Seat 4: 8a4fea0c ($10.15 in chips)
Seat 5: Hero ($9.14 in chips)
Seat 6: 8cbe28ff ($15.04 in chips)
7199e0d7: posts small blind $0.05
3600e543: posts big blind $0.1
*** HOLE CARDS ***
Dealt to 8494623e 
Dealt to 7199e0d7 
Dealt to 3600e543 
Dealt to 8a4fea0c 
Dealt to Hero [5h 6c]
Dealt to 8cbe28ff 
8a4fea0c: raises $0.15 to $0.25
Hero: folds
8cbe28ff: folds
8494623e: folds
7199e0d7: folds
3600e543: folds
Uncalled bet ($0.15) returned to 8a4fea0c
*** SHOWDOWN ***
8a4fea0c collected $0.25 from pot
*** SUMMARY ***
Total pot $0.25 | Rake $0 | Jackpot $0 | Bingo $0 | Fortune $0
Seat 1: 8494623e (button) folded before Flop (didn't bet)
Seat 2: 7199e0d7 (small blind) folded before Flop
Seat 3: 3600e543 (big blind) folded before Flop
Seat 4: 8a4fea0c collected ($0.25)
Seat 5: Hero folded before Flop (didn't bet)
Seat 6: 8cbe28ff folded before Flop (didn't bet)


Poker Hand #RC1433009488: Hold'em No Limit  ($0.05/$0.1) - 2023/03/27 17:01:44
Table 'RushAndCash28104748' 6-max Seat #1 is the button
Seat 1: f1c9dcba ($13.38 in chips)
Seat 2: 1b6cf177 ($10 in chips)
Seat 3: bc85f946 ($19.39 in chips)
Seat 4: b2f2c43b ($13.1 in chips)
Seat 5: 2eeaefd9 ($9.73 in chips)
Seat 6: Hero ($8.82 in chips)
1b6cf177: posts small blind $0.05
bc85f946: posts big blind $0.1
*** HOLE CARDS ***
Dealt to f1c9dcba 
Dealt to 1b6cf177 
Dealt to bc85f946 
Dealt to b2f2c43b 
Dealt to 2eeaefd9 
Dealt to Hero [8c 7c]
b2f2c43b: folds
2eeaefd9: folds
Hero: raises $0.15 to $0.25
f1c9dcba: folds
1b6cf177: calls $0.2
bc85f946: folds
*** FLOP *** [9c Qd Jd]
1b6cf177: checks
Hero: bets $0.3
1b6cf177: folds
Uncalled bet ($0.3) returned to Hero
*** SHOWDOWN ***
Hero collected $0.57 from pot
*** SUMMARY ***
Total pot $0.6 | Rake $0.03 | Jackpot $0 | Bingo $0 | Fortune $0
Board [9c Qd Jd]
Seat 1: f1c9dcba (button) folded before Flop (didn't bet)
Seat 2: 1b6cf177 (small blind) folded on the Flop
Seat 3: bc85f946 (big blind) folded before Flop
Seat 4: b2f2c43b folded before Flop (didn't bet)
Seat 5: 2eeaefd9 folded before Flop (didn't bet)
Seat 6: Hero won ($0.57)


Poker Hand #RC1433009418: Hold'em No Limit  ($0.05/$0.1) - 2023/03/27 17:01:34
Table 'RushAndCash28104678' 6-max Seat #1 is the button
Seat 1: e8e8ede3 ($11.84 in chips)
Seat 2: a3406b53 ($11.28 in chips)
Seat 3: cbd5f4f9 ($10 in chips)
Seat 4: 45dec125 ($23.05 in chips)
Seat 5: 3b8b50de ($12.23 in chips)
Seat 6: Hero ($8.82 in chips)
a3406b53: posts small blind $0.05
cbd5f4f9: posts big blind $0.1
*** HOLE CARDS ***
Dealt to e8e8ede3 
Dealt to a3406b53 
Dealt to cbd5f4f9 
Dealt to 45dec125 
Dealt to 3b8b50de 
Dealt to Hero [Js 4s]
45dec125: folds
3b8b50de: folds
Hero: folds
e8e8ede3: raises $0.1 to $0.2
a3406b53: folds
cbd5f4f9: folds
Uncalled bet ($0.1) returned to e8e8ede3
*** SHOWDOWN ***
e8e8ede3 collected $0.25 from pot
*** SUMMARY ***
Total pot $0.25 | Rake $0 | Jackpot $0 | Bingo $0 | Fortune $0
Seat 1: e8e8ede3 (button) collected ($0.25)
Seat 2: a3406b53 (small blind) folded before Flop
Seat 3: cbd5f4f9 (big blind) folded before Flop
Seat 4: 45dec125 folded before Flop (didn't bet)
Seat 5: 3b8b50de folded before Flop (didn't bet)
Seat 6: Hero folded before Flop (didn't bet)


Poker Hand #RC1433008778: Hold'em No Limit  ($0.05/$0.1) - 2023/03/27 16:59:59
Table 'RushAndCash28104038' 6-max Seat #1 is the button
Seat 1: Hero ($9.85 in chips)
Seat 2: 3d61df95 ($10 in chips)
Seat 3: c6eec460 ($9.87 in chips)
Seat 4: 392a56aa ($10.91 in chips)
Seat 5: a3406b53 ($10 in chips)
Seat 6: 5a327a81 ($15.16 in chips)
3d61df95: posts small blind $0.05
c6eec460: posts big blind $0.1
*** HOLE CARDS ***
Dealt to Hero [8h 8d]
Dealt to 3d61df95 
Dealt to c6eec460 
Dealt to 392a56aa 
Dealt to a3406b53 
Dealt to 5a327a81 
392a56aa: folds
a3406b53: raises $0.12 to $0.22
5a327a81: calls $0.22
Hero: calls $0.22
3d61df95: folds
c6eec460: folds
*** FLOP *** [9c 6h 3d]
a3406b53: checks
5a327a81: checks
Hero: bets $0.41
a3406b53: calls $0.41
5a327a81: folds
*** TURN *** [9c 6h 3d] [Th]
a3406b53: checks
Hero: checks
*** RIVER *** [9c 6h 3d Th] [9d]
a3406b53: checks
Hero: bets $0.4
a3406b53: raises $1.85 to $2.25
Hero: folds
Uncalled bet ($1.85) returned to a3406b53
*** SHOWDOWN ***
a3406b53 collected $2.31 from pot
*** SUMMARY ***
Total pot $2.43 | Rake $0.12 | Jackpot $0 | Bingo $0 | Fortune $0
Board [9c 6h 3d Th 9d]
Seat 1: Hero (button) folded on the River
Seat 2: 3d61df95 (small blind) folded before Flop
Seat 3: c6eec460 (big blind) folded before Flop
Seat 4: 392a56aa folded before Flop (didn't bet)
Seat 5: a3406b53 won ($2.31)
Seat 6: 5a327a81 folded on the Flop


Poker Hand #RC1433008711: Hold'em No Limit  ($0.05/$0.1) - 2023/03/27 16:59:49
Table 'RushAndCash28103971' 6-max Seat #1 is the button
Seat 1: 3bfa5da4 ($7.84 in chips)
Seat 2: Hero ($9.9 in chips)
Seat 3: e63365d1 ($10.61 in chips)
Seat 4: cf1ad4dd ($15.04 in chips)
Seat 5: 16e6710f ($20.05 in chips)
Seat 6: 175d7253 ($12.68 in chips)
Hero: posts small blind $0.05
e63365d1: posts big blind $0.1
*** HOLE CARDS ***
Dealt to 3bfa5da4 
Dealt to Hero [5s 4c]
Dealt to e63365d1 
Dealt to cf1ad4dd 
Dealt to 16e6710f 
Dealt to 175d7253 
cf1ad4dd: raises $0.15 to $0.25
16e6710f: folds
175d7253: folds
3bfa5da4: raises $0.15 to $0.4
Hero: folds
e63365d1: folds
cf1ad4dd: calls $0.15
*** FLOP *** [Ts 2s 2h]
cf1ad4dd: checks
3bfa5da4: bets $0.95
cf1ad4dd: calls $0.95
*** TURN *** [Ts 2s 2h] [6d]
cf1ad4dd: checks
3bfa5da4: checks
*** RIVER *** [Ts 2s 2h 6d] [9s]
cf1ad4dd: bets $0.95
3bfa5da4: calls $0.95
cf1ad4dd: shows [Tc Ks] (Pair of Tens and Pair of Twos)
3bfa5da4: shows [9c Th] (Pair of Tens and Pair of Nines)
*** SHOWDOWN ***
3bfa5da4 collected $4.37 from pot
*** SUMMARY ***
Total pot $4.75 | Rake $0.23 | Jackpot $0.15 | Bingo $0 | Fortune $0
Board [Ts 2s 2h 6d 9s]
Seat 1: 3bfa5da4 (button) showed [9c Th] and won ($4.37) with Pair of Tens and Pair of Nines
Seat 2: Hero (small blind) folded before Flop
Seat 3: e63365d1 (big blind) folded before Flop
Seat 4: cf1ad4dd showed [Tc Ks] and lost with Pair of Tens and Pair of Twos
Seat 5: 16e6710f folded before Flop (didn't bet)
Seat 6: 175d7253 folded before Flop (didn't bet)


Poker Hand #RC1433008575: Hold'em No Limit  ($0.05/$0.1) - 2023/03/27 16:59:30
Table 'RushAndCash28103835' 6-max Seat #1 is the button
Seat 1: ab344d4f ($13.35 in chips)
Seat 2: f6dc442d ($10.12 in chips)
Seat 3: Hero ($10 in chips)
Seat 4: 59483bf4 ($10.78 in chips)
Seat 5: c3bde2ae ($8 in chips)
Seat 6: 2d406ff5 ($13.92 in chips)
f6dc442d: posts small blind $0.05
Hero: posts big blind $0.1
*** HOLE CARDS ***
Dealt to ab344d4f 
Dealt to f6dc442d 
Dealt to Hero [3c Ks]
Dealt to 59483bf4 
Dealt to c3bde2ae 
Dealt to 2d406ff5 
59483bf4: folds
c3bde2ae: folds
2d406ff5: folds
ab344d4f: folds
f6dc442d: raises $0.2 to $0.3
Hero: folds
Uncalled bet ($0.2) returned to f6dc442d
*** SHOWDOWN ***
f6dc442d collected $0.2 from pot
*** SUMMARY ***
Total pot $0.2 | Rake $0 | Jackpot $0 | Bingo $0 | Fortune $0
Seat 1: ab344d4f (button) folded before Flop (didn't bet)
Seat 2: f6dc442d (small blind) collected ($0.2)
Seat 3: Hero (big blind) folded before Flop
Seat 4: 59483bf4 folded before Flop (didn't bet)
Seat 5: c3bde2ae folded before Flop (didn't bet)
Seat 6: 2d406ff5 folded before Flop (didn't bet)


