Poker Hand #RC1317016251: Hold'em No Limit  ($0.05/$0.1) - 2023/02/02 14:32:17
Table 'RushAndCash5131511' 6-max Seat #1 is the button
Seat 1: Hero ($21.58 in chips)
Seat 2: 3321726b ($10.05 in chips)
Seat 3: 8189bd18 ($25.71 in chips)
Seat 4: daa5ec7 ($10 in chips)
Seat 5: 1d3e8d87 ($27.98 in chips)
Seat 6: db80bd69 ($10.2 in chips)
3321726b: posts small blind $0.05
8189bd18: posts big blind $0.1
*** HOLE CARDS ***
Dealt to Hero [Kc Ts]
Dealt to 3321726b 
Dealt to 8189bd18 
Dealt to daa5ec7 
Dealt to 1d3e8d87 
Dealt to db80bd69 
daa5ec7: folds
1d3e8d87: folds
db80bd69: folds
Hero: raises $0.15 to $0.25
3321726b: folds
8189bd18: raises $0.8 to $1.05
Hero: folds
Uncalled bet ($0.8) returned to 8189bd18
*** SHOWDOWN ***
8189bd18 collected $0.53 from pot
*** SUMMARY ***
Total pot $0.55 | Rake $0.02 | Jackpot $0 | Bingo $0 | Fortune $0
Seat 1: Hero (button) folded before Flop
Seat 2: 3321726b (small blind) folded before Flop
Seat 3: 8189bd18 (big blind) collected ($0.53)
Seat 4: daa5ec7 folded before Flop (didn't bet)
Seat 5: 1d3e8d87 folded before Flop (didn't bet)
Seat 6: db80bd69 folded before Flop (didn't bet)


Poker Hand #RC1317015134: Hold'em No Limit  ($0.05/$0.1) - 2023/02/02 14:28:47
Table 'RushAndCash5130394' 6-max Seat #1 is the button
Seat 1: f9be463a ($5.22 in chips)
Seat 2: Hero ($17.53 in chips)
Seat 3: 306b3799 ($25.75 in chips)
Seat 4: cdc032bb ($12.2 in chips)
Seat 5: daa5ec7 ($13.4 in chips)
Seat 6: be6c4ecc ($11.04 in chips)
Hero: posts small blind $0.05
306b3799: posts big blind $0.1
*** HOLE CARDS ***
Dealt to f9be463a 
Dealt to Hero [Qc Qd]
Dealt to 306b3799 
Dealt to cdc032bb 
Dealt to daa5ec7 
Dealt to be6c4ecc 
cdc032bb: folds
daa5ec7: raises $0.2 to $0.3
be6c4ecc: raises $0.6 to $0.9
f9be463a: folds
Hero: calls $0.85
306b3799: folds
daa5ec7: raises $2.5 to $3.4
be6c4ecc: folds
Hero: calls $2.5
*** FLOP *** [3s Js Ts]
Hero: checks
daa5ec7: bets $0.1
Hero: calls $0.1
*** TURN *** [3s Js Ts] [6d]
Hero: checks
daa5ec7: checks
*** RIVER *** [3s Js Ts 6d] [2d]
Hero: checks
daa5ec7: checks
Hero: shows [Qc Qd] (Pair of Queens)
daa5ec7: shows [Kh Ad] (Ace-High)
*** SHOWDOWN ***
Hero collected $7.55 from pot
*** SUMMARY ***
Total pot $8 | Rake $0.3 | Jackpot $0.15 | Bingo $0 | Fortune $0
Board [3s Js Ts 6d 2d]
Seat 1: f9be463a (button) folded before Flop (didn't bet)
Seat 2: Hero (small blind) showed [Qc Qd] and won ($7.55) with Pair of Queens
Seat 3: 306b3799 (big blind) folded before Flop
Seat 4: cdc032bb folded before Flop (didn't bet)
Seat 5: daa5ec7 showed [Kh Ad] and lost with Ace-High
Seat 6: be6c4ecc folded before Flop


Poker Hand #RC1317015114: Hold'em No Limit  ($0.05/$0.1) - 2023/02/02 14:28:43
Table 'RushAndCash5130374' 6-max Seat #1 is the button
Seat 1: 123789f2 ($82.98 in chips)
Seat 2: d2642a4f ($29.64 in chips)
Seat 3: f10da04e ($13.53 in chips)
Seat 4: Hero ($17.53 in chips)
Seat 5: 306b3799 ($25.75 in chips)
Seat 6: 53a4a718 ($11.04 in chips)
d2642a4f: posts small blind $0.05
f10da04e: posts big blind $0.1
*** HOLE CARDS ***
Dealt to 123789f2 
Dealt to d2642a4f 
Dealt to f10da04e 
Dealt to Hero [8c 5h]
Dealt to 306b3799 
Dealt to 53a4a718 
Hero: folds
306b3799: folds
53a4a718: folds
123789f2: folds
d2642a4f: folds
Uncalled bet ($0.05) returned to f10da04e
*** SHOWDOWN ***
f10da04e collected $0.1 from pot
*** SUMMARY ***
Total pot $0.1 | Rake $0 | Jackpot $0 | Bingo $0 | Fortune $0
Seat 1: 123789f2 (button) folded before Flop (didn't bet)
Seat 2: d2642a4f (small blind) folded before Flop
Seat 3: f10da04e (big blind) collected ($0.1)
Seat 4: Hero folded before Flop (didn't bet)
Seat 5: 306b3799 folded before Flop (didn't bet)
Seat 6: 53a4a718 folded before Flop (didn't bet)


Poker Hand #RC1317015090: Hold'em No Limit  ($0.05/$0.1) - 2023/02/02 14:28:40
Table 'RushAndCash5130350' 6-max Seat #1 is the button
Seat 1: 306b3799 ($25.75 in chips)
Seat 2: b959cff5 ($12.1 in chips)
Seat 3: ba78ff20 ($10.91 in chips)
Seat 4: 694c1edf ($15.29 in chips)
Seat 5: Hero ($17.53 in chips)
Seat 6: 1e2f428c ($15.95 in chips)
b959cff5: posts small blind $0.05
ba78ff20: posts big blind $0.1
*** HOLE CARDS ***
Dealt to 306b3799 
Dealt to b959cff5 
Dealt to ba78ff20 
Dealt to 694c1edf 
Dealt to Hero [8c 4d]
Dealt to 1e2f428c 
694c1edf: folds
Hero: folds
1e2f428c: raises $0.2 to $0.3
306b3799: folds
b959cff5: folds
ba78ff20: folds
Uncalled bet ($0.2) returned to 1e2f428c
*** SHOWDOWN ***
1e2f428c collected $0.25 from pot
*** SUMMARY ***
Total pot $0.25 | Rake $0 | Jackpot $0 | Bingo $0 | Fortune $0
Seat 1: 306b3799 (button) folded before Flop (didn't bet)
Seat 2: b959cff5 (small blind) folded before Flop
Seat 3: ba78ff20 (big blind) folded before Flop
Seat 4: 694c1edf folded before Flop (didn't bet)
Seat 5: Hero folded before Flop (didn't bet)
Seat 6: 1e2f428c collected ($0.25)


Poker Hand #RC1317015046: Hold'em No Limit  ($0.05/$0.1) - 2023/02/02 14:28:30
Table 'RushAndCash5130306' 6-max Seat #1 is the button
Seat 1: 297006d8 ($11.6 in chips)
Seat 2: Hero ($17.58 in chips)
Seat 3: ba78ff20 ($11.01 in chips)
Seat 4: d35e662c ($14.16 in chips)
Seat 5: 1d98a6e5 ($12.29 in chips)
Seat 6: 4c103877 ($10.54 in chips)
Hero: posts small blind $0.05
ba78ff20: posts big blind $0.1
*** HOLE CARDS ***
Dealt to 297006d8 
Dealt to Hero [Jc 7c]
Dealt to ba78ff20 
Dealt to d35e662c 
Dealt to 1d98a6e5 
Dealt to 4c103877 
d35e662c: raises $0.2 to $0.3
1d98a6e5: folds
4c103877: folds
297006d8: folds
Hero: folds
ba78ff20: folds
Uncalled bet ($0.2) returned to d35e662c
*** SHOWDOWN ***
d35e662c collected $0.25 from pot
*** SUMMARY ***
Total pot $0.25 | Rake $0 | Jackpot $0 | Bingo $0 | Fortune $0
Seat 1: 297006d8 (button) folded before Flop (didn't bet)
Seat 2: Hero (small blind) folded before Flop
Seat 3: ba78ff20 (big blind) folded before Flop
Seat 4: d35e662c collected ($0.25)
Seat 5: 1d98a6e5 folded before Flop (didn't bet)
Seat 6: 4c103877 folded before Flop (didn't bet)


Poker Hand #RC1317015018: Hold'em No Limit  ($0.05/$0.1) - 2023/02/02 14:28:25
Table 'RushAndCash5130278' 6-max Seat #1 is the button
Seat 1: 63234475 ($10 in chips)
Seat 2: eab1657 ($10 in chips)
Seat 3: 309311cd ($33.82 in chips)
Seat 4: f7288b7c ($14.23 in chips)
Seat 5: Hero ($17.58 in chips)
Seat 6: 9ef3b3eb ($6.94 in chips)
eab1657: posts small blind $0.05
309311cd: posts big blind $0.1
*** HOLE CARDS ***
Dealt to 63234475 
Dealt to eab1657 
Dealt to 309311cd 
Dealt to f7288b7c 
Dealt to Hero [8d Jd]
Dealt to 9ef3b3eb 
f7288b7c: folds
Hero: folds
9ef3b3eb: raises $0.15 to $0.25
63234475: folds
eab1657: raises $0.9 to $1.15
309311cd: folds
9ef3b3eb: folds
Uncalled bet ($0.9) returned to eab1657
*** SHOWDOWN ***
eab1657 collected $0.57 from pot
*** SUMMARY ***
Total pot $0.6 | Rake $0.03 | Jackpot $0 | Bingo $0 | Fortune $0
Seat 1: 63234475 (button) folded before Flop (didn't bet)
Seat 2: eab1657 (small blind) collected ($0.57)
Seat 3: 309311cd (big blind) folded before Flop
Seat 4: f7288b7c folded before Flop (didn't bet)
Seat 5: Hero folded before Flop (didn't bet)
Seat 6: 9ef3b3eb folded before Flop


Poker Hand #RC1317014992: Hold'em No Limit  ($0.05/$0.1) - 2023/02/02 14:28:21
Table 'RushAndCash5130252' 6-max Seat #1 is the button
Seat 1: Hero ($17.58 in chips)
Seat 2: c30c5a32 ($24.87 in chips)
Seat 3: 7d4a2f54 ($24.05 in chips)
Seat 4: 210420c4 ($12.15 in chips)
Seat 5: 460b8983 ($10 in chips)
Seat 6: beab8ea4 ($14.25 in chips)
c30c5a32: posts small blind $0.05
7d4a2f54: posts big blind $0.1
*** HOLE CARDS ***
Dealt to Hero [7s 3d]
Dealt to c30c5a32 
Dealt to 7d4a2f54 
Dealt to 210420c4 
Dealt to 460b8983 
Dealt to beab8ea4 
210420c4: raises $0.15 to $0.25
460b8983: raises $0.65 to $0.9
beab8ea4: raises $1.65 to $2.55
Hero: folds
c30c5a32: folds
7d4a2f54: folds
210420c4: folds
460b8983: folds
Uncalled bet ($1.65) returned to beab8ea4
*** SHOWDOWN ***
beab8ea4 collected $2.09 from pot
*** SUMMARY ***
Total pot $2.2 | Rake $0.11 | Jackpot $0 | Bingo $0 | Fortune $0
Seat 1: Hero (button) folded before Flop (didn't bet)
Seat 2: c30c5a32 (small blind) folded before Flop
Seat 3: 7d4a2f54 (big blind) folded before Flop
Seat 4: 210420c4 folded before Flop
Seat 5: 460b8983 folded before Flop
Seat 6: beab8ea4 collected ($2.09)


Poker Hand #RC1317014918: Hold'em No Limit  ($0.05/$0.1) - 2023/02/02 14:28:06
Table 'RushAndCash5130178' 6-max Seat #1 is the button
Seat 1: 44aa8ff7 ($11.48 in chips)
Seat 2: a21e595b ($8.32 in chips)
Seat 3: Hero ($17.68 in chips)
Seat 4: 65f718e7 ($11.69 in chips)
Seat 5: 8d56d7e5 ($10.26 in chips)
Seat 6: 4a335b53 ($11.46 in chips)
a21e595b: posts small blind $0.05
Hero: posts big blind $0.1
*** HOLE CARDS ***
Dealt to 44aa8ff7 
Dealt to a21e595b 
Dealt to Hero [6h 3h]
Dealt to 65f718e7 
Dealt to 8d56d7e5 
Dealt to 4a335b53 
65f718e7: folds
8d56d7e5: folds
4a335b53: raises $0.15 to $0.25
44aa8ff7: folds
a21e595b: folds
Hero: folds
Uncalled bet ($0.15) returned to 4a335b53
*** SHOWDOWN ***
4a335b53 collected $0.25 from pot
*** SUMMARY ***
Total pot $0.25 | Rake $0 | Jackpot $0 | Bingo $0 | Fortune $0
Seat 1: 44aa8ff7 (button) folded before Flop (didn't bet)
Seat 2: a21e595b (small blind) folded before Flop
Seat 3: Hero (big blind) folded before Flop
Seat 4: 65f718e7 folded before Flop (didn't bet)
Seat 5: 8d56d7e5 folded before Flop (didn't bet)
Seat 6: 4a335b53 collected ($0.25)


Poker Hand #RC1317014897: Hold'em No Limit  ($0.05/$0.1) - 2023/02/02 14:28:03
Table 'RushAndCash5130157' 6-max Seat #1 is the button
Seat 1: 76b5c4c4 ($9.38 in chips)
Seat 2: fcfe495d ($11.86 in chips)
Seat 3: e180a561 ($10.1 in chips)
Seat 4: d107460c ($10.41 in chips)
Seat 5: Hero ($17.68 in chips)
Seat 6: 6a206b7e ($13.18 in chips)
fcfe495d: posts small blind $0.05
e180a561: posts big blind $0.1
*** HOLE CARDS ***
Dealt to 76b5c4c4 
Dealt to fcfe495d 
Dealt to e180a561 
Dealt to d107460c 
Dealt to Hero [4s 8h]
Dealt to 6a206b7e 
d107460c: raises $0.15 to $0.25
Hero: folds
6a206b7e: folds
76b5c4c4: folds
fcfe495d: folds
e180a561: folds
Uncalled bet ($0.15) returned to d107460c
*** SHOWDOWN ***
d107460c collected $0.25 from pot
*** SUMMARY ***
Total pot $0.25 | Rake $0 | Jackpot $0 | Bingo $0 | Fortune $0
Seat 1: 76b5c4c4 (button) folded before Flop (didn't bet)
Seat 2: fcfe495d (small blind) folded before Flop
Seat 3: e180a561 (big blind) folded before Flop
Seat 4: d107460c collected ($0.25)
Seat 5: Hero folded before Flop (didn't bet)
Seat 6: 6a206b7e folded before Flop (didn't bet)


Poker Hand #RC1317014877: Hold'em No Limit  ($0.05/$0.1) - 2023/02/02 14:27:59
Table 'RushAndCash5130137' 6-max Seat #1 is the button
Seat 1: d618215d ($6.34 in chips)
Seat 2: deabc729 ($10 in chips)
Seat 3: 44aa8ff7 ($11.58 in chips)
Seat 4: Hero ($17.68 in chips)
Seat 5: e1671d4c ($4 in chips)
Seat 6: 6358b6c9 ($10.64 in chips)
deabc729: posts small blind $0.05
44aa8ff7: posts big blind $0.1
*** HOLE CARDS ***
Dealt to d618215d 
Dealt to deabc729 
Dealt to 44aa8ff7 
Dealt to Hero [Ts Qh]
Dealt to e1671d4c 
Dealt to 6358b6c9 
Hero: folds
e1671d4c: folds
6358b6c9: raises $0.1 to $0.2
d618215d: folds
deabc729: folds
44aa8ff7: folds
Uncalled bet ($0.1) returned to 6358b6c9
*** SHOWDOWN ***
6358b6c9 collected $0.25 from pot
*** SUMMARY ***
Total pot $0.25 | Rake $0 | Jackpot $0 | Bingo $0 | Fortune $0
Seat 1: d618215d (button) folded before Flop (didn't bet)
Seat 2: deabc729 (small blind) folded before Flop
Seat 3: 44aa8ff7 (big blind) folded before Flop
Seat 4: Hero folded before Flop (didn't bet)
Seat 5: e1671d4c folded before Flop (didn't bet)
Seat 6: 6358b6c9 collected ($0.25)


Poker Hand #RC1317014857: Hold'em No Limit  ($0.05/$0.1) - 2023/02/02 14:27:55
Table 'RushAndCash5130117' 6-max Seat #1 is the button
Seat 1: 20cf1b07 ($10.3 in chips)
Seat 2: 74569e26 ($10 in chips)
Seat 3: Hero ($17.78 in chips)
Seat 4: 123789f2 ($83.03 in chips)
Seat 5: c4b8ef0c ($24.94 in chips)
Seat 6: 54c96301 ($9.3 in chips)
74569e26: posts small blind $0.05
Hero: posts big blind $0.1
*** HOLE CARDS ***
Dealt to 20cf1b07 
Dealt to 74569e26 
Dealt to Hero [4c 2c]
Dealt to 123789f2 
Dealt to c4b8ef0c 
Dealt to 54c96301 
123789f2: folds
c4b8ef0c: raises $0.12 to $0.22
54c96301: folds
20cf1b07: folds
74569e26: folds
Hero: folds
Uncalled bet ($0.12) returned to c4b8ef0c
*** SHOWDOWN ***
c4b8ef0c collected $0.25 from pot
*** SUMMARY ***
Total pot $0.25 | Rake $0 | Jackpot $0 | Bingo $0 | Fortune $0
Seat 1: 20cf1b07 (button) folded before Flop (didn't bet)
Seat 2: 74569e26 (small blind) folded before Flop
Seat 3: Hero (big blind) folded before Flop
Seat 4: 123789f2 folded before Flop (didn't bet)
Seat 5: c4b8ef0c collected ($0.25)
Seat 6: 54c96301 folded before Flop (didn't bet)


Poker Hand #RC1317014822: Hold'em No Limit  ($0.05/$0.1) - 2023/02/02 14:27:48
Table 'RushAndCash5130082' 6-max Seat #1 is the button
Seat 1: Hero ($17.78 in chips)
Seat 2: 44aa8ff7 ($11.63 in chips)
Seat 3: 5c17b844 ($11.77 in chips)
Seat 4: 87e882aa ($10 in chips)
Seat 5: c1d8982e ($10.15 in chips)
Seat 6: d39fee52 ($10.23 in chips)
44aa8ff7: posts small blind $0.05
5c17b844: posts big blind $0.1
*** HOLE CARDS ***
Dealt to Hero [Kc 7h]
Dealt to 44aa8ff7 
Dealt to 5c17b844 
Dealt to 87e882aa 
Dealt to c1d8982e 
Dealt to d39fee52 
87e882aa: raises $0.15 to $0.25
c1d8982e: folds
d39fee52: folds
Hero: folds
44aa8ff7: folds
5c17b844: folds
Uncalled bet ($0.15) returned to 87e882aa
*** SHOWDOWN ***
87e882aa collected $0.25 from pot
*** SUMMARY ***
Total pot $0.25 | Rake $0 | Jackpot $0 | Bingo $0 | Fortune $0
Seat 1: Hero (button) folded before Flop (didn't bet)
Seat 2: 44aa8ff7 (small blind) folded before Flop
Seat 3: 5c17b844 (big blind) folded before Flop
Seat 4: 87e882aa collected ($0.25)
Seat 5: c1d8982e folded before Flop (didn't bet)
Seat 6: d39fee52 folded before Flop (didn't bet)


Poker Hand #RC1317014759: Hold'em No Limit  ($0.05/$0.1) - 2023/02/02 14:27:35
Table 'RushAndCash5130019' 6-max Seat #1 is the button
Seat 1: 1fed28bb ($4.68 in chips)
Seat 2: Hero ($17.83 in chips)
Seat 3: 10dde30f ($8.5 in chips)
Seat 4: 196baf24 ($9.85 in chips)
Seat 5: 43449f06 ($11.73 in chips)
Seat 6: d35e662c ($14.16 in chips)
Hero: posts small blind $0.05
10dde30f: posts big blind $0.1
*** HOLE CARDS ***
Dealt to 1fed28bb 
Dealt to Hero [2s 9d]
Dealt to 10dde30f 
Dealt to 196baf24 
Dealt to 43449f06 
Dealt to d35e662c 
196baf24: folds
43449f06: folds
d35e662c: folds
1fed28bb: raises $0.2 to $0.3
Hero: folds
10dde30f: folds
Uncalled bet ($0.2) returned to 1fed28bb
*** SHOWDOWN ***
1fed28bb collected $0.25 from pot
*** SUMMARY ***
Total pot $0.25 | Rake $0 | Jackpot $0 | Bingo $0 | Fortune $0
Seat 1: 1fed28bb (button) collected ($0.25)
Seat 2: Hero (small blind) folded before Flop
Seat 3: 10dde30f (big blind) folded before Flop
Seat 4: 196baf24 folded before Flop (didn't bet)
Seat 5: 43449f06 folded before Flop (didn't bet)
Seat 6: d35e662c folded before Flop (didn't bet)


Poker Hand #RC1317014741: Hold'em No Limit  ($0.05/$0.1) - 2023/02/02 14:27:31
Table 'RushAndCash5130001' 6-max Seat #1 is the button
Seat 1: 159dec68 ($39.72 in chips)
Seat 2: c11f5846 ($10.3 in chips)
Seat 3: 8281a47c ($10.42 in chips)
Seat 4: 7fe430c2 ($10 in chips)
Seat 5: Hero ($17.83 in chips)
Seat 6: 4df22a05 ($10 in chips)
c11f5846: posts small blind $0.05
8281a47c: posts big blind $0.1
*** HOLE CARDS ***
Dealt to 159dec68 
Dealt to c11f5846 
Dealt to 8281a47c 
Dealt to 7fe430c2 
Dealt to Hero [3h Jd]
Dealt to 4df22a05 
7fe430c2: folds
Hero: folds
4df22a05: folds
159dec68: raises $0.15 to $0.25
c11f5846: folds
8281a47c: calls $0.15
*** FLOP *** [8s Ad Kd]
8281a47c: checks
159dec68: checks
*** TURN *** [8s Ad Kd] [6s]
8281a47c: checks
159dec68: checks
*** RIVER *** [8s Ad Kd 6s] [Qd]
8281a47c: checks
159dec68: checks
8281a47c: shows [Th Kc] (Pair of Kings)
159dec68: shows [Qc Js] (Pair of Queens)
*** SHOWDOWN ***
8281a47c collected $0.53 from pot
*** SUMMARY ***
Total pot $0.55 | Rake $0.02 | Jackpot $0 | Bingo $0 | Fortune $0
Board [8s Ad Kd 6s Qd]
Seat 1: 159dec68 (button) showed [Qc Js] and lost with Pair of Queens
Seat 2: c11f5846 (small blind) folded before Flop
Seat 3: 8281a47c (big blind) showed [Th Kc] and won ($0.53) with Pair of Kings
Seat 4: 7fe430c2 folded before Flop (didn't bet)
Seat 5: Hero folded before Flop (didn't bet)
Seat 6: 4df22a05 folded before Flop (didn't bet)


Poker Hand #RC1316974679: Hold'em No Limit  ($0.05/$0.1) - 2023/02/02 14:27:18
Table 'RushAndCash5129939' 6-max Seat #1 is the button
Seat 1: 7fe430c2 ($10 in chips)
Seat 2: 2bc400f8 ($32.73 in chips)
Seat 3: c96b7e5a ($10.03 in chips)
Seat 4: b9fc2b4e ($10 in chips)
Seat 5: 6804f1f4 ($13.42 in chips)
Seat 6: Hero ($17.68 in chips)
2bc400f8: posts small blind $0.05
c96b7e5a: posts big blind $0.1
*** HOLE CARDS ***
Dealt to 7fe430c2 
Dealt to 2bc400f8 
Dealt to c96b7e5a 
Dealt to b9fc2b4e 
Dealt to 6804f1f4 
Dealt to Hero [2s 2h]
b9fc2b4e: folds
6804f1f4: folds
Hero: raises $0.15 to $0.25
7fe430c2: folds
2bc400f8: folds
c96b7e5a: folds
Uncalled bet ($0.15) returned to Hero
*** SHOWDOWN ***
Hero collected $0.25 from pot
*** SUMMARY ***
Total pot $0.25 | Rake $0 | Jackpot $0 | Bingo $0 | Fortune $0
Seat 1: 7fe430c2 (button) folded before Flop (didn't bet)
Seat 2: 2bc400f8 (small blind) folded before Flop
Seat 3: c96b7e5a (big blind) folded before Flop
Seat 4: b9fc2b4e folded before Flop (didn't bet)
Seat 5: 6804f1f4 folded before Flop (didn't bet)
Seat 6: Hero collected ($0.25)


Poker Hand #RC1316974660: Hold'em No Limit  ($0.05/$0.1) - 2023/02/02 14:27:14
Table 'RushAndCash5129920' 6-max Seat #1 is the button
Seat 1: f10da04e ($13.48 in chips)
Seat 2: c2f0f90f ($9.6 in chips)
Seat 3: 7ec1e2d8 ($10.76 in chips)
Seat 4: Hero ($17.68 in chips)
Seat 5: c96b7e5a ($10.03 in chips)
Seat 6: fed38223 ($10.09 in chips)
c2f0f90f: posts small blind $0.05
7ec1e2d8: posts big blind $0.1
*** HOLE CARDS ***
Dealt to f10da04e 
Dealt to c2f0f90f 
Dealt to 7ec1e2d8 
Dealt to Hero [Td Kh]
Dealt to c96b7e5a 
Dealt to fed38223 
Hero: folds
c96b7e5a: folds
fed38223: raises $0.2 to $0.3
f10da04e: folds
c2f0f90f: folds
7ec1e2d8: calls $0.2
*** FLOP *** [Ks Qc 4c]
7ec1e2d8: checks
fed38223: bets $0.17
7ec1e2d8: folds
Uncalled bet ($0.17) returned to fed38223
*** SHOWDOWN ***
fed38223 collected $0.62 from pot
*** SUMMARY ***
Total pot $0.65 | Rake $0.03 | Jackpot $0 | Bingo $0 | Fortune $0
Board [Ks Qc 4c]
Seat 1: f10da04e (button) folded before Flop (didn't bet)
Seat 2: c2f0f90f (small blind) folded before Flop
Seat 3: 7ec1e2d8 (big blind) folded on the Flop
Seat 4: Hero folded before Flop (didn't bet)
Seat 5: c96b7e5a folded before Flop (didn't bet)
Seat 6: fed38223 won ($0.62)


Poker Hand #RC1316974581: Hold'em No Limit  ($0.05/$0.1) - 2023/02/02 14:26:58
Table 'RushAndCash5129841' 6-max Seat #1 is the button
Seat 1: d51969cd ($9.33 in chips)
Seat 2: Hero ($17.58 in chips)
Seat 3: 2c7d4ccb ($21.9 in chips)
Seat 4: 69c69bc3 ($17.78 in chips)
Seat 5: c6729c5f ($5.06 in chips)
Seat 6: 24a3978e ($10 in chips)
Hero: posts small blind $0.05
2c7d4ccb: posts big blind $0.1
*** HOLE CARDS ***
Dealt to d51969cd 
Dealt to Hero [7h Kc]
Dealt to 2c7d4ccb 
Dealt to 69c69bc3 
Dealt to c6729c5f 
Dealt to 24a3978e 
69c69bc3: folds
c6729c5f: folds
24a3978e: folds
d51969cd: folds
Hero: raises $0.2 to $0.3
2c7d4ccb: folds
Uncalled bet ($0.2) returned to Hero
*** SHOWDOWN ***
Hero collected $0.2 from pot
*** SUMMARY ***
Total pot $0.2 | Rake $0 | Jackpot $0 | Bingo $0 | Fortune $0
Seat 1: d51969cd (button) folded before Flop (didn't bet)
Seat 2: Hero (small blind) collected ($0.2)
Seat 3: 2c7d4ccb (big blind) folded before Flop
Seat 4: 69c69bc3 folded before Flop (didn't bet)
Seat 5: c6729c5f folded before Flop (didn't bet)
Seat 6: 24a3978e folded before Flop (didn't bet)


Poker Hand #RC1316974549: Hold'em No Limit  ($0.05/$0.1) - 2023/02/02 14:26:53
Table 'RushAndCash5129809' 6-max Seat #1 is the button
Seat 1: cdc032bb ($9.85 in chips)
Seat 2: 123789f2 ($83.48 in chips)
Seat 3: Hero ($17.68 in chips)
Seat 4: 3c7accf8 ($11.12 in chips)
Seat 5: 1d275be8 ($10.48 in chips)
Seat 6: f3a5f7ce ($11.96 in chips)
123789f2: posts small blind $0.05
Hero: posts big blind $0.1
*** HOLE CARDS ***
Dealt to cdc032bb 
Dealt to 123789f2 
Dealt to Hero [2s Kc]
Dealt to 3c7accf8 
Dealt to 1d275be8 
Dealt to f3a5f7ce 
3c7accf8: folds
1d275be8: raises $0.15 to $0.25
f3a5f7ce: folds
cdc032bb: folds
123789f2: calls $0.2
Hero: folds
*** FLOP *** [5c Jh Td]
123789f2: checks
1d275be8: bets $0.3
123789f2: calls $0.3
*** TURN *** [5c Jh Td] [Qh]
123789f2: checks
1d275be8: bets $0.9
123789f2: folds
Uncalled bet ($0.9) returned to 1d275be8
*** SHOWDOWN ***
1d275be8 collected $1.14 from pot
*** SUMMARY ***
Total pot $1.2 | Rake $0.06 | Jackpot $0 | Bingo $0 | Fortune $0
Board [5c Jh Td Qh]
Seat 1: cdc032bb (button) folded before Flop (didn't bet)
Seat 2: 123789f2 (small blind) folded on the Turn
Seat 3: Hero (big blind) folded before Flop
Seat 4: 3c7accf8 folded before Flop (didn't bet)
Seat 5: 1d275be8 won ($1.14)
Seat 6: f3a5f7ce folded before Flop (didn't bet)


Poker Hand #RC1316974519: Hold'em No Limit  ($0.05/$0.1) - 2023/02/02 14:26:47
Table 'RushAndCash5129779' 6-max Seat #1 is the button
Seat 1: dda3de4d ($10.54 in chips)
Seat 2: 8e30054 ($10.05 in chips)
Seat 3: 79ac26c1 ($12.44 in chips)
Seat 4: a672d5d2 ($19.11 in chips)
Seat 5: ef486511 ($26.08 in chips)
Seat 6: Hero ($17.68 in chips)
8e30054: posts small blind $0.05
79ac26c1: posts big blind $0.1
*** HOLE CARDS ***
Dealt to dda3de4d 
Dealt to 8e30054 
Dealt to 79ac26c1 
Dealt to a672d5d2 
Dealt to ef486511 
Dealt to Hero [9d 8s]
a672d5d2: folds
ef486511: folds
Hero: folds
dda3de4d: raises $0.2 to $0.3
8e30054: folds
79ac26c1: calls $0.2
*** FLOP *** [4d 5s 7h]
79ac26c1: checks
dda3de4d: bets $0.51
79ac26c1: folds
Uncalled bet ($0.51) returned to dda3de4d
*** SHOWDOWN ***
dda3de4d collected $0.62 from pot
*** SUMMARY ***
Total pot $0.65 | Rake $0.03 | Jackpot $0 | Bingo $0 | Fortune $0
Board [4d 5s 7h]
Seat 1: dda3de4d (button) won ($0.62)
Seat 2: 8e30054 (small blind) folded before Flop
Seat 3: 79ac26c1 (big blind) folded on the Flop
Seat 4: a672d5d2 folded before Flop (didn't bet)
Seat 5: ef486511 folded before Flop (didn't bet)
Seat 6: Hero folded before Flop (didn't bet)


Poker Hand #RC1316974471: Hold'em No Limit  ($0.05/$0.1) - 2023/02/02 14:26:37
Table 'RushAndCash5129731' 6-max Seat #1 is the button
Seat 1: Hero ($17.68 in chips)
Seat 2: c94b061f ($10.45 in chips)
Seat 3: e9f4837d ($10.62 in chips)
Seat 4: a45956ba ($18.35 in chips)
Seat 5: c33bc2cc ($10.2 in chips)
Seat 6: cb98a323 ($11.31 in chips)
c94b061f: posts small blind $0.05
e9f4837d: posts big blind $0.1
*** HOLE CARDS ***
Dealt to Hero [Th 8d]
Dealt to c94b061f 
Dealt to e9f4837d 
Dealt to a45956ba 
Dealt to c33bc2cc 
Dealt to cb98a323 
a45956ba: folds
c33bc2cc: raises $0.14 to $0.24
cb98a323: folds
Hero: folds
c94b061f: folds
e9f4837d: folds
Uncalled bet ($0.14) returned to c33bc2cc
*** SHOWDOWN ***
c33bc2cc collected $0.25 from pot
*** SUMMARY ***
Total pot $0.25 | Rake $0 | Jackpot $0 | Bingo $0 | Fortune $0
Seat 1: Hero (button) folded before Flop (didn't bet)
Seat 2: c94b061f (small blind) folded before Flop
Seat 3: e9f4837d (big blind) folded before Flop
Seat 4: a45956ba folded before Flop (didn't bet)
Seat 5: c33bc2cc collected ($0.25)
Seat 6: cb98a323 folded before Flop (didn't bet)


Poker Hand #RC1316974443: Hold'em No Limit  ($0.05/$0.1) - 2023/02/02 14:26:33
Table 'RushAndCash5129703' 6-max Seat #1 is the button
Seat 1: 3828897b ($25.23 in chips)
Seat 2: 7ed16543 ($17.92 in chips)
Seat 3: ebf061b2 ($10.62 in chips)
Seat 4: Hero ($17.68 in chips)
Seat 5: 6358b6c9 ($10 in chips)
Seat 6: eab1657 ($10.15 in chips)
7ed16543: posts small blind $0.05
ebf061b2: posts big blind $0.1
*** HOLE CARDS ***
Dealt to 3828897b 
Dealt to 7ed16543 
Dealt to ebf061b2 
Dealt to Hero [9h 3d]
Dealt to 6358b6c9 
Dealt to eab1657 
Hero: folds
6358b6c9: raises $0.12 to $0.22
eab1657: folds
3828897b: calls $0.22
7ed16543: folds
ebf061b2: folds
*** FLOP *** [Qs 5d Ts]
6358b6c9: bets $0.3
3828897b: folds
Uncalled bet ($0.3) returned to 6358b6c9
*** SHOWDOWN ***
6358b6c9 collected $0.56 from pot
*** SUMMARY ***
Total pot $0.59 | Rake $0.03 | Jackpot $0 | Bingo $0 | Fortune $0
Board [Qs 5d Ts]
Seat 1: 3828897b (button) folded on the Flop
Seat 2: 7ed16543 (small blind) folded before Flop
Seat 3: ebf061b2 (big blind) folded before Flop
Seat 4: Hero folded before Flop (didn't bet)
Seat 5: 6358b6c9 won ($0.56)
Seat 6: eab1657 folded before Flop (didn't bet)


Poker Hand #RC1316974310: Hold'em No Limit  ($0.05/$0.1) - 2023/02/02 14:26:07
Table 'RushAndCash5129570' 6-max Seat #1 is the button
Seat 1: 299eef01 ($8.72 in chips)
Seat 2: Hero ($17.73 in chips)
Seat 3: c01af219 ($10.53 in chips)
Seat 4: d433a235 ($15.54 in chips)
Seat 5: 2798beed ($10 in chips)
Seat 6: f7288b7c ($17.25 in chips)
Hero: posts small blind $0.05
c01af219: posts big blind $0.1
*** HOLE CARDS ***
Dealt to 299eef01 
Dealt to Hero [3d 2s]
Dealt to c01af219 
Dealt to d433a235 
Dealt to 2798beed 
Dealt to f7288b7c 
d433a235: folds
2798beed: folds
f7288b7c: folds
299eef01: folds
Hero: folds
Uncalled bet ($0.05) returned to c01af219
*** SHOWDOWN ***
c01af219 collected $0.1 from pot
*** SUMMARY ***
Total pot $0.1 | Rake $0 | Jackpot $0 | Bingo $0 | Fortune $0
Seat 1: 299eef01 (button) folded before Flop (didn't bet)
Seat 2: Hero (small blind) folded before Flop
Seat 3: c01af219 (big blind) collected ($0.1)
Seat 4: d433a235 folded before Flop (didn't bet)
Seat 5: 2798beed folded before Flop (didn't bet)
Seat 6: f7288b7c folded before Flop (didn't bet)


Poker Hand #RC1316973997: Hold'em No Limit  ($0.05/$0.1) - 2023/02/02 14:25:03
Table 'RushAndCash5129257' 6-max Seat #1 is the button
Seat 1: acc5d169 ($9.85 in chips)
Seat 2: dea4decb ($13.16 in chips)
Seat 3: Hero ($19.08 in chips)
Seat 4: c051ff7b ($8.9 in chips)
Seat 5: 7563cba7 ($28.91 in chips)
Seat 6: d433a235 ($14.27 in chips)
dea4decb: posts small blind $0.05
Hero: posts big blind $0.1
*** HOLE CARDS ***
Dealt to acc5d169 
Dealt to dea4decb 
Dealt to Hero [Th Tc]
Dealt to c051ff7b 
Dealt to 7563cba7 
Dealt to d433a235 
c051ff7b: folds
7563cba7: folds
d433a235: raises $0.1 to $0.2
acc5d169: folds
dea4decb: folds
Hero: raises $0.6 to $0.8
d433a235: calls $0.6
*** FLOP *** [2d 6h 8s]
Hero: bets $0.55
d433a235: raises $1.45 to $2
Hero: folds
Uncalled bet ($1.45) returned to d433a235
d433a235: shows [5h 7h] (Eight-High)
*** SHOWDOWN ***
d433a235 collected $2.62 from pot
*** SUMMARY ***
Total pot $2.75 | Rake $0.13 | Jackpot $0 | Bingo $0 | Fortune $0
Board [2d 6h 8s]
Seat 1: acc5d169 (button) folded before Flop (didn't bet)
Seat 2: dea4decb (small blind) folded before Flop
Seat 3: Hero (big blind) folded on the Flop
Seat 4: c051ff7b folded before Flop (didn't bet)
Seat 5: 7563cba7 folded before Flop (didn't bet)
Seat 6: d433a235 showed [5h 7h] and won ($2.62) with Eight-High


Poker Hand #RC1316973974: Hold'em No Limit  ($0.05/$0.1) - 2023/02/02 14:24:59
Table 'RushAndCash5129234' 6-max Seat #1 is the button
Seat 1: Hero ($19.08 in chips)
Seat 2: 816754c1 ($9.26 in chips)
Seat 3: 196baf24 ($10 in chips)
Seat 4: 4629ad ($10.17 in chips)
Seat 5: 90df046f ($10.28 in chips)
Seat 6: c94b061f ($10.45 in chips)
816754c1: posts small blind $0.05
196baf24: posts big blind $0.1
*** HOLE CARDS ***
Dealt to Hero [7h 5s]
Dealt to 816754c1 
Dealt to 196baf24 
Dealt to 4629ad 
Dealt to 90df046f 
Dealt to c94b061f 
4629ad: folds
90df046f: raises $0.15 to $0.25
c94b061f: folds
Hero: folds
816754c1: folds
196baf24: folds
Uncalled bet ($0.15) returned to 90df046f
*** SHOWDOWN ***
90df046f collected $0.25 from pot
*** SUMMARY ***
Total pot $0.25 | Rake $0 | Jackpot $0 | Bingo $0 | Fortune $0
Seat 1: Hero (button) folded before Flop (didn't bet)
Seat 2: 816754c1 (small blind) folded before Flop
Seat 3: 196baf24 (big blind) folded before Flop
Seat 4: 4629ad folded before Flop (didn't bet)
Seat 5: 90df046f collected ($0.25)
Seat 6: c94b061f folded before Flop (didn't bet)


Poker Hand #RC1316973954: Hold'em No Limit  ($0.05/$0.1) - 2023/02/02 14:24:55
Table 'RushAndCash5129214' 6-max Seat #1 is the button
Seat 1: 84a2c758 ($34.74 in chips)
Seat 2: d2642a4f ($30.69 in chips)
Seat 3: 20cf1b07 ($9.32 in chips)
Seat 4: 9011226 ($16.44 in chips)
Seat 5: Hero ($19.08 in chips)
Seat 6: 9225e909 ($15.99 in chips)
d2642a4f: posts small blind $0.05
20cf1b07: posts big blind $0.1
*** HOLE CARDS ***
Dealt to 84a2c758 
Dealt to d2642a4f 
Dealt to 20cf1b07 
Dealt to 9011226 
Dealt to Hero [Js 4h]
Dealt to 9225e909 
9011226: folds
Hero: folds
9225e909: folds
84a2c758: raises $0.1 to $0.2
d2642a4f: folds
20cf1b07: folds
Uncalled bet ($0.1) returned to 84a2c758
*** SHOWDOWN ***
84a2c758 collected $0.25 from pot
*** SUMMARY ***
Total pot $0.25 | Rake $0 | Jackpot $0 | Bingo $0 | Fortune $0
Seat 1: 84a2c758 (button) collected ($0.25)
Seat 2: d2642a4f (small blind) folded before Flop
Seat 3: 20cf1b07 (big blind) folded before Flop
Seat 4: 9011226 folded before Flop (didn't bet)
Seat 5: Hero folded before Flop (didn't bet)
Seat 6: 9225e909 folded before Flop (didn't bet)


Poker Hand #RC1316973931: Hold'em No Limit  ($0.05/$0.1) - 2023/02/02 14:24:50
Table 'RushAndCash5129191' 6-max Seat #1 is the button
Seat 1: Hero ($19.08 in chips)
Seat 2: f3a5f7ce ($14.53 in chips)
Seat 3: ef486511 ($26.84 in chips)
Seat 4: 550b0936 ($12.87 in chips)
Seat 5: 795d5161 ($19.33 in chips)
Seat 6: 5b7a7c5d ($22.53 in chips)
f3a5f7ce: posts small blind $0.05
ef486511: posts big blind $0.1
*** HOLE CARDS ***
Dealt to Hero [3d 4d]
Dealt to f3a5f7ce 
Dealt to ef486511 
Dealt to 550b0936 
Dealt to 795d5161 
Dealt to 5b7a7c5d 
550b0936: folds
795d5161: raises $0.11 to $0.21
5b7a7c5d: folds
Hero: folds
f3a5f7ce: calls $0.16
ef486511: calls $0.11
*** FLOP *** [Tc 7h Js]
f3a5f7ce: checks
ef486511: checks
795d5161: bets $0.31
f3a5f7ce: calls $0.31
ef486511: folds
*** TURN *** [Tc 7h Js] [Kh]
f3a5f7ce: checks
795d5161: bets $0.8
f3a5f7ce: calls $0.8
*** RIVER *** [Tc 7h Js Kh] [2h]
f3a5f7ce: checks
795d5161: bets $0.95
f3a5f7ce: calls $0.95
795d5161: shows [Qs Ad] (Aces-High Straight)
f3a5f7ce: shows [Qh Ks] (Pair of Kings)
*** SHOWDOWN ***
795d5161 collected $4.37 from pot
*** SUMMARY ***
Total pot $4.75 | Rake $0.23 | Jackpot $0.15 | Bingo $0 | Fortune $0
Board [Tc 7h Js Kh 2h]
Seat 1: Hero (button) folded before Flop (didn't bet)
Seat 2: f3a5f7ce (small blind) showed [Qh Ks] and lost with Pair of Kings
Seat 3: ef486511 (big blind) folded on the Flop
Seat 4: 550b0936 folded before Flop (didn't bet)
Seat 5: 795d5161 showed [Qs Ad] and won ($4.37) with Aces-High Straight
Seat 6: 5b7a7c5d folded before Flop (didn't bet)


Poker Hand #RC1316973904: Hold'em No Limit  ($0.05/$0.1) - 2023/02/02 14:24:44
Table 'RushAndCash5129164' 6-max Seat #1 is the button
Seat 1: 4c103877 ($11.02 in chips)
Seat 2: 984f5587 ($10.05 in chips)
Seat 3: ce5eff63 ($10.4 in chips)
Seat 4: Hero ($19.08 in chips)
Seat 5: 7ec1e2d8 ($10.33 in chips)
Seat 6: 6dc1626d ($10.8 in chips)
984f5587: posts small blind $0.05
ce5eff63: posts big blind $0.1
*** HOLE CARDS ***
Dealt to 4c103877 
Dealt to 984f5587 
Dealt to ce5eff63 
Dealt to Hero [8d Th]
Dealt to 7ec1e2d8 
Dealt to 6dc1626d 
Hero: folds
7ec1e2d8: folds
6dc1626d: folds
4c103877: folds
984f5587: folds
Uncalled bet ($0.05) returned to ce5eff63
*** SHOWDOWN ***
ce5eff63 collected $0.1 from pot
*** SUMMARY ***
Total pot $0.1 | Rake $0 | Jackpot $0 | Bingo $0 | Fortune $0
Seat 1: 4c103877 (button) folded before Flop (didn't bet)
Seat 2: 984f5587 (small blind) folded before Flop
Seat 3: ce5eff63 (big blind) collected ($0.1)
Seat 4: Hero folded before Flop (didn't bet)
Seat 5: 7ec1e2d8 folded before Flop (didn't bet)
Seat 6: 6dc1626d folded before Flop (didn't bet)


Poker Hand #RC1316973505: Hold'em No Limit  ($0.05/$0.1) - 2023/02/02 14:23:20
Table 'RushAndCash5128765' 6-max Seat #1 is the button
Seat 1: 4f2fb9ed ($73.54 in chips)
Seat 2: c8fbcf60 ($8.95 in chips)
Seat 3: Hero ($19.28 in chips)
Seat 4: dc61b47a ($19.91 in chips)
Seat 5: dda3de4d ($10.32 in chips)
Seat 6: ce5eff63 ($11.25 in chips)
c8fbcf60: posts small blind $0.05
Hero: posts big blind $0.1
*** HOLE CARDS ***
Dealt to 4f2fb9ed 
Dealt to c8fbcf60 
Dealt to Hero [Ad Ts]
Dealt to dc61b47a 
Dealt to dda3de4d 
Dealt to ce5eff63 
dc61b47a: folds
dda3de4d: folds
ce5eff63: raises $0.1 to $0.2
4f2fb9ed: calls $0.2
c8fbcf60: folds
Hero: calls $0.1
*** FLOP *** [3c 4h 8h]
Hero: checks
ce5eff63: bets $0.65
4f2fb9ed: calls $0.65
Hero: folds
*** TURN *** [3c 4h 8h] [Jh]
ce5eff63: checks
4f2fb9ed: checks
*** RIVER *** [3c 4h 8h Jh] [Td]
ce5eff63: checks
4f2fb9ed: bets $1.08
ce5eff63: folds
Uncalled bet ($1.08) returned to 4f2fb9ed
*** SHOWDOWN ***
4f2fb9ed collected $1.86 from pot
*** SUMMARY ***
Total pot $1.95 | Rake $0.09 | Jackpot $0 | Bingo $0 | Fortune $0
Board [3c 4h 8h Jh Td]
Seat 1: 4f2fb9ed (button) won ($1.86)
Seat 2: c8fbcf60 (small blind) folded before Flop
Seat 3: Hero (big blind) folded on the Flop
Seat 4: dc61b47a folded before Flop (didn't bet)
Seat 5: dda3de4d folded before Flop (didn't bet)
Seat 6: ce5eff63 folded on the River


Poker Hand #RC1316973483: Hold'em No Limit  ($0.05/$0.1) - 2023/02/02 14:23:16
Table 'RushAndCash5128743' 6-max Seat #1 is the button
Seat 1: 4a573796 ($10.15 in chips)
Seat 2: 7ed16543 ($18.52 in chips)
Seat 3: 210d7130 ($10 in chips)
Seat 4: 2bc400f8 ($32.78 in chips)
Seat 5: Hero ($19.28 in chips)
Seat 6: 95482d10 ($32.35 in chips)
7ed16543: posts small blind $0.05
210d7130: posts big blind $0.1
*** HOLE CARDS ***
Dealt to 4a573796 
Dealt to 7ed16543 
Dealt to 210d7130 
Dealt to 2bc400f8 
Dealt to Hero [2s Ah]
Dealt to 95482d10 
2bc400f8: folds
Hero: folds
95482d10: folds
4a573796: folds
7ed16543: folds
Uncalled bet ($0.05) returned to 210d7130
*** SHOWDOWN ***
210d7130 collected $0.1 from pot
*** SUMMARY ***
Total pot $0.1 | Rake $0 | Jackpot $0 | Bingo $0 | Fortune $0
Seat 1: 4a573796 (button) folded before Flop (didn't bet)
Seat 2: 7ed16543 (small blind) folded before Flop
Seat 3: 210d7130 (big blind) collected ($0.1)
Seat 4: 2bc400f8 folded before Flop (didn't bet)
Seat 5: Hero folded before Flop (didn't bet)
Seat 6: 95482d10 folded before Flop (didn't bet)


Poker Hand #RC1316973459: Hold'em No Limit  ($0.05/$0.1) - 2023/02/02 14:23:12
Table 'RushAndCash5128719' 6-max Seat #1 is the button
Seat 1: d0dab242 ($11.24 in chips)
Seat 2: Hero ($19.33 in chips)
Seat 3: ae06f3ce ($10 in chips)
Seat 4: 70157308 ($10.41 in chips)
Seat 5: 5e77364e ($10.79 in chips)
Seat 6: 97a247ed ($10 in chips)
Hero: posts small blind $0.05
ae06f3ce: posts big blind $0.1
*** HOLE CARDS ***
Dealt to d0dab242 
Dealt to Hero [Td 6c]
Dealt to ae06f3ce 
Dealt to 70157308 
Dealt to 5e77364e 
Dealt to 97a247ed 
70157308: folds
5e77364e: folds
97a247ed: folds
d0dab242: raises $0.15 to $0.25
Hero: folds
ae06f3ce: folds
Uncalled bet ($0.15) returned to d0dab242
*** SHOWDOWN ***
d0dab242 collected $0.25 from pot
*** SUMMARY ***
Total pot $0.25 | Rake $0 | Jackpot $0 | Bingo $0 | Fortune $0
Seat 1: d0dab242 (button) collected ($0.25)
Seat 2: Hero (small blind) folded before Flop
Seat 3: ae06f3ce (big blind) folded before Flop
Seat 4: 70157308 folded before Flop (didn't bet)
Seat 5: 5e77364e folded before Flop (didn't bet)
Seat 6: 97a247ed folded before Flop (didn't bet)


Poker Hand #RC1316973433: Hold'em No Limit  ($0.05/$0.1) - 2023/02/02 14:23:06
Table 'RushAndCash5128693' 6-max Seat #1 is the button
Seat 1: 1dab96e2 ($18.57 in chips)
Seat 2: 342e92a1 ($9.99 in chips)
Seat 3: b435a3ae ($11.45 in chips)
Seat 4: 1d3e8d87 ($19.35 in chips)
Seat 5: Hero ($19.33 in chips)
Seat 6: f959fe17 ($10 in chips)
342e92a1: posts small blind $0.05
b435a3ae: posts big blind $0.1
*** HOLE CARDS ***
Dealt to 1dab96e2 
Dealt to 342e92a1 
Dealt to b435a3ae 
Dealt to 1d3e8d87 
Dealt to Hero [Ac 7h]
Dealt to f959fe17 
1d3e8d87: folds
Hero: folds
f959fe17: folds
1dab96e2: folds
342e92a1: raises $0.2 to $0.3
b435a3ae: calls $0.2
*** FLOP *** [5h 6c 8s]
342e92a1: bets $0.28
b435a3ae: folds
Uncalled bet ($0.28) returned to 342e92a1
*** SHOWDOWN ***
342e92a1 collected $0.57 from pot
*** SUMMARY ***
Total pot $0.6 | Rake $0.03 | Jackpot $0 | Bingo $0 | Fortune $0
Board [5h 6c 8s]
Seat 1: 1dab96e2 (button) folded before Flop (didn't bet)
Seat 2: 342e92a1 (small blind) won ($0.57)
Seat 3: b435a3ae (big blind) folded on the Flop
Seat 4: 1d3e8d87 folded before Flop (didn't bet)
Seat 5: Hero folded before Flop (didn't bet)
Seat 6: f959fe17 folded before Flop (didn't bet)


Poker Hand #RC1316973387: Hold'em No Limit  ($0.05/$0.1) - 2023/02/02 14:22:58
Table 'RushAndCash5128647' 6-max Seat #1 is the button
Seat 1: ef486511 ($25.68 in chips)
Seat 2: Hero ($19.38 in chips)
Seat 3: 8189bd18 ($11.72 in chips)
Seat 4: 9745ffc0 ($10 in chips)
Seat 5: 186e057b ($12.73 in chips)
Seat 6: 4df22a05 ($10.17 in chips)
Hero: posts small blind $0.05
8189bd18: posts big blind $0.1
*** HOLE CARDS ***
Dealt to ef486511 
Dealt to Hero [Ac 9d]
Dealt to 8189bd18 
Dealt to 9745ffc0 
Dealt to 186e057b 
Dealt to 4df22a05 
9745ffc0: folds
186e057b: raises $0.15 to $0.25
4df22a05: raises $0.65 to $0.9
ef486511: raises $1.4 to $2.3
Hero: folds
8189bd18: folds
186e057b: folds
4df22a05: folds
Uncalled bet ($1.4) returned to ef486511
*** SHOWDOWN ***
ef486511 collected $2.09 from pot
*** SUMMARY ***
Total pot $2.2 | Rake $0.11 | Jackpot $0 | Bingo $0 | Fortune $0
Seat 1: ef486511 (button) collected ($2.09)
Seat 2: Hero (small blind) folded before Flop
Seat 3: 8189bd18 (big blind) folded before Flop
Seat 4: 9745ffc0 folded before Flop (didn't bet)
Seat 5: 186e057b folded before Flop
Seat 6: 4df22a05 folded before Flop


Poker Hand #RC1316973321: Hold'em No Limit  ($0.05/$0.1) - 2023/02/02 14:22:45
Table 'RushAndCash5128581' 6-max Seat #1 is the button
Seat 1: Hero ($19.38 in chips)
Seat 2: 8b179012 ($10 in chips)
Seat 3: 9e594eb2 ($25.03 in chips)
Seat 4: 25d551b ($11.75 in chips)
Seat 5: 33efe3f7 ($12.86 in chips)
Seat 6: 9745ffc0 ($10 in chips)
8b179012: posts small blind $0.05
9e594eb2: posts big blind $0.1
*** HOLE CARDS ***
Dealt to Hero [Qs 2s]
Dealt to 8b179012 
Dealt to 9e594eb2 
Dealt to 25d551b 
Dealt to 33efe3f7 
Dealt to 9745ffc0 
25d551b: folds
33efe3f7: raises $0.15 to $0.25
9745ffc0: folds
Hero: folds
8b179012: folds
9e594eb2: folds
Uncalled bet ($0.15) returned to 33efe3f7
*** SHOWDOWN ***
33efe3f7 collected $0.25 from pot
*** SUMMARY ***
Total pot $0.25 | Rake $0 | Jackpot $0 | Bingo $0 | Fortune $0
Seat 1: Hero (button) folded before Flop (didn't bet)
Seat 2: 8b179012 (small blind) folded before Flop
Seat 3: 9e594eb2 (big blind) folded before Flop
Seat 4: 25d551b folded before Flop (didn't bet)
Seat 5: 33efe3f7 collected ($0.25)
Seat 6: 9745ffc0 folded before Flop (didn't bet)


Poker Hand #RC1316973299: Hold'em No Limit  ($0.05/$0.1) - 2023/02/02 14:22:41
Table 'RushAndCash5128559' 6-max Seat #1 is the button
Seat 1: d274add4 ($8.57 in chips)
Seat 2: cb6f9c95 ($10 in chips)
Seat 3: 9b7234f2 ($11.79 in chips)
Seat 4: 95482d10 ($32.45 in chips)
Seat 5: Hero ($19.38 in chips)
Seat 6: da20f38d ($9 in chips)
cb6f9c95: posts small blind $0.05
9b7234f2: posts big blind $0.1
*** HOLE CARDS ***
Dealt to d274add4 
Dealt to cb6f9c95 
Dealt to 9b7234f2 
Dealt to 95482d10 
Dealt to Hero [3c Kh]
Dealt to da20f38d 
95482d10: folds
Hero: folds
da20f38d: raises $0.15 to $0.25
d274add4: raises $0.65 to $0.9
cb6f9c95: folds
9b7234f2: folds
da20f38d: folds
Uncalled bet ($0.65) returned to d274add4
*** SHOWDOWN ***
d274add4 collected $0.62 from pot
*** SUMMARY ***
Total pot $0.65 | Rake $0.03 | Jackpot $0 | Bingo $0 | Fortune $0
Seat 1: d274add4 (button) collected ($0.62)
Seat 2: cb6f9c95 (small blind) folded before Flop
Seat 3: 9b7234f2 (big blind) folded before Flop
Seat 4: 95482d10 folded before Flop (didn't bet)
Seat 5: Hero folded before Flop (didn't bet)
Seat 6: da20f38d folded before Flop


Poker Hand #RC1316973282: Hold'em No Limit  ($0.05/$0.1) - 2023/02/02 14:22:36
Table 'RushAndCash5128542' 6-max Seat #1 is the button
Seat 1: 7476e663 ($10.63 in chips)
Seat 2: 4df22a05 ($10.07 in chips)
Seat 3: 8eb66f4e ($10.76 in chips)
Seat 4: Hero ($19.38 in chips)
Seat 5: b19d0d06 ($10.27 in chips)
Seat 6: 2ff998a5 ($19.57 in chips)
4df22a05: posts small blind $0.05
8eb66f4e: posts big blind $0.1
*** HOLE CARDS ***
Dealt to 7476e663 
Dealt to 4df22a05 
Dealt to 8eb66f4e 
Dealt to Hero [9c 7h]
Dealt to b19d0d06 
Dealt to 2ff998a5 
Hero: folds
b19d0d06: folds
2ff998a5: raises $0.15 to $0.25
7476e663: raises $0.45 to $0.7
4df22a05: folds
8eb66f4e: folds
2ff998a5: calls $0.45
*** FLOP *** [9d Kc Js]
2ff998a5: checks
7476e663: bets $0.52
2ff998a5: calls $0.52
*** TURN *** [9d Kc Js] [6h]
2ff998a5: checks
7476e663: bets $1.3
2ff998a5: folds
Uncalled bet ($1.3) returned to 7476e663
*** SHOWDOWN ***
7476e663 collected $2.46 from pot
*** SUMMARY ***
Total pot $2.59 | Rake $0.13 | Jackpot $0 | Bingo $0 | Fortune $0
Board [9d Kc Js 6h]
Seat 1: 7476e663 (button) won ($2.46)
Seat 2: 4df22a05 (small blind) folded before Flop
Seat 3: 8eb66f4e (big blind) folded before Flop
Seat 4: Hero folded before Flop (didn't bet)
Seat 5: b19d0d06 folded before Flop (didn't bet)
Seat 6: 2ff998a5 folded on the Turn


Poker Hand #RC1316973249: Hold'em No Limit  ($0.05/$0.1) - 2023/02/02 14:22:29
Table 'RushAndCash5128509' 6-max Seat #1 is the button
Seat 1: 94298a61 ($9.11 in chips)
Seat 2: 11d84950 ($13.8 in chips)
Seat 3: 581609fc ($10.64 in chips)
Seat 4: Hero ($19.38 in chips)
Seat 5: a9a3ee5d ($12.66 in chips)
Seat 6: 6a206b7e ($10.48 in chips)
11d84950: posts small blind $0.05
581609fc: posts big blind $0.1
*** HOLE CARDS ***
Dealt to 94298a61 
Dealt to 11d84950 
Dealt to 581609fc 
Dealt to Hero [3d 9s]
Dealt to a9a3ee5d 
Dealt to 6a206b7e 
Hero: folds
a9a3ee5d: folds
6a206b7e: folds
94298a61: folds
11d84950: raises $0.2 to $0.3
581609fc: folds
Uncalled bet ($0.2) returned to 11d84950
*** SHOWDOWN ***
11d84950 collected $0.2 from pot
*** SUMMARY ***
Total pot $0.2 | Rake $0 | Jackpot $0 | Bingo $0 | Fortune $0
Seat 1: 94298a61 (button) folded before Flop (didn't bet)
Seat 2: 11d84950 (small blind) collected ($0.2)
Seat 3: 581609fc (big blind) folded before Flop
Seat 4: Hero folded before Flop (didn't bet)
Seat 5: a9a3ee5d folded before Flop (didn't bet)
Seat 6: 6a206b7e folded before Flop (didn't bet)


Poker Hand #RC1316973229: Hold'em No Limit  ($0.05/$0.1) - 2023/02/02 14:22:24
Table 'RushAndCash5128489' 6-max Seat #1 is the button
Seat 1: Hero ($19.38 in chips)
Seat 2: 1beb42 ($4 in chips)
Seat 3: 8d56d7e5 ($11.75 in chips)
Seat 4: f6606457 ($11.38 in chips)
Seat 5: abe55004 ($23.01 in chips)
Seat 6: a350fe66 ($10.43 in chips)
1beb42: posts small blind $0.05
8d56d7e5: posts big blind $0.1
*** HOLE CARDS ***
Dealt to Hero [4c 7c]
Dealt to 1beb42 
Dealt to 8d56d7e5 
Dealt to f6606457 
Dealt to abe55004 
Dealt to a350fe66 
f6606457: folds
abe55004: raises $0.15 to $0.25
a350fe66: folds
Hero: folds
1beb42: folds
8d56d7e5: folds
Uncalled bet ($0.15) returned to abe55004
*** SHOWDOWN ***
abe55004 collected $0.25 from pot
*** SUMMARY ***
Total pot $0.25 | Rake $0 | Jackpot $0 | Bingo $0 | Fortune $0
Seat 1: Hero (button) folded before Flop (didn't bet)
Seat 2: 1beb42 (small blind) folded before Flop
Seat 3: 8d56d7e5 (big blind) folded before Flop
Seat 4: f6606457 folded before Flop (didn't bet)
Seat 5: abe55004 collected ($0.25)
Seat 6: a350fe66 folded before Flop (didn't bet)


Poker Hand #RC1316973164: Hold'em No Limit  ($0.05/$0.1) - 2023/02/02 14:22:13
Table 'RushAndCash5128424' 6-max Seat #1 is the button
Seat 1: 20cf1b07 ($9.95 in chips)
Seat 2: dc61b47a ($22.96 in chips)
Seat 3: Hero ($19.48 in chips)
Seat 4: 22c2a83c ($22.22 in chips)
Seat 5: 7e265af5 ($9.6 in chips)
Seat 6: 57c17a65 ($29.87 in chips)
dc61b47a: posts small blind $0.05
Hero: posts big blind $0.1
*** HOLE CARDS ***
Dealt to 20cf1b07 
Dealt to dc61b47a 
Dealt to Hero [2h Ad]
Dealt to 22c2a83c 
Dealt to 7e265af5 
Dealt to 57c17a65 
22c2a83c: folds
7e265af5: raises $0.2 to $0.3
57c17a65: folds
20cf1b07: folds
dc61b47a: folds
Hero: folds
Uncalled bet ($0.2) returned to 7e265af5
*** SHOWDOWN ***
7e265af5 collected $0.25 from pot
*** SUMMARY ***
Total pot $0.25 | Rake $0 | Jackpot $0 | Bingo $0 | Fortune $0
Seat 1: 20cf1b07 (button) folded before Flop (didn't bet)
Seat 2: dc61b47a (small blind) folded before Flop
Seat 3: Hero (big blind) folded before Flop
Seat 4: 22c2a83c folded before Flop (didn't bet)
Seat 5: 7e265af5 collected ($0.25)
Seat 6: 57c17a65 folded before Flop (didn't bet)


Poker Hand #RC1316973121: Hold'em No Limit  ($0.05/$0.1) - 2023/02/02 14:22:04
Table 'RushAndCash5128381' 6-max Seat #1 is the button
Seat 1: 6dc1626d ($10.15 in chips)
Seat 2: 54e91b44 ($15.26 in chips)
Seat 3: d433a235 ($14.97 in chips)
Seat 4: f6606457 ($11.53 in chips)
Seat 5: 40c04b68 ($10.75 in chips)
Seat 6: Hero ($19.48 in chips)
54e91b44: posts small blind $0.05
d433a235: posts big blind $0.1
*** HOLE CARDS ***
Dealt to 6dc1626d 
Dealt to 54e91b44 
Dealt to d433a235 
Dealt to f6606457 
Dealt to 40c04b68 
Dealt to Hero [6s 9c]
f6606457: folds
40c04b68: folds
Hero: folds
6dc1626d: raises $0.1 to $0.2
54e91b44: folds
d433a235: calls $0.1
*** FLOP *** [3s 2s 6h]
d433a235: checks
6dc1626d: bets $0.16
d433a235: folds
Uncalled bet ($0.16) returned to 6dc1626d
*** SHOWDOWN ***
6dc1626d collected $0.43 from pot
*** SUMMARY ***
Total pot $0.45 | Rake $0.02 | Jackpot $0 | Bingo $0 | Fortune $0
Board [3s 2s 6h]
Seat 1: 6dc1626d (button) won ($0.43)
Seat 2: 54e91b44 (small blind) folded before Flop
Seat 3: d433a235 (big blind) folded on the Flop
Seat 4: f6606457 folded before Flop (didn't bet)
Seat 5: 40c04b68 folded before Flop (didn't bet)
Seat 6: Hero folded before Flop (didn't bet)


Poker Hand #RC1316973037: Hold'em No Limit  ($0.05/$0.1) - 2023/02/02 14:21:47
Table 'RushAndCash5128297' 6-max Seat #1 is the button
Seat 1: d51969cd ($9.88 in chips)
Seat 2: Hero ($19.53 in chips)
Seat 3: 59bf16ec ($8.06 in chips)
Seat 4: d433a235 ($14.97 in chips)
Seat 5: c33bc2cc ($11.81 in chips)
Seat 6: fa9f76ef ($10 in chips)
Hero: posts small blind $0.05
59bf16ec: posts big blind $0.1
*** HOLE CARDS ***
Dealt to d51969cd 
Dealt to Hero [Kd 6s]
Dealt to 59bf16ec 
Dealt to d433a235 
Dealt to c33bc2cc 
Dealt to fa9f76ef 
d433a235: folds
c33bc2cc: raises $0.14 to $0.24
fa9f76ef: raises $0.56 to $0.8
d51969cd: folds
Hero: folds
59bf16ec: folds
c33bc2cc: calls $0.56
*** FLOP *** [Jh Jc 5d]
c33bc2cc: checks
fa9f76ef: checks
*** TURN *** [Jh Jc 5d] [Th]
c33bc2cc: checks
fa9f76ef: bets $1.26
c33bc2cc: folds
Uncalled bet ($1.26) returned to fa9f76ef
*** SHOWDOWN ***
fa9f76ef collected $1.67 from pot
*** SUMMARY ***
Total pot $1.75 | Rake $0.08 | Jackpot $0 | Bingo $0 | Fortune $0
Board [Jh Jc 5d Th]
Seat 1: d51969cd (button) folded before Flop (didn't bet)
Seat 2: Hero (small blind) folded before Flop
Seat 3: 59bf16ec (big blind) folded before Flop
Seat 4: d433a235 folded before Flop (didn't bet)
Seat 5: c33bc2cc folded on the Turn
Seat 6: fa9f76ef won ($1.67)


Poker Hand #RC1316972701: Hold'em No Limit  ($0.05/$0.1) - 2023/02/02 14:20:43
Table 'RushAndCash5127961' 6-max Seat #1 is the button
Seat 1: de55a96b ($22.09 in chips)
Seat 2: c33bc2cc ($11.3 in chips)
Seat 3: Hero ($20.09 in chips)
Seat 4: c4b8ef0c ($17.73 in chips)
Seat 5: 4b955da1 ($20.78 in chips)
Seat 6: 44aa8ff7 ($9.85 in chips)
c33bc2cc: posts small blind $0.05
Hero: posts big blind $0.1
*** HOLE CARDS ***
Dealt to de55a96b 
Dealt to c33bc2cc 
Dealt to Hero [8s Qh]
Dealt to c4b8ef0c 
Dealt to 4b955da1 
Dealt to 44aa8ff7 
c4b8ef0c: folds
4b955da1: folds
44aa8ff7: folds
de55a96b: folds
c33bc2cc: raises $0.14 to $0.24
Hero: calls $0.14
*** FLOP *** [Qs Th 9h]
c33bc2cc: bets $0.32
Hero: calls $0.32
*** TURN *** [Qs Th 9h] [3c]
c33bc2cc: bets $0.73
Hero: folds
Uncalled bet ($0.73) returned to c33bc2cc
*** SHOWDOWN ***
c33bc2cc collected $1.07 from pot
*** SUMMARY ***
Total pot $1.12 | Rake $0.05 | Jackpot $0 | Bingo $0 | Fortune $0
Board [Qs Th 9h 3c]
Seat 1: de55a96b (button) folded before Flop (didn't bet)
Seat 2: c33bc2cc (small blind) won ($1.07)
Seat 3: Hero (big blind) folded on the Turn
Seat 4: c4b8ef0c folded before Flop (didn't bet)
Seat 5: 4b955da1 folded before Flop (didn't bet)
Seat 6: 44aa8ff7 folded before Flop (didn't bet)


Poker Hand #RC1316972609: Hold'em No Limit  ($0.05/$0.1) - 2023/02/02 14:20:26
Table 'RushAndCash5127869' 6-max Seat #1 is the button
Seat 1: 495966e4 ($9.43 in chips)
Seat 2: ae06f3ce ($10 in chips)
Seat 3: 4c103877 ($10 in chips)
Seat 4: 48451ad4 ($22.08 in chips)
Seat 5: 8d56d7e5 ($10.79 in chips)
Seat 6: Hero ($19.94 in chips)
ae06f3ce: posts small blind $0.05
4c103877: posts big blind $0.1
*** HOLE CARDS ***
Dealt to 495966e4 
Dealt to ae06f3ce 
Dealt to 4c103877 
Dealt to 48451ad4 
Dealt to 8d56d7e5 
Dealt to Hero [9c Qc]
48451ad4: folds
8d56d7e5: folds
Hero: raises $0.15 to $0.25
495966e4: folds
ae06f3ce: folds
4c103877: folds
Uncalled bet ($0.15) returned to Hero
*** SHOWDOWN ***
Hero collected $0.25 from pot
*** SUMMARY ***
Total pot $0.25 | Rake $0 | Jackpot $0 | Bingo $0 | Fortune $0
Seat 1: 495966e4 (button) folded before Flop (didn't bet)
Seat 2: ae06f3ce (small blind) folded before Flop
Seat 3: 4c103877 (big blind) folded before Flop
Seat 4: 48451ad4 folded before Flop (didn't bet)
Seat 5: 8d56d7e5 folded before Flop (didn't bet)
Seat 6: Hero collected ($0.25)


Poker Hand #RC1316972581: Hold'em No Limit  ($0.05/$0.1) - 2023/02/02 14:20:21
Table 'RushAndCash5127841' 6-max Seat #1 is the button
Seat 1: b19d0d06 ($13.25 in chips)
Seat 2: 572f93bc ($11.62 in chips)
Seat 3: c69a3d90 ($10 in chips)
Seat 4: fe2dec61 ($14.05 in chips)
Seat 5: 5ee1e2f2 ($35.01 in chips)
Seat 6: Hero ($19.94 in chips)
572f93bc: posts small blind $0.05
c69a3d90: posts big blind $0.1
*** HOLE CARDS ***
Dealt to b19d0d06 
Dealt to 572f93bc 
Dealt to c69a3d90 
Dealt to fe2dec61 
Dealt to 5ee1e2f2 
Dealt to Hero [4c Js]
fe2dec61: folds
5ee1e2f2: folds
Hero: folds
b19d0d06: raises $0.15 to $0.25
572f93bc: folds
c69a3d90: calls $0.15
*** FLOP *** [Ks Qc 8d]
c69a3d90: checks
b19d0d06: bets $0.31
c69a3d90: folds
Uncalled bet ($0.31) returned to b19d0d06
*** SHOWDOWN ***
b19d0d06 collected $0.53 from pot
*** SUMMARY ***
Total pot $0.55 | Rake $0.02 | Jackpot $0 | Bingo $0 | Fortune $0
Board [Ks Qc 8d]
Seat 1: b19d0d06 (button) won ($0.53)
Seat 2: 572f93bc (small blind) folded before Flop
Seat 3: c69a3d90 (big blind) folded on the Flop
Seat 4: fe2dec61 folded before Flop (didn't bet)
Seat 5: 5ee1e2f2 folded before Flop (didn't bet)
Seat 6: Hero folded before Flop (didn't bet)


Poker Hand #RC1316971158: Hold'em No Limit  ($0.05/$0.1) - 2023/02/02 14:15:45
Table 'RushAndCash5126418' 6-max Seat #1 is the button
Seat 1: 3e4899ff ($24.69 in chips)
Seat 2: 9ce8cf5d ($12.68 in chips)
Seat 3: b959cff5 ($12.04 in chips)
Seat 4: ab813cc1 ($20.5 in chips)
Seat 5: Hero ($19.94 in chips)
Seat 6: 6eab5fda ($10 in chips)
9ce8cf5d: posts small blind $0.05
b959cff5: posts big blind $0.1
*** HOLE CARDS ***
Dealt to 3e4899ff 
Dealt to 9ce8cf5d 
Dealt to b959cff5 
Dealt to ab813cc1 
Dealt to Hero [9c 3s]
Dealt to 6eab5fda 
ab813cc1: folds
Hero: folds
6eab5fda: folds
3e4899ff: folds
9ce8cf5d: folds
Uncalled bet ($0.05) returned to b959cff5
*** SHOWDOWN ***
b959cff5 collected $0.1 from pot
*** SUMMARY ***
Total pot $0.1 | Rake $0 | Jackpot $0 | Bingo $0 | Fortune $0
Seat 1: 3e4899ff (button) folded before Flop (didn't bet)
Seat 2: 9ce8cf5d (small blind) folded before Flop
Seat 3: b959cff5 (big blind) collected ($0.1)
Seat 4: ab813cc1 folded before Flop (didn't bet)
Seat 5: Hero folded before Flop (didn't bet)
Seat 6: 6eab5fda folded before Flop (didn't bet)


Poker Hand #RC1316971075: Hold'em No Limit  ($0.05/$0.1) - 2023/02/02 14:15:30
Table 'RushAndCash5126335' 6-max Seat #1 is the button
Seat 1: a600769a ($10 in chips)
Seat 2: c8896c28 ($10 in chips)
Seat 3: 33efe3f7 ($8.53 in chips)
Seat 4: Hero ($19.94 in chips)
Seat 5: 342e92a1 ($9.15 in chips)
Seat 6: a45956ba ($16.67 in chips)
c8896c28: posts small blind $0.05
33efe3f7: posts big blind $0.1
*** HOLE CARDS ***
Dealt to a600769a 
Dealt to c8896c28 
Dealt to 33efe3f7 
Dealt to Hero [7c 5s]
Dealt to 342e92a1 
Dealt to a45956ba 
Hero: folds
342e92a1: folds
a45956ba: raises $0.2 to $0.3
a600769a: folds
c8896c28: raises $0.9 to $1.2
33efe3f7: folds
a45956ba: calls $0.9
*** FLOP *** [Th Kc Tc]
c8896c28: bets $0.83
a45956ba: calls $0.83
*** TURN *** [Th Kc Tc] [Jc]
c8896c28: bets $1.38
a45956ba: folds
Uncalled bet ($1.38) returned to c8896c28
*** SHOWDOWN ***
c8896c28 collected $3.81 from pot
*** SUMMARY ***
Total pot $4.16 | Rake $0.2 | Jackpot $0.15 | Bingo $0 | Fortune $0
Board [Th Kc Tc Jc]
Seat 1: a600769a (button) folded before Flop (didn't bet)
Seat 2: c8896c28 (small blind) won ($3.81)
Seat 3: 33efe3f7 (big blind) folded before Flop
Seat 4: Hero folded before Flop (didn't bet)
Seat 5: 342e92a1 folded before Flop (didn't bet)
Seat 6: a45956ba folded on the Turn


Poker Hand #RC1316970643: Hold'em No Limit  ($0.05/$0.1) - 2023/02/02 14:14:12
Table 'RushAndCash5125903' 6-max Seat #1 is the button
Seat 1: ac6f2c30 ($9.74 in chips)
Seat 2: Hero ($11.56 in chips)
Seat 3: 7f130f74 ($28.55 in chips)
Seat 4: a1f8a9e6 ($5 in chips)
Seat 5: 4cdea9eb ($27.9 in chips)
Seat 6: e9d4fb38 ($8.73 in chips)
Hero: posts small blind $0.05
7f130f74: posts big blind $0.1
*** HOLE CARDS ***
Dealt to ac6f2c30 
Dealt to Hero [Td Tc]
Dealt to 7f130f74 
Dealt to a1f8a9e6 
Dealt to 4cdea9eb 
Dealt to e9d4fb38 
a1f8a9e6: folds
4cdea9eb: folds
e9d4fb38: raises $0.2 to $0.3
ac6f2c30: folds
Hero: raises $0.9 to $1.2
7f130f74: folds
e9d4fb38: calls $0.9
*** FLOP *** [7h 9d 8d]
Hero: checks
e9d4fb38: checks
*** TURN *** [7h 9d 8d] [4d]
Hero: bets $1.25
e9d4fb38: calls $1.25
*** RIVER *** [7h 9d 8d 4d] [5s]
Hero: bets $1.65
e9d4fb38: raises $4.63 to $6.28 and is all-in
Hero: calls $4.63
e9d4fb38: shows [Jd Kh] (King-High)
Hero: shows [Td Tc] (Pair of Tens)
*** SHOWDOWN ***
Hero collected $17.11 from pot
*** SUMMARY ***
Total pot $17.56 | Rake $0.3 | Jackpot $0.15 | Bingo $0 | Fortune $0
Board [7h 9d 8d 4d 5s]
Seat 1: ac6f2c30 (button) folded before Flop (didn't bet)
Seat 2: Hero (small blind) showed [Td Tc] and won ($17.11) with Pair of Tens
Seat 3: 7f130f74 (big blind) folded before Flop
Seat 4: a1f8a9e6 folded before Flop (didn't bet)
Seat 5: 4cdea9eb folded before Flop (didn't bet)
Seat 6: e9d4fb38 showed [Jd Kh] and lost with King-High


Poker Hand #RC1316970620: Hold'em No Limit  ($0.05/$0.1) - 2023/02/02 14:14:08
Table 'RushAndCash5125880' 6-max Seat #1 is the button
Seat 1: c5ca61d4 ($11.32 in chips)
Seat 2: be4c3689 ($10 in chips)
Seat 3: Hero ($11.66 in chips)
Seat 4: 264fd48e ($12.39 in chips)
Seat 5: 1ac652fb ($10 in chips)
Seat 6: e4437eee ($34.25 in chips)
be4c3689: posts small blind $0.05
Hero: posts big blind $0.1
*** HOLE CARDS ***
Dealt to c5ca61d4 
Dealt to be4c3689 
Dealt to Hero [7d 2h]
Dealt to 264fd48e 
Dealt to 1ac652fb 
Dealt to e4437eee 
264fd48e: raises $0.15 to $0.25
1ac652fb: folds
e4437eee: folds
c5ca61d4: folds
be4c3689: folds
Hero: folds
Uncalled bet ($0.15) returned to 264fd48e
*** SHOWDOWN ***
264fd48e collected $0.25 from pot
*** SUMMARY ***
Total pot $0.25 | Rake $0 | Jackpot $0 | Bingo $0 | Fortune $0
Seat 1: c5ca61d4 (button) folded before Flop (didn't bet)
Seat 2: be4c3689 (small blind) folded before Flop
Seat 3: Hero (big blind) folded before Flop
Seat 4: 264fd48e collected ($0.25)
Seat 5: 1ac652fb folded before Flop (didn't bet)
Seat 6: e4437eee folded before Flop (didn't bet)


Poker Hand #RC1316970597: Hold'em No Limit  ($0.05/$0.1) - 2023/02/02 14:14:04
Table 'RushAndCash5125857' 6-max Seat #1 is the button
Seat 1: bc9f93b5 ($11.3 in chips)
Seat 2: ec1168a1 ($10.45 in chips)
Seat 3: 2e79ae04 ($16.32 in chips)
Seat 4: 35dc0748 ($15.75 in chips)
Seat 5: Hero ($11.66 in chips)
Seat 6: adc92ac2 ($12.69 in chips)
ec1168a1: posts small blind $0.05
2e79ae04: posts big blind $0.1
*** HOLE CARDS ***
Dealt to bc9f93b5 
Dealt to ec1168a1 
Dealt to 2e79ae04 
Dealt to 35dc0748 
Dealt to Hero [Th 7c]
Dealt to adc92ac2 
35dc0748: folds
Hero: folds
adc92ac2: folds
bc9f93b5: folds
ec1168a1: folds
Uncalled bet ($0.05) returned to 2e79ae04
*** SHOWDOWN ***
2e79ae04 collected $0.1 from pot
*** SUMMARY ***
Total pot $0.1 | Rake $0 | Jackpot $0 | Bingo $0 | Fortune $0
Seat 1: bc9f93b5 (button) folded before Flop (didn't bet)
Seat 2: ec1168a1 (small blind) folded before Flop
Seat 3: 2e79ae04 (big blind) collected ($0.1)
Seat 4: 35dc0748 folded before Flop (didn't bet)
Seat 5: Hero folded before Flop (didn't bet)
Seat 6: adc92ac2 folded before Flop (didn't bet)


Poker Hand #RC1316970573: Hold'em No Limit  ($0.05/$0.1) - 2023/02/02 14:14:00
Table 'RushAndCash5125833' 6-max Seat #1 is the button
Seat 1: b6f0c91f ($11.43 in chips)
Seat 2: 572cd94 ($26.49 in chips)
Seat 3: 2c7d4ccb ($18.21 in chips)
Seat 4: 18c2b034 ($10.88 in chips)
Seat 5: fe2dec61 ($11.89 in chips)
Seat 6: Hero ($11.66 in chips)
572cd94: posts small blind $0.05
2c7d4ccb: posts big blind $0.1
*** HOLE CARDS ***
Dealt to b6f0c91f 
Dealt to 572cd94 
Dealt to 2c7d4ccb 
Dealt to 18c2b034 
Dealt to fe2dec61 
Dealt to Hero [Qd 2d]
18c2b034: folds
fe2dec61: folds
Hero: folds
b6f0c91f: folds
572cd94: raises $0.2 to $0.3
2c7d4ccb: calls $0.2
*** FLOP *** [Ks Th 6c]
572cd94: bets $0.2
2c7d4ccb: calls $0.2
*** TURN *** [Ks Th 6c] [8c]
572cd94: checks
2c7d4ccb: checks
*** RIVER *** [Ks Th 6c 8c] [Qh]
572cd94: checks
2c7d4ccb: bets $0.5
572cd94: folds
Uncalled bet ($0.5) returned to 2c7d4ccb
*** SHOWDOWN ***
2c7d4ccb collected $0.95 from pot
*** SUMMARY ***
Total pot $1 | Rake $0.05 | Jackpot $0 | Bingo $0 | Fortune $0
Board [Ks Th 6c 8c Qh]
Seat 1: b6f0c91f (button) folded before Flop (didn't bet)
Seat 2: 572cd94 (small blind) folded on the River
Seat 3: 2c7d4ccb (big blind) won ($0.95)
Seat 4: 18c2b034 folded before Flop (didn't bet)
Seat 5: fe2dec61 folded before Flop (didn't bet)
Seat 6: Hero folded before Flop (didn't bet)


Poker Hand #RC1316970537: Hold'em No Limit  ($0.05/$0.1) - 2023/02/02 14:13:54
Table 'RushAndCash5125797' 6-max Seat #1 is the button
Seat 1: Hero ($11.66 in chips)
Seat 2: c8896c28 ($10 in chips)
Seat 3: 769ced75 ($10 in chips)
Seat 4: ef486511 ($20.32 in chips)
Seat 5: 6e45b603 ($19.42 in chips)
Seat 6: dda3de4d ($11.88 in chips)
c8896c28: posts small blind $0.05
769ced75: posts big blind $0.1
*** HOLE CARDS ***
Dealt to Hero [2d 4s]
Dealt to c8896c28 
Dealt to 769ced75 
Dealt to ef486511 
Dealt to 6e45b603 
Dealt to dda3de4d 
ef486511: folds
6e45b603: folds
dda3de4d: raises $0.2 to $0.3
Hero: folds
c8896c28: raises $1 to $1.3
769ced75: folds
dda3de4d: folds
Uncalled bet ($1) returned to c8896c28
*** SHOWDOWN ***
c8896c28 collected $0.67 from pot
*** SUMMARY ***
Total pot $0.7 | Rake $0.03 | Jackpot $0 | Bingo $0 | Fortune $0
Seat 1: Hero (button) folded before Flop (didn't bet)
Seat 2: c8896c28 (small blind) collected ($0.67)
Seat 3: 769ced75 (big blind) folded before Flop
Seat 4: ef486511 folded before Flop (didn't bet)
Seat 5: 6e45b603 folded before Flop (didn't bet)
Seat 6: dda3de4d folded before Flop


Poker Hand #RC1316970271: Hold'em No Limit  ($0.05/$0.1) - 2023/02/02 14:13:07
Table 'RushAndCash5125531' 6-max Seat #1 is the button
Seat 1: 6e45b603 ($19.77 in chips)
Seat 2: d17cb4b0 ($29.18 in chips)
Seat 3: c2f0f90f ($5.28 in chips)
Seat 4: Hero ($11.2 in chips)
Seat 5: 2f826a19 ($16.03 in chips)
Seat 6: c69a3d90 ($10.23 in chips)
d17cb4b0: posts small blind $0.05
c2f0f90f: posts big blind $0.1
*** HOLE CARDS ***
Dealt to 6e45b603 
Dealt to d17cb4b0 
Dealt to c2f0f90f 
Dealt to Hero [Qd As]
Dealt to 2f826a19 
Dealt to c69a3d90 
Hero: raises $0.15 to $0.25
2f826a19: folds
c69a3d90: folds
6e45b603: calls $0.25
d17cb4b0: folds
c2f0f90f: folds
*** FLOP *** [Ks 8s 9d]
Hero: bets $0.1
6e45b603: calls $0.1
*** TURN *** [Ks 8s 9d] [3c]
Hero: checks
6e45b603: checks
*** RIVER *** [Ks 8s 9d 3c] [Qh]
Hero: bets $0.15
6e45b603: folds
Uncalled bet ($0.15) returned to Hero
*** SHOWDOWN ***
Hero collected $0.81 from pot
*** SUMMARY ***
Total pot $0.85 | Rake $0.04 | Jackpot $0 | Bingo $0 | Fortune $0
Board [Ks 8s 9d 3c Qh]
Seat 1: 6e45b603 (button) folded on the River
Seat 2: d17cb4b0 (small blind) folded before Flop
Seat 3: c2f0f90f (big blind) folded before Flop
Seat 4: Hero won ($0.81)
Seat 5: 2f826a19 folded before Flop (didn't bet)
Seat 6: c69a3d90 folded before Flop (didn't bet)


Poker Hand #RC1316970248: Hold'em No Limit  ($0.05/$0.1) - 2023/02/02 14:13:03
Table 'RushAndCash5125508' 6-max Seat #1 is the button
Seat 1: dc860c57 ($20.01 in chips)
Seat 2: Hero ($11.25 in chips)
Seat 3: d618215d ($10.2 in chips)
Seat 4: ce5eff63 ($12.02 in chips)
Seat 5: 2a5867f9 ($10.15 in chips)
Seat 6: d17cb4b0 ($29.18 in chips)
Hero: posts small blind $0.05
d618215d: posts big blind $0.1
*** HOLE CARDS ***
Dealt to dc860c57 
Dealt to Hero [6c Th]
Dealt to d618215d 
Dealt to ce5eff63 
Dealt to 2a5867f9 
Dealt to d17cb4b0 
ce5eff63: folds
2a5867f9: raises $0.15 to $0.25
d17cb4b0: folds
dc860c57: folds
Hero: folds
d618215d: folds
Uncalled bet ($0.15) returned to 2a5867f9
*** SHOWDOWN ***
2a5867f9 collected $0.25 from pot
*** SUMMARY ***
Total pot $0.25 | Rake $0 | Jackpot $0 | Bingo $0 | Fortune $0
Seat 1: dc860c57 (button) folded before Flop (didn't bet)
Seat 2: Hero (small blind) folded before Flop
Seat 3: d618215d (big blind) folded before Flop
Seat 4: ce5eff63 folded before Flop (didn't bet)
Seat 5: 2a5867f9 collected ($0.25)
Seat 6: d17cb4b0 folded before Flop (didn't bet)


Poker Hand #RC1316970227: Hold'em No Limit  ($0.05/$0.1) - 2023/02/02 14:12:59
Table 'RushAndCash5125487' 6-max Seat #1 is the button
Seat 1: c3329338 ($11.25 in chips)
Seat 2: 297006d8 ($11.26 in chips)
Seat 3: 611e0890 ($10 in chips)
Seat 4: Hero ($11.25 in chips)
Seat 5: cb873d5a ($9.13 in chips)
Seat 6: 7476e663 ($10.97 in chips)
297006d8: posts small blind $0.05
611e0890: posts big blind $0.1
*** HOLE CARDS ***
Dealt to c3329338 
Dealt to 297006d8 
Dealt to 611e0890 
Dealt to Hero [Jh 7s]
Dealt to cb873d5a 
Dealt to 7476e663 
Hero: folds
cb873d5a: folds
7476e663: raises $0.15 to $0.25
c3329338: folds
297006d8: folds
611e0890: folds
Uncalled bet ($0.15) returned to 7476e663
*** SHOWDOWN ***
7476e663 collected $0.25 from pot
*** SUMMARY ***
Total pot $0.25 | Rake $0 | Jackpot $0 | Bingo $0 | Fortune $0
Seat 1: c3329338 (button) folded before Flop (didn't bet)
Seat 2: 297006d8 (small blind) folded before Flop
Seat 3: 611e0890 (big blind) folded before Flop
Seat 4: Hero folded before Flop (didn't bet)
Seat 5: cb873d5a folded before Flop (didn't bet)
Seat 6: 7476e663 collected ($0.25)


Poker Hand #RC1316970181: Hold'em No Limit  ($0.05/$0.1) - 2023/02/02 14:12:51
Table 'RushAndCash5125441' 6-max Seat #1 is the button
Seat 1: a672d5d2 ($11.28 in chips)
Seat 2: 1ac652fb ($11.14 in chips)
Seat 3: Hero ($11.35 in chips)
Seat 4: c2f0f90f ($5.28 in chips)
Seat 5: 1d98175 ($15.22 in chips)
Seat 6: ba78ff20 ($13.65 in chips)
1ac652fb: posts small blind $0.05
Hero: posts big blind $0.1
*** HOLE CARDS ***
Dealt to a672d5d2 
Dealt to 1ac652fb 
Dealt to Hero [Kc Td]
Dealt to c2f0f90f 
Dealt to 1d98175 
Dealt to ba78ff20 
c2f0f90f: folds
1d98175: raises $0.16 to $0.26
ba78ff20: folds
a672d5d2: folds
1ac652fb: folds
Hero: folds
Uncalled bet ($0.16) returned to 1d98175
*** SHOWDOWN ***
1d98175 collected $0.25 from pot
*** SUMMARY ***
Total pot $0.25 | Rake $0 | Jackpot $0 | Bingo $0 | Fortune $0
Seat 1: a672d5d2 (button) folded before Flop (didn't bet)
Seat 2: 1ac652fb (small blind) folded before Flop
Seat 3: Hero (big blind) folded before Flop
Seat 4: c2f0f90f folded before Flop (didn't bet)
Seat 5: 1d98175 collected ($0.25)
Seat 6: ba78ff20 folded before Flop (didn't bet)


Poker Hand #RC1316970154: Hold'em No Limit  ($0.05/$0.1) - 2023/02/02 14:12:47
Table 'RushAndCash5125414' 6-max Seat #1 is the button
Seat 1: Hero ($11.35 in chips)
Seat 2: f6606457 ($10.07 in chips)
Seat 3: ceac471a ($19.41 in chips)
Seat 4: 4bd70137 ($14.82 in chips)
Seat 5: ba78ff20 ($13.65 in chips)
Seat 6: a67b8426 ($6.56 in chips)
f6606457: posts small blind $0.05
ceac471a: posts big blind $0.1
*** HOLE CARDS ***
Dealt to Hero [9h 6h]
Dealt to f6606457 
Dealt to ceac471a 
Dealt to 4bd70137 
Dealt to ba78ff20 
Dealt to a67b8426 
4bd70137: folds
ba78ff20: folds
a67b8426: folds
Hero: folds
f6606457: folds
Uncalled bet ($0.05) returned to ceac471a
*** SHOWDOWN ***
ceac471a collected $0.1 from pot
*** SUMMARY ***
Total pot $0.1 | Rake $0 | Jackpot $0 | Bingo $0 | Fortune $0
Seat 1: Hero (button) folded before Flop (didn't bet)
Seat 2: f6606457 (small blind) folded before Flop
Seat 3: ceac471a (big blind) collected ($0.1)
Seat 4: 4bd70137 folded before Flop (didn't bet)
Seat 5: ba78ff20 folded before Flop (didn't bet)
Seat 6: a67b8426 folded before Flop (didn't bet)


Poker Hand #RC1316970114: Hold'em No Limit  ($0.05/$0.1) - 2023/02/02 14:12:40
Table 'RushAndCash5125374' 6-max Seat #1 is the button
Seat 1: ab813cc1 ($21.32 in chips)
Seat 2: b68b3ba3 ($22.88 in chips)
Seat 3: 56edf98b ($10 in chips)
Seat 4: Hero ($11.35 in chips)
Seat 5: 33adbf61 ($10 in chips)
Seat 6: 2d35a3e0 ($10 in chips)
b68b3ba3: posts small blind $0.05
56edf98b: posts big blind $0.1
*** HOLE CARDS ***
Dealt to ab813cc1 
Dealt to b68b3ba3 
Dealt to 56edf98b 
Dealt to Hero [8h 4d]
Dealt to 33adbf61 
Dealt to 2d35a3e0 
Hero: folds
33adbf61: folds
2d35a3e0: folds
ab813cc1: folds
b68b3ba3: raises $0.16 to $0.26
56edf98b: folds
Uncalled bet ($0.16) returned to b68b3ba3
*** SHOWDOWN ***
b68b3ba3 collected $0.2 from pot
*** SUMMARY ***
Total pot $0.2 | Rake $0 | Jackpot $0 | Bingo $0 | Fortune $0
Seat 1: ab813cc1 (button) folded before Flop (didn't bet)
Seat 2: b68b3ba3 (small blind) collected ($0.2)
Seat 3: 56edf98b (big blind) folded before Flop
Seat 4: Hero folded before Flop (didn't bet)
Seat 5: 33adbf61 folded before Flop (didn't bet)
Seat 6: 2d35a3e0 folded before Flop (didn't bet)


Poker Hand #RC1316970090: Hold'em No Limit  ($0.05/$0.1) - 2023/02/02 14:12:36
Table 'RushAndCash5125350' 6-max Seat #1 is the button
Seat 1: 2d35a3e0 ($10 in chips)
Seat 2: b40b6aa4 ($39.41 in chips)
Seat 3: 3e4899ff ($26.23 in chips)
Seat 4: Hero ($11.35 in chips)
Seat 5: 560a41a6 ($10.94 in chips)
Seat 6: 101a2367 ($10.07 in chips)
b40b6aa4: posts small blind $0.05
3e4899ff: posts big blind $0.1
*** HOLE CARDS ***
Dealt to 2d35a3e0 
Dealt to b40b6aa4 
Dealt to 3e4899ff 
Dealt to Hero [5s 8h]
Dealt to 560a41a6 
Dealt to 101a2367 
Hero: folds
560a41a6: folds
101a2367: raises $0.2 to $0.3
2d35a3e0: folds
b40b6aa4: raises $0.9 to $1.2
3e4899ff: folds
101a2367: raises $1.88 to $3.08
b40b6aa4: folds
Uncalled bet ($1.88) returned to 101a2367
*** SHOWDOWN ***
101a2367 collected $2.38 from pot
*** SUMMARY ***
Total pot $2.5 | Rake $0.12 | Jackpot $0 | Bingo $0 | Fortune $0
Seat 1: 2d35a3e0 (button) folded before Flop (didn't bet)
Seat 2: b40b6aa4 (small blind) folded before Flop
Seat 3: 3e4899ff (big blind) folded before Flop
Seat 4: Hero folded before Flop (didn't bet)
Seat 5: 560a41a6 folded before Flop (didn't bet)
Seat 6: 101a2367 collected ($2.38)


Poker Hand #RC1316970022: Hold'em No Limit  ($0.05/$0.1) - 2023/02/02 14:12:24
Table 'RushAndCash5125282' 6-max Seat #1 is the button
Seat 1: 476c070f ($10.35 in chips)
Seat 2: Hero ($11.4 in chips)
Seat 3: ee57d6f8 ($14.24 in chips)
Seat 4: 87261336 ($14.46 in chips)
Seat 5: 1c4fcc86 ($14.09 in chips)
Seat 6: e9d4fb38 ($13.8 in chips)
Hero: posts small blind $0.05
ee57d6f8: posts big blind $0.1
*** HOLE CARDS ***
Dealt to 476c070f 
Dealt to Hero [4s 3d]
Dealt to ee57d6f8 
Dealt to 87261336 
Dealt to 1c4fcc86 
Dealt to e9d4fb38 
87261336: folds
1c4fcc86: folds
e9d4fb38: folds
476c070f: raises $0.15 to $0.25
Hero: folds
ee57d6f8: folds
Uncalled bet ($0.15) returned to 476c070f
*** SHOWDOWN ***
476c070f collected $0.25 from pot
*** SUMMARY ***
Total pot $0.25 | Rake $0 | Jackpot $0 | Bingo $0 | Fortune $0
Seat 1: 476c070f (button) collected ($0.25)
Seat 2: Hero (small blind) folded before Flop
Seat 3: ee57d6f8 (big blind) folded before Flop
Seat 4: 87261336 folded before Flop (didn't bet)
Seat 5: 1c4fcc86 folded before Flop (didn't bet)
Seat 6: e9d4fb38 folded before Flop (didn't bet)


Poker Hand #RC1316969786: Hold'em No Limit  ($0.05/$0.1) - 2023/02/02 14:11:38
Table 'RushAndCash5125046' 6-max Seat #1 is the button
Seat 1: 1c0d9010 ($18 in chips)
Seat 2: db681ca6 ($21.49 in chips)
Seat 3: abe55004 ($27.64 in chips)
Seat 4: 958f8c93 ($10.79 in chips)
Seat 5: 83985f83 ($11.07 in chips)
Seat 6: Hero ($9.24 in chips)
db681ca6: posts small blind $0.05
abe55004: posts big blind $0.1
*** HOLE CARDS ***
Dealt to 1c0d9010 
Dealt to db681ca6 
Dealt to abe55004 
Dealt to 958f8c93 
Dealt to 83985f83 
Dealt to Hero [Kh Kc]
958f8c93: raises $0.2 to $0.3
83985f83: folds
Hero: raises $0.58 to $0.88
1c0d9010: folds
db681ca6: folds
abe55004: folds
958f8c93: raises $1.52 to $2.4
Hero: raises $6.84 to $9.24 and is all-in
958f8c93: folds
Uncalled bet ($6.84) returned to Hero
*** SHOWDOWN ***
Hero collected $4.56 from pot
*** SUMMARY ***
Total pot $4.95 | Rake $0.24 | Jackpot $0.15 | Bingo $0 | Fortune $0
Seat 1: 1c0d9010 (button) folded before Flop (didn't bet)
Seat 2: db681ca6 (small blind) folded before Flop
Seat 3: abe55004 (big blind) folded before Flop
Seat 4: 958f8c93 folded before Flop
Seat 5: 83985f83 folded before Flop (didn't bet)
Seat 6: Hero collected ($4.56)


Poker Hand #RC1316969718: Hold'em No Limit  ($0.05/$0.1) - 2023/02/02 14:11:27
Table 'RushAndCash5124978' 6-max Seat #1 is the button
Seat 1: 74980fba ($10.75 in chips)
Seat 2: 4a2cc52a ($10.38 in chips)
Seat 3: Hero ($9.34 in chips)
Seat 4: a0036dfb ($26.76 in chips)
Seat 5: 7da9a14 ($10.82 in chips)
Seat 6: 309311cd ($31.65 in chips)
4a2cc52a: posts small blind $0.05
Hero: posts big blind $0.1
*** HOLE CARDS ***
Dealt to 74980fba 
Dealt to 4a2cc52a 
Dealt to Hero [Jc 4d]
Dealt to a0036dfb 
Dealt to 7da9a14 
Dealt to 309311cd 
a0036dfb: folds
7da9a14: raises $0.15 to $0.25
309311cd: folds
74980fba: folds
4a2cc52a: folds
Hero: folds
Uncalled bet ($0.15) returned to 7da9a14
*** SHOWDOWN ***
7da9a14 collected $0.25 from pot
*** SUMMARY ***
Total pot $0.25 | Rake $0 | Jackpot $0 | Bingo $0 | Fortune $0
Seat 1: 74980fba (button) folded before Flop (didn't bet)
Seat 2: 4a2cc52a (small blind) folded before Flop
Seat 3: Hero (big blind) folded before Flop
Seat 4: a0036dfb folded before Flop (didn't bet)
Seat 5: 7da9a14 collected ($0.25)
Seat 6: 309311cd folded before Flop (didn't bet)


Poker Hand #RC1316969551: Hold'em No Limit  ($0.05/$0.1) - 2023/02/02 14:10:57
Table 'RushAndCash5124811' 6-max Seat #1 is the button
Seat 1: Hero ($8.92 in chips)
Seat 2: 1d98175 ($14.24 in chips)
Seat 3: 78230982 ($17.34 in chips)
Seat 4: 59bf16ec ($3.18 in chips)
Seat 5: 285c8536 ($3.98 in chips)
Seat 6: d433a235 ($13.62 in chips)
1d98175: posts small blind $0.05
78230982: posts big blind $0.1
*** HOLE CARDS ***
Dealt to Hero [Kd Qc]
Dealt to 1d98175 
Dealt to 78230982 
Dealt to 59bf16ec 
Dealt to 285c8536 
Dealt to d433a235 
59bf16ec: folds
285c8536: folds
d433a235: raises $0.2 to $0.3
Hero: raises $0.6 to $0.9
1d98175: folds
78230982: folds
d433a235: folds
Uncalled bet ($0.6) returned to Hero
*** SHOWDOWN ***
Hero collected $0.72 from pot
*** SUMMARY ***
Total pot $0.75 | Rake $0.03 | Jackpot $0 | Bingo $0 | Fortune $0
Seat 1: Hero (button) collected ($0.72)
Seat 2: 1d98175 (small blind) folded before Flop
Seat 3: 78230982 (big blind) folded before Flop
Seat 4: 59bf16ec folded before Flop (didn't bet)
Seat 5: 285c8536 folded before Flop (didn't bet)
Seat 6: d433a235 folded before Flop


Poker Hand #RC1316969484: Hold'em No Limit  ($0.05/$0.1) - 2023/02/02 14:10:45
Table 'RushAndCash5124744' 6-max Seat #1 is the button
Seat 1: 69c69bc3 ($9.97 in chips)
Seat 2: afc499f9 ($9.9 in chips)
Seat 3: 251516e7 ($17.53 in chips)
Seat 4: 1c0d9010 ($18.25 in chips)
Seat 5: Hero ($8.77 in chips)
Seat 6: d1d9500b ($5.29 in chips)
afc499f9: posts small blind $0.05
251516e7: posts big blind $0.1
*** HOLE CARDS ***
Dealt to 69c69bc3 
Dealt to afc499f9 
Dealt to 251516e7 
Dealt to 1c0d9010 
Dealt to Hero [9c Ts]
Dealt to d1d9500b 
1c0d9010: folds
Hero: raises $0.15 to $0.25
d1d9500b: folds
69c69bc3: folds
afc499f9: folds
251516e7: folds
Uncalled bet ($0.15) returned to Hero
*** SHOWDOWN ***
Hero collected $0.25 from pot
*** SUMMARY ***
Total pot $0.25 | Rake $0 | Jackpot $0 | Bingo $0 | Fortune $0
Seat 1: 69c69bc3 (button) folded before Flop (didn't bet)
Seat 2: afc499f9 (small blind) folded before Flop
Seat 3: 251516e7 (big blind) folded before Flop
Seat 4: 1c0d9010 folded before Flop (didn't bet)
Seat 5: Hero collected ($0.25)
Seat 6: d1d9500b folded before Flop (didn't bet)


Poker Hand #RC1316969460: Hold'em No Limit  ($0.05/$0.1) - 2023/02/02 14:10:41
Table 'RushAndCash5124720' 6-max Seat #1 is the button
Seat 1: 5ee1e2f2 ($36.35 in chips)
Seat 2: bea2df50 ($10.05 in chips)
Seat 3: 35dc0748 ($14.26 in chips)
Seat 4: Hero ($8.77 in chips)
Seat 5: 47c9e3b4 ($11.41 in chips)
Seat 6: d35e662c ($13.76 in chips)
bea2df50: posts small blind $0.05
35dc0748: posts big blind $0.1
*** HOLE CARDS ***
Dealt to 5ee1e2f2 
Dealt to bea2df50 
Dealt to 35dc0748 
Dealt to Hero [5c Ks]
Dealt to 47c9e3b4 
Dealt to d35e662c 
Hero: folds
47c9e3b4: folds
d35e662c: folds
5ee1e2f2: raises $0.1 to $0.2
bea2df50: calls $0.15
35dc0748: calls $0.1
*** FLOP *** [2s 8c 9c]
bea2df50: checks
35dc0748: checks
5ee1e2f2: bets $0.18
bea2df50: calls $0.18
35dc0748: raises $0.89 to $1.07
5ee1e2f2: folds
bea2df50: calls $0.89
*** TURN *** [2s 8c 9c] [Ad]
bea2df50: checks
35dc0748: bets $2.28
bea2df50: folds
Uncalled bet ($2.28) returned to 35dc0748
*** SHOWDOWN ***
35dc0748 collected $2.78 from pot
*** SUMMARY ***
Total pot $2.92 | Rake $0.14 | Jackpot $0 | Bingo $0 | Fortune $0
Board [2s 8c 9c Ad]
Seat 1: 5ee1e2f2 (button) folded on the Flop
Seat 2: bea2df50 (small blind) folded on the Turn
Seat 3: 35dc0748 (big blind) won ($2.78)
Seat 4: Hero folded before Flop (didn't bet)
Seat 5: 47c9e3b4 folded before Flop (didn't bet)
Seat 6: d35e662c folded before Flop (didn't bet)


Poker Hand #RC1316969406: Hold'em No Limit  ($0.05/$0.1) - 2023/02/02 14:10:30
Table 'RushAndCash5124666' 6-max Seat #1 is the button
Seat 1: 9b2ff61d ($45.83 in chips)
Seat 2: 7f2aa15e ($10.15 in chips)
Seat 3: Hero ($8.72 in chips)
Seat 4: f74ce7b9 ($12.61 in chips)
Seat 5: ec06370 ($11.18 in chips)
Seat 6: 56edf98b ($10.26 in chips)
7f2aa15e: posts small blind $0.05
Hero: posts big blind $0.1
*** HOLE CARDS ***
Dealt to 9b2ff61d 
Dealt to 7f2aa15e 
Dealt to Hero [4d 7c]
Dealt to f74ce7b9 
Dealt to ec06370 
Dealt to 56edf98b 
f74ce7b9: folds
ec06370: folds
56edf98b: folds
9b2ff61d: folds
7f2aa15e: folds
Uncalled bet ($0.05) returned to Hero
*** SHOWDOWN ***
Hero collected $0.1 from pot
*** SUMMARY ***
Total pot $0.1 | Rake $0 | Jackpot $0 | Bingo $0 | Fortune $0
Seat 1: 9b2ff61d (button) folded before Flop (didn't bet)
Seat 2: 7f2aa15e (small blind) folded before Flop
Seat 3: Hero (big blind) collected ($0.1)
Seat 4: f74ce7b9 folded before Flop (didn't bet)
Seat 5: ec06370 folded before Flop (didn't bet)
Seat 6: 56edf98b folded before Flop (didn't bet)


Poker Hand #RC1316969369: Hold'em No Limit  ($0.05/$0.1) - 2023/02/02 14:10:22
Table 'RushAndCash5124629' 6-max Seat #1 is the button
Seat 1: 46885d6b ($10 in chips)
Seat 2: Hero ($8.77 in chips)
Seat 3: 22c2a83c ($22.22 in chips)
Seat 4: 28829331 ($14.87 in chips)
Seat 5: 42614d1c ($9.8 in chips)
Seat 6: 8189bd18 ($10 in chips)
Hero: posts small blind $0.05
22c2a83c: posts big blind $0.1
*** HOLE CARDS ***
Dealt to 46885d6b 
Dealt to Hero [9c As]
Dealt to 22c2a83c 
Dealt to 28829331 
Dealt to 42614d1c 
Dealt to 8189bd18 
28829331: raises $0.15 to $0.25
42614d1c: folds
8189bd18: folds
46885d6b: folds
Hero: folds
22c2a83c: folds
Uncalled bet ($0.15) returned to 28829331
*** SHOWDOWN ***
28829331 collected $0.25 from pot
*** SUMMARY ***
Total pot $0.25 | Rake $0 | Jackpot $0 | Bingo $0 | Fortune $0
Seat 1: 46885d6b (button) folded before Flop (didn't bet)
Seat 2: Hero (small blind) folded before Flop
Seat 3: 22c2a83c (big blind) folded before Flop
Seat 4: 28829331 collected ($0.25)
Seat 5: 42614d1c folded before Flop (didn't bet)
Seat 6: 8189bd18 folded before Flop (didn't bet)


Poker Hand #RC1316969335: Hold'em No Limit  ($0.05/$0.1) - 2023/02/02 14:10:15
Table 'RushAndCash5124595' 6-max Seat #1 is the button
Seat 1: Hero ($8.77 in chips)
Seat 2: c69a3d90 ($10.28 in chips)
Seat 3: e95e7e24 ($9.55 in chips)
Seat 4: 755a658d ($11.21 in chips)
Seat 5: f971222 ($12.53 in chips)
Seat 6: 476c070f ($10.6 in chips)
c69a3d90: posts small blind $0.05
e95e7e24: posts big blind $0.1
*** HOLE CARDS ***
Dealt to Hero [3d 7d]
Dealt to c69a3d90 
Dealt to e95e7e24 
Dealt to 755a658d 
Dealt to f971222 
Dealt to 476c070f 
755a658d: folds
f971222: folds
476c070f: folds
Hero: folds
c69a3d90: folds
Uncalled bet ($0.05) returned to e95e7e24
*** SHOWDOWN ***
e95e7e24 collected $0.1 from pot
*** SUMMARY ***
Total pot $0.1 | Rake $0 | Jackpot $0 | Bingo $0 | Fortune $0
Seat 1: Hero (button) folded before Flop (didn't bet)
Seat 2: c69a3d90 (small blind) folded before Flop
Seat 3: e95e7e24 (big blind) collected ($0.1)
Seat 4: 755a658d folded before Flop (didn't bet)
Seat 5: f971222 folded before Flop (didn't bet)
Seat 6: 476c070f folded before Flop (didn't bet)


Poker Hand #RC1316969277: Hold'em No Limit  ($0.05/$0.1) - 2023/02/02 14:10:04
Table 'RushAndCash5124537' 6-max Seat #1 is the button
Seat 1: f243914 ($17.5 in chips)
Seat 2: 87261336 ($14.86 in chips)
Seat 3: 65f718e7 ($12.09 in chips)
Seat 4: 146043d ($14.52 in chips)
Seat 5: f2679df9 ($15.61 in chips)
Seat 6: Hero ($8.62 in chips)
87261336: posts small blind $0.05
65f718e7: posts big blind $0.1
*** HOLE CARDS ***
Dealt to f243914 
Dealt to 87261336 
Dealt to 65f718e7 
Dealt to 146043d 
Dealt to f2679df9 
Dealt to Hero [Th Td]
146043d: folds
f2679df9: folds
Hero: raises $0.15 to $0.25
f243914: folds
87261336: folds
65f718e7: folds
Uncalled bet ($0.15) returned to Hero
*** SHOWDOWN ***
Hero collected $0.25 from pot
*** SUMMARY ***
Total pot $0.25 | Rake $0 | Jackpot $0 | Bingo $0 | Fortune $0
Seat 1: f243914 (button) folded before Flop (didn't bet)
Seat 2: 87261336 (small blind) folded before Flop
Seat 3: 65f718e7 (big blind) folded before Flop
Seat 4: 146043d folded before Flop (didn't bet)
Seat 5: f2679df9 folded before Flop (didn't bet)
Seat 6: Hero collected ($0.25)


Poker Hand #RC1316969256: Hold'em No Limit  ($0.05/$0.1) - 2023/02/02 14:10:00
Table 'RushAndCash5124516' 6-max Seat #1 is the button
Seat 1: 9e594eb2 ($12.23 in chips)
Seat 2: c2f9a8fb ($12.15 in chips)
Seat 3: d509ee56 ($10.42 in chips)
Seat 4: 146043d ($14.52 in chips)
Seat 5: Hero ($8.62 in chips)
Seat 6: 9effbff ($12.19 in chips)
c2f9a8fb: posts small blind $0.05
d509ee56: posts big blind $0.1
*** HOLE CARDS ***
Dealt to 9e594eb2 
Dealt to c2f9a8fb 
Dealt to d509ee56 
Dealt to 146043d 
Dealt to Hero [5h 3s]
Dealt to 9effbff 
146043d: folds
Hero: folds
9effbff: raises $0.15 to $0.25
9e594eb2: calls $0.25
c2f9a8fb: folds
d509ee56: folds
*** FLOP *** [As Jc Qc]
9effbff: bets $0.33
9e594eb2: calls $0.33
*** TURN *** [As Jc Qc] [9d]
9effbff: checks
9e594eb2: checks
*** RIVER *** [As Jc Qc 9d] [Ts]
9effbff: checks
9e594eb2: checks
9effbff: shows [4d 5d] (Ace-High)
9e594eb2: shows [3h Ah] (Pair of Aces)
*** SHOWDOWN ***
9e594eb2 collected $1.25 from pot
*** SUMMARY ***
Total pot $1.31 | Rake $0.06 | Jackpot $0 | Bingo $0 | Fortune $0
Board [As Jc Qc 9d Ts]
Seat 1: 9e594eb2 (button) showed [3h Ah] and won ($1.25) with Pair of Aces
Seat 2: c2f9a8fb (small blind) folded before Flop
Seat 3: d509ee56 (big blind) folded before Flop
Seat 4: 146043d folded before Flop (didn't bet)
Seat 5: Hero folded before Flop (didn't bet)
Seat 6: 9effbff showed [4d 5d] and lost with Ace-High


Poker Hand #RC1316969238: Hold'em No Limit  ($0.05/$0.1) - 2023/02/02 14:09:56
Table 'RushAndCash5124498' 6-max Seat #1 is the button
Seat 1: c4b8ef0c ($19.51 in chips)
Seat 2: 611e0890 ($10.15 in chips)
Seat 3: 3828897b ($16.5 in chips)
Seat 4: 6eab5fda ($10 in chips)
Seat 5: ba4bcf27 ($12.02 in chips)
Seat 6: Hero ($8.62 in chips)
611e0890: posts small blind $0.05
3828897b: posts big blind $0.1
*** HOLE CARDS ***
Dealt to c4b8ef0c 
Dealt to 611e0890 
Dealt to 3828897b 
Dealt to 6eab5fda 
Dealt to ba4bcf27 
Dealt to Hero [4d 8c]
6eab5fda: folds
ba4bcf27: folds
Hero: folds
c4b8ef0c: raises $0.12 to $0.22
611e0890: folds
3828897b: folds
Uncalled bet ($0.12) returned to c4b8ef0c
*** SHOWDOWN ***
c4b8ef0c collected $0.25 from pot
*** SUMMARY ***
Total pot $0.25 | Rake $0 | Jackpot $0 | Bingo $0 | Fortune $0
Seat 1: c4b8ef0c (button) collected ($0.25)
Seat 2: 611e0890 (small blind) folded before Flop
Seat 3: 3828897b (big blind) folded before Flop
Seat 4: 6eab5fda folded before Flop (didn't bet)
Seat 5: ba4bcf27 folded before Flop (didn't bet)
Seat 6: Hero folded before Flop (didn't bet)


Poker Hand #RC1316969216: Hold'em No Limit  ($0.05/$0.1) - 2023/02/02 14:09:52
Table 'RushAndCash5124476' 6-max Seat #1 is the button
Seat 1: 4875e50a ($15.96 in chips)
Seat 2: fdd2cab3 ($10.4 in chips)
Seat 3: 297006d8 ($12.08 in chips)
Seat 4: e2ecd0c0 ($10.05 in chips)
Seat 5: 48451ad4 ($11.71 in chips)
Seat 6: Hero ($8.62 in chips)
fdd2cab3: posts small blind $0.05
297006d8: posts big blind $0.1
*** HOLE CARDS ***
Dealt to 4875e50a 
Dealt to fdd2cab3 
Dealt to 297006d8 
Dealt to e2ecd0c0 
Dealt to 48451ad4 
Dealt to Hero [Jd 3d]
e2ecd0c0: folds
48451ad4: raises $0.15 to $0.25
Hero: folds
4875e50a: folds
fdd2cab3: folds
297006d8: calls $0.15
*** FLOP *** [Ad 2s 7d]
297006d8: checks
48451ad4: checks
*** TURN *** [Ad 2s 7d] [Ac]
297006d8: checks
48451ad4: bets $0.3
297006d8: calls $0.3
*** RIVER *** [Ad 2s 7d Ac] [6c]
297006d8: checks
48451ad4: bets $0.7
297006d8: calls $0.7
48451ad4: shows [Ks As] (Three Aces)
297006d8: shows [Ah Qc] (Three Aces)
*** SHOWDOWN ***
48451ad4 collected $2.43 from pot
*** SUMMARY ***
Total pot $2.55 | Rake $0.12 | Jackpot $0 | Bingo $0 | Fortune $0
Board [Ad 2s 7d Ac 6c]
Seat 1: 4875e50a (button) folded before Flop (didn't bet)
Seat 2: fdd2cab3 (small blind) folded before Flop
Seat 3: 297006d8 (big blind) showed [Ah Qc] and lost with Three Aces
Seat 4: e2ecd0c0 folded before Flop (didn't bet)
Seat 5: 48451ad4 showed [Ks As] and won ($2.43) with Three Aces
Seat 6: Hero folded before Flop (didn't bet)


Poker Hand #RC1316969184: Hold'em No Limit  ($0.05/$0.1) - 2023/02/02 14:09:46
Table 'RushAndCash5124444' 6-max Seat #1 is the button
Seat 1: f1e34997 ($10.9 in chips)
Seat 2: 80a53ef6 ($9.75 in chips)
Seat 3: cd4cffb1 ($12.19 in chips)
Seat 4: 4bd70137 ($18.77 in chips)
Seat 5: dace1a54 ($10 in chips)
Seat 6: Hero ($8.62 in chips)
80a53ef6: posts small blind $0.05
cd4cffb1: posts big blind $0.1
*** HOLE CARDS ***
Dealt to f1e34997 
Dealt to 80a53ef6 
Dealt to cd4cffb1 
Dealt to 4bd70137 
Dealt to dace1a54 
Dealt to Hero [3h 8h]
4bd70137: raises $0.15 to $0.25
dace1a54: folds
Hero: folds
f1e34997: folds
80a53ef6: folds
cd4cffb1: folds
Uncalled bet ($0.15) returned to 4bd70137
*** SHOWDOWN ***
4bd70137 collected $0.25 from pot
*** SUMMARY ***
Total pot $0.25 | Rake $0 | Jackpot $0 | Bingo $0 | Fortune $0
Seat 1: f1e34997 (button) folded before Flop (didn't bet)
Seat 2: 80a53ef6 (small blind) folded before Flop
Seat 3: cd4cffb1 (big blind) folded before Flop
Seat 4: 4bd70137 collected ($0.25)
Seat 5: dace1a54 folded before Flop (didn't bet)
Seat 6: Hero folded before Flop (didn't bet)


Poker Hand #RC1316969162: Hold'em No Limit  ($0.05/$0.1) - 2023/02/02 14:09:43
Table 'RushAndCash5124422' 6-max Seat #1 is the button
Seat 1: 452ab956 ($19.27 in chips)
Seat 2: 101a2367 ($9.85 in chips)
Seat 3: Hero ($8.72 in chips)
Seat 4: c2f9a8fb ($12.1 in chips)
Seat 5: 93cecb64 ($4.1 in chips)
Seat 6: ac88941d ($15.8 in chips)
101a2367: posts small blind $0.05
Hero: posts big blind $0.1
*** HOLE CARDS ***
Dealt to 452ab956 
Dealt to 101a2367 
Dealt to Hero [9s 4d]
Dealt to c2f9a8fb 
Dealt to 93cecb64 
Dealt to ac88941d 
c2f9a8fb: folds
93cecb64: raises $0.1 to $0.2
ac88941d: folds
452ab956: folds
101a2367: folds
Hero: folds
Uncalled bet ($0.1) returned to 93cecb64
*** SHOWDOWN ***
93cecb64 collected $0.25 from pot
*** SUMMARY ***
Total pot $0.25 | Rake $0 | Jackpot $0 | Bingo $0 | Fortune $0
Seat 1: 452ab956 (button) folded before Flop (didn't bet)
Seat 2: 101a2367 (small blind) folded before Flop
Seat 3: Hero (big blind) folded before Flop
Seat 4: c2f9a8fb folded before Flop (didn't bet)
Seat 5: 93cecb64 collected ($0.25)
Seat 6: ac88941d folded before Flop (didn't bet)


Poker Hand #RC1316969138: Hold'em No Limit  ($0.05/$0.1) - 2023/02/02 14:09:38
Table 'RushAndCash5124398' 6-max Seat #1 is the button
Seat 1: 98f6e09c ($20.86 in chips)
Seat 2: 9e594eb2 ($12.23 in chips)
Seat 3: c5946ce2 ($9.45 in chips)
Seat 4: Hero ($8.72 in chips)
Seat 5: c2f9a8fb ($12.1 in chips)
Seat 6: 6e45b603 ($19.08 in chips)
9e594eb2: posts small blind $0.05
c5946ce2: posts big blind $0.1
*** HOLE CARDS ***
Dealt to 98f6e09c 
Dealt to 9e594eb2 
Dealt to c5946ce2 
Dealt to Hero [5c 8d]
Dealt to c2f9a8fb 
Dealt to 6e45b603 
Hero: folds
c2f9a8fb: folds
6e45b603: folds
98f6e09c: raises $0.2 to $0.3
9e594eb2: folds
c5946ce2: calls $0.2
*** FLOP *** [3h 9d 2h]
c5946ce2: checks
98f6e09c: bets $0.33
c5946ce2: folds
Uncalled bet ($0.33) returned to 98f6e09c
*** SHOWDOWN ***
98f6e09c collected $0.62 from pot
*** SUMMARY ***
Total pot $0.65 | Rake $0.03 | Jackpot $0 | Bingo $0 | Fortune $0
Board [3h 9d 2h]
Seat 1: 98f6e09c (button) won ($0.62)
Seat 2: 9e594eb2 (small blind) folded before Flop
Seat 3: c5946ce2 (big blind) folded on the Flop
Seat 4: Hero folded before Flop (didn't bet)
Seat 5: c2f9a8fb folded before Flop (didn't bet)
Seat 6: 6e45b603 folded before Flop (didn't bet)


Poker Hand #RC1316969110: Hold'em No Limit  ($0.05/$0.1) - 2023/02/02 14:09:34
Table 'RushAndCash5124370' 6-max Seat #1 is the button
Seat 1: Hero ($8.72 in chips)
Seat 2: df707b71 ($19.64 in chips)
Seat 3: 42e299f4 ($10 in chips)
Seat 4: f7288b7c ($10 in chips)
Seat 5: 35dc0748 ($13.33 in chips)
Seat 6: c69a3d90 ($10 in chips)
df707b71: posts small blind $0.05
42e299f4: posts big blind $0.1
*** HOLE CARDS ***
Dealt to Hero [Ac 2h]
Dealt to df707b71 
Dealt to 42e299f4 
Dealt to f7288b7c 
Dealt to 35dc0748 
Dealt to c69a3d90 
f7288b7c: folds
35dc0748: folds
c69a3d90: folds
Hero: folds
df707b71: folds
Uncalled bet ($0.05) returned to 42e299f4
*** SHOWDOWN ***
42e299f4 collected $0.1 from pot
*** SUMMARY ***
Total pot $0.1 | Rake $0 | Jackpot $0 | Bingo $0 | Fortune $0
Seat 1: Hero (button) folded before Flop (didn't bet)
Seat 2: df707b71 (small blind) folded before Flop
Seat 3: 42e299f4 (big blind) collected ($0.1)
Seat 4: f7288b7c folded before Flop (didn't bet)
Seat 5: 35dc0748 folded before Flop (didn't bet)
Seat 6: c69a3d90 folded before Flop (didn't bet)


Poker Hand #RC1316969079: Hold'em No Limit  ($0.05/$0.1) - 2023/02/02 14:09:28
Table 'RushAndCash5124339' 6-max Seat #1 is the button
Seat 1: c1f7f989 ($14.9 in chips)
Seat 2: 92e2488a ($14.62 in chips)
Seat 3: d2642a4f ($24.07 in chips)
Seat 4: 42e299f4 ($10 in chips)
Seat 5: 795d5161 ($13.06 in chips)
Seat 6: Hero ($8.72 in chips)
92e2488a: posts small blind $0.05
d2642a4f: posts big blind $0.1
*** HOLE CARDS ***
Dealt to c1f7f989 
Dealt to 92e2488a 
Dealt to d2642a4f 
Dealt to 42e299f4 
Dealt to 795d5161 
Dealt to Hero [6d Qd]
42e299f4: folds
795d5161: folds
Hero: folds
c1f7f989: raises $0.15 to $0.25
92e2488a: folds
d2642a4f: calls $0.15
*** FLOP *** [7d 5h 4d]
d2642a4f: checks
c1f7f989: checks
*** TURN *** [7d 5h 4d] [6s]
d2642a4f: checks
c1f7f989: checks
*** RIVER *** [7d 5h 4d 6s] [5d]
d2642a4f: checks
c1f7f989: checks
d2642a4f: shows [Qh Kc] (Pair of Fives)
c1f7f989: shows [Jh Ad] (Pair of Fives)
*** SHOWDOWN ***
c1f7f989 collected $0.53 from pot
*** SUMMARY ***
Total pot $0.55 | Rake $0.02 | Jackpot $0 | Bingo $0 | Fortune $0
Board [7d 5h 4d 6s 5d]
Seat 1: c1f7f989 (button) showed [Jh Ad] and won ($0.53) with Pair of Fives
Seat 2: 92e2488a (small blind) folded before Flop
Seat 3: d2642a4f (big blind) showed [Qh Kc] and lost with Pair of Fives
Seat 4: 42e299f4 folded before Flop (didn't bet)
Seat 5: 795d5161 folded before Flop (didn't bet)
Seat 6: Hero folded before Flop (didn't bet)


Poker Hand #RC1316969055: Hold'em No Limit  ($0.05/$0.1) - 2023/02/02 14:09:23
Table 'RushAndCash5124315' 6-max Seat #1 is the button
Seat 1: 46ec31ae ($12 in chips)
Seat 2: Hero ($8.77 in chips)
Seat 3: 142474e3 ($14.1 in chips)
Seat 4: 8ad5fa25 ($10.27 in chips)
Seat 5: 2b9a0dce ($10.81 in chips)
Seat 6: 1c0d9010 ($18.62 in chips)
Hero: posts small blind $0.05
142474e3: posts big blind $0.1
*** HOLE CARDS ***
Dealt to 46ec31ae 
Dealt to Hero [Jc 7h]
Dealt to 142474e3 
Dealt to 8ad5fa25 
Dealt to 2b9a0dce 
Dealt to 1c0d9010 
8ad5fa25: folds
2b9a0dce: folds
1c0d9010: raises $0.12 to $0.22
46ec31ae: raises $0.53 to $0.75
Hero: folds
142474e3: folds
1c0d9010: folds
Uncalled bet ($0.53) returned to 46ec31ae
*** SHOWDOWN ***
46ec31ae collected $0.56 from pot
*** SUMMARY ***
Total pot $0.59 | Rake $0.03 | Jackpot $0 | Bingo $0 | Fortune $0
Seat 1: 46ec31ae (button) collected ($0.56)
Seat 2: Hero (small blind) folded before Flop
Seat 3: 142474e3 (big blind) folded before Flop
Seat 4: 8ad5fa25 folded before Flop (didn't bet)
Seat 5: 2b9a0dce folded before Flop (didn't bet)
Seat 6: 1c0d9010 folded before Flop


Poker Hand #RC1316969018: Hold'em No Limit  ($0.05/$0.1) - 2023/02/02 14:09:16
Table 'RushAndCash5124278' 6-max Seat #1 is the button
Seat 1: 7f130f74 ($30.19 in chips)
Seat 2: c5ca61d4 ($12.35 in chips)
Seat 3: Hero ($8.87 in chips)
Seat 4: bd260b3e ($14.54 in chips)
Seat 5: 63234475 ($12.4 in chips)
Seat 6: 14b16f86 ($9.8 in chips)
c5ca61d4: posts small blind $0.05
Hero: posts big blind $0.1
*** HOLE CARDS ***
Dealt to 7f130f74 
Dealt to c5ca61d4 
Dealt to Hero [Qc 9s]
Dealt to bd260b3e 
Dealt to 63234475 
Dealt to 14b16f86 
bd260b3e: raises $0.15 to $0.25
63234475: folds
14b16f86: folds
7f130f74: folds
c5ca61d4: folds
Hero: folds
Uncalled bet ($0.15) returned to bd260b3e
*** SHOWDOWN ***
bd260b3e collected $0.25 from pot
*** SUMMARY ***
Total pot $0.25 | Rake $0 | Jackpot $0 | Bingo $0 | Fortune $0
Seat 1: 7f130f74 (button) folded before Flop (didn't bet)
Seat 2: c5ca61d4 (small blind) folded before Flop
Seat 3: Hero (big blind) folded before Flop
Seat 4: bd260b3e collected ($0.25)
Seat 5: 63234475 folded before Flop (didn't bet)
Seat 6: 14b16f86 folded before Flop (didn't bet)


Poker Hand #RC1316968967: Hold'em No Limit  ($0.05/$0.1) - 2023/02/02 14:09:07
Table 'RushAndCash5124227' 6-max Seat #1 is the button
Seat 1: 4c304032 ($10.37 in chips)
Seat 2: Hero ($8.92 in chips)
Seat 3: 47c9e3b4 ($8.7 in chips)
Seat 4: ef486511 ($21.62 in chips)
Seat 5: 4bd70137 ($19.07 in chips)
Seat 6: 3f092720 ($12.16 in chips)
Hero: posts small blind $0.05
47c9e3b4: posts big blind $0.1
*** HOLE CARDS ***
Dealt to 4c304032 
Dealt to Hero [6h Ad]
Dealt to 47c9e3b4 
Dealt to ef486511 
Dealt to 4bd70137 
Dealt to 3f092720 
ef486511: folds
4bd70137: folds
3f092720: raises $0.15 to $0.25
4c304032: calls $0.25
Hero: folds
47c9e3b4: calls $0.15
*** FLOP *** [Ts Qc 6s]
47c9e3b4: checks
3f092720: checks
4c304032: bets $0.4
47c9e3b4: raises $0.4 to $0.8
3f092720: folds
4c304032: calls $0.4
*** TURN *** [Ts Qc 6s] [3h]
47c9e3b4: checks
4c304032: checks
*** RIVER *** [Ts Qc 6s 3h] [Js]
47c9e3b4: bets $1.8
4c304032: calls $1.8
47c9e3b4: shows [8s 5s] (Jack High Flush)
4c304032: shows [Jd Kh] (Pair of Jacks)
*** SHOWDOWN ***
47c9e3b4 collected $5.56 from pot
*** SUMMARY ***
Total pot $6 | Rake $0.29 | Jackpot $0.15 | Bingo $0 | Fortune $0
Board [Ts Qc 6s 3h Js]
Seat 1: 4c304032 (button) showed [Jd Kh] and lost with Pair of Jacks
Seat 2: Hero (small blind) folded before Flop
Seat 3: 47c9e3b4 (big blind) showed [8s 5s] and won ($5.56) with Jack High Flush
Seat 4: ef486511 folded before Flop (didn't bet)
Seat 5: 4bd70137 folded before Flop (didn't bet)
Seat 6: 3f092720 folded on the Flop


Poker Hand #RC1316968948: Hold'em No Limit  ($0.05/$0.1) - 2023/02/02 14:09:03
Table 'RushAndCash5124208' 6-max Seat #1 is the button
Seat 1: ef486511 ($21.62 in chips)
Seat 2: 28b26cef ($10 in chips)
Seat 3: 2b9a0dce ($10.96 in chips)
Seat 4: Hero ($8.92 in chips)
Seat 5: 387b7d40 ($10.55 in chips)
Seat 6: 30ced322 ($10.18 in chips)
28b26cef: posts small blind $0.05
2b9a0dce: posts big blind $0.1
*** HOLE CARDS ***
Dealt to ef486511 
Dealt to 28b26cef 
Dealt to 2b9a0dce 
Dealt to Hero [9s Qc]
Dealt to 387b7d40 
Dealt to 30ced322 
Hero: folds
387b7d40: folds
30ced322: folds
ef486511: folds
28b26cef: raises $0.2 to $0.3
2b9a0dce: folds
Uncalled bet ($0.2) returned to 28b26cef
*** SHOWDOWN ***
28b26cef collected $0.2 from pot
*** SUMMARY ***
Total pot $0.2 | Rake $0 | Jackpot $0 | Bingo $0 | Fortune $0
Seat 1: ef486511 (button) folded before Flop (didn't bet)
Seat 2: 28b26cef (small blind) collected ($0.2)
Seat 3: 2b9a0dce (big blind) folded before Flop
Seat 4: Hero folded before Flop (didn't bet)
Seat 5: 387b7d40 folded before Flop (didn't bet)
Seat 6: 30ced322 folded before Flop (didn't bet)


Poker Hand #RC1316968924: Hold'em No Limit  ($0.05/$0.1) - 2023/02/02 14:08:58
Table 'RushAndCash5124184' 6-max Seat #1 is the button
Seat 1: Hero ($8.92 in chips)
Seat 2: e4437eee ($34.36 in chips)
Seat 3: c3d52b15 ($10.25 in chips)
Seat 4: 6eab5fda ($9.65 in chips)
Seat 5: b29a0d80 ($10.15 in chips)
Seat 6: dbe299ba ($10.15 in chips)
e4437eee: posts small blind $0.05
c3d52b15: posts big blind $0.1
*** HOLE CARDS ***
Dealt to Hero [2d 5s]
Dealt to e4437eee 
Dealt to c3d52b15 
Dealt to 6eab5fda 
Dealt to b29a0d80 
Dealt to dbe299ba 
6eab5fda: folds
b29a0d80: folds
dbe299ba: folds
Hero: folds
e4437eee: raises $0.2 to $0.3
c3d52b15: calls $0.2
*** FLOP *** [2h Qs Th]
e4437eee: bets $0.6
c3d52b15: calls $0.6
*** TURN *** [2h Qs Th] [9d]
e4437eee: bets $33.46 and is all-in
c3d52b15: folds
Uncalled bet ($33.46) returned to e4437eee
*** SHOWDOWN ***
e4437eee collected $1.71 from pot
*** SUMMARY ***
Total pot $1.8 | Rake $0.09 | Jackpot $0 | Bingo $0 | Fortune $0
Board [2h Qs Th 9d]
Seat 1: Hero (button) folded before Flop (didn't bet)
Seat 2: e4437eee (small blind) won ($1.71)
Seat 3: c3d52b15 (big blind) folded on the Turn
Seat 4: 6eab5fda folded before Flop (didn't bet)
Seat 5: b29a0d80 folded before Flop (didn't bet)
Seat 6: dbe299ba folded before Flop (didn't bet)


Poker Hand #RC1316968860: Hold'em No Limit  ($0.05/$0.1) - 2023/02/02 14:08:46
Table 'RushAndCash5124120' 6-max Seat #1 is the button
Seat 1: d39fee52 ($10 in chips)
Seat 2: a422a406 ($10 in chips)
Seat 3: 92e2488a ($14.72 in chips)
Seat 4: Hero ($8.77 in chips)
Seat 5: 63b65f10 ($9.25 in chips)
Seat 6: dda3de4d ($10.89 in chips)
a422a406: posts small blind $0.05
92e2488a: posts big blind $0.1
*** HOLE CARDS ***
Dealt to d39fee52 
Dealt to a422a406 
Dealt to 92e2488a 
Dealt to Hero [Qh Kc]
Dealt to 63b65f10 
Dealt to dda3de4d 
Hero: raises $0.15 to $0.25
63b65f10: folds
dda3de4d: folds
d39fee52: folds
a422a406: folds
92e2488a: folds
Uncalled bet ($0.15) returned to Hero
*** SHOWDOWN ***
Hero collected $0.25 from pot
*** SUMMARY ***
Total pot $0.25 | Rake $0 | Jackpot $0 | Bingo $0 | Fortune $0
Seat 1: d39fee52 (button) folded before Flop (didn't bet)
Seat 2: a422a406 (small blind) folded before Flop
Seat 3: 92e2488a (big blind) folded before Flop
Seat 4: Hero collected ($0.25)
Seat 5: 63b65f10 folded before Flop (didn't bet)
Seat 6: dda3de4d folded before Flop (didn't bet)


Poker Hand #RC1316968821: Hold'em No Limit  ($0.05/$0.1) - 2023/02/02 14:08:39
Table 'RushAndCash5124081' 6-max Seat #1 is the button
Seat 1: fa2a15cf ($19.94 in chips)
Seat 2: b4d21b83 ($10 in chips)
Seat 3: ef486511 ($21.77 in chips)
Seat 4: 264fb31 ($10.76 in chips)
Seat 5: Hero ($8.77 in chips)
Seat 6: 1d8da6b1 ($10 in chips)
b4d21b83: posts small blind $0.05
ef486511: posts big blind $0.1
*** HOLE CARDS ***
Dealt to fa2a15cf 
Dealt to b4d21b83 
Dealt to ef486511 
Dealt to 264fb31 
Dealt to Hero [3h 3c]
Dealt to 1d8da6b1 
264fb31: folds
Hero: folds
1d8da6b1: raises $0.13 to $0.23
fa2a15cf: folds
b4d21b83: folds
ef486511: folds
Uncalled bet ($0.13) returned to 1d8da6b1
*** SHOWDOWN ***
1d8da6b1 collected $0.25 from pot
*** SUMMARY ***
Total pot $0.25 | Rake $0 | Jackpot $0 | Bingo $0 | Fortune $0
Seat 1: fa2a15cf (button) folded before Flop (didn't bet)
Seat 2: b4d21b83 (small blind) folded before Flop
Seat 3: ef486511 (big blind) folded before Flop
Seat 4: 264fb31 folded before Flop (didn't bet)
Seat 5: Hero folded before Flop (didn't bet)
Seat 6: 1d8da6b1 collected ($0.25)


Poker Hand #RC1316968743: Hold'em No Limit  ($0.05/$0.1) - 2023/02/02 14:08:25
Table 'RushAndCash5124003' 6-max Seat #1 is the button
Seat 1: ee80910b ($8.69 in chips)
Seat 2: 9e594eb2 ($10.46 in chips)
Seat 3: f02123a0 ($10 in chips)
Seat 4: dd446660 ($9.68 in chips)
Seat 5: b68b3ba3 ($21.58 in chips)
Seat 6: Hero ($8.77 in chips)
9e594eb2: posts small blind $0.05
f02123a0: posts big blind $0.1
*** HOLE CARDS ***
Dealt to ee80910b 
Dealt to 9e594eb2 
Dealt to f02123a0 
Dealt to dd446660 
Dealt to b68b3ba3 
Dealt to Hero [Jc 4s]
dd446660: folds
b68b3ba3: folds
Hero: folds
ee80910b: folds
9e594eb2: raises $0.15 to $0.25
f02123a0: folds
Uncalled bet ($0.15) returned to 9e594eb2
*** SHOWDOWN ***
9e594eb2 collected $0.2 from pot
*** SUMMARY ***
Total pot $0.2 | Rake $0 | Jackpot $0 | Bingo $0 | Fortune $0
Seat 1: ee80910b (button) folded before Flop (didn't bet)
Seat 2: 9e594eb2 (small blind) collected ($0.2)
Seat 3: f02123a0 (big blind) folded before Flop
Seat 4: dd446660 folded before Flop (didn't bet)
Seat 5: b68b3ba3 folded before Flop (didn't bet)
Seat 6: Hero folded before Flop (didn't bet)


Poker Hand #RC1316968705: Hold'em No Limit  ($0.05/$0.1) - 2023/02/02 14:08:18
Table 'RushAndCash5123965' 6-max Seat #1 is the button
Seat 1: Hero ($8.77 in chips)
Seat 2: 5b7a7c5d ($9.49 in chips)
Seat 3: 3581c5a7 ($12.78 in chips)
Seat 4: a185134c ($15.54 in chips)
Seat 5: cb873d5a ($9.61 in chips)
Seat 6: 2ddb4a39 ($10 in chips)
5b7a7c5d: posts small blind $0.05
3581c5a7: posts big blind $0.1
*** HOLE CARDS ***
Dealt to Hero [6c 2d]
Dealt to 5b7a7c5d 
Dealt to 3581c5a7 
Dealt to a185134c 
Dealt to cb873d5a 
Dealt to 2ddb4a39 
a185134c: folds
cb873d5a: folds
2ddb4a39: folds
Hero: folds
5b7a7c5d: folds
Uncalled bet ($0.05) returned to 3581c5a7
*** SHOWDOWN ***
3581c5a7 collected $0.1 from pot
*** SUMMARY ***
Total pot $0.1 | Rake $0 | Jackpot $0 | Bingo $0 | Fortune $0
Seat 1: Hero (button) folded before Flop (didn't bet)
Seat 2: 5b7a7c5d (small blind) folded before Flop
Seat 3: 3581c5a7 (big blind) collected ($0.1)
Seat 4: a185134c folded before Flop (didn't bet)
Seat 5: cb873d5a folded before Flop (didn't bet)
Seat 6: 2ddb4a39 folded before Flop (didn't bet)


Poker Hand #RC1316968684: Hold'em No Limit  ($0.05/$0.1) - 2023/02/02 14:08:14
Table 'RushAndCash5123944' 6-max Seat #1 is the button
Seat 1: 4a335b53 ($13.62 in chips)
Seat 2: 90df046f ($10 in chips)
Seat 3: dc581a50 ($29.09 in chips)
Seat 4: Hero ($8.77 in chips)
Seat 5: 7f130f74 ($30.96 in chips)
Seat 6: 1d98a6e5 ($12.55 in chips)
90df046f: posts small blind $0.05
dc581a50: posts big blind $0.1
*** HOLE CARDS ***
Dealt to 4a335b53 
Dealt to 90df046f 
Dealt to dc581a50 
Dealt to Hero [Qh 2h]
Dealt to 7f130f74 
Dealt to 1d98a6e5 
Hero: folds
7f130f74: folds
1d98a6e5: folds
4a335b53: folds
90df046f: folds
Uncalled bet ($0.05) returned to dc581a50
*** SHOWDOWN ***
dc581a50 collected $0.1 from pot
*** SUMMARY ***
Total pot $0.1 | Rake $0 | Jackpot $0 | Bingo $0 | Fortune $0
Seat 1: 4a335b53 (button) folded before Flop (didn't bet)
Seat 2: 90df046f (small blind) folded before Flop
Seat 3: dc581a50 (big blind) collected ($0.1)
Seat 4: Hero folded before Flop (didn't bet)
Seat 5: 7f130f74 folded before Flop (didn't bet)
Seat 6: 1d98a6e5 folded before Flop (didn't bet)


Poker Hand #RC1316968664: Hold'em No Limit  ($0.05/$0.1) - 2023/02/02 14:08:10
Table 'RushAndCash5123924' 6-max Seat #1 is the button
Seat 1: d17cb4b0 ($27.54 in chips)
Seat 2: a45956ba ($14.69 in chips)
Seat 3: Hero ($8.87 in chips)
Seat 4: 5eb6be30 ($10 in chips)
Seat 5: 123789f2 ($81.29 in chips)
Seat 6: 39b91777 ($11.51 in chips)
a45956ba: posts small blind $0.05
Hero: posts big blind $0.1
*** HOLE CARDS ***
Dealt to d17cb4b0 
Dealt to a45956ba 
Dealt to Hero [8c 9s]
Dealt to 5eb6be30 
Dealt to 123789f2 
Dealt to 39b91777 
5eb6be30: folds
123789f2: folds
39b91777: folds
d17cb4b0: folds
a45956ba: raises $0.2 to $0.3
Hero: folds
Uncalled bet ($0.2) returned to a45956ba
*** SHOWDOWN ***
a45956ba collected $0.2 from pot
*** SUMMARY ***
Total pot $0.2 | Rake $0 | Jackpot $0 | Bingo $0 | Fortune $0
Seat 1: d17cb4b0 (button) folded before Flop (didn't bet)
Seat 2: a45956ba (small blind) collected ($0.2)
Seat 3: Hero (big blind) folded before Flop
Seat 4: 5eb6be30 folded before Flop (didn't bet)
Seat 5: 123789f2 folded before Flop (didn't bet)
Seat 6: 39b91777 folded before Flop (didn't bet)


Poker Hand #RC1316968585: Hold'em No Limit  ($0.05/$0.1) - 2023/02/02 14:07:56
Table 'RushAndCash5123845' 6-max Seat #1 is the button
Seat 1: 33adbf61 ($11.61 in chips)
Seat 2: Hero ($8.77 in chips)
Seat 3: 83cf0341 ($10 in chips)
Seat 4: a2078f34 ($27.97 in chips)
Seat 5: 6b6ecc43 ($15.24 in chips)
Seat 6: af900ae2 ($17.72 in chips)
Hero: posts small blind $0.05
83cf0341: posts big blind $0.1
*** HOLE CARDS ***
Dealt to 33adbf61 
Dealt to Hero [Ks 2s]
Dealt to 83cf0341 
Dealt to a2078f34 
Dealt to 6b6ecc43 
Dealt to af900ae2 
a2078f34: folds
6b6ecc43: folds
af900ae2: folds
33adbf61: folds
Hero: raises $0.2 to $0.3
83cf0341: folds
Uncalled bet ($0.2) returned to Hero
*** SHOWDOWN ***
Hero collected $0.2 from pot
*** SUMMARY ***
Total pot $0.2 | Rake $0 | Jackpot $0 | Bingo $0 | Fortune $0
Seat 1: 33adbf61 (button) folded before Flop (didn't bet)
Seat 2: Hero (small blind) collected ($0.2)
Seat 3: 83cf0341 (big blind) folded before Flop
Seat 4: a2078f34 folded before Flop (didn't bet)
Seat 5: 6b6ecc43 folded before Flop (didn't bet)
Seat 6: af900ae2 folded before Flop (didn't bet)


Poker Hand #RC1316968558: Hold'em No Limit  ($0.05/$0.1) - 2023/02/02 14:07:50
Table 'RushAndCash5123818' 6-max Seat #1 is the button
Seat 1: 5fe89e96 ($27.58 in chips)
Seat 2: ec6a9a1d ($14.65 in chips)
Seat 3: a185134c ($15.54 in chips)
Seat 4: 8d56d7e5 ($10.95 in chips)
Seat 5: e557815 ($29.3 in chips)
Seat 6: Hero ($8.77 in chips)
ec6a9a1d: posts small blind $0.05
a185134c: posts big blind $0.1
*** HOLE CARDS ***
Dealt to 5fe89e96 
Dealt to ec6a9a1d 
Dealt to a185134c 
Dealt to 8d56d7e5 
Dealt to e557815 
Dealt to Hero [Qd 4h]
8d56d7e5: folds
e557815: folds
Hero: folds
5fe89e96: folds
ec6a9a1d: folds
Uncalled bet ($0.05) returned to a185134c
*** SHOWDOWN ***
a185134c collected $0.1 from pot
*** SUMMARY ***
Total pot $0.1 | Rake $0 | Jackpot $0 | Bingo $0 | Fortune $0
Seat 1: 5fe89e96 (button) folded before Flop (didn't bet)
Seat 2: ec6a9a1d (small blind) folded before Flop
Seat 3: a185134c (big blind) collected ($0.1)
Seat 4: 8d56d7e5 folded before Flop (didn't bet)
Seat 5: e557815 folded before Flop (didn't bet)
Seat 6: Hero folded before Flop (didn't bet)


Poker Hand #RC1316968514: Hold'em No Limit  ($0.05/$0.1) - 2023/02/02 14:07:43
Table 'RushAndCash5123774' 6-max Seat #1 is the button
Seat 1: 39dd7bb2 ($7.94 in chips)
Seat 2: Hero ($8.82 in chips)
Seat 3: f7288b7c ($10.97 in chips)
Seat 4: cc1b8ee3 ($10.15 in chips)
Seat 5: 643572d0 ($11.56 in chips)
Seat 6: 2cfe9823 ($10 in chips)
Hero: posts small blind $0.05
f7288b7c: posts big blind $0.1
*** HOLE CARDS ***
Dealt to 39dd7bb2 
Dealt to Hero [Tc 2d]
Dealt to f7288b7c 
Dealt to cc1b8ee3 
Dealt to 643572d0 
Dealt to 2cfe9823 
cc1b8ee3: raises $0.2 to $0.3
643572d0: folds
2cfe9823: folds
39dd7bb2: folds
Hero: folds
f7288b7c: folds
Uncalled bet ($0.2) returned to cc1b8ee3
*** SHOWDOWN ***
cc1b8ee3 collected $0.25 from pot
*** SUMMARY ***
Total pot $0.25 | Rake $0 | Jackpot $0 | Bingo $0 | Fortune $0
Seat 1: 39dd7bb2 (button) folded before Flop (didn't bet)
Seat 2: Hero (small blind) folded before Flop
Seat 3: f7288b7c (big blind) folded before Flop
Seat 4: cc1b8ee3 collected ($0.25)
Seat 5: 643572d0 folded before Flop (didn't bet)
Seat 6: 2cfe9823 folded before Flop (didn't bet)


Poker Hand #RC1316968493: Hold'em No Limit  ($0.05/$0.1) - 2023/02/02 14:07:39
Table 'RushAndCash5123753' 6-max Seat #1 is the button
Seat 1: 69c69bc3 ($10 in chips)
Seat 2: 671d13f1 ($10.27 in chips)
Seat 3: 28b26cef ($10 in chips)
Seat 4: Hero ($8.82 in chips)
Seat 5: bc4185b2 ($11.03 in chips)
Seat 6: 45860c19 ($9.85 in chips)
671d13f1: posts small blind $0.05
28b26cef: posts big blind $0.1
*** HOLE CARDS ***
Dealt to 69c69bc3 
Dealt to 671d13f1 
Dealt to 28b26cef 
Dealt to Hero [7d 8c]
Dealt to bc4185b2 
Dealt to 45860c19 
Hero: folds
bc4185b2: folds
45860c19: raises $0.15 to $0.25
69c69bc3: folds
671d13f1: raises $0.75 to $1
28b26cef: folds
45860c19: folds
Uncalled bet ($0.75) returned to 671d13f1
*** SHOWDOWN ***
671d13f1 collected $0.57 from pot
*** SUMMARY ***
Total pot $0.6 | Rake $0.03 | Jackpot $0 | Bingo $0 | Fortune $0
Seat 1: 69c69bc3 (button) folded before Flop (didn't bet)
Seat 2: 671d13f1 (small blind) collected ($0.57)
Seat 3: 28b26cef (big blind) folded before Flop
Seat 4: Hero folded before Flop (didn't bet)
Seat 5: bc4185b2 folded before Flop (didn't bet)
Seat 6: 45860c19 folded before Flop


Poker Hand #RC1316968471: Hold'em No Limit  ($0.05/$0.1) - 2023/02/02 14:07:35
Table 'RushAndCash5123731' 6-max Seat #1 is the button
Seat 1: Hero ($8.82 in chips)
Seat 2: a350fe66 ($10.23 in chips)
Seat 3: afd25674 ($11.29 in chips)
Seat 4: 17db5231 ($10.29 in chips)
Seat 5: 5291f299 ($18.71 in chips)
Seat 6: c5ca61d4 ($12.02 in chips)
a350fe66: posts small blind $0.05
afd25674: posts big blind $0.1
*** HOLE CARDS ***
Dealt to Hero [9h 6c]
Dealt to a350fe66 
Dealt to afd25674 
Dealt to 17db5231 
Dealt to 5291f299 
Dealt to c5ca61d4 
17db5231: folds
5291f299: folds
c5ca61d4: raises $0.15 to $0.25
Hero: folds
a350fe66: folds
afd25674: folds
Uncalled bet ($0.15) returned to c5ca61d4
*** SHOWDOWN ***
c5ca61d4 collected $0.25 from pot
*** SUMMARY ***
Total pot $0.25 | Rake $0 | Jackpot $0 | Bingo $0 | Fortune $0
Seat 1: Hero (button) folded before Flop (didn't bet)
Seat 2: a350fe66 (small blind) folded before Flop
Seat 3: afd25674 (big blind) folded before Flop
Seat 4: 17db5231 folded before Flop (didn't bet)
Seat 5: 5291f299 folded before Flop (didn't bet)
Seat 6: c5ca61d4 collected ($0.25)


Poker Hand #RC1316968449: Hold'em No Limit  ($0.05/$0.1) - 2023/02/02 14:07:31
Table 'RushAndCash5123709' 6-max Seat #1 is the button
Seat 1: b40b6aa4 ($29.57 in chips)
Seat 2: 101a2367 ($9.75 in chips)
Seat 3: Hero ($8.92 in chips)
Seat 4: a9a3ee5d ($10 in chips)
Seat 5: 97c932ca ($12.03 in chips)
Seat 6: 35dc0748 ($12.24 in chips)
101a2367: posts small blind $0.05
Hero: posts big blind $0.1
*** HOLE CARDS ***
Dealt to b40b6aa4 
Dealt to 101a2367 
Dealt to Hero [4d 5c]
Dealt to a9a3ee5d 
Dealt to 97c932ca 
Dealt to 35dc0748 
a9a3ee5d: folds
97c932ca: raises $0.15 to $0.25
35dc0748: raises $0.51 to $0.76
b40b6aa4: folds
101a2367: folds
Hero: folds
97c932ca: calls $0.51
*** FLOP *** [8s 8c 3s]
97c932ca: checks
35dc0748: bets $0.89
97c932ca: calls $0.89
*** TURN *** [8s 8c 3s] [Th]
97c932ca: checks
35dc0748: bets $2.5
97c932ca: folds
Uncalled bet ($2.5) returned to 35dc0748
*** SHOWDOWN ***
35dc0748 collected $3.14 from pot
*** SUMMARY ***
Total pot $3.45 | Rake $0.16 | Jackpot $0.15 | Bingo $0 | Fortune $0
Board [8s 8c 3s Th]
Seat 1: b40b6aa4 (button) folded before Flop (didn't bet)
Seat 2: 101a2367 (small blind) folded before Flop
Seat 3: Hero (big blind) folded before Flop
Seat 4: a9a3ee5d folded before Flop (didn't bet)
Seat 5: 97c932ca folded on the Turn
Seat 6: 35dc0748 won ($3.14)


Poker Hand #RC1316968430: Hold'em No Limit  ($0.05/$0.1) - 2023/02/02 14:07:27
Table 'RushAndCash5123690' 6-max Seat #1 is the button
Seat 1: 1e2f428c ($10.75 in chips)
Seat 2: 6c03085a ($22.08 in chips)
Seat 3: dc860c57 ($10 in chips)
Seat 4: Hero ($8.92 in chips)
Seat 5: 36995b58 ($23.65 in chips)
Seat 6: 95f47e2f ($18.42 in chips)
6c03085a: posts small blind $0.05
dc860c57: posts big blind $0.1
*** HOLE CARDS ***
Dealt to 1e2f428c 
Dealt to 6c03085a 
Dealt to dc860c57 
Dealt to Hero [3s 5d]
Dealt to 36995b58 
Dealt to 95f47e2f 
Hero: folds
36995b58: folds
95f47e2f: raises $0.12 to $0.22
1e2f428c: folds
6c03085a: folds
dc860c57: folds
Uncalled bet ($0.12) returned to 95f47e2f
*** SHOWDOWN ***
95f47e2f collected $0.25 from pot
*** SUMMARY ***
Total pot $0.25 | Rake $0 | Jackpot $0 | Bingo $0 | Fortune $0
Seat 1: 1e2f428c (button) folded before Flop (didn't bet)
Seat 2: 6c03085a (small blind) folded before Flop
Seat 3: dc860c57 (big blind) folded before Flop
Seat 4: Hero folded before Flop (didn't bet)
Seat 5: 36995b58 folded before Flop (didn't bet)
Seat 6: 95f47e2f collected ($0.25)


Poker Hand #RC1316968401: Hold'em No Limit  ($0.05/$0.1) - 2023/02/02 14:07:22
Table 'RushAndCash5123661' 6-max Seat #1 is the button
Seat 1: 73473cd ($9.95 in chips)
Seat 2: 1beb42 ($6.19 in chips)
Seat 3: 5421c2ce ($18.59 in chips)
Seat 4: f56e3525 ($10.33 in chips)
Seat 5: Hero ($8.92 in chips)
Seat 6: c29495ca ($18.07 in chips)
1beb42: posts small blind $0.05
5421c2ce: posts big blind $0.1
*** HOLE CARDS ***
Dealt to 73473cd 
Dealt to 1beb42 
Dealt to 5421c2ce 
Dealt to f56e3525 
Dealt to Hero [8h Ks]
Dealt to c29495ca 
f56e3525: folds
Hero: folds
c29495ca: folds
73473cd: raises $0.15 to $0.25
1beb42: folds
5421c2ce: folds
Uncalled bet ($0.15) returned to 73473cd
*** SHOWDOWN ***
73473cd collected $0.25 from pot
*** SUMMARY ***
Total pot $0.25 | Rake $0 | Jackpot $0 | Bingo $0 | Fortune $0
Seat 1: 73473cd (button) collected ($0.25)
Seat 2: 1beb42 (small blind) folded before Flop
Seat 3: 5421c2ce (big blind) folded before Flop
Seat 4: f56e3525 folded before Flop (didn't bet)
Seat 5: Hero folded before Flop (didn't bet)
Seat 6: c29495ca folded before Flop (didn't bet)


Poker Hand #RC1316968347: Hold'em No Limit  ($0.05/$0.1) - 2023/02/02 14:07:12
Table 'RushAndCash5123607' 6-max Seat #1 is the button
Seat 1: Hero ($8.92 in chips)
Seat 2: 984f5587 ($10.09 in chips)
Seat 3: 79c753e6 ($17.42 in chips)
Seat 4: 64511e15 ($10.42 in chips)
Seat 5: a3917618 ($12.58 in chips)
Seat 6: 21f098d ($10 in chips)
984f5587: posts small blind $0.05
79c753e6: posts big blind $0.1
*** HOLE CARDS ***
Dealt to Hero [5h 5d]
Dealt to 984f5587 
Dealt to 79c753e6 
Dealt to 64511e15 
Dealt to a3917618 
Dealt to 21f098d 
64511e15: raises $0.2 to $0.3
a3917618: folds
21f098d: raises $0.57 to $0.87
Hero: folds
984f5587: folds
79c753e6: raises $1.15 to $2.02
64511e15: folds
21f098d: folds
Uncalled bet ($1.15) returned to 79c753e6
*** SHOWDOWN ***
79c753e6 collected $1.99 from pot
*** SUMMARY ***
Total pot $2.09 | Rake $0.1 | Jackpot $0 | Bingo $0 | Fortune $0
Seat 1: Hero (button) folded before Flop (didn't bet)
Seat 2: 984f5587 (small blind) folded before Flop
Seat 3: 79c753e6 (big blind) collected ($1.99)
Seat 4: 64511e15 folded before Flop
Seat 5: a3917618 folded before Flop (didn't bet)
Seat 6: 21f098d folded before Flop


Poker Hand #RC1316968280: Hold'em No Limit  ($0.05/$0.1) - 2023/02/02 14:06:59
Table 'RushAndCash5123540' 6-max Seat #1 is the button
Seat 1: cd8d77cf ($10.97 in chips)
Seat 2: Hero ($8.97 in chips)
Seat 3: 23429e9d ($15.17 in chips)
Seat 4: 5b7a7c5d ($9.59 in chips)
Seat 5: 4dc2d5db ($37.37 in chips)
Seat 6: f971222 ($14.12 in chips)
Hero: posts small blind $0.05
23429e9d: posts big blind $0.1
*** HOLE CARDS ***
Dealt to cd8d77cf 
Dealt to Hero [Jh Ad]
Dealt to 23429e9d 
Dealt to 5b7a7c5d 
Dealt to 4dc2d5db 
Dealt to f971222 
5b7a7c5d: raises $0.15 to $0.25
4dc2d5db: folds
f971222: folds
cd8d77cf: folds
Hero: folds
23429e9d: folds
Uncalled bet ($0.15) returned to 5b7a7c5d
*** SHOWDOWN ***
5b7a7c5d collected $0.25 from pot
*** SUMMARY ***
Total pot $0.25 | Rake $0 | Jackpot $0 | Bingo $0 | Fortune $0
Seat 1: cd8d77cf (button) folded before Flop (didn't bet)
Seat 2: Hero (small blind) folded before Flop
Seat 3: 23429e9d (big blind) folded before Flop
Seat 4: 5b7a7c5d collected ($0.25)
Seat 5: 4dc2d5db folded before Flop (didn't bet)
Seat 6: f971222 folded before Flop (didn't bet)


Poker Hand #RC1316968228: Hold'em No Limit  ($0.05/$0.1) - 2023/02/02 14:06:50
Table 'RushAndCash5123488' 6-max Seat #1 is the button
Seat 1: 2c7d4ccb ($18.21 in chips)
Seat 2: c1f7f989 ($15.2 in chips)
Seat 3: Hero ($8.92 in chips)
Seat 4: 1ac652fb ($13.64 in chips)
Seat 5: 28b26cef ($10 in chips)
Seat 6: f7288b7c ($10.74 in chips)
c1f7f989: posts small blind $0.05
Hero: posts big blind $0.1
*** HOLE CARDS ***
Dealt to 2c7d4ccb 
Dealt to c1f7f989 
Dealt to Hero [Ad 6d]
Dealt to 1ac652fb 
Dealt to 28b26cef 
Dealt to f7288b7c 
1ac652fb: folds
28b26cef: folds
f7288b7c: folds
2c7d4ccb: folds
c1f7f989: folds
Uncalled bet ($0.05) returned to Hero
*** SHOWDOWN ***
Hero collected $0.1 from pot
*** SUMMARY ***
Total pot $0.1 | Rake $0 | Jackpot $0 | Bingo $0 | Fortune $0
Seat 1: 2c7d4ccb (button) folded before Flop (didn't bet)
Seat 2: c1f7f989 (small blind) folded before Flop
Seat 3: Hero (big blind) collected ($0.1)
Seat 4: 1ac652fb folded before Flop (didn't bet)
Seat 5: 28b26cef folded before Flop (didn't bet)
Seat 6: f7288b7c folded before Flop (didn't bet)


Poker Hand #RC1316968146: Hold'em No Limit  ($0.05/$0.1) - 2023/02/02 14:06:35
Table 'RushAndCash5123406' 6-max Seat #1 is the button
Seat 1: 1d98175 ($15.92 in chips)
Seat 2: 5fb55c79 ($10 in chips)
Seat 3: 4875e50a ($15.98 in chips)
Seat 4: f2679df9 ($15.13 in chips)
Seat 5: Hero ($8.92 in chips)
Seat 6: 98928c59 ($10 in chips)
5fb55c79: posts small blind $0.05
4875e50a: posts big blind $0.1
*** HOLE CARDS ***
Dealt to 1d98175 
Dealt to 5fb55c79 
Dealt to 4875e50a 
Dealt to f2679df9 
Dealt to Hero [6s Js]
Dealt to 98928c59 
f2679df9: folds
Hero: folds
98928c59: raises $0.12 to $0.22
1d98175: raises $0.6 to $0.82
5fb55c79: raises $1.68 to $2.5
4875e50a: folds
98928c59: folds
1d98175: folds
Uncalled bet ($1.68) returned to 5fb55c79
*** SHOWDOWN ***
5fb55c79 collected $1.87 from pot
*** SUMMARY ***
Total pot $1.96 | Rake $0.09 | Jackpot $0 | Bingo $0 | Fortune $0
Seat 1: 1d98175 (button) folded before Flop
Seat 2: 5fb55c79 (small blind) collected ($1.87)
Seat 3: 4875e50a (big blind) folded before Flop
Seat 4: f2679df9 folded before Flop (didn't bet)
Seat 5: Hero folded before Flop (didn't bet)
Seat 6: 98928c59 folded before Flop


Poker Hand #RC1316968124: Hold'em No Limit  ($0.05/$0.1) - 2023/02/02 14:06:31
Table 'RushAndCash5123384' 6-max Seat #1 is the button
Seat 1: 572cd94 ($14.83 in chips)
Seat 2: 30ced322 ($14.02 in chips)
Seat 3: 2eca8532 ($15.67 in chips)
Seat 4: dcb6f389 ($10.43 in chips)
Seat 5: Hero ($8.92 in chips)
Seat 6: 28b26cef ($10.07 in chips)
30ced322: posts small blind $0.05
2eca8532: posts big blind $0.1
*** HOLE CARDS ***
Dealt to 572cd94 
Dealt to 30ced322 
Dealt to 2eca8532 
Dealt to dcb6f389 
Dealt to Hero [6h 4h]
Dealt to 28b26cef 
dcb6f389: folds
Hero: folds
28b26cef: raises $0.2 to $0.3
572cd94: raises $0.75 to $1.05
30ced322: folds
2eca8532: folds
28b26cef: folds
Uncalled bet ($0.75) returned to 572cd94
*** SHOWDOWN ***
572cd94 collected $0.72 from pot
*** SUMMARY ***
Total pot $0.75 | Rake $0.03 | Jackpot $0 | Bingo $0 | Fortune $0
Seat 1: 572cd94 (button) collected ($0.72)
Seat 2: 30ced322 (small blind) folded before Flop
Seat 3: 2eca8532 (big blind) folded before Flop
Seat 4: dcb6f389 folded before Flop (didn't bet)
Seat 5: Hero folded before Flop (didn't bet)
Seat 6: 28b26cef folded before Flop


Poker Hand #RC1316968098: Hold'em No Limit  ($0.05/$0.1) - 2023/02/02 14:06:25
Table 'RushAndCash5123358' 6-max Seat #1 is the button
Seat 1: b68b3ba3 ($21.38 in chips)
Seat 2: 8f740579 ($10.93 in chips)
Seat 3: b0dcb3d9 ($10 in chips)
Seat 4: 306b3799 ($9.65 in chips)
Seat 5: Hero ($8.92 in chips)
Seat 6: 70ddaa82 ($10 in chips)
8f740579: posts small blind $0.05
b0dcb3d9: posts big blind $0.1
*** HOLE CARDS ***
Dealt to b68b3ba3 
Dealt to 8f740579 
Dealt to b0dcb3d9 
Dealt to 306b3799 
Dealt to Hero [4c Ts]
Dealt to 70ddaa82 
306b3799: folds
Hero: folds
70ddaa82: raises $0.15 to $0.25
b68b3ba3: calls $0.25
8f740579: folds
b0dcb3d9: calls $0.15
*** FLOP *** [Tc 8h 3s]
b0dcb3d9: checks
70ddaa82: checks
b68b3ba3: bets $0.47
b0dcb3d9: folds
70ddaa82: folds
Uncalled bet ($0.47) returned to b68b3ba3
*** SHOWDOWN ***
b68b3ba3 collected $0.76 from pot
*** SUMMARY ***
Total pot $0.8 | Rake $0.04 | Jackpot $0 | Bingo $0 | Fortune $0
Board [Tc 8h 3s]
Seat 1: b68b3ba3 (button) won ($0.76)
Seat 2: 8f740579 (small blind) folded before Flop
Seat 3: b0dcb3d9 (big blind) folded on the Flop
Seat 4: 306b3799 folded before Flop (didn't bet)
Seat 5: Hero folded before Flop (didn't bet)
Seat 6: 70ddaa82 folded on the Flop


Poker Hand #RC1316968064: Hold'em No Limit  ($0.05/$0.1) - 2023/02/02 14:06:19
Table 'RushAndCash5123324' 6-max Seat #1 is the button
Seat 1: 309311cd ($26.77 in chips)
Seat 2: 77b06e9b ($10 in chips)
Seat 3: Hero ($9.02 in chips)
Seat 4: 580fdf93 ($35.66 in chips)
Seat 5: 44aa8ff7 ($9.98 in chips)
Seat 6: 2eb8267a ($10.25 in chips)
77b06e9b: posts small blind $0.05
Hero: posts big blind $0.1
*** HOLE CARDS ***
Dealt to 309311cd 
Dealt to 77b06e9b 
Dealt to Hero [5d Tc]
Dealt to 580fdf93 
Dealt to 44aa8ff7 
Dealt to 2eb8267a 
580fdf93: folds
44aa8ff7: folds
2eb8267a: raises $0.15 to $0.25
309311cd: folds
77b06e9b: folds
Hero: folds
Uncalled bet ($0.15) returned to 2eb8267a
*** SHOWDOWN ***
2eb8267a collected $0.25 from pot
*** SUMMARY ***
Total pot $0.25 | Rake $0 | Jackpot $0 | Bingo $0 | Fortune $0
Seat 1: 309311cd (button) folded before Flop (didn't bet)
Seat 2: 77b06e9b (small blind) folded before Flop
Seat 3: Hero (big blind) folded before Flop
Seat 4: 580fdf93 folded before Flop (didn't bet)
Seat 5: 44aa8ff7 folded before Flop (didn't bet)
Seat 6: 2eb8267a collected ($0.25)


Poker Hand #RC1316968039: Hold'em No Limit  ($0.05/$0.1) - 2023/02/02 14:06:14
Table 'RushAndCash5123299' 6-max Seat #1 is the button
Seat 1: Hero ($9.02 in chips)
Seat 2: f50a59e0 ($4.31 in chips)
Seat 3: 306b3799 ($9.75 in chips)
Seat 4: 692753f ($18.58 in chips)
Seat 5: 3f72d59c ($12.29 in chips)
Seat 6: 5291f299 ($18.71 in chips)
f50a59e0: posts small blind $0.05
306b3799: posts big blind $0.1
*** HOLE CARDS ***
Dealt to Hero [2s 9s]
Dealt to f50a59e0 
Dealt to 306b3799 
Dealt to 692753f 
Dealt to 3f72d59c 
Dealt to 5291f299 
692753f: folds
3f72d59c: folds
5291f299: folds
Hero: folds
f50a59e0: raises $0.1 to $0.2
306b3799: folds
Uncalled bet ($0.1) returned to f50a59e0
*** SHOWDOWN ***
f50a59e0 collected $0.2 from pot
*** SUMMARY ***
Total pot $0.2 | Rake $0 | Jackpot $0 | Bingo $0 | Fortune $0
Seat 1: Hero (button) folded before Flop (didn't bet)
Seat 2: f50a59e0 (small blind) collected ($0.2)
Seat 3: 306b3799 (big blind) folded before Flop
Seat 4: 692753f folded before Flop (didn't bet)
Seat 5: 3f72d59c folded before Flop (didn't bet)
Seat 6: 5291f299 folded before Flop (didn't bet)


Poker Hand #RC1316968017: Hold'em No Limit  ($0.05/$0.1) - 2023/02/02 14:06:10
Table 'RushAndCash5123277' 6-max Seat #1 is the button
Seat 1: 79c753e6 ($17.17 in chips)
Seat 2: Hero ($9.07 in chips)
Seat 3: d61170a9 ($6.34 in chips)
Seat 4: 76deb1e3 ($10.32 in chips)
Seat 5: 4c09ee18 ($14.17 in chips)
Seat 6: bea2df50 ($9.97 in chips)
Hero: posts small blind $0.05
d61170a9: posts big blind $0.1
*** HOLE CARDS ***
Dealt to 79c753e6 
Dealt to Hero [Ts 7s]
Dealt to d61170a9 
Dealt to 76deb1e3 
Dealt to 4c09ee18 
Dealt to bea2df50 
76deb1e3: folds
4c09ee18: folds
bea2df50: folds
79c753e6: raises $0.15 to $0.25
Hero: folds
d61170a9: folds
Uncalled bet ($0.15) returned to 79c753e6
*** SHOWDOWN ***
79c753e6 collected $0.25 from pot
*** SUMMARY ***
Total pot $0.25 | Rake $0 | Jackpot $0 | Bingo $0 | Fortune $0
Seat 1: 79c753e6 (button) collected ($0.25)
Seat 2: Hero (small blind) folded before Flop
Seat 3: d61170a9 (big blind) folded before Flop
Seat 4: 76deb1e3 folded before Flop (didn't bet)
Seat 5: 4c09ee18 folded before Flop (didn't bet)
Seat 6: bea2df50 folded before Flop (didn't bet)


Poker Hand #RC1316967996: Hold'em No Limit  ($0.05/$0.1) - 2023/02/02 14:06:06
Table 'RushAndCash5123256' 6-max Seat #1 is the button
Seat 1: f4c833d7 ($16 in chips)
Seat 2: d61170a9 ($6.39 in chips)
Seat 3: d0dab242 ($10 in chips)
Seat 4: Hero ($9.07 in chips)
Seat 5: 28b26cef ($10.17 in chips)
Seat 6: e557815 ($28.89 in chips)
d61170a9: posts small blind $0.05
d0dab242: posts big blind $0.1
*** HOLE CARDS ***
Dealt to f4c833d7 
Dealt to d61170a9 
Dealt to d0dab242 
Dealt to Hero [5d Jh]
Dealt to 28b26cef 
Dealt to e557815 
Hero: folds
28b26cef: folds
e557815: folds
f4c833d7: folds
d61170a9: folds
Uncalled bet ($0.05) returned to d0dab242
*** SHOWDOWN ***
d0dab242 collected $0.1 from pot
*** SUMMARY ***
Total pot $0.1 | Rake $0 | Jackpot $0 | Bingo $0 | Fortune $0
Seat 1: f4c833d7 (button) folded before Flop (didn't bet)
Seat 2: d61170a9 (small blind) folded before Flop
Seat 3: d0dab242 (big blind) collected ($0.1)
Seat 4: Hero folded before Flop (didn't bet)
Seat 5: 28b26cef folded before Flop (didn't bet)
Seat 6: e557815 folded before Flop (didn't bet)


Poker Hand #RC1316967935: Hold'em No Limit  ($0.05/$0.1) - 2023/02/02 14:05:55
Table 'RushAndCash5123195' 6-max Seat #1 is the button
Seat 1: 2669e4dd ($11.26 in chips)
Seat 2: 65b54471 ($3.55 in chips)
Seat 3: 1d98a6e5 ($14.1 in chips)
Seat 4: 3a59afdc ($10.18 in chips)
Seat 5: Hero ($8.92 in chips)
Seat 6: 46885d6b ($11.03 in chips)
65b54471: posts small blind $0.05
1d98a6e5: posts big blind $0.1
*** HOLE CARDS ***
Dealt to 2669e4dd 
Dealt to 65b54471 
Dealt to 1d98a6e5 
Dealt to 3a59afdc 
Dealt to Hero [Qd Jd]
Dealt to 46885d6b 
3a59afdc: folds
Hero: raises $0.15 to $0.25
46885d6b: folds
2669e4dd: folds
65b54471: folds
1d98a6e5: folds
Uncalled bet ($0.15) returned to Hero
*** SHOWDOWN ***
Hero collected $0.25 from pot
*** SUMMARY ***
Total pot $0.25 | Rake $0 | Jackpot $0 | Bingo $0 | Fortune $0
Seat 1: 2669e4dd (button) folded before Flop (didn't bet)
Seat 2: 65b54471 (small blind) folded before Flop
Seat 3: 1d98a6e5 (big blind) folded before Flop
Seat 4: 3a59afdc folded before Flop (didn't bet)
Seat 5: Hero collected ($0.25)
Seat 6: 46885d6b folded before Flop (didn't bet)


Poker Hand #RC1316967912: Hold'em No Limit  ($0.05/$0.1) - 2023/02/02 14:05:51
Table 'RushAndCash5123172' 6-max Seat #1 is the button
Seat 1: 2e79ae04 ($17.98 in chips)
Seat 2: 28829331 ($11.46 in chips)
Seat 3: Hero ($9.02 in chips)
Seat 4: 7ed16543 ($19 in chips)
Seat 5: 95482d10 ($33.98 in chips)
Seat 6: ee57d6f8 ($14.03 in chips)
28829331: posts small blind $0.05
Hero: posts big blind $0.1
*** HOLE CARDS ***
Dealt to 2e79ae04 
Dealt to 28829331 
Dealt to Hero [9s 6c]
Dealt to 7ed16543 
Dealt to 95482d10 
Dealt to ee57d6f8 
7ed16543: folds
95482d10: folds
ee57d6f8: raises $0.15 to $0.25
2e79ae04: folds
28829331: folds
Hero: folds
Uncalled bet ($0.15) returned to ee57d6f8
*** SHOWDOWN ***
ee57d6f8 collected $0.25 from pot
*** SUMMARY ***
Total pot $0.25 | Rake $0 | Jackpot $0 | Bingo $0 | Fortune $0
Seat 1: 2e79ae04 (button) folded before Flop (didn't bet)
Seat 2: 28829331 (small blind) folded before Flop
Seat 3: Hero (big blind) folded before Flop
Seat 4: 7ed16543 folded before Flop (didn't bet)
Seat 5: 95482d10 folded before Flop (didn't bet)
Seat 6: ee57d6f8 collected ($0.25)


Poker Hand #RC1316967476: Hold'em No Limit  ($0.05/$0.1) - 2023/02/02 14:04:34
Table 'RushAndCash5122736' 6-max Seat #1 is the button
Seat 1: Hero ($8.31 in chips)
Seat 2: e557815 ($28.3 in chips)
Seat 3: 1136a089 ($9.2 in chips)
Seat 4: 30ced322 ($13.02 in chips)
Seat 5: f50a59e0 ($4.1 in chips)
Seat 6: 28829331 ($12.09 in chips)
e557815: posts small blind $0.05
1136a089: posts big blind $0.1
*** HOLE CARDS ***
Dealt to Hero [9h Th]
Dealt to e557815 
Dealt to 1136a089 
Dealt to 30ced322 
Dealt to f50a59e0 
Dealt to 28829331 
30ced322: folds
f50a59e0: folds
28829331: raises $0.15 to $0.25
Hero: calls $0.25
e557815: folds
1136a089: folds
*** FLOP *** [7h 9c 3d]
28829331: bets $0.38
Hero: calls $0.38
*** TURN *** [7h 9c 3d] [Jd]
28829331: checks
Hero: bets $0.42
28829331: folds
Uncalled bet ($0.42) returned to Hero
*** SHOWDOWN ***
Hero collected $1.34 from pot
*** SUMMARY ***
Total pot $1.41 | Rake $0.07 | Jackpot $0 | Bingo $0 | Fortune $0
Board [7h 9c 3d Jd]
Seat 1: Hero (button) won ($1.34)
Seat 2: e557815 (small blind) folded before Flop
Seat 3: 1136a089 (big blind) folded before Flop
Seat 4: 30ced322 folded before Flop (didn't bet)
Seat 5: f50a59e0 folded before Flop (didn't bet)
Seat 6: 28829331 folded on the Turn


Poker Hand #RC1316967451: Hold'em No Limit  ($0.05/$0.1) - 2023/02/02 14:04:30
Table 'RushAndCash5122711' 6-max Seat #1 is the button
Seat 1: f50a59e0 ($4.1 in chips)
Seat 2: 2ddb4a39 ($10 in chips)
Seat 3: 84bd5921 ($10.06 in chips)
Seat 4: 1136a089 ($9.2 in chips)
Seat 5: Hero ($8.31 in chips)
Seat 6: e557815 ($28.3 in chips)
2ddb4a39: posts small blind $0.05
84bd5921: posts big blind $0.1
*** HOLE CARDS ***
Dealt to f50a59e0 
Dealt to 2ddb4a39 
Dealt to 84bd5921 
Dealt to 1136a089 
Dealt to Hero [Js 2h]
Dealt to e557815 
1136a089: folds
Hero: folds
e557815: folds
f50a59e0: folds
2ddb4a39: folds
Uncalled bet ($0.05) returned to 84bd5921
*** SHOWDOWN ***
84bd5921 collected $0.1 from pot
*** SUMMARY ***
Total pot $0.1 | Rake $0 | Jackpot $0 | Bingo $0 | Fortune $0
Seat 1: f50a59e0 (button) folded before Flop (didn't bet)
Seat 2: 2ddb4a39 (small blind) folded before Flop
Seat 3: 84bd5921 (big blind) collected ($0.1)
Seat 4: 1136a089 folded before Flop (didn't bet)
Seat 5: Hero folded before Flop (didn't bet)
Seat 6: e557815 folded before Flop (didn't bet)


Poker Hand #RC1316967428: Hold'em No Limit  ($0.05/$0.1) - 2023/02/02 14:04:26
Table 'RushAndCash5122688' 6-max Seat #1 is the button
Seat 1: 50acbe7c ($19.68 in chips)
Seat 2: Hero ($8.36 in chips)
Seat 3: 554fdc7 ($17.24 in chips)
Seat 4: 771cdbd4 ($11.6 in chips)
Seat 5: d0dab242 ($10.1 in chips)
Seat 6: b4d21b83 ($10.15 in chips)
Hero: posts small blind $0.05
554fdc7: posts big blind $0.1
*** HOLE CARDS ***
Dealt to 50acbe7c 
Dealt to Hero [8c 5d]
Dealt to 554fdc7 
Dealt to 771cdbd4 
Dealt to d0dab242 
Dealt to b4d21b83 
771cdbd4: folds
d0dab242: folds
b4d21b83: folds
50acbe7c: raises $0.15 to $0.25
Hero: folds
554fdc7: folds
Uncalled bet ($0.15) returned to 50acbe7c
*** SHOWDOWN ***
50acbe7c collected $0.25 from pot
*** SUMMARY ***
Total pot $0.25 | Rake $0 | Jackpot $0 | Bingo $0 | Fortune $0
Seat 1: 50acbe7c (button) collected ($0.25)
Seat 2: Hero (small blind) folded before Flop
Seat 3: 554fdc7 (big blind) folded before Flop
Seat 4: 771cdbd4 folded before Flop (didn't bet)
Seat 5: d0dab242 folded before Flop (didn't bet)
Seat 6: b4d21b83 folded before Flop (didn't bet)


Poker Hand #RC1316967408: Hold'em No Limit  ($0.05/$0.1) - 2023/02/02 14:04:21
Table 'RushAndCash5122668' 6-max Seat #1 is the button
Seat 1: d0dab242 ($10.1 in chips)
Seat 2: 7033435b ($10.25 in chips)
Seat 3: dea4decb ($19.8 in chips)
Seat 4: 6c03085a ($23.94 in chips)
Seat 5: fd3c236a ($12.75 in chips)
Seat 6: Hero ($8.36 in chips)
7033435b: posts small blind $0.05
dea4decb: posts big blind $0.1
*** HOLE CARDS ***
Dealt to d0dab242 
Dealt to 7033435b 
Dealt to dea4decb 
Dealt to 6c03085a 
Dealt to fd3c236a 
Dealt to Hero [4c Js]
6c03085a: folds
fd3c236a: folds
Hero: folds
d0dab242: folds
7033435b: folds
Uncalled bet ($0.05) returned to dea4decb
*** SHOWDOWN ***
dea4decb collected $0.1 from pot
*** SUMMARY ***
Total pot $0.1 | Rake $0 | Jackpot $0 | Bingo $0 | Fortune $0
Seat 1: d0dab242 (button) folded before Flop (didn't bet)
Seat 2: 7033435b (small blind) folded before Flop
Seat 3: dea4decb (big blind) collected ($0.1)
Seat 4: 6c03085a folded before Flop (didn't bet)
Seat 5: fd3c236a folded before Flop (didn't bet)
Seat 6: Hero folded before Flop (didn't bet)


Poker Hand #RC1316966695: Hold'em No Limit  ($0.05/$0.1) - 2023/02/02 14:02:14
Table 'RushAndCash5121955' 6-max Seat #1 is the button
Seat 1: 2cfe9823 ($10.15 in chips)
Seat 2: 37c77bfe ($21.22 in chips)
Seat 3: ba4bcf27 ($10 in chips)
Seat 4: b40b6aa4 ($29.64 in chips)
Seat 5: Hero ($11.08 in chips)
Seat 6: 59bf16ec ($5.91 in chips)
37c77bfe: posts small blind $0.05
ba4bcf27: posts big blind $0.1
*** HOLE CARDS ***
Dealt to 2cfe9823 
Dealt to 37c77bfe 
Dealt to ba4bcf27 
Dealt to b40b6aa4 
Dealt to Hero [Jh Js]
Dealt to 59bf16ec 
b40b6aa4: folds
Hero: raises $0.15 to $0.25
59bf16ec: calls $0.25
2cfe9823: folds
37c77bfe: calls $0.2
ba4bcf27: folds
*** FLOP *** [Qs 8s 2c]
37c77bfe: checks
Hero: checks
59bf16ec: checks
*** TURN *** [Qs 8s 2c] [9c]
37c77bfe: checks
Hero: bets $0.38
59bf16ec: calls $0.38
37c77bfe: folds
*** RIVER *** [Qs 8s 2c 9c] [6d]
Hero: bets $0.64
59bf16ec: raises $1.45 to $2.09
Hero: calls $1.45
59bf16ec: shows [2h 2s] (Three Twos)
Hero: shows [Jh Js] (Pair of Jacks)
*** SHOWDOWN ***
59bf16ec collected $5.31 from pot
*** SUMMARY ***
Total pot $5.79 | Rake $0.33 | Jackpot $0.15 | Bingo $0 | Fortune $0
Board [Qs 8s 2c 9c 6d]
Seat 1: 2cfe9823 (button) folded before Flop (didn't bet)
Seat 2: 37c77bfe (small blind) folded on the Turn
Seat 3: ba4bcf27 (big blind) folded before Flop
Seat 4: b40b6aa4 folded before Flop (didn't bet)
Seat 5: Hero showed [Jh Js] and lost with Pair of Jacks
Seat 6: 59bf16ec showed [2h 2s] and won ($5.31) with Three Twos


Poker Hand #RC1316966673: Hold'em No Limit  ($0.05/$0.1) - 2023/02/02 14:02:10
Table 'RushAndCash5121933' 6-max Seat #1 is the button
Seat 1: 8cef4f6e ($10.1 in chips)
Seat 2: 4a335b53 ($12.37 in chips)
Seat 3: db8fa48b ($11.14 in chips)
Seat 4: 37c77bfe ($21.22 in chips)
Seat 5: 9b7234f2 ($10.72 in chips)
Seat 6: Hero ($11.08 in chips)
4a335b53: posts small blind $0.05
db8fa48b: posts big blind $0.1
*** HOLE CARDS ***
Dealt to 8cef4f6e 
Dealt to 4a335b53 
Dealt to db8fa48b 
Dealt to 37c77bfe 
Dealt to 9b7234f2 
Dealt to Hero [3c 6c]
37c77bfe: folds
9b7234f2: folds
Hero: folds
8cef4f6e: raises $0.15 to $0.25
4a335b53: raises $0.9 to $1.15
db8fa48b: folds
8cef4f6e: folds
Uncalled bet ($0.9) returned to 4a335b53
*** SHOWDOWN ***
4a335b53 collected $0.57 from pot
*** SUMMARY ***
Total pot $0.6 | Rake $0.03 | Jackpot $0 | Bingo $0 | Fortune $0
Seat 1: 8cef4f6e (button) folded before Flop
Seat 2: 4a335b53 (small blind) collected ($0.57)
Seat 3: db8fa48b (big blind) folded before Flop
Seat 4: 37c77bfe folded before Flop (didn't bet)
Seat 5: 9b7234f2 folded before Flop (didn't bet)
Seat 6: Hero folded before Flop (didn't bet)


Poker Hand #RC1316966613: Hold'em No Limit  ($0.05/$0.1) - 2023/02/02 14:01:58
Table 'RushAndCash5121873' 6-max Seat #1 is the button
Seat 1: 79c753e6 ($13 in chips)
Seat 2: 210420c4 ($11.02 in chips)
Seat 3: 2940f906 ($11.03 in chips)
Seat 4: 1c69fcd5 ($15.15 in chips)
Seat 5: Hero ($10.93 in chips)
Seat 6: 8d56d7e5 ($10.42 in chips)
210420c4: posts small blind $0.05
2940f906: posts big blind $0.1
*** HOLE CARDS ***
Dealt to 79c753e6 
Dealt to 210420c4 
Dealt to 2940f906 
Dealt to 1c69fcd5 
Dealt to Hero [9c Kc]
Dealt to 8d56d7e5 
1c69fcd5: folds
Hero: raises $0.15 to $0.25
8d56d7e5: folds
79c753e6: folds
210420c4: folds
2940f906: folds
Uncalled bet ($0.15) returned to Hero
*** SHOWDOWN ***
Hero collected $0.25 from pot
*** SUMMARY ***
Total pot $0.25 | Rake $0 | Jackpot $0 | Bingo $0 | Fortune $0
Seat 1: 79c753e6 (button) folded before Flop (didn't bet)
Seat 2: 210420c4 (small blind) folded before Flop
Seat 3: 2940f906 (big blind) folded before Flop
Seat 4: 1c69fcd5 folded before Flop (didn't bet)
Seat 5: Hero collected ($0.25)
Seat 6: 8d56d7e5 folded before Flop (didn't bet)


Poker Hand #RC1316966591: Hold'em No Limit  ($0.05/$0.1) - 2023/02/02 14:01:54
Table 'RushAndCash5121851' 6-max Seat #1 is the button
Seat 1: 28829331 ($11.8 in chips)
Seat 2: dc581a50 ($28.56 in chips)
Seat 3: Hero ($11.03 in chips)
Seat 4: 7d55b12d ($10.34 in chips)
Seat 5: 2326f258 ($10.05 in chips)
Seat 6: 21467c52 ($12.41 in chips)
dc581a50: posts small blind $0.05
Hero: posts big blind $0.1
*** HOLE CARDS ***
Dealt to 28829331 
Dealt to dc581a50 
Dealt to Hero [3h Kd]
Dealt to 7d55b12d 
Dealt to 2326f258 
Dealt to 21467c52 
7d55b12d: folds
2326f258: folds
21467c52: folds
28829331: folds
dc581a50: raises $0.2 to $0.3
Hero: folds
Uncalled bet ($0.2) returned to dc581a50
*** SHOWDOWN ***
dc581a50 collected $0.2 from pot
*** SUMMARY ***
Total pot $0.2 | Rake $0 | Jackpot $0 | Bingo $0 | Fortune $0
Seat 1: 28829331 (button) folded before Flop (didn't bet)
Seat 2: dc581a50 (small blind) collected ($0.2)
Seat 3: Hero (big blind) folded before Flop
Seat 4: 7d55b12d folded before Flop (didn't bet)
Seat 5: 2326f258 folded before Flop (didn't bet)
Seat 6: 21467c52 folded before Flop (didn't bet)


Poker Hand #RC1316966571: Hold'em No Limit  ($0.05/$0.1) - 2023/02/02 14:01:50
Table 'RushAndCash5121831' 6-max Seat #1 is the button
Seat 1: 309311cd ($24.54 in chips)
Seat 2: Hero ($11.08 in chips)
Seat 3: 42e299f4 ($10 in chips)
Seat 4: 690e4249 ($11.03 in chips)
Seat 5: a369504c ($11.68 in chips)
Seat 6: 84c6ab9d ($8.34 in chips)
Hero: posts small blind $0.05
42e299f4: posts big blind $0.1
*** HOLE CARDS ***
Dealt to 309311cd 
Dealt to Hero [Qd 2c]
Dealt to 42e299f4 
Dealt to 690e4249 
Dealt to a369504c 
Dealt to 84c6ab9d 
690e4249: folds
a369504c: folds
84c6ab9d: folds
309311cd: folds
Hero: folds
Uncalled bet ($0.05) returned to 42e299f4
*** SHOWDOWN ***
42e299f4 collected $0.1 from pot
*** SUMMARY ***
Total pot $0.1 | Rake $0 | Jackpot $0 | Bingo $0 | Fortune $0
Seat 1: 309311cd (button) folded before Flop (didn't bet)
Seat 2: Hero (small blind) folded before Flop
Seat 3: 42e299f4 (big blind) collected ($0.1)
Seat 4: 690e4249 folded before Flop (didn't bet)
Seat 5: a369504c folded before Flop (didn't bet)
Seat 6: 84c6ab9d folded before Flop (didn't bet)


Poker Hand #RC1316966551: Hold'em No Limit  ($0.05/$0.1) - 2023/02/02 14:01:46
Table 'RushAndCash5121811' 6-max Seat #1 is the button
Seat 1: Hero ($11.08 in chips)
Seat 2: 70157308 ($10.48 in chips)
Seat 3: e58114d9 ($14.25 in chips)
Seat 4: a56a4b2d ($10.47 in chips)
Seat 5: 6a39bd11 ($10.8 in chips)
Seat 6: f659ca7d ($6.4 in chips)
70157308: posts small blind $0.05
e58114d9: posts big blind $0.1
*** HOLE CARDS ***
Dealt to Hero [Qc 3h]
Dealt to 70157308 
Dealt to e58114d9 
Dealt to a56a4b2d 
Dealt to 6a39bd11 
Dealt to f659ca7d 
a56a4b2d: folds
6a39bd11: folds
f659ca7d: folds
Hero: folds
70157308: folds
Uncalled bet ($0.05) returned to e58114d9
*** SHOWDOWN ***
e58114d9 collected $0.1 from pot
*** SUMMARY ***
Total pot $0.1 | Rake $0 | Jackpot $0 | Bingo $0 | Fortune $0
Seat 1: Hero (button) folded before Flop (didn't bet)
Seat 2: 70157308 (small blind) folded before Flop
Seat 3: e58114d9 (big blind) collected ($0.1)
Seat 4: a56a4b2d folded before Flop (didn't bet)
Seat 5: 6a39bd11 folded before Flop (didn't bet)
Seat 6: f659ca7d folded before Flop (didn't bet)


Poker Hand #RC1316966402: Hold'em No Limit  ($0.05/$0.1) - 2023/02/02 14:01:18
Table 'RushAndCash5121662' 6-max Seat #1 is the button
Seat 1: 94298a61 ($4.54 in chips)
Seat 2: db8fa48b ($11.04 in chips)
Seat 3: 59db7a29 ($11.36 in chips)
Seat 4: 5421c2ce ($18.71 in chips)
Seat 5: Hero ($10.93 in chips)
Seat 6: f50a59e0 ($4 in chips)
db8fa48b: posts small blind $0.05
59db7a29: posts big blind $0.1
*** HOLE CARDS ***
Dealt to 94298a61 
Dealt to db8fa48b 
Dealt to 59db7a29 
Dealt to 5421c2ce 
Dealt to Hero [Td Qd]
Dealt to f50a59e0 
5421c2ce: folds
Hero: raises $0.15 to $0.25
f50a59e0: folds
94298a61: folds
db8fa48b: folds
59db7a29: folds
Uncalled bet ($0.15) returned to Hero
*** SHOWDOWN ***
Hero collected $0.25 from pot
*** SUMMARY ***
Total pot $0.25 | Rake $0 | Jackpot $0 | Bingo $0 | Fortune $0
Seat 1: 94298a61 (button) folded before Flop (didn't bet)
Seat 2: db8fa48b (small blind) folded before Flop
Seat 3: 59db7a29 (big blind) folded before Flop
Seat 4: 5421c2ce folded before Flop (didn't bet)
Seat 5: Hero collected ($0.25)
Seat 6: f50a59e0 folded before Flop (didn't bet)


Poker Hand #RC1316966334: Hold'em No Limit  ($0.05/$0.1) - 2023/02/02 14:01:04
Table 'RushAndCash5121594' 6-max Seat #1 is the button
Seat 1: 30296b0f ($5.96 in chips)
Seat 2: 476c070f ($10 in chips)
Seat 3: 4a156b00 ($10 in chips)
Seat 4: Hero ($10.78 in chips)
Seat 5: ac6f2c30 ($9.75 in chips)
Seat 6: 8d56d7e5 ($10.42 in chips)
476c070f: posts small blind $0.05
4a156b00: posts big blind $0.1
*** HOLE CARDS ***
Dealt to 30296b0f 
Dealt to 476c070f 
Dealt to 4a156b00 
Dealt to Hero [8s Ks]
Dealt to ac6f2c30 
Dealt to 8d56d7e5 
Hero: raises $0.15 to $0.25
ac6f2c30: folds
8d56d7e5: folds
30296b0f: folds
476c070f: folds
4a156b00: folds
Uncalled bet ($0.15) returned to Hero
*** SHOWDOWN ***
Hero collected $0.25 from pot
*** SUMMARY ***
Total pot $0.25 | Rake $0 | Jackpot $0 | Bingo $0 | Fortune $0
Seat 1: 30296b0f (button) folded before Flop (didn't bet)
Seat 2: 476c070f (small blind) folded before Flop
Seat 3: 4a156b00 (big blind) folded before Flop
Seat 4: Hero collected ($0.25)
Seat 5: ac6f2c30 folded before Flop (didn't bet)
Seat 6: 8d56d7e5 folded before Flop (didn't bet)


Poker Hand #RC1316966310: Hold'em No Limit  ($0.05/$0.1) - 2023/02/02 14:01:00
Table 'RushAndCash5121570' 6-max Seat #1 is the button
Seat 1: Hero ($10.78 in chips)
Seat 2: 64511e15 ($19.51 in chips)
Seat 3: f07ce14f ($13.96 in chips)
Seat 4: c7cb04d4 ($33.64 in chips)
Seat 5: c69a3d90 ($10 in chips)
Seat 6: 45eb3128 ($15.47 in chips)
64511e15: posts small blind $0.05
f07ce14f: posts big blind $0.1
*** HOLE CARDS ***
Dealt to Hero [Qd 5h]
Dealt to 64511e15 
Dealt to f07ce14f 
Dealt to c7cb04d4 
Dealt to c69a3d90 
Dealt to 45eb3128 
c7cb04d4: raises $0.15 to $0.25
c69a3d90: folds
45eb3128: folds
Hero: folds
64511e15: folds
f07ce14f: calls $0.15
*** FLOP *** [Jd Tc 6d]
f07ce14f: checks
c7cb04d4: checks
*** TURN *** [Jd Tc 6d] [3s]
f07ce14f: checks
c7cb04d4: bets $0.28
f07ce14f: calls $0.28
*** RIVER *** [Jd Tc 6d 3s] [8d]
f07ce14f: checks
c7cb04d4: checks
f07ce14f: shows [4s 6s] (Pair of Sixes)
c7cb04d4: shows [Ac Js] (Pair of Jacks)
*** SHOWDOWN ***
c7cb04d4 collected $1.06 from pot
*** SUMMARY ***
Total pot $1.11 | Rake $0.05 | Jackpot $0 | Bingo $0 | Fortune $0
Board [Jd Tc 6d 3s 8d]
Seat 1: Hero (button) folded before Flop (didn't bet)
Seat 2: 64511e15 (small blind) folded before Flop
Seat 3: f07ce14f (big blind) showed [4s 6s] and lost with Pair of Sixes
Seat 4: c7cb04d4 showed [Ac Js] and won ($1.06) with Pair of Jacks
Seat 5: c69a3d90 folded before Flop (didn't bet)
Seat 6: 45eb3128 folded before Flop (didn't bet)


Poker Hand #RC1316966129: Hold'em No Limit  ($0.05/$0.1) - 2023/02/02 14:00:26
Table 'RushAndCash5121389' 6-max Seat #1 is the button
Seat 1: c2f0f90f ($9.19 in chips)
Seat 2: ab6684ec ($10 in chips)
Seat 3: 64511e15 ($19.23 in chips)
Seat 4: ce5eff63 ($17.06 in chips)
Seat 5: 159dec68 ($9.85 in chips)
Seat 6: Hero ($11.03 in chips)
ab6684ec: posts small blind $0.05
64511e15: posts big blind $0.1
*** HOLE CARDS ***
Dealt to c2f0f90f 
Dealt to ab6684ec 
Dealt to 64511e15 
Dealt to ce5eff63 
Dealt to 159dec68 
Dealt to Hero [Ah 6h]
ce5eff63: folds
159dec68: folds
Hero: raises $0.15 to $0.25
c2f0f90f: folds
ab6684ec: folds
64511e15: raises $0.9 to $1.15
Hero: folds
Uncalled bet ($0.9) returned to 64511e15
*** SHOWDOWN ***
64511e15 collected $0.53 from pot
*** SUMMARY ***
Total pot $0.55 | Rake $0.02 | Jackpot $0 | Bingo $0 | Fortune $0
Seat 1: c2f0f90f (button) folded before Flop (didn't bet)
Seat 2: ab6684ec (small blind) folded before Flop
Seat 3: 64511e15 (big blind) collected ($0.53)
Seat 4: ce5eff63 folded before Flop (didn't bet)
Seat 5: 159dec68 folded before Flop (didn't bet)
Seat 6: Hero folded before Flop


Poker Hand #RC1316966051: Hold'em No Limit  ($0.05/$0.1) - 2023/02/02 14:00:12
Table 'RushAndCash5121311' 6-max Seat #1 is the button
Seat 1: 36f46669 ($22.48 in chips)
Seat 2: Hero ($11.08 in chips)
Seat 3: 8491f75f ($19.76 in chips)
Seat 4: dea4decb ($20.72 in chips)
Seat 5: f56e3525 ($12.14 in chips)
Seat 6: 210420c4 ($11.67 in chips)
Hero: posts small blind $0.05
8491f75f: posts big blind $0.1
*** HOLE CARDS ***
Dealt to 36f46669 
Dealt to Hero [As 5d]
Dealt to 8491f75f 
Dealt to dea4decb 
Dealt to f56e3525 
Dealt to 210420c4 
dea4decb: folds
f56e3525: folds
210420c4: raises $0.15 to $0.25
36f46669: calls $0.25
Hero: folds
8491f75f: calls $0.15
*** FLOP *** [7s Ah 4d]
8491f75f: checks
210420c4: checks
36f46669: checks
*** TURN *** [7s Ah 4d] [3s]
8491f75f: checks
210420c4: checks
36f46669: bets $0.52
8491f75f: folds
210420c4: folds
Uncalled bet ($0.52) returned to 36f46669
*** SHOWDOWN ***
36f46669 collected $0.76 from pot
*** SUMMARY ***
Total pot $0.8 | Rake $0.04 | Jackpot $0 | Bingo $0 | Fortune $0
Board [7s Ah 4d 3s]
Seat 1: 36f46669 (button) won ($0.76)
Seat 2: Hero (small blind) folded before Flop
Seat 3: 8491f75f (big blind) folded on the Turn
Seat 4: dea4decb folded before Flop (didn't bet)
Seat 5: f56e3525 folded before Flop (didn't bet)
Seat 6: 210420c4 folded on the Turn


Poker Hand #RC1316965964: Hold'em No Limit  ($0.05/$0.1) - 2023/02/02 13:59:55
Table 'RushAndCash5121224' 6-max Seat #1 is the button
Seat 1: 2c7d4ccb ($8.71 in chips)
Seat 2: f7288b7c ($11.56 in chips)
Seat 3: Hero ($11.18 in chips)
Seat 4: bc4185b2 ($10 in chips)
Seat 5: f07ce14f ($13.96 in chips)
Seat 6: dc860c57 ($10 in chips)
f7288b7c: posts small blind $0.05
Hero: posts big blind $0.1
*** HOLE CARDS ***
Dealt to 2c7d4ccb 
Dealt to f7288b7c 
Dealt to Hero [6d Qh]
Dealt to bc4185b2 
Dealt to f07ce14f 
Dealt to dc860c57 
bc4185b2: folds
f07ce14f: folds
dc860c57: folds
2c7d4ccb: raises $0.15 to $0.25
f7288b7c: folds
Hero: folds
Uncalled bet ($0.15) returned to 2c7d4ccb
*** SHOWDOWN ***
2c7d4ccb collected $0.25 from pot
*** SUMMARY ***
Total pot $0.25 | Rake $0 | Jackpot $0 | Bingo $0 | Fortune $0
Seat 1: 2c7d4ccb (button) collected ($0.25)
Seat 2: f7288b7c (small blind) folded before Flop
Seat 3: Hero (big blind) folded before Flop
Seat 4: bc4185b2 folded before Flop (didn't bet)
Seat 5: f07ce14f folded before Flop (didn't bet)
Seat 6: dc860c57 folded before Flop (didn't bet)


Poker Hand #RC1316965685: Hold'em No Limit  ($0.05/$0.1) - 2023/02/02 13:59:04
Table 'RushAndCash5120945' 6-max Seat #1 is the button
Seat 1: 9e3d2277 ($10.49 in chips)
Seat 2: f07ce14f ($12.01 in chips)
Seat 3: 625d7d7d ($16.49 in chips)
Seat 4: 1ac652fb ($12.98 in chips)
Seat 5: 37629f45 ($20.82 in chips)
Seat 6: Hero ($13.18 in chips)
f07ce14f: posts small blind $0.05
625d7d7d: posts big blind $0.1
*** HOLE CARDS ***
Dealt to 9e3d2277 
Dealt to f07ce14f 
Dealt to 625d7d7d 
Dealt to 1ac652fb 
Dealt to 37629f45 
Dealt to Hero [Qs Qh]
1ac652fb: folds
37629f45: raises $0.1 to $0.2
Hero: raises $0.42 to $0.62
9e3d2277: folds
f07ce14f: raises $1.38 to $2
625d7d7d: folds
37629f45: folds
Hero: calls $1.38
*** FLOP *** [Kc Ad Jh]
f07ce14f: bets $1.15
Hero: folds
Uncalled bet ($1.15) returned to f07ce14f
*** SHOWDOWN ***
f07ce14f collected $3.95 from pot
*** SUMMARY ***
Total pot $4.3 | Rake $0.2 | Jackpot $0.15 | Bingo $0 | Fortune $0
Board [Kc Ad Jh]
Seat 1: 9e3d2277 (button) folded before Flop (didn't bet)
Seat 2: f07ce14f (small blind) won ($3.95)
Seat 3: 625d7d7d (big blind) folded before Flop
Seat 4: 1ac652fb folded before Flop (didn't bet)
Seat 5: 37629f45 folded before Flop
Seat 6: Hero folded on the Flop


Poker Hand #RC1316965649: Hold'em No Limit  ($0.05/$0.1) - 2023/02/02 13:58:58
Table 'RushAndCash5120909' 6-max Seat #1 is the button
Seat 1: 5445ae0b ($10 in chips)
Seat 2: Hero ($13.23 in chips)
Seat 3: b11ed9ee ($12.18 in chips)
Seat 4: cb98a323 ($12.46 in chips)
Seat 5: ba8a4759 ($10.28 in chips)
Seat 6: f971222 ($13.5 in chips)
Hero: posts small blind $0.05
b11ed9ee: posts big blind $0.1
*** HOLE CARDS ***
Dealt to 5445ae0b 
Dealt to Hero [Jh 5s]
Dealt to b11ed9ee 
Dealt to cb98a323 
Dealt to ba8a4759 
Dealt to f971222 
cb98a323: folds
ba8a4759: folds
f971222: folds
5445ae0b: raises $0.15 to $0.25
Hero: folds
b11ed9ee: calls $0.15
*** FLOP *** [2s Qd Ah]
b11ed9ee: checks
5445ae0b: bets $0.42
b11ed9ee: folds
Uncalled bet ($0.42) returned to 5445ae0b
*** SHOWDOWN ***
5445ae0b collected $0.53 from pot
*** SUMMARY ***
Total pot $0.55 | Rake $0.02 | Jackpot $0 | Bingo $0 | Fortune $0
Board [2s Qd Ah]
Seat 1: 5445ae0b (button) won ($0.53)
Seat 2: Hero (small blind) folded before Flop
Seat 3: b11ed9ee (big blind) folded on the Flop
Seat 4: cb98a323 folded before Flop (didn't bet)
Seat 5: ba8a4759 folded before Flop (didn't bet)
Seat 6: f971222 folded before Flop (didn't bet)


Poker Hand #RC1316965455: Hold'em No Limit  ($0.05/$0.1) - 2023/02/02 13:58:19
Table 'RushAndCash5120715' 6-max Seat #1 is the button
Seat 1: 5b1e1098 ($8.55 in chips)
Seat 2: 17db5231 ($10.26 in chips)
Seat 3: Hero ($13.48 in chips)
Seat 4: 3bd9997d ($9.7 in chips)
Seat 5: ba8a4759 ($10 in chips)
Seat 6: 45eb3128 ($14.78 in chips)
17db5231: posts small blind $0.05
Hero: posts big blind $0.1
*** HOLE CARDS ***
Dealt to 5b1e1098 
Dealt to 17db5231 
Dealt to Hero [Jh Th]
Dealt to 3bd9997d 
Dealt to ba8a4759 
Dealt to 45eb3128 
3bd9997d: folds
ba8a4759: raises $0.15 to $0.25
45eb3128: folds
5b1e1098: folds
17db5231: folds
Hero: calls $0.15
*** FLOP *** [8h Kc 6s]
Hero: checks
ba8a4759: bets $0.19
Hero: folds
Uncalled bet ($0.19) returned to ba8a4759
*** SHOWDOWN ***
ba8a4759 collected $0.53 from pot
*** SUMMARY ***
Total pot $0.55 | Rake $0.02 | Jackpot $0 | Bingo $0 | Fortune $0
Board [8h Kc 6s]
Seat 1: 5b1e1098 (button) folded before Flop (didn't bet)
Seat 2: 17db5231 (small blind) folded before Flop
Seat 3: Hero (big blind) folded on the Flop
Seat 4: 3bd9997d folded before Flop (didn't bet)
Seat 5: ba8a4759 won ($0.53)
Seat 6: 45eb3128 folded before Flop (didn't bet)


Poker Hand #RC1316965427: Hold'em No Limit  ($0.05/$0.1) - 2023/02/02 13:58:13
Table 'RushAndCash5120687' 6-max Seat #1 is the button
Seat 1: 41f356ff ($10 in chips)
Seat 2: 6c03085a ($23.5 in chips)
Seat 3: 39f3f2c ($10.15 in chips)
Seat 4: d33a0ae9 ($21.25 in chips)
Seat 5: Hero ($13.48 in chips)
Seat 6: 9225e909 ($19.51 in chips)
6c03085a: posts small blind $0.05
39f3f2c: posts big blind $0.1
*** HOLE CARDS ***
Dealt to 41f356ff 
Dealt to 6c03085a 
Dealt to 39f3f2c 
Dealt to d33a0ae9 
Dealt to Hero [6h Js]
Dealt to 9225e909 
d33a0ae9: folds
Hero: folds
9225e909: folds
41f356ff: folds
6c03085a: raises $0.15 to $0.25
39f3f2c: raises $0.85 to $1.1
6c03085a: folds
Uncalled bet ($0.85) returned to 39f3f2c
*** SHOWDOWN ***
39f3f2c collected $0.48 from pot
*** SUMMARY ***
Total pot $0.5 | Rake $0.02 | Jackpot $0 | Bingo $0 | Fortune $0
Seat 1: 41f356ff (button) folded before Flop (didn't bet)
Seat 2: 6c03085a (small blind) folded before Flop
Seat 3: 39f3f2c (big blind) collected ($0.48)
Seat 4: d33a0ae9 folded before Flop (didn't bet)
Seat 5: Hero folded before Flop (didn't bet)
Seat 6: 9225e909 folded before Flop (didn't bet)


Poker Hand #RC1316965399: Hold'em No Limit  ($0.05/$0.1) - 2023/02/02 13:58:07
Table 'RushAndCash5120659' 6-max Seat #1 is the button
Seat 1: 98f6e09c ($19.41 in chips)
Seat 2: df707b71 ($19.07 in chips)
Seat 3: 6aaca674 ($2.95 in chips)
Seat 4: 9aed9c2a ($28.44 in chips)
Seat 5: a7dd82d4 ($12.28 in chips)
Seat 6: Hero ($13.48 in chips)
df707b71: posts small blind $0.05
6aaca674: posts big blind $0.1
*** HOLE CARDS ***
Dealt to 98f6e09c 
Dealt to df707b71 
Dealt to 6aaca674 
Dealt to 9aed9c2a 
Dealt to a7dd82d4 
Dealt to Hero [Qs 7h]
9aed9c2a: folds
a7dd82d4: folds
Hero: folds
98f6e09c: folds
df707b71: folds
Uncalled bet ($0.05) returned to 6aaca674
*** SHOWDOWN ***
6aaca674 collected $0.1 from pot
*** SUMMARY ***
Total pot $0.1 | Rake $0 | Jackpot $0 | Bingo $0 | Fortune $0
Seat 1: 98f6e09c (button) folded before Flop (didn't bet)
Seat 2: df707b71 (small blind) folded before Flop
Seat 3: 6aaca674 (big blind) collected ($0.1)
Seat 4: 9aed9c2a folded before Flop (didn't bet)
Seat 5: a7dd82d4 folded before Flop (didn't bet)
Seat 6: Hero folded before Flop (didn't bet)


Poker Hand #RC1316965337: Hold'em No Limit  ($0.05/$0.1) - 2023/02/02 13:57:54
Table 'RushAndCash5120597' 6-max Seat #1 is the button
Seat 1: Hero ($13.48 in chips)
Seat 2: 3d2bf5bc ($13.66 in chips)
Seat 3: 580fdf93 ($34.45 in chips)
Seat 4: 6b6ecc43 ($13.99 in chips)
Seat 5: 6928721a ($4.73 in chips)
Seat 6: fc290eae ($20.27 in chips)
3d2bf5bc: posts small blind $0.05
580fdf93: posts big blind $0.1
*** HOLE CARDS ***
Dealt to Hero [Ks 6c]
Dealt to 3d2bf5bc 
Dealt to 580fdf93 
Dealt to 6b6ecc43 
Dealt to 6928721a 
Dealt to fc290eae 
6b6ecc43: folds
6928721a: folds
fc290eae: folds
Hero: folds
3d2bf5bc: folds
Uncalled bet ($0.05) returned to 580fdf93
*** SHOWDOWN ***
580fdf93 collected $0.1 from pot
*** SUMMARY ***
Total pot $0.1 | Rake $0 | Jackpot $0 | Bingo $0 | Fortune $0
Seat 1: Hero (button) folded before Flop (didn't bet)
Seat 2: 3d2bf5bc (small blind) folded before Flop
Seat 3: 580fdf93 (big blind) collected ($0.1)
Seat 4: 6b6ecc43 folded before Flop (didn't bet)
Seat 5: 6928721a folded before Flop (didn't bet)
Seat 6: fc290eae folded before Flop (didn't bet)


Poker Hand #RC1316965318: Hold'em No Limit  ($0.05/$0.1) - 2023/02/02 13:57:50
Table 'RushAndCash5120578' 6-max Seat #1 is the button
Seat 1: 83cf0341 ($10.1 in chips)
Seat 2: 3581c5a7 ($13.75 in chips)
Seat 3: 3bd9997d ($10 in chips)
Seat 4: 8d56d7e5 ($10.15 in chips)
Seat 5: Hero ($13.48 in chips)
Seat 6: b219d968 ($14.18 in chips)
3581c5a7: posts small blind $0.05
3bd9997d: posts big blind $0.1
*** HOLE CARDS ***
Dealt to 83cf0341 
Dealt to 3581c5a7 
Dealt to 3bd9997d 
Dealt to 8d56d7e5 
Dealt to Hero [Td 2c]
Dealt to b219d968 
8d56d7e5: folds
Hero: folds
b219d968: folds
83cf0341: raises $0.15 to $0.25
3581c5a7: folds
3bd9997d: folds
Uncalled bet ($0.15) returned to 83cf0341
*** SHOWDOWN ***
83cf0341 collected $0.25 from pot
*** SUMMARY ***
Total pot $0.25 | Rake $0 | Jackpot $0 | Bingo $0 | Fortune $0
Seat 1: 83cf0341 (button) collected ($0.25)
Seat 2: 3581c5a7 (small blind) folded before Flop
Seat 3: 3bd9997d (big blind) folded before Flop
Seat 4: 8d56d7e5 folded before Flop (didn't bet)
Seat 5: Hero folded before Flop (didn't bet)
Seat 6: b219d968 folded before Flop (didn't bet)


Poker Hand #RC1316965300: Hold'em No Limit  ($0.05/$0.1) - 2023/02/02 13:57:46
Table 'RushAndCash5120560' 6-max Seat #1 is the button
Seat 1: cb98a323 ($12.64 in chips)
Seat 2: c69a3d90 ($10 in chips)
Seat 3: ba36758d ($14.48 in chips)
Seat 4: bd260b3e ($13.62 in chips)
Seat 5: Hero ($13.48 in chips)
Seat 6: 5ee1e2f2 ($37.67 in chips)
c69a3d90: posts small blind $0.05
ba36758d: posts big blind $0.1
*** HOLE CARDS ***
Dealt to cb98a323 
Dealt to c69a3d90 
Dealt to ba36758d 
Dealt to bd260b3e 
Dealt to Hero [4s Th]
Dealt to 5ee1e2f2 
bd260b3e: folds
Hero: folds
5ee1e2f2: raises $0.2 to $0.3
cb98a323: folds
c69a3d90: folds
ba36758d: folds
Uncalled bet ($0.2) returned to 5ee1e2f2
*** SHOWDOWN ***
5ee1e2f2 collected $0.25 from pot
*** SUMMARY ***
Total pot $0.25 | Rake $0 | Jackpot $0 | Bingo $0 | Fortune $0
Seat 1: cb98a323 (button) folded before Flop (didn't bet)
Seat 2: c69a3d90 (small blind) folded before Flop
Seat 3: ba36758d (big blind) folded before Flop
Seat 4: bd260b3e folded before Flop (didn't bet)
Seat 5: Hero folded before Flop (didn't bet)
Seat 6: 5ee1e2f2 collected ($0.25)


Poker Hand #RC1316965197: Hold'em No Limit  ($0.05/$0.1) - 2023/02/02 13:57:22
Table 'RushAndCash5120457' 6-max Seat #1 is the button
Seat 1: f659ca7d ($6.65 in chips)
Seat 2: 30ced322 ($11.55 in chips)
Seat 3: f50a59e0 ($3.41 in chips)
Seat 4: 534c06d7 ($11.79 in chips)
Seat 5: Hero ($13.11 in chips)
Seat 6: f9402878 ($24.09 in chips)
30ced322: posts small blind $0.05
f50a59e0: posts big blind $0.1
*** HOLE CARDS ***
Dealt to f659ca7d 
Dealt to 30ced322 
Dealt to f50a59e0 
Dealt to 534c06d7 
Dealt to Hero [As Qh]
Dealt to f9402878 
534c06d7: raises $0.15 to $0.25
Hero: raises $0.5 to $0.75
f9402878: folds
f659ca7d: folds
30ced322: folds
f50a59e0: folds
534c06d7: folds
Uncalled bet ($0.5) returned to Hero
*** SHOWDOWN ***
Hero collected $0.62 from pot
*** SUMMARY ***
Total pot $0.65 | Rake $0.03 | Jackpot $0 | Bingo $0 | Fortune $0
Seat 1: f659ca7d (button) folded before Flop (didn't bet)
Seat 2: 30ced322 (small blind) folded before Flop
Seat 3: f50a59e0 (big blind) folded before Flop
Seat 4: 534c06d7 folded before Flop
Seat 5: Hero collected ($0.62)
Seat 6: f9402878 folded before Flop (didn't bet)


Poker Hand #RC1316965163: Hold'em No Limit  ($0.05/$0.1) - 2023/02/02 13:57:15
Table 'RushAndCash5120423' 6-max Seat #1 is the button
Seat 1: dc61b47a ($10 in chips)
Seat 2: 39f3f2c ($10.11 in chips)
Seat 3: Hero ($13.21 in chips)
Seat 4: 74980fba ($12.52 in chips)
Seat 5: 8f740579 ($9.16 in chips)
Seat 6: 2326f258 ($10 in chips)
39f3f2c: posts small blind $0.05
Hero: posts big blind $0.1
*** HOLE CARDS ***
Dealt to dc61b47a 
Dealt to 39f3f2c 
Dealt to Hero [5s 7d]
Dealt to 74980fba 
Dealt to 8f740579 
Dealt to 2326f258 
74980fba: folds
8f740579: folds
2326f258: folds
dc61b47a: raises $0.1 to $0.2
39f3f2c: raises $0.8 to $1
Hero: folds
dc61b47a: raises $1.25 to $2.25
39f3f2c: calls $1.25
*** FLOP *** [9s 3d 4s]
39f3f2c: checks
dc61b47a: bets $2.3
39f3f2c: folds
Uncalled bet ($2.3) returned to dc61b47a
*** SHOWDOWN ***
dc61b47a collected $4.23 from pot
*** SUMMARY ***
Total pot $4.6 | Rake $0.22 | Jackpot $0.15 | Bingo $0 | Fortune $0
Board [9s 3d 4s]
Seat 1: dc61b47a (button) won ($4.23)
Seat 2: 39f3f2c (small blind) folded on the Flop
Seat 3: Hero (big blind) folded before Flop
Seat 4: 74980fba folded before Flop (didn't bet)
Seat 5: 8f740579 folded before Flop (didn't bet)
Seat 6: 2326f258 folded before Flop (didn't bet)


Poker Hand #RC1316965135: Hold'em No Limit  ($0.05/$0.1) - 2023/02/02 13:57:10
Table 'RushAndCash5120395' 6-max Seat #1 is the button
Seat 1: Hero ($13.21 in chips)
Seat 2: dc61b47a ($10 in chips)
Seat 3: 44cee332 ($10.67 in chips)
Seat 4: 5c17b844 ($9.11 in chips)
Seat 5: a56a4b2d ($10 in chips)
Seat 6: 67b1a6be ($8.28 in chips)
dc61b47a: posts small blind $0.05
44cee332: posts big blind $0.1
*** HOLE CARDS ***
Dealt to Hero [2h 6d]
Dealt to dc61b47a 
Dealt to 44cee332 
Dealt to 5c17b844 
Dealt to a56a4b2d 
Dealt to 67b1a6be 
5c17b844: folds
a56a4b2d: folds
67b1a6be: folds
Hero: folds
dc61b47a: folds
Uncalled bet ($0.05) returned to 44cee332
*** SHOWDOWN ***
44cee332 collected $0.1 from pot
*** SUMMARY ***
Total pot $0.1 | Rake $0 | Jackpot $0 | Bingo $0 | Fortune $0
Seat 1: Hero (button) folded before Flop (didn't bet)
Seat 2: dc61b47a (small blind) folded before Flop
Seat 3: 44cee332 (big blind) collected ($0.1)
Seat 4: 5c17b844 folded before Flop (didn't bet)
Seat 5: a56a4b2d folded before Flop (didn't bet)
Seat 6: 67b1a6be folded before Flop (didn't bet)


Poker Hand #RC1316965107: Hold'em No Limit  ($0.05/$0.1) - 2023/02/02 13:57:06
Table 'RushAndCash5120367' 6-max Seat #1 is the button
Seat 1: 6d833efb ($9.95 in chips)
Seat 2: 23429e9d ($9.5 in chips)
Seat 3: 97ad5e0f ($10.9 in chips)
Seat 4: Hero ($13.21 in chips)
Seat 5: 4bd70137 ($16.55 in chips)
Seat 6: 975c29af ($10.76 in chips)
23429e9d: posts small blind $0.05
97ad5e0f: posts big blind $0.1
*** HOLE CARDS ***
Dealt to 6d833efb 
Dealt to 23429e9d 
Dealt to 97ad5e0f 
Dealt to Hero [7c 3c]
Dealt to 4bd70137 
Dealt to 975c29af 
Hero: folds
4bd70137: folds
975c29af: folds
6d833efb: folds
23429e9d: folds
Uncalled bet ($0.05) returned to 97ad5e0f
*** SHOWDOWN ***
97ad5e0f collected $0.1 from pot
*** SUMMARY ***
Total pot $0.1 | Rake $0 | Jackpot $0 | Bingo $0 | Fortune $0
Seat 1: 6d833efb (button) folded before Flop (didn't bet)
Seat 2: 23429e9d (small blind) folded before Flop
Seat 3: 97ad5e0f (big blind) collected ($0.1)
Seat 4: Hero folded before Flop (didn't bet)
Seat 5: 4bd70137 folded before Flop (didn't bet)
Seat 6: 975c29af folded before Flop (didn't bet)


Poker Hand #RC1316965081: Hold'em No Limit  ($0.05/$0.1) - 2023/02/02 13:57:02
Table 'RushAndCash5120341' 6-max Seat #1 is the button
Seat 1: 47c9e3b4 ($9.72 in chips)
Seat 2: Hero ($13.26 in chips)
Seat 3: 2956368b ($7.08 in chips)
Seat 4: 48451ad4 ($10.21 in chips)
Seat 5: 40313cc8 ($10.2 in chips)
Seat 6: 59bf16ec ($7.27 in chips)
Hero: posts small blind $0.05
2956368b: posts big blind $0.1
*** HOLE CARDS ***
Dealt to 47c9e3b4 
Dealt to Hero [6h 9d]
Dealt to 2956368b 
Dealt to 48451ad4 
Dealt to 40313cc8 
Dealt to 59bf16ec 
48451ad4: folds
40313cc8: folds
59bf16ec: folds
47c9e3b4: folds
Hero: folds
Uncalled bet ($0.05) returned to 2956368b
*** SHOWDOWN ***
2956368b collected $0.1 from pot
*** SUMMARY ***
Total pot $0.1 | Rake $0 | Jackpot $0 | Bingo $0 | Fortune $0
Seat 1: 47c9e3b4 (button) folded before Flop (didn't bet)
Seat 2: Hero (small blind) folded before Flop
Seat 3: 2956368b (big blind) collected ($0.1)
Seat 4: 48451ad4 folded before Flop (didn't bet)
Seat 5: 40313cc8 folded before Flop (didn't bet)
Seat 6: 59bf16ec folded before Flop (didn't bet)


Poker Hand #RC1316965051: Hold'em No Limit  ($0.05/$0.1) - 2023/02/02 13:56:57
Table 'RushAndCash5120311' 6-max Seat #1 is the button
Seat 1: 1beb42 ($5.16 in chips)
Seat 2: d107460c ($11.34 in chips)
Seat 3: 975c29af ($10.91 in chips)
Seat 4: bc9f93b5 ($15.88 in chips)
Seat 5: Hero ($13.26 in chips)
Seat 6: f02123a0 ($10.52 in chips)
d107460c: posts small blind $0.05
975c29af: posts big blind $0.1
*** HOLE CARDS ***
Dealt to 1beb42 
Dealt to d107460c 
Dealt to 975c29af 
Dealt to bc9f93b5 
Dealt to Hero [4c Jd]
Dealt to f02123a0 
bc9f93b5: folds
Hero: folds
f02123a0: folds
1beb42: folds
d107460c: folds
Uncalled bet ($0.05) returned to 975c29af
*** SHOWDOWN ***
975c29af collected $0.1 from pot
*** SUMMARY ***
Total pot $0.1 | Rake $0 | Jackpot $0 | Bingo $0 | Fortune $0
Seat 1: 1beb42 (button) folded before Flop (didn't bet)
Seat 2: d107460c (small blind) folded before Flop
Seat 3: 975c29af (big blind) collected ($0.1)
Seat 4: bc9f93b5 folded before Flop (didn't bet)
Seat 5: Hero folded before Flop (didn't bet)
Seat 6: f02123a0 folded before Flop (didn't bet)


Poker Hand #RC1316964831: Hold'em No Limit  ($0.05/$0.1) - 2023/02/02 13:56:16
Table 'RushAndCash5120091' 6-max Seat #1 is the button
Seat 1: 4a156b00 ($10 in chips)
Seat 2: d2642a4f ($24.38 in chips)
Seat 3: 36f46669 ($12.01 in chips)
Seat 4: d107460c ($11.59 in chips)
Seat 5: Hero ($12.89 in chips)
Seat 6: ba2fa3e2 ($11.91 in chips)
d2642a4f: posts small blind $0.05
36f46669: posts big blind $0.1
*** HOLE CARDS ***
Dealt to 4a156b00 
Dealt to d2642a4f 
Dealt to 36f46669 
Dealt to d107460c 
Dealt to Hero [Ac As]
Dealt to ba2fa3e2 
d107460c: raises $0.15 to $0.25
Hero: raises $0.53 to $0.78
ba2fa3e2: folds
4a156b00: folds
d2642a4f: folds
36f46669: folds
d107460c: folds
Uncalled bet ($0.53) returned to Hero
*** SHOWDOWN ***
Hero collected $0.62 from pot
*** SUMMARY ***
Total pot $0.65 | Rake $0.03 | Jackpot $0 | Bingo $0 | Fortune $0
Seat 1: 4a156b00 (button) folded before Flop (didn't bet)
Seat 2: d2642a4f (small blind) folded before Flop
Seat 3: 36f46669 (big blind) folded before Flop
Seat 4: d107460c folded before Flop
Seat 5: Hero collected ($0.62)
Seat 6: ba2fa3e2 folded before Flop (didn't bet)


Poker Hand #RC1316964762: Hold'em No Limit  ($0.05/$0.1) - 2023/02/02 13:56:01
Table 'RushAndCash5120022' 6-max Seat #1 is the button
Seat 1: Hero ($12.74 in chips)
Seat 2: 1beb42 ($5.21 in chips)
Seat 3: f02123a0 ($10.15 in chips)
Seat 4: ce5eff63 ($14.44 in chips)
Seat 5: 3828897b ($21.37 in chips)
Seat 6: 8844038f ($16.33 in chips)
1beb42: posts small blind $0.05
f02123a0: posts big blind $0.1
*** HOLE CARDS ***
Dealt to Hero [7d Ac]
Dealt to 1beb42 
Dealt to f02123a0 
Dealt to ce5eff63 
Dealt to 3828897b 
Dealt to 8844038f 
ce5eff63: folds
3828897b: folds
8844038f: folds
Hero: raises $0.15 to $0.25
1beb42: folds
f02123a0: folds
Uncalled bet ($0.15) returned to Hero
*** SHOWDOWN ***
Hero collected $0.25 from pot
*** SUMMARY ***
Total pot $0.25 | Rake $0 | Jackpot $0 | Bingo $0 | Fortune $0
Seat 1: Hero (button) collected ($0.25)
Seat 2: 1beb42 (small blind) folded before Flop
Seat 3: f02123a0 (big blind) folded before Flop
Seat 4: ce5eff63 folded before Flop (didn't bet)
Seat 5: 3828897b folded before Flop (didn't bet)
Seat 6: 8844038f folded before Flop (didn't bet)


Poker Hand #RC1316924718: Hold'em No Limit  ($0.05/$0.1) - 2023/02/02 13:55:53
Table 'RushAndCash5119978' 6-max Seat #1 is the button
Seat 1: 1a840e6d ($11.81 in chips)
Seat 2: Hero ($12.79 in chips)
Seat 3: 2798beed ($14.61 in chips)
Seat 4: ceac471a ($18.77 in chips)
Seat 5: 7275fd02 ($8.01 in chips)
Seat 6: a95299fd ($22.79 in chips)
Hero: posts small blind $0.05
2798beed: posts big blind $0.1
*** HOLE CARDS ***
Dealt to 1a840e6d 
Dealt to Hero [4d 9s]
Dealt to 2798beed 
Dealt to ceac471a 
Dealt to 7275fd02 
Dealt to a95299fd 
ceac471a: folds
7275fd02: folds
a95299fd: raises $0.15 to $0.25
1a840e6d: folds
Hero: folds
2798beed: calls $0.15
*** FLOP *** [Jc Th 4s]
2798beed: checks
a95299fd: bets $0.42
2798beed: calls $0.42
*** TURN *** [Jc Th 4s] [3h]
2798beed: checks
a95299fd: bets $1.39
2798beed: calls $1.39
*** RIVER *** [Jc Th 4s 3h] [6c]
2798beed: checks
a95299fd: bets $4.17
2798beed: folds
Uncalled bet ($4.17) returned to a95299fd
*** SHOWDOWN ***
a95299fd collected $3.82 from pot
*** SUMMARY ***
Total pot $4.17 | Rake $0.2 | Jackpot $0.15 | Bingo $0 | Fortune $0
Board [Jc Th 4s 3h 6c]
Seat 1: 1a840e6d (button) folded before Flop (didn't bet)
Seat 2: Hero (small blind) folded before Flop
Seat 3: 2798beed (big blind) folded on the River
Seat 4: ceac471a folded before Flop (didn't bet)
Seat 5: 7275fd02 folded before Flop (didn't bet)
Seat 6: a95299fd won ($3.82)


Poker Hand #RC1316924693: Hold'em No Limit  ($0.05/$0.1) - 2023/02/02 13:55:49
Table 'RushAndCash5119953' 6-max Seat #1 is the button
Seat 1: 8eb66f4e ($11.03 in chips)
Seat 2: 385d4d13 ($9.55 in chips)
Seat 3: 42614d1c ($9.64 in chips)
Seat 4: Hero ($12.79 in chips)
Seat 5: ff7a9d33 ($11.08 in chips)
Seat 6: 7d2e4391 ($5.92 in chips)
385d4d13: posts small blind $0.05
42614d1c: posts big blind $0.1
*** HOLE CARDS ***
Dealt to 8eb66f4e 
Dealt to 385d4d13 
Dealt to 42614d1c 
Dealt to Hero [As 9h]
Dealt to ff7a9d33 
Dealt to 7d2e4391 
Hero: folds
ff7a9d33: folds
7d2e4391: folds
8eb66f4e: raises $0.15 to $0.25
385d4d13: folds
42614d1c: calls $0.15
*** FLOP *** [4h 4s 4d]
42614d1c: checks
8eb66f4e: bets $0.19
42614d1c: folds
Uncalled bet ($0.19) returned to 8eb66f4e
*** SHOWDOWN ***
8eb66f4e collected $0.53 from pot
*** SUMMARY ***
Total pot $0.55 | Rake $0.02 | Jackpot $0 | Bingo $0 | Fortune $0
Board [4h 4s 4d]
Seat 1: 8eb66f4e (button) won ($0.53)
Seat 2: 385d4d13 (small blind) folded before Flop
Seat 3: 42614d1c (big blind) folded on the Flop
Seat 4: Hero folded before Flop (didn't bet)
Seat 5: ff7a9d33 folded before Flop (didn't bet)
Seat 6: 7d2e4391 folded before Flop (didn't bet)


Poker Hand #RC1316924644: Hold'em No Limit  ($0.05/$0.1) - 2023/02/02 13:55:40
Table 'RushAndCash5119904' 6-max Seat #1 is the button
Seat 1: 611e0890 ($10 in chips)
Seat 2: ee57d6f8 ($10 in chips)
Seat 3: Hero ($12.89 in chips)
Seat 4: 593cc204 ($5.93 in chips)
Seat 5: 29e6d264 ($35.66 in chips)
Seat 6: 509c41a2 ($25.05 in chips)
ee57d6f8: posts small blind $0.05
Hero: posts big blind $0.1
*** HOLE CARDS ***
Dealt to 611e0890 
Dealt to ee57d6f8 
Dealt to Hero [Ad 6s]
Dealt to 593cc204 
Dealt to 29e6d264 
Dealt to 509c41a2 
593cc204: folds
29e6d264: folds
509c41a2: folds
611e0890: raises $0.11 to $0.21
ee57d6f8: folds
Hero: folds
Uncalled bet ($0.11) returned to 611e0890
*** SHOWDOWN ***
611e0890 collected $0.25 from pot
*** SUMMARY ***
Total pot $0.25 | Rake $0 | Jackpot $0 | Bingo $0 | Fortune $0
Seat 1: 611e0890 (button) collected ($0.25)
Seat 2: ee57d6f8 (small blind) folded before Flop
Seat 3: Hero (big blind) folded before Flop
Seat 4: 593cc204 folded before Flop (didn't bet)
Seat 5: 29e6d264 folded before Flop (didn't bet)
Seat 6: 509c41a2 folded before Flop (didn't bet)


Poker Hand #RC1316924506: Hold'em No Limit  ($0.05/$0.1) - 2023/02/02 13:55:17
Table 'RushAndCash5119766' 6-max Seat #1 is the button
Seat 1: 264fd48e ($10.06 in chips)
Seat 2: Hero ($12.94 in chips)
Seat 3: c2732de7 ($9.09 in chips)
Seat 4: 30ced322 ($11.55 in chips)
Seat 5: 74980fba ($11.36 in chips)
Seat 6: 5c17b844 ($10.36 in chips)
Hero: posts small blind $0.05
c2732de7: posts big blind $0.1
*** HOLE CARDS ***
Dealt to 264fd48e 
Dealt to Hero [4h Ks]
Dealt to c2732de7 
Dealt to 30ced322 
Dealt to 74980fba 
Dealt to 5c17b844 
30ced322: folds
74980fba: raises $0.12 to $0.22
5c17b844: raises $0.59 to $0.81
264fd48e: folds
Hero: folds
c2732de7: folds
74980fba: calls $0.59
*** FLOP *** [Js 4s 5h]
74980fba: checks
5c17b844: bets $0.59
74980fba: raises $1.01 to $1.6
5c17b844: folds
Uncalled bet ($1.01) returned to 74980fba
*** SHOWDOWN ***
74980fba collected $2.81 from pot
*** SUMMARY ***
Total pot $2.95 | Rake $0.14 | Jackpot $0 | Bingo $0 | Fortune $0
Board [Js 4s 5h]
Seat 1: 264fd48e (button) folded before Flop (didn't bet)
Seat 2: Hero (small blind) folded before Flop
Seat 3: c2732de7 (big blind) folded before Flop
Seat 4: 30ced322 folded before Flop (didn't bet)
Seat 5: 74980fba won ($2.81)
Seat 6: 5c17b844 folded on the Flop


Poker Hand #RC1316924444: Hold'em No Limit  ($0.05/$0.1) - 2023/02/02 13:55:07
Table 'RushAndCash5119704' 6-max Seat #1 is the button
Seat 1: 2c7d4ccb ($9.12 in chips)
Seat 2: 4f07bf6a ($22.28 in chips)
Seat 3: Hero ($13.04 in chips)
Seat 4: cc1b8ee3 ($10 in chips)
Seat 5: a67b8426 ($10.07 in chips)
Seat 6: 5fb55c79 ($10 in chips)
4f07bf6a: posts small blind $0.05
Hero: posts big blind $0.1
*** HOLE CARDS ***
Dealt to 2c7d4ccb 
Dealt to 4f07bf6a 
Dealt to Hero [5h Qh]
Dealt to cc1b8ee3 
Dealt to a67b8426 
Dealt to 5fb55c79 
cc1b8ee3: folds
a67b8426: raises $0.15 to $0.25
5fb55c79: folds
2c7d4ccb: folds
4f07bf6a: folds
Hero: folds
Uncalled bet ($0.15) returned to a67b8426
*** SHOWDOWN ***
a67b8426 collected $0.25 from pot
*** SUMMARY ***
Total pot $0.25 | Rake $0 | Jackpot $0 | Bingo $0 | Fortune $0
Seat 1: 2c7d4ccb (button) folded before Flop (didn't bet)
Seat 2: 4f07bf6a (small blind) folded before Flop
Seat 3: Hero (big blind) folded before Flop
Seat 4: cc1b8ee3 folded before Flop (didn't bet)
Seat 5: a67b8426 collected ($0.25)
Seat 6: 5fb55c79 folded before Flop (didn't bet)


Poker Hand #RC1316923904: Hold'em No Limit  ($0.05/$0.1) - 2023/02/02 13:53:35
Table 'RushAndCash5119164' 6-max Seat #1 is the button
Seat 1: c69a3d90 ($10 in chips)
Seat 2: 29325a4e ($7.55 in chips)
Seat 3: c619e978 ($10.1 in chips)
Seat 4: Hero ($10.87 in chips)
Seat 5: 3f72d59c ($10 in chips)
Seat 6: ec6a9a1d ($12.98 in chips)
29325a4e: posts small blind $0.05
c619e978: posts big blind $0.1
*** HOLE CARDS ***
Dealt to c69a3d90 
Dealt to 29325a4e 
Dealt to c619e978 
Dealt to Hero [Tc Ac]
Dealt to 3f72d59c 
Dealt to ec6a9a1d 
Hero: raises $0.15 to $0.25
3f72d59c: folds
ec6a9a1d: folds
c69a3d90: calls $0.25
29325a4e: folds
c619e978: calls $0.15
*** FLOP *** [Jh 6d Th]
c619e978: checks
Hero: checks
c69a3d90: checks
*** TURN *** [Jh 6d Th] [Td]
c619e978: checks
Hero: bets $0.4
c69a3d90: folds
c619e978: calls $0.4
*** RIVER *** [Jh 6d Th Td] [6s]
c619e978: checks
Hero: bets $1.6
c619e978: calls $1.6
Hero: shows [Tc Ac] (Tens Full over Sixes)
c619e978: shows [9h 6h] (Sixes Full over Tens)
*** SHOWDOWN ***
Hero collected $4.42 from pot
*** SUMMARY ***
Total pot $4.8 | Rake $0.23 | Jackpot $0.15 | Bingo $0 | Fortune $0
Board [Jh 6d Th Td 6s]
Seat 1: c69a3d90 (button) folded on the Turn
Seat 2: 29325a4e (small blind) folded before Flop
Seat 3: c619e978 (big blind) showed [9h 6h] and lost with Sixes Full over Tens
Seat 4: Hero showed [Tc Ac] and won ($4.42) with Tens Full over Sixes
Seat 5: 3f72d59c folded before Flop (didn't bet)
Seat 6: ec6a9a1d folded before Flop (didn't bet)


Poker Hand #RC1316923883: Hold'em No Limit  ($0.05/$0.1) - 2023/02/02 13:53:31
Table 'RushAndCash5119143' 6-max Seat #1 is the button
Seat 1: cd8d77cf ($10 in chips)
Seat 2: 23429e9d ($11.66 in chips)
Seat 3: b451cf6b ($6.47 in chips)
Seat 4: 142474e3 ($14.69 in chips)
Seat 5: 3f72d59c ($10 in chips)
Seat 6: Hero ($10.87 in chips)
23429e9d: posts small blind $0.05
b451cf6b: posts big blind $0.1
*** HOLE CARDS ***
Dealt to cd8d77cf 
Dealt to 23429e9d 
Dealt to b451cf6b 
Dealt to 142474e3 
Dealt to 3f72d59c 
Dealt to Hero [2c Jd]
142474e3: folds
3f72d59c: folds
Hero: folds
cd8d77cf: folds
23429e9d: folds
Uncalled bet ($0.05) returned to b451cf6b
*** SHOWDOWN ***
b451cf6b collected $0.1 from pot
*** SUMMARY ***
Total pot $0.1 | Rake $0 | Jackpot $0 | Bingo $0 | Fortune $0
Seat 1: cd8d77cf (button) folded before Flop (didn't bet)
Seat 2: 23429e9d (small blind) folded before Flop
Seat 3: b451cf6b (big blind) collected ($0.1)
Seat 4: 142474e3 folded before Flop (didn't bet)
Seat 5: 3f72d59c folded before Flop (didn't bet)
Seat 6: Hero folded before Flop (didn't bet)


Poker Hand #RC1316923863: Hold'em No Limit  ($0.05/$0.1) - 2023/02/02 13:53:27
Table 'RushAndCash5119123' 6-max Seat #1 is the button
Seat 1: Hero ($10.87 in chips)
Seat 2: 81edd1dd ($0.93 in chips)
Seat 3: 9b165837 ($10 in chips)
Seat 4: 29325a4e ($7.55 in chips)
Seat 5: bc9f93b5 ($15.41 in chips)
Seat 6: 174e4954 ($15.99 in chips)
81edd1dd: posts small blind $0.05
9b165837: posts big blind $0.1
*** HOLE CARDS ***
Dealt to Hero [3d 8c]
Dealt to 81edd1dd 
Dealt to 9b165837 
Dealt to 29325a4e 
Dealt to bc9f93b5 
Dealt to 174e4954 
29325a4e: folds
bc9f93b5: folds
174e4954: folds
Hero: folds
81edd1dd: calls $0.05
9b165837: checks
*** FLOP *** [5d Jc 8h]
81edd1dd: checks
9b165837: checks
*** TURN *** [5d Jc 8h] [6s]
81edd1dd: checks
9b165837: checks
*** RIVER *** [5d Jc 8h 6s] [5h]
81edd1dd: bets $0.2
9b165837: folds
Uncalled bet ($0.2) returned to 81edd1dd
*** SHOWDOWN ***
81edd1dd collected $0.19 from pot
*** SUMMARY ***
Total pot $0.2 | Rake $0.01 | Jackpot $0 | Bingo $0 | Fortune $0
Board [5d Jc 8h 6s 5h]
Seat 1: Hero (button) folded before Flop (didn't bet)
Seat 2: 81edd1dd (small blind) won ($0.19)
Seat 3: 9b165837 (big blind) folded on the River
Seat 4: 29325a4e folded before Flop (didn't bet)
Seat 5: bc9f93b5 folded before Flop (didn't bet)
Seat 6: 174e4954 folded before Flop (didn't bet)


Poker Hand #RC1316923841: Hold'em No Limit  ($0.05/$0.1) - 2023/02/02 13:53:23
Table 'RushAndCash5119101' 6-max Seat #1 is the button
Seat 1: 773aeb87 ($12.35 in chips)
Seat 2: fa51e773 ($10.29 in chips)
Seat 3: 174e4954 ($16.09 in chips)
Seat 4: Hero ($10.87 in chips)
Seat 5: 5eb6be30 ($10.27 in chips)
Seat 6: daaa7691 ($11.56 in chips)
fa51e773: posts small blind $0.05
174e4954: posts big blind $0.1
*** HOLE CARDS ***
Dealt to 773aeb87 
Dealt to fa51e773 
Dealt to 174e4954 
Dealt to Hero [8s Qh]
Dealt to 5eb6be30 
Dealt to daaa7691 
Hero: folds
5eb6be30: folds
daaa7691: raises $0.15 to $0.25
773aeb87: folds
fa51e773: folds
174e4954: folds
Uncalled bet ($0.15) returned to daaa7691
*** SHOWDOWN ***
daaa7691 collected $0.25 from pot
*** SUMMARY ***
Total pot $0.25 | Rake $0 | Jackpot $0 | Bingo $0 | Fortune $0
Seat 1: 773aeb87 (button) folded before Flop (didn't bet)
Seat 2: fa51e773 (small blind) folded before Flop
Seat 3: 174e4954 (big blind) folded before Flop
Seat 4: Hero folded before Flop (didn't bet)
Seat 5: 5eb6be30 folded before Flop (didn't bet)
Seat 6: daaa7691 collected ($0.25)


Poker Hand #RC1316923822: Hold'em No Limit  ($0.05/$0.1) - 2023/02/02 13:53:20
Table 'RushAndCash5119082' 6-max Seat #1 is the button
Seat 1: 66e09ffa ($10 in chips)
Seat 2: 9ce8cf5d ($20.38 in chips)
Seat 3: e45ce097 ($27.36 in chips)
Seat 4: 8f740579 ($9.98 in chips)
Seat 5: Hero ($10.87 in chips)
Seat 6: 1d3e8d87 ($14.11 in chips)
9ce8cf5d: posts small blind $0.05
e45ce097: posts big blind $0.1
*** HOLE CARDS ***
Dealt to 66e09ffa 
Dealt to 9ce8cf5d 
Dealt to e45ce097 
Dealt to 8f740579 
Dealt to Hero [9h 7s]
Dealt to 1d3e8d87 
8f740579: raises $0.15 to $0.25
Hero: folds
1d3e8d87: folds
66e09ffa: folds
9ce8cf5d: folds
e45ce097: folds
Uncalled bet ($0.15) returned to 8f740579
*** SHOWDOWN ***
8f740579 collected $0.25 from pot
*** SUMMARY ***
Total pot $0.25 | Rake $0 | Jackpot $0 | Bingo $0 | Fortune $0
Seat 1: 66e09ffa (button) folded before Flop (didn't bet)
Seat 2: 9ce8cf5d (small blind) folded before Flop
Seat 3: e45ce097 (big blind) folded before Flop
Seat 4: 8f740579 collected ($0.25)
Seat 5: Hero folded before Flop (didn't bet)
Seat 6: 1d3e8d87 folded before Flop (didn't bet)


Poker Hand #RC1316923806: Hold'em No Limit  ($0.05/$0.1) - 2023/02/02 13:53:16
Table 'RushAndCash5119066' 6-max Seat #1 is the button
Seat 1: a5ff5048 ($10.25 in chips)
Seat 2: 20841665 ($11.6 in chips)
Seat 3: 251516e7 ($19.38 in chips)
Seat 4: 61818dd8 ($9.05 in chips)
Seat 5: Hero ($10.87 in chips)
Seat 6: 18c2b034 ($9.7 in chips)
20841665: posts small blind $0.05
251516e7: posts big blind $0.1
*** HOLE CARDS ***
Dealt to a5ff5048 
Dealt to 20841665 
Dealt to 251516e7 
Dealt to 61818dd8 
Dealt to Hero [9c 5d]
Dealt to 18c2b034 
61818dd8: folds
Hero: folds
18c2b034: folds
a5ff5048: folds
20841665: raises $0.15 to $0.25
251516e7: folds
Uncalled bet ($0.15) returned to 20841665
*** SHOWDOWN ***
20841665 collected $0.2 from pot
*** SUMMARY ***
Total pot $0.2 | Rake $0 | Jackpot $0 | Bingo $0 | Fortune $0
Seat 1: a5ff5048 (button) folded before Flop (didn't bet)
Seat 2: 20841665 (small blind) collected ($0.2)
Seat 3: 251516e7 (big blind) folded before Flop
Seat 4: 61818dd8 folded before Flop (didn't bet)
Seat 5: Hero folded before Flop (didn't bet)
Seat 6: 18c2b034 folded before Flop (didn't bet)


Poker Hand #RC1316923786: Hold'em No Limit  ($0.05/$0.1) - 2023/02/02 13:53:12
Table 'RushAndCash5119046' 6-max Seat #1 is the button
Seat 1: 3cf601f2 ($9.17 in chips)
Seat 2: feb8f704 ($10.18 in chips)
Seat 3: cf6e2d2d ($10 in chips)
Seat 4: Hero ($10.87 in chips)
Seat 5: f4c833d7 ($10.15 in chips)
Seat 6: 8cef4f6e ($14.54 in chips)
feb8f704: posts small blind $0.05
cf6e2d2d: posts big blind $0.1
*** HOLE CARDS ***
Dealt to 3cf601f2 
Dealt to feb8f704 
Dealt to cf6e2d2d 
Dealt to Hero [3s 7h]
Dealt to f4c833d7 
Dealt to 8cef4f6e 
Hero: folds
f4c833d7: raises $0.2 to $0.3
8cef4f6e: raises $0.6 to $0.9
3cf601f2: folds
feb8f704: folds
cf6e2d2d: folds
f4c833d7: calls $0.6
*** FLOP *** [8c Kd 4d]
f4c833d7: checks
8cef4f6e: bets $0.75
f4c833d7: calls $0.75
*** TURN *** [8c Kd 4d] [5h]
f4c833d7: checks
8cef4f6e: bets $2.55
f4c833d7: raises $5.95 to $8.5 and is all-in
8cef4f6e: calls $5.95
f4c833d7: shows [8h 8s] (Three Eights)
8cef4f6e: shows [Ah Ac] (Pair of Aces)
*** RIVER *** [8c Kd 4d 5h] [Jh]
*** SHOWDOWN ***
f4c833d7 collected $20 from pot
*** SUMMARY ***
Total pot $20.45 | Rake $0.3 | Jackpot $0.15 | Bingo $0 | Fortune $0
Board [8c Kd 4d 5h Jh]
Seat 1: 3cf601f2 (button) folded before Flop (didn't bet)
Seat 2: feb8f704 (small blind) folded before Flop
Seat 3: cf6e2d2d (big blind) folded before Flop
Seat 4: Hero folded before Flop (didn't bet)
Seat 5: f4c833d7 showed [8h 8s] and won ($20) with Three Eights
Seat 6: 8cef4f6e showed [Ah Ac] and lost with Pair of Aces


Poker Hand #RC1316923766: Hold'em No Limit  ($0.05/$0.1) - 2023/02/02 13:53:09
Table 'RushAndCash5119026' 6-max Seat #1 is the button
Seat 1: 57a516a0 ($14.64 in chips)
Seat 2: cd8d77cf ($10.05 in chips)
Seat 3: 4dc2d5db ($30.05 in chips)
Seat 4: Hero ($10.87 in chips)
Seat 5: 9db9f619 ($6.02 in chips)
Seat 6: 1e4b2e49 ($17.2 in chips)
cd8d77cf: posts small blind $0.05
4dc2d5db: posts big blind $0.1
*** HOLE CARDS ***
Dealt to 57a516a0 
Dealt to cd8d77cf 
Dealt to 4dc2d5db 
Dealt to Hero [5d Ts]
Dealt to 9db9f619 
Dealt to 1e4b2e49 
Hero: folds
9db9f619: folds
1e4b2e49: raises $0.1 to $0.2
57a516a0: folds
cd8d77cf: folds
4dc2d5db: calls $0.1
*** FLOP *** [9h 3s Jh]
4dc2d5db: checks
1e4b2e49: checks
*** TURN *** [9h 3s Jh] [2d]
4dc2d5db: checks
1e4b2e49: checks
*** RIVER *** [9h 3s Jh 2d] [6s]
4dc2d5db: checks
1e4b2e49: bets $0.23
4dc2d5db: calls $0.23
1e4b2e49: shows [7c 8c] (Jack-High)
4dc2d5db: shows [Kh Qc] (King-High)
*** SHOWDOWN ***
4dc2d5db collected $0.87 from pot
*** SUMMARY ***
Total pot $0.91 | Rake $0.04 | Jackpot $0 | Bingo $0 | Fortune $0
Board [9h 3s Jh 2d 6s]
Seat 1: 57a516a0 (button) folded before Flop (didn't bet)
Seat 2: cd8d77cf (small blind) folded before Flop
Seat 3: 4dc2d5db (big blind) showed [Kh Qc] and won ($0.87) with King-High
Seat 4: Hero folded before Flop (didn't bet)
Seat 5: 9db9f619 folded before Flop (didn't bet)
Seat 6: 1e4b2e49 showed [7c 8c] and lost with Jack-High


Poker Hand #RC1316923736: Hold'em No Limit  ($0.05/$0.1) - 2023/02/02 13:53:04
Table 'RushAndCash5118996' 6-max Seat #1 is the button
Seat 1: b694a5da ($10.15 in chips)
Seat 2: 694c1edf ($16.85 in chips)
Seat 3: Hero ($10.97 in chips)
Seat 4: e0ce025c ($10.01 in chips)
Seat 5: 41f356ff ($10.13 in chips)
Seat 6: 7a65b7db ($11.84 in chips)
694c1edf: posts small blind $0.05
Hero: posts big blind $0.1
*** HOLE CARDS ***
Dealt to b694a5da 
Dealt to 694c1edf 
Dealt to Hero [3d Qc]
Dealt to e0ce025c 
Dealt to 41f356ff 
Dealt to 7a65b7db 
e0ce025c: raises $0.15 to $0.25
41f356ff: folds
7a65b7db: folds
b694a5da: folds
694c1edf: folds
Hero: folds
Uncalled bet ($0.15) returned to e0ce025c
*** SHOWDOWN ***
e0ce025c collected $0.25 from pot
*** SUMMARY ***
Total pot $0.25 | Rake $0 | Jackpot $0 | Bingo $0 | Fortune $0
Seat 1: b694a5da (button) folded before Flop (didn't bet)
Seat 2: 694c1edf (small blind) folded before Flop
Seat 3: Hero (big blind) folded before Flop
Seat 4: e0ce025c collected ($0.25)
Seat 5: 41f356ff folded before Flop (didn't bet)
Seat 6: 7a65b7db folded before Flop (didn't bet)


Poker Hand #RC1316923712: Hold'em No Limit  ($0.05/$0.1) - 2023/02/02 13:52:59
Table 'RushAndCash5118972' 6-max Seat #1 is the button
Seat 1: Hero ($10.97 in chips)
Seat 2: ac6f2c30 ($9.41 in chips)
Seat 3: 25cb00e0 ($10.03 in chips)
Seat 4: df02d839 ($10.1 in chips)
Seat 5: 16193806 ($10.09 in chips)
Seat 6: ba8a4759 ($10 in chips)
ac6f2c30: posts small blind $0.05
25cb00e0: posts big blind $0.1
*** HOLE CARDS ***
Dealt to Hero [4d 7c]
Dealt to ac6f2c30 
Dealt to 25cb00e0 
Dealt to df02d839 
Dealt to 16193806 
Dealt to ba8a4759 
df02d839: folds
16193806: folds
ba8a4759: raises $0.15 to $0.25
Hero: folds
ac6f2c30: folds
25cb00e0: raises $0.85 to $1.1
ba8a4759: raises $1.35 to $2.45
25cb00e0: folds
Uncalled bet ($1.35) returned to ba8a4759
*** SHOWDOWN ***
ba8a4759 collected $2.14 from pot
*** SUMMARY ***
Total pot $2.25 | Rake $0.11 | Jackpot $0 | Bingo $0 | Fortune $0
Seat 1: Hero (button) folded before Flop (didn't bet)
Seat 2: ac6f2c30 (small blind) folded before Flop
Seat 3: 25cb00e0 (big blind) folded before Flop
Seat 4: df02d839 folded before Flop (didn't bet)
Seat 5: 16193806 folded before Flop (didn't bet)
Seat 6: ba8a4759 collected ($2.14)


Poker Hand #RC1316923682: Hold'em No Limit  ($0.05/$0.1) - 2023/02/02 13:52:53
Table 'RushAndCash5118942' 6-max Seat #1 is the button
Seat 1: f4c833d7 ($10 in chips)
Seat 2: Hero ($11.02 in chips)
Seat 3: b834df54 ($24.2 in chips)
Seat 4: a43d3a7f ($10 in chips)
Seat 5: cd289374 ($13.26 in chips)
Seat 6: d86f1c20 ($10.71 in chips)
Hero: posts small blind $0.05
b834df54: posts big blind $0.1
*** HOLE CARDS ***
Dealt to f4c833d7 
Dealt to Hero [Qd 3c]
Dealt to b834df54 
Dealt to a43d3a7f 
Dealt to cd289374 
Dealt to d86f1c20 
a43d3a7f: folds
cd289374: folds
d86f1c20: folds
f4c833d7: raises $0.15 to $0.25
Hero: folds
b834df54: folds
Uncalled bet ($0.15) returned to f4c833d7
*** SHOWDOWN ***
f4c833d7 collected $0.25 from pot
*** SUMMARY ***
Total pot $0.25 | Rake $0 | Jackpot $0 | Bingo $0 | Fortune $0
Seat 1: f4c833d7 (button) collected ($0.25)
Seat 2: Hero (small blind) folded before Flop
Seat 3: b834df54 (big blind) folded before Flop
Seat 4: a43d3a7f folded before Flop (didn't bet)
Seat 5: cd289374 folded before Flop (didn't bet)
Seat 6: d86f1c20 folded before Flop (didn't bet)


Poker Hand #RC1316923588: Hold'em No Limit  ($0.05/$0.1) - 2023/02/02 13:52:37
Table 'RushAndCash5118848' 6-max Seat #1 is the button
Seat 1: d1d9500b ($8.04 in chips)
Seat 2: f4ac5f12 ($10.41 in chips)
Seat 3: e7c7aa80 ($10.35 in chips)
Seat 4: Hero ($10.87 in chips)
Seat 5: 8d32bb20 ($12.18 in chips)
Seat 6: c66b4a30 ($14.73 in chips)
f4ac5f12: posts small blind $0.05
e7c7aa80: posts big blind $0.1
*** HOLE CARDS ***
Dealt to d1d9500b 
Dealt to f4ac5f12 
Dealt to e7c7aa80 
Dealt to Hero [7c 8c]
Dealt to 8d32bb20 
Dealt to c66b4a30 
Hero: raises $0.15 to $0.25
8d32bb20: folds
c66b4a30: folds
d1d9500b: folds
f4ac5f12: folds
e7c7aa80: folds
Uncalled bet ($0.15) returned to Hero
*** SHOWDOWN ***
Hero collected $0.25 from pot
*** SUMMARY ***
Total pot $0.25 | Rake $0 | Jackpot $0 | Bingo $0 | Fortune $0
Seat 1: d1d9500b (button) folded before Flop (didn't bet)
Seat 2: f4ac5f12 (small blind) folded before Flop
Seat 3: e7c7aa80 (big blind) folded before Flop
Seat 4: Hero collected ($0.25)
Seat 5: 8d32bb20 folded before Flop (didn't bet)
Seat 6: c66b4a30 folded before Flop (didn't bet)


Poker Hand #RC1316923558: Hold'em No Limit  ($0.05/$0.1) - 2023/02/02 13:52:31
Table 'RushAndCash5118818' 6-max Seat #1 is the button
Seat 1: 3c631a97 ($11.1 in chips)
Seat 2: Hero ($10.92 in chips)
Seat 3: f971222 ($10.15 in chips)
Seat 4: 89dbab57 ($13.9 in chips)
Seat 5: 3828897b ($21.66 in chips)
Seat 6: 81edd1dd ($0.96 in chips)
Hero: posts small blind $0.05
f971222: posts big blind $0.1
*** HOLE CARDS ***
Dealt to 3c631a97 
Dealt to Hero [3s 6d]
Dealt to f971222 
Dealt to 89dbab57 
Dealt to 3828897b 
Dealt to 81edd1dd 
89dbab57: folds
3828897b: folds
81edd1dd: folds
3c631a97: raises $0.13 to $0.23
Hero: folds
f971222: calls $0.13
*** FLOP *** [7d Kd Ad]
f971222: checks
3c631a97: bets $0.17
f971222: calls $0.17
*** TURN *** [7d Kd Ad] [Qh]
f971222: checks
3c631a97: bets $0.29
f971222: calls $0.29
*** RIVER *** [7d Kd Ad Qh] [Ah]
f971222: checks
3c631a97: checks
f971222: shows [Qd Jd] (Ace High Flush)
3c631a97: shows [As Ts] (Three Aces)
*** SHOWDOWN ***
f971222 collected $1.36 from pot
*** SUMMARY ***
Total pot $1.43 | Rake $0.07 | Jackpot $0 | Bingo $0 | Fortune $0
Board [7d Kd Ad Qh Ah]
Seat 1: 3c631a97 (button) showed [As Ts] and lost with Three Aces
Seat 2: Hero (small blind) folded before Flop
Seat 3: f971222 (big blind) showed [Qd Jd] and won ($1.36) with Ace High Flush
Seat 4: 89dbab57 folded before Flop (didn't bet)
Seat 5: 3828897b folded before Flop (didn't bet)
Seat 6: 81edd1dd folded before Flop (didn't bet)


Poker Hand #RC1316923536: Hold'em No Limit  ($0.05/$0.1) - 2023/02/02 13:52:28
Table 'RushAndCash5118796' 6-max Seat #1 is the button
Seat 1: Hero ($10.92 in chips)
Seat 2: 6dc1626d ($10.2 in chips)
Seat 3: 83985f83 ($10 in chips)
Seat 4: 83cf0341 ($10.57 in chips)
Seat 5: 3828897b ($21.66 in chips)
Seat 6: b8f75f5 ($10.62 in chips)
6dc1626d: posts small blind $0.05
83985f83: posts big blind $0.1
*** HOLE CARDS ***
Dealt to Hero [7h Td]
Dealt to 6dc1626d 
Dealt to 83985f83 
Dealt to 83cf0341 
Dealt to 3828897b 
Dealt to b8f75f5 
83cf0341: folds
3828897b: folds
b8f75f5: folds
Hero: folds
6dc1626d: raises $0.1 to $0.2
83985f83: folds
Uncalled bet ($0.1) returned to 6dc1626d
*** SHOWDOWN ***
6dc1626d collected $0.2 from pot
*** SUMMARY ***
Total pot $0.2 | Rake $0 | Jackpot $0 | Bingo $0 | Fortune $0
Seat 1: Hero (button) folded before Flop (didn't bet)
Seat 2: 6dc1626d (small blind) collected ($0.2)
Seat 3: 83985f83 (big blind) folded before Flop
Seat 4: 83cf0341 folded before Flop (didn't bet)
Seat 5: 3828897b folded before Flop (didn't bet)
Seat 6: b8f75f5 folded before Flop (didn't bet)


Poker Hand #RC1316923513: Hold'em No Limit  ($0.05/$0.1) - 2023/02/02 13:52:24
Table 'RushAndCash5118773' 6-max Seat #1 is the button
Seat 1: 2eb8267a ($10 in chips)
Seat 2: 83cf0341 ($10.62 in chips)
Seat 3: Hero ($11.02 in chips)
Seat 4: a2078f34 ($20.59 in chips)
Seat 5: 690e4249 ($10 in chips)
Seat 6: e331248e ($19.63 in chips)
83cf0341: posts small blind $0.05
Hero: posts big blind $0.1
*** HOLE CARDS ***
Dealt to 2eb8267a 
Dealt to 83cf0341 
Dealt to Hero [9d 6h]
Dealt to a2078f34 
Dealt to 690e4249 
Dealt to e331248e 
a2078f34: raises $0.11 to $0.21
690e4249: folds
e331248e: folds
2eb8267a: folds
83cf0341: folds
Hero: folds
Uncalled bet ($0.11) returned to a2078f34
*** SHOWDOWN ***
a2078f34 collected $0.25 from pot
*** SUMMARY ***
Total pot $0.25 | Rake $0 | Jackpot $0 | Bingo $0 | Fortune $0
Seat 1: 2eb8267a (button) folded before Flop (didn't bet)
Seat 2: 83cf0341 (small blind) folded before Flop
Seat 3: Hero (big blind) folded before Flop
Seat 4: a2078f34 collected ($0.25)
Seat 5: 690e4249 folded before Flop (didn't bet)
Seat 6: e331248e folded before Flop (didn't bet)


Poker Hand #RC1316923490: Hold'em No Limit  ($0.05/$0.1) - 2023/02/02 13:52:20
Table 'RushAndCash5118750' 6-max Seat #1 is the button
Seat 1: 38008ffc ($30.88 in chips)
Seat 2: 59bf16ec ($3.93 in chips)
Seat 3: 9b2ff61d ($35.33 in chips)
Seat 4: bfc551dc ($13.33 in chips)
Seat 5: a369504c ($18.49 in chips)
Seat 6: Hero ($11.02 in chips)
59bf16ec: posts small blind $0.05
9b2ff61d: posts big blind $0.1
*** HOLE CARDS ***
Dealt to 38008ffc 
Dealt to 59bf16ec 
Dealt to 9b2ff61d 
Dealt to bfc551dc 
Dealt to a369504c 
Dealt to Hero [6s 3d]
bfc551dc: folds
a369504c: folds
Hero: folds
38008ffc: folds
59bf16ec: folds
Uncalled bet ($0.05) returned to 9b2ff61d
*** SHOWDOWN ***
9b2ff61d collected $0.1 from pot
*** SUMMARY ***
Total pot $0.1 | Rake $0 | Jackpot $0 | Bingo $0 | Fortune $0
Seat 1: 38008ffc (button) folded before Flop (didn't bet)
Seat 2: 59bf16ec (small blind) folded before Flop
Seat 3: 9b2ff61d (big blind) collected ($0.1)
Seat 4: bfc551dc folded before Flop (didn't bet)
Seat 5: a369504c folded before Flop (didn't bet)
Seat 6: Hero folded before Flop (didn't bet)


Poker Hand #RC1316923401: Hold'em No Limit  ($0.05/$0.1) - 2023/02/02 13:52:04
Table 'RushAndCash5118661' 6-max Seat #1 is the button
Seat 1: Hero ($10.87 in chips)
Seat 2: f6eae14b ($16.23 in chips)
Seat 3: e45ce097 ($27.63 in chips)
Seat 4: 9286244f ($11.18 in chips)
Seat 5: 3443af90 ($18.81 in chips)
Seat 6: b03b0bf4 ($9.8 in chips)
f6eae14b: posts small blind $0.05
e45ce097: posts big blind $0.1
*** HOLE CARDS ***
Dealt to Hero [Qc Kd]
Dealt to f6eae14b 
Dealt to e45ce097 
Dealt to 9286244f 
Dealt to 3443af90 
Dealt to b03b0bf4 
9286244f: folds
3443af90: folds
b03b0bf4: folds
Hero: raises $0.15 to $0.25
f6eae14b: folds
e45ce097: folds
Uncalled bet ($0.15) returned to Hero
*** SHOWDOWN ***
Hero collected $0.25 from pot
*** SUMMARY ***
Total pot $0.25 | Rake $0 | Jackpot $0 | Bingo $0 | Fortune $0
Seat 1: Hero (button) collected ($0.25)
Seat 2: f6eae14b (small blind) folded before Flop
Seat 3: e45ce097 (big blind) folded before Flop
Seat 4: 9286244f folded before Flop (didn't bet)
Seat 5: 3443af90 folded before Flop (didn't bet)
Seat 6: b03b0bf4 folded before Flop (didn't bet)


Poker Hand #RC1316923381: Hold'em No Limit  ($0.05/$0.1) - 2023/02/02 13:51:59
Table 'RushAndCash5118641' 6-max Seat #1 is the button
Seat 1: 6e07ea95 ($5.3 in chips)
Seat 2: c356fffd ($10.66 in chips)
Seat 3: c7cb04d4 ($31.06 in chips)
Seat 4: 38e737d1 ($18.38 in chips)
Seat 5: 460b8983 ($14.39 in chips)
Seat 6: Hero ($10.87 in chips)
c356fffd: posts small blind $0.05
c7cb04d4: posts big blind $0.1
*** HOLE CARDS ***
Dealt to 6e07ea95 
Dealt to c356fffd 
Dealt to c7cb04d4 
Dealt to 38e737d1 
Dealt to 460b8983 
Dealt to Hero [4s Ts]
38e737d1: folds
460b8983: folds
Hero: folds
6e07ea95: raises $0.2 to $0.3
c356fffd: calls $0.25
c7cb04d4: folds
*** FLOP *** [Qd Kd Ah]
c356fffd: checks
6e07ea95: bets $0.35
c356fffd: folds
Uncalled bet ($0.35) returned to 6e07ea95
*** SHOWDOWN ***
6e07ea95 collected $0.66 from pot
*** SUMMARY ***
Total pot $0.7 | Rake $0.04 | Jackpot $0 | Bingo $0 | Fortune $0
Board [Qd Kd Ah]
Seat 1: 6e07ea95 (button) won ($0.66)
Seat 2: c356fffd (small blind) folded on the Flop
Seat 3: c7cb04d4 (big blind) folded before Flop
Seat 4: 38e737d1 folded before Flop (didn't bet)
Seat 5: 460b8983 folded before Flop (didn't bet)
Seat 6: Hero folded before Flop (didn't bet)


Poker Hand #RC1316923339: Hold'em No Limit  ($0.05/$0.1) - 2023/02/02 13:51:52
Table 'RushAndCash5118599' 6-max Seat #1 is the button
Seat 1: 23429e9d ($11.84 in chips)
Seat 2: 6b6ecc43 ($13.15 in chips)
Seat 3: ec1168a1 ($10 in chips)
Seat 4: 593cc204 ($7.5 in chips)
Seat 5: dfe56014 ($17.8 in chips)
Seat 6: Hero ($10.87 in chips)
6b6ecc43: posts small blind $0.05
ec1168a1: posts big blind $0.1
*** HOLE CARDS ***
Dealt to 23429e9d 
Dealt to 6b6ecc43 
Dealt to ec1168a1 
Dealt to 593cc204 
Dealt to dfe56014 
Dealt to Hero [9s Kc]
593cc204: folds
dfe56014: folds
Hero: folds
23429e9d: folds
6b6ecc43: folds
Uncalled bet ($0.05) returned to ec1168a1
*** SHOWDOWN ***
ec1168a1 collected $0.1 from pot
*** SUMMARY ***
Total pot $0.1 | Rake $0 | Jackpot $0 | Bingo $0 | Fortune $0
Seat 1: 23429e9d (button) folded before Flop (didn't bet)
Seat 2: 6b6ecc43 (small blind) folded before Flop
Seat 3: ec1168a1 (big blind) collected ($0.1)
Seat 4: 593cc204 folded before Flop (didn't bet)
Seat 5: dfe56014 folded before Flop (didn't bet)
Seat 6: Hero folded before Flop (didn't bet)


Poker Hand #RC1316923313: Hold'em No Limit  ($0.05/$0.1) - 2023/02/02 13:51:48
Table 'RushAndCash5118573' 6-max Seat #1 is the button
Seat 1: bd260b3e ($12.14 in chips)
Seat 2: 2f7a4c4d ($10.96 in chips)
Seat 3: 5421c2ce ($10.71 in chips)
Seat 4: 78230982 ($12.66 in chips)
Seat 5: Hero ($10.87 in chips)
Seat 6: 38008ffc ($30.73 in chips)
2f7a4c4d: posts small blind $0.05
5421c2ce: posts big blind $0.1
*** HOLE CARDS ***
Dealt to bd260b3e 
Dealt to 2f7a4c4d 
Dealt to 5421c2ce 
Dealt to 78230982 
Dealt to Hero [7c 3h]
Dealt to 38008ffc 
78230982: folds
Hero: folds
38008ffc: raises $0.15 to $0.25
bd260b3e: folds
2f7a4c4d: folds
5421c2ce: folds
Uncalled bet ($0.15) returned to 38008ffc
*** SHOWDOWN ***
38008ffc collected $0.25 from pot
*** SUMMARY ***
Total pot $0.25 | Rake $0 | Jackpot $0 | Bingo $0 | Fortune $0
Seat 1: bd260b3e (button) folded before Flop (didn't bet)
Seat 2: 2f7a4c4d (small blind) folded before Flop
Seat 3: 5421c2ce (big blind) folded before Flop
Seat 4: 78230982 folded before Flop (didn't bet)
Seat 5: Hero folded before Flop (didn't bet)
Seat 6: 38008ffc collected ($0.25)


Poker Hand #RC1316923288: Hold'em No Limit  ($0.05/$0.1) - 2023/02/02 13:51:44
Table 'RushAndCash5118548' 6-max Seat #1 is the button
Seat 1: a890f3ca ($10 in chips)
Seat 2: d2642a4f ($23.14 in chips)
Seat 3: Hero ($10.97 in chips)
Seat 4: 9ada769 ($11.5 in chips)
Seat 5: 2280f4aa ($11.5 in chips)
Seat 6: 38008ffc ($30.73 in chips)
d2642a4f: posts small blind $0.05
Hero: posts big blind $0.1
*** HOLE CARDS ***
Dealt to a890f3ca 
Dealt to d2642a4f 
Dealt to Hero [8d 2c]
Dealt to 9ada769 
Dealt to 2280f4aa 
Dealt to 38008ffc 
9ada769: folds
2280f4aa: folds
38008ffc: folds
a890f3ca: raises $0.15 to $0.25
d2642a4f: folds
Hero: folds
Uncalled bet ($0.15) returned to a890f3ca
*** SHOWDOWN ***
a890f3ca collected $0.25 from pot
*** SUMMARY ***
Total pot $0.25 | Rake $0 | Jackpot $0 | Bingo $0 | Fortune $0
Seat 1: a890f3ca (button) collected ($0.25)
Seat 2: d2642a4f (small blind) folded before Flop
Seat 3: Hero (big blind) folded before Flop
Seat 4: 9ada769 folded before Flop (didn't bet)
Seat 5: 2280f4aa folded before Flop (didn't bet)
Seat 6: 38008ffc folded before Flop (didn't bet)


Poker Hand #RC1316923262: Hold'em No Limit  ($0.05/$0.1) - 2023/02/02 13:51:41
Table 'RushAndCash5118522' 6-max Seat #1 is the button
Seat 1: 472e5b99 ($10.35 in chips)
Seat 2: Hero ($11.02 in chips)
Seat 3: ba4bcf27 ($10.3 in chips)
Seat 4: 6b6ecc43 ($13.15 in chips)
Seat 5: 2798beed ($11.05 in chips)
Seat 6: b56b8308 ($11.53 in chips)
Hero: posts small blind $0.05
ba4bcf27: posts big blind $0.1
*** HOLE CARDS ***
Dealt to 472e5b99 
Dealt to Hero [8d 4d]
Dealt to ba4bcf27 
Dealt to 6b6ecc43 
Dealt to 2798beed 
Dealt to b56b8308 
6b6ecc43: folds
2798beed: folds
b56b8308: folds
472e5b99: folds
Hero: folds
Uncalled bet ($0.05) returned to ba4bcf27
*** SHOWDOWN ***
ba4bcf27 collected $0.1 from pot
*** SUMMARY ***
Total pot $0.1 | Rake $0 | Jackpot $0 | Bingo $0 | Fortune $0
Seat 1: 472e5b99 (button) folded before Flop (didn't bet)
Seat 2: Hero (small blind) folded before Flop
Seat 3: ba4bcf27 (big blind) collected ($0.1)
Seat 4: 6b6ecc43 folded before Flop (didn't bet)
Seat 5: 2798beed folded before Flop (didn't bet)
Seat 6: b56b8308 folded before Flop (didn't bet)


Poker Hand #RC1316923236: Hold'em No Limit  ($0.05/$0.1) - 2023/02/02 13:51:37
Table 'RushAndCash5118496' 6-max Seat #1 is the button
Seat 1: 29e6d264 ($34.67 in chips)
Seat 2: 4a335b53 ($10.73 in chips)
Seat 3: a9c78298 ($10 in chips)
Seat 4: 23429e9d ($11.99 in chips)
Seat 5: 8a02bdd6 ($20.15 in chips)
Seat 6: Hero ($11.02 in chips)
4a335b53: posts small blind $0.05
a9c78298: posts big blind $0.1
*** HOLE CARDS ***
Dealt to 29e6d264 
Dealt to 4a335b53 
Dealt to a9c78298 
Dealt to 23429e9d 
Dealt to 8a02bdd6 
Dealt to Hero [4h Ks]
23429e9d: folds
8a02bdd6: folds
Hero: folds
29e6d264: raises $0.1 to $0.2
4a335b53: raises $0.75 to $0.95
a9c78298: folds
29e6d264: folds
Uncalled bet ($0.75) returned to 4a335b53
*** SHOWDOWN ***
4a335b53 collected $0.48 from pot
*** SUMMARY ***
Total pot $0.5 | Rake $0.02 | Jackpot $0 | Bingo $0 | Fortune $0
Seat 1: 29e6d264 (button) folded before Flop
Seat 2: 4a335b53 (small blind) collected ($0.48)
Seat 3: a9c78298 (big blind) folded before Flop
Seat 4: 23429e9d folded before Flop (didn't bet)
Seat 5: 8a02bdd6 folded before Flop (didn't bet)
Seat 6: Hero folded before Flop (didn't bet)


Poker Hand #RC1316923209: Hold'em No Limit  ($0.05/$0.1) - 2023/02/02 13:51:33
Table 'RushAndCash5118469' 6-max Seat #1 is the button
Seat 1: 29325a4e ($4.3 in chips)
Seat 2: 3ddb11 ($16.6 in chips)
Seat 3: df707b71 ($19.42 in chips)
Seat 4: a7dd82d4 ($10 in chips)
Seat 5: 25ed30b3 ($10 in chips)
Seat 6: Hero ($10.87 in chips)
3ddb11: posts small blind $0.05
df707b71: posts big blind $0.1
*** HOLE CARDS ***
Dealt to 29325a4e 
Dealt to 3ddb11 
Dealt to df707b71 
Dealt to a7dd82d4 
Dealt to 25ed30b3 
Dealt to Hero [Qd 5s]
a7dd82d4: folds
25ed30b3: folds
Hero: folds
29325a4e: folds
3ddb11: folds
Uncalled bet ($0.05) returned to df707b71
*** SHOWDOWN ***
df707b71 collected $0.1 from pot
*** SUMMARY ***
Total pot $0.1 | Rake $0 | Jackpot $0 | Bingo $0 | Fortune $0
Seat 1: 29325a4e (button) folded before Flop (didn't bet)
Seat 2: 3ddb11 (small blind) folded before Flop
Seat 3: df707b71 (big blind) collected ($0.1)
Seat 4: a7dd82d4 folded before Flop (didn't bet)
Seat 5: 25ed30b3 folded before Flop (didn't bet)
Seat 6: Hero folded before Flop (didn't bet)


Poker Hand #RC1316923183: Hold'em No Limit  ($0.05/$0.1) - 2023/02/02 13:51:28
Table 'RushAndCash5118443' 6-max Seat #1 is the button
Seat 1: 7ba7ddec ($17.11 in chips)
Seat 2: cb98a323 ($14.24 in chips)
Seat 3: Hero ($10.97 in chips)
Seat 4: 2f9df460 ($12.76 in chips)
Seat 5: 36f46669 ($12.21 in chips)
Seat 6: 42614d1c ($9.03 in chips)
cb98a323: posts small blind $0.05
Hero: posts big blind $0.1
*** HOLE CARDS ***
Dealt to 7ba7ddec 
Dealt to cb98a323 
Dealt to Hero [4c 9d]
Dealt to 2f9df460 
Dealt to 36f46669 
Dealt to 42614d1c 
2f9df460: folds
36f46669: folds
42614d1c: folds
7ba7ddec: folds
cb98a323: folds
Uncalled bet ($0.05) returned to Hero
*** SHOWDOWN ***
Hero collected $0.1 from pot
*** SUMMARY ***
Total pot $0.1 | Rake $0 | Jackpot $0 | Bingo $0 | Fortune $0
Seat 1: 7ba7ddec (button) folded before Flop (didn't bet)
Seat 2: cb98a323 (small blind) folded before Flop
Seat 3: Hero (big blind) collected ($0.1)
Seat 4: 2f9df460 folded before Flop (didn't bet)
Seat 5: 36f46669 folded before Flop (didn't bet)
Seat 6: 42614d1c folded before Flop (didn't bet)


Poker Hand #RC1316923157: Hold'em No Limit  ($0.05/$0.1) - 2023/02/02 13:51:23
Table 'RushAndCash5118417' 6-max Seat #1 is the button
Seat 1: Hero ($10.97 in chips)
Seat 2: ff7a9d33 ($10.33 in chips)
Seat 3: 10b69628 ($15.35 in chips)
Seat 4: 5958aec1 ($10 in chips)
Seat 5: 21467c52 ($11.75 in chips)
Seat 6: b9fc2b4e ($16.96 in chips)
ff7a9d33: posts small blind $0.05
10b69628: posts big blind $0.1
*** HOLE CARDS ***
Dealt to Hero [Jd 3c]
Dealt to ff7a9d33 
Dealt to 10b69628 
Dealt to 5958aec1 
Dealt to 21467c52 
Dealt to b9fc2b4e 
5958aec1: folds
21467c52: folds
b9fc2b4e: folds
Hero: folds
ff7a9d33: folds
Uncalled bet ($0.05) returned to 10b69628
*** SHOWDOWN ***
10b69628 collected $0.1 from pot
*** SUMMARY ***
Total pot $0.1 | Rake $0 | Jackpot $0 | Bingo $0 | Fortune $0
Seat 1: Hero (button) folded before Flop (didn't bet)
Seat 2: ff7a9d33 (small blind) folded before Flop
Seat 3: 10b69628 (big blind) collected ($0.1)
Seat 4: 5958aec1 folded before Flop (didn't bet)
Seat 5: 21467c52 folded before Flop (didn't bet)
Seat 6: b9fc2b4e folded before Flop (didn't bet)


Poker Hand #RC1316923128: Hold'em No Limit  ($0.05/$0.1) - 2023/02/02 13:51:19
Table 'RushAndCash5118388' 6-max Seat #1 is the button
Seat 1: 534c06d7 ($12.75 in chips)
Seat 2: Hero ($11.02 in chips)
Seat 3: 8a02bdd6 ($20.25 in chips)
Seat 4: e331248e ($19.78 in chips)
Seat 5: d8fa0745 ($10.47 in chips)
Seat 6: 44295b1f ($10.22 in chips)
Hero: posts small blind $0.05
8a02bdd6: posts big blind $0.1
*** HOLE CARDS ***
Dealt to 534c06d7 
Dealt to Hero [Th 5h]
Dealt to 8a02bdd6 
Dealt to e331248e 
Dealt to d8fa0745 
Dealt to 44295b1f 
e331248e: folds
d8fa0745: folds
44295b1f: folds
534c06d7: raises $0.15 to $0.25
Hero: folds
8a02bdd6: folds
Uncalled bet ($0.15) returned to 534c06d7
*** SHOWDOWN ***
534c06d7 collected $0.25 from pot
*** SUMMARY ***
Total pot $0.25 | Rake $0 | Jackpot $0 | Bingo $0 | Fortune $0
Seat 1: 534c06d7 (button) collected ($0.25)
Seat 2: Hero (small blind) folded before Flop
Seat 3: 8a02bdd6 (big blind) folded before Flop
Seat 4: e331248e folded before Flop (didn't bet)
Seat 5: d8fa0745 folded before Flop (didn't bet)
Seat 6: 44295b1f folded before Flop (didn't bet)


Poker Hand #RC1316923106: Hold'em No Limit  ($0.05/$0.1) - 2023/02/02 13:51:15
Table 'RushAndCash5118366' 6-max Seat #1 is the button
Seat 1: 4b642a01 ($12.6 in chips)
Seat 2: dc581a50 ($10.23 in chips)
Seat 3: 8491f75f ($19.75 in chips)
Seat 4: Hero ($11.02 in chips)
Seat 5: 773aeb87 ($12.2 in chips)
Seat 6: ec6a9a1d ($10.14 in chips)
dc581a50: posts small blind $0.05
8491f75f: posts big blind $0.1
*** HOLE CARDS ***
Dealt to 4b642a01 
Dealt to dc581a50 
Dealt to 8491f75f 
Dealt to Hero [7h As]
Dealt to 773aeb87 
Dealt to ec6a9a1d 
Hero: folds
773aeb87: folds
ec6a9a1d: folds
4b642a01: folds
dc581a50: folds
Uncalled bet ($0.05) returned to 8491f75f
*** SHOWDOWN ***
8491f75f collected $0.1 from pot
*** SUMMARY ***
Total pot $0.1 | Rake $0 | Jackpot $0 | Bingo $0 | Fortune $0
Seat 1: 4b642a01 (button) folded before Flop (didn't bet)
Seat 2: dc581a50 (small blind) folded before Flop
Seat 3: 8491f75f (big blind) collected ($0.1)
Seat 4: Hero folded before Flop (didn't bet)
Seat 5: 773aeb87 folded before Flop (didn't bet)
Seat 6: ec6a9a1d folded before Flop (didn't bet)


Poker Hand #RC1316923071: Hold'em No Limit  ($0.05/$0.1) - 2023/02/02 13:51:09
Table 'RushAndCash5118331' 6-max Seat #1 is the button
Seat 1: 1d98175 ($10.96 in chips)
Seat 2: 6a39bd11 ($12.12 in chips)
Seat 3: cb873d5a ($9.54 in chips)
Seat 4: d457cef0 ($10.08 in chips)
Seat 5: 70157308 ($12.25 in chips)
Seat 6: Hero ($11.02 in chips)
6a39bd11: posts small blind $0.05
cb873d5a: posts big blind $0.1
*** HOLE CARDS ***
Dealt to 1d98175 
Dealt to 6a39bd11 
Dealt to cb873d5a 
Dealt to d457cef0 
Dealt to 70157308 
Dealt to Hero [2c 7h]
d457cef0: folds
70157308: folds
Hero: folds
1d98175: raises $0.1 to $0.2
6a39bd11: folds
cb873d5a: folds
Uncalled bet ($0.1) returned to 1d98175
*** SHOWDOWN ***
1d98175 collected $0.25 from pot
*** SUMMARY ***
Total pot $0.25 | Rake $0 | Jackpot $0 | Bingo $0 | Fortune $0
Seat 1: 1d98175 (button) collected ($0.25)
Seat 2: 6a39bd11 (small blind) folded before Flop
Seat 3: cb873d5a (big blind) folded before Flop
Seat 4: d457cef0 folded before Flop (didn't bet)
Seat 5: 70157308 folded before Flop (didn't bet)
Seat 6: Hero folded before Flop (didn't bet)


Poker Hand #RC1316923047: Hold'em No Limit  ($0.05/$0.1) - 2023/02/02 13:51:05
Table 'RushAndCash5118307' 6-max Seat #1 is the button
Seat 1: e21bef76 ($14.13 in chips)
Seat 2: 84a2c758 ($10.28 in chips)
Seat 3: e79a686f ($10.06 in chips)
Seat 4: ec06370 ($11.11 in chips)
Seat 5: Hero ($11.02 in chips)
Seat 6: bf04d9a2 ($11.25 in chips)
84a2c758: posts small blind $0.05
e79a686f: posts big blind $0.1
*** HOLE CARDS ***
Dealt to e21bef76 
Dealt to 84a2c758 
Dealt to e79a686f 
Dealt to ec06370 
Dealt to Hero [2h 3c]
Dealt to bf04d9a2 
ec06370: folds
Hero: folds
bf04d9a2: folds
e21bef76: raises $0.15 to $0.25
84a2c758: folds
e79a686f: folds
Uncalled bet ($0.15) returned to e21bef76
*** SHOWDOWN ***
e21bef76 collected $0.25 from pot
*** SUMMARY ***
Total pot $0.25 | Rake $0 | Jackpot $0 | Bingo $0 | Fortune $0
Seat 1: e21bef76 (button) collected ($0.25)
Seat 2: 84a2c758 (small blind) folded before Flop
Seat 3: e79a686f (big blind) folded before Flop
Seat 4: ec06370 folded before Flop (didn't bet)
Seat 5: Hero folded before Flop (didn't bet)
Seat 6: bf04d9a2 folded before Flop (didn't bet)


Poker Hand #RC1316923023: Hold'em No Limit  ($0.05/$0.1) - 2023/02/02 13:51:01
Table 'RushAndCash5118283' 6-max Seat #1 is the button
Seat 1: Hero ($11.02 in chips)
Seat 2: 84bd5921 ($11.02 in chips)
Seat 3: d29c0c1b ($22.71 in chips)
Seat 4: c356fffd ($10.81 in chips)
Seat 5: ce2b1ec ($10.07 in chips)
Seat 6: 39b91777 ($10 in chips)
84bd5921: posts small blind $0.05
d29c0c1b: posts big blind $0.1
*** HOLE CARDS ***
Dealt to Hero [Kh 4s]
Dealt to 84bd5921 
Dealt to d29c0c1b 
Dealt to c356fffd 
Dealt to ce2b1ec 
Dealt to 39b91777 
c356fffd: folds
ce2b1ec: folds
39b91777: raises $0.15 to $0.25
Hero: folds
84bd5921: folds
d29c0c1b: calls $0.15
*** FLOP *** [7d As 6d]
d29c0c1b: checks
39b91777: checks
*** TURN *** [7d As 6d] [4d]
d29c0c1b: checks
39b91777: checks
*** RIVER *** [7d As 6d 4d] [2d]
d29c0c1b: checks
39b91777: checks
d29c0c1b: shows [Qd Th] (Queen High Flush)
39b91777: shows [8d Ac] (Eight High Flush)
*** SHOWDOWN ***
d29c0c1b collected $0.53 from pot
*** SUMMARY ***
Total pot $0.55 | Rake $0.02 | Jackpot $0 | Bingo $0 | Fortune $0
Board [7d As 6d 4d 2d]
Seat 1: Hero (button) folded before Flop (didn't bet)
Seat 2: 84bd5921 (small blind) folded before Flop
Seat 3: d29c0c1b (big blind) showed [Qd Th] and won ($0.53) with Queen High Flush
Seat 4: c356fffd folded before Flop (didn't bet)
Seat 5: ce2b1ec folded before Flop (didn't bet)
Seat 6: 39b91777 showed [8d Ac] and lost with Eight High Flush


Poker Hand #RC1316923000: Hold'em No Limit  ($0.05/$0.1) - 2023/02/02 13:50:57
Table 'RushAndCash5118260' 6-max Seat #1 is the button
Seat 1: feb8f704 ($9.13 in chips)
Seat 2: 21467c52 ($11.75 in chips)
Seat 3: 10b69628 ($15.55 in chips)
Seat 4: Hero ($11.02 in chips)
Seat 5: 83ab6f84 ($16.21 in chips)
Seat 6: aa273a33 ($10.5 in chips)
21467c52: posts small blind $0.05
10b69628: posts big blind $0.1
*** HOLE CARDS ***
Dealt to feb8f704 
Dealt to 21467c52 
Dealt to 10b69628 
Dealt to Hero [7h 2s]
Dealt to 83ab6f84 
Dealt to aa273a33 
Hero: folds
83ab6f84: raises $0.14 to $0.24
aa273a33: folds
feb8f704: folds
21467c52: folds
10b69628: folds
Uncalled bet ($0.14) returned to 83ab6f84
*** SHOWDOWN ***
83ab6f84 collected $0.25 from pot
*** SUMMARY ***
Total pot $0.25 | Rake $0 | Jackpot $0 | Bingo $0 | Fortune $0
Seat 1: feb8f704 (button) folded before Flop (didn't bet)
Seat 2: 21467c52 (small blind) folded before Flop
Seat 3: 10b69628 (big blind) folded before Flop
Seat 4: Hero folded before Flop (didn't bet)
Seat 5: 83ab6f84 collected ($0.25)
Seat 6: aa273a33 folded before Flop (didn't bet)


Poker Hand #RC1316922976: Hold'em No Limit  ($0.05/$0.1) - 2023/02/02 13:50:52
Table 'RushAndCash5118236' 6-max Seat #1 is the button
Seat 1: 38008ffc ($30.73 in chips)
Seat 2: Hero ($11.07 in chips)
Seat 3: 94298a61 ($4 in chips)
Seat 4: 509c41a2 ($24.52 in chips)
Seat 5: 21467c52 ($11.75 in chips)
Seat 6: 81edd1dd ($5.2 in chips)
Hero: posts small blind $0.05
94298a61: posts big blind $0.1
*** HOLE CARDS ***
Dealt to 38008ffc 
Dealt to Hero [3d Qd]
Dealt to 94298a61 
Dealt to 509c41a2 
Dealt to 21467c52 
Dealt to 81edd1dd 
509c41a2: raises $0.2 to $0.3
21467c52: folds
81edd1dd: folds
38008ffc: folds
Hero: folds
94298a61: calls $0.2
*** FLOP *** [5s 8s Td]
94298a61: checks
509c41a2: checks
*** TURN *** [5s 8s Td] [4s]
94298a61: bets $0.22
509c41a2: calls $0.22
*** RIVER *** [5s 8s Td 4s] [4c]
94298a61: checks
509c41a2: checks
94298a61: shows [3c 5c] (Pair of Fives and Pair of Fours)
509c41a2: shows [Ks Ac] (Pair of Fours)
*** SHOWDOWN ***
94298a61 collected $1.04 from pot
*** SUMMARY ***
Total pot $1.09 | Rake $0.05 | Jackpot $0 | Bingo $0 | Fortune $0
Board [5s 8s Td 4s 4c]
Seat 1: 38008ffc (button) folded before Flop (didn't bet)
Seat 2: Hero (small blind) folded before Flop
Seat 3: 94298a61 (big blind) showed [3c 5c] and won ($1.04) with Pair of Fives and Pair of Fours
Seat 4: 509c41a2 showed [Ks Ac] and lost with Pair of Fours
Seat 5: 21467c52 folded before Flop (didn't bet)
Seat 6: 81edd1dd folded before Flop (didn't bet)


Poker Hand #RC1316922954: Hold'em No Limit  ($0.05/$0.1) - 2023/02/02 13:50:48
Table 'RushAndCash5118214' 6-max Seat #1 is the button
Seat 1: e58114d9 ($12.63 in chips)
Seat 2: 8f1069bc ($8.61 in chips)
Seat 3: Hero ($11.17 in chips)
Seat 4: b90e9337 ($12.51 in chips)
Seat 5: c7cb04d4 ($31.26 in chips)
Seat 6: 2326f258 ($11.34 in chips)
8f1069bc: posts small blind $0.05
Hero: posts big blind $0.1
*** HOLE CARDS ***
Dealt to e58114d9 
Dealt to 8f1069bc 
Dealt to Hero [Kd 2s]
Dealt to b90e9337 
Dealt to c7cb04d4 
Dealt to 2326f258 
b90e9337: folds
c7cb04d4: folds
2326f258: raises $0.2 to $0.3
e58114d9: calls $0.3
8f1069bc: calls $0.25
Hero: folds
*** FLOP *** [4s 2c 4h]
8f1069bc: checks
2326f258: checks
e58114d9: bets $0.3
8f1069bc: folds
2326f258: folds
Uncalled bet ($0.3) returned to e58114d9
*** SHOWDOWN ***
e58114d9 collected $0.95 from pot
*** SUMMARY ***
Total pot $1 | Rake $0.05 | Jackpot $0 | Bingo $0 | Fortune $0
Board [4s 2c 4h]
Seat 1: e58114d9 (button) won ($0.95)
Seat 2: 8f1069bc (small blind) folded on the Flop
Seat 3: Hero (big blind) folded before Flop
Seat 4: b90e9337 folded before Flop (didn't bet)
Seat 5: c7cb04d4 folded before Flop (didn't bet)
Seat 6: 2326f258 folded on the Flop


Poker Hand #RC1316922930: Hold'em No Limit  ($0.05/$0.1) - 2023/02/02 13:50:44
Table 'RushAndCash5118190' 6-max Seat #1 is the button
Seat 1: 35dc0748 ($10.2 in chips)
Seat 2: 264fb31 ($11.89 in chips)
Seat 3: 89bfc792 ($10.95 in chips)
Seat 4: 909d58f9 ($29.64 in chips)
Seat 5: Hero ($11.17 in chips)
Seat 6: 57f24a62 ($23.85 in chips)
264fb31: posts small blind $0.05
89bfc792: posts big blind $0.1
*** HOLE CARDS ***
Dealt to 35dc0748 
Dealt to 264fb31 
Dealt to 89bfc792 
Dealt to 909d58f9 
Dealt to Hero [7d Jh]
Dealt to 57f24a62 
909d58f9: folds
Hero: folds
57f24a62: folds
35dc0748: raises $0.15 to $0.25
264fb31: folds
89bfc792: raises $0.95 to $1.2
35dc0748: folds
Uncalled bet ($0.95) returned to 89bfc792
*** SHOWDOWN ***
89bfc792 collected $0.53 from pot
*** SUMMARY ***
Total pot $0.55 | Rake $0.02 | Jackpot $0 | Bingo $0 | Fortune $0
Seat 1: 35dc0748 (button) folded before Flop
Seat 2: 264fb31 (small blind) folded before Flop
Seat 3: 89bfc792 (big blind) collected ($0.53)
Seat 4: 909d58f9 folded before Flop (didn't bet)
Seat 5: Hero folded before Flop (didn't bet)
Seat 6: 57f24a62 folded before Flop (didn't bet)


Poker Hand #RC1316922851: Hold'em No Limit  ($0.05/$0.1) - 2023/02/02 13:50:30
Table 'RushAndCash5118111' 6-max Seat #1 is the button
Seat 1: 18c2b034 ($9.85 in chips)
Seat 2: 6b0aa086 ($12.89 in chips)
Seat 3: 8f740579 ($10.25 in chips)
Seat 4: ef486511 ($22.88 in chips)
Seat 5: a0b046cd ($12.8 in chips)
Seat 6: Hero ($11.02 in chips)
6b0aa086: posts small blind $0.05
8f740579: posts big blind $0.1
*** HOLE CARDS ***
Dealt to 18c2b034 
Dealt to 6b0aa086 
Dealt to 8f740579 
Dealt to ef486511 
Dealt to a0b046cd 
Dealt to Hero [Jd Kh]
ef486511: folds
a0b046cd: folds
Hero: raises $0.15 to $0.25
18c2b034: folds
6b0aa086: folds
8f740579: folds
Uncalled bet ($0.15) returned to Hero
*** SHOWDOWN ***
Hero collected $0.25 from pot
*** SUMMARY ***
Total pot $0.25 | Rake $0 | Jackpot $0 | Bingo $0 | Fortune $0
Seat 1: 18c2b034 (button) folded before Flop (didn't bet)
Seat 2: 6b0aa086 (small blind) folded before Flop
Seat 3: 8f740579 (big blind) folded before Flop
Seat 4: ef486511 folded before Flop (didn't bet)
Seat 5: a0b046cd folded before Flop (didn't bet)
Seat 6: Hero collected ($0.25)


Poker Hand #RC1316922798: Hold'em No Limit  ($0.05/$0.1) - 2023/02/02 13:50:22
Table 'RushAndCash5118058' 6-max Seat #1 is the button
Seat 1: Hero ($11.02 in chips)
Seat 2: e331248e ($19.51 in chips)
Seat 3: 3828897b ($21.41 in chips)
Seat 4: 6da50ea8 ($16.61 in chips)
Seat 5: 7275fd02 ($3.55 in chips)
Seat 6: 1b0438cc ($9.45 in chips)
e331248e: posts small blind $0.05
3828897b: posts big blind $0.1
*** HOLE CARDS ***
Dealt to Hero [Qc Th]
Dealt to e331248e 
Dealt to 3828897b 
Dealt to 6da50ea8 
Dealt to 7275fd02 
Dealt to 1b0438cc 
6da50ea8: raises $0.23 to $0.33
7275fd02: folds
1b0438cc: folds
Hero: folds
e331248e: folds
3828897b: folds
Uncalled bet ($0.23) returned to 6da50ea8
*** SHOWDOWN ***
6da50ea8 collected $0.25 from pot
*** SUMMARY ***
Total pot $0.25 | Rake $0 | Jackpot $0 | Bingo $0 | Fortune $0
Seat 1: Hero (button) folded before Flop (didn't bet)
Seat 2: e331248e (small blind) folded before Flop
Seat 3: 3828897b (big blind) folded before Flop
Seat 4: 6da50ea8 collected ($0.25)
Seat 5: 7275fd02 folded before Flop (didn't bet)
Seat 6: 1b0438cc folded before Flop (didn't bet)


Poker Hand #RC1316922775: Hold'em No Limit  ($0.05/$0.1) - 2023/02/02 13:50:19
Table 'RushAndCash5118035' 6-max Seat #1 is the button
Seat 1: 572cd94 ($9.19 in chips)
Seat 2: Hero ($11.07 in chips)
Seat 3: 27cfe22f ($9.43 in chips)
Seat 4: ec06370 ($10.84 in chips)
Seat 5: db8fa48b ($10 in chips)
Seat 6: 37629f45 ($16.72 in chips)
Hero: posts small blind $0.05
27cfe22f: posts big blind $0.1
*** HOLE CARDS ***
Dealt to 572cd94 
Dealt to Hero [6c 9h]
Dealt to 27cfe22f 
Dealt to ec06370 
Dealt to db8fa48b 
Dealt to 37629f45 
ec06370: folds
db8fa48b: raises $0.1 to $0.2
37629f45: folds
572cd94: folds
Hero: folds
27cfe22f: folds
Uncalled bet ($0.1) returned to db8fa48b
*** SHOWDOWN ***
db8fa48b collected $0.25 from pot
*** SUMMARY ***
Total pot $0.25 | Rake $0 | Jackpot $0 | Bingo $0 | Fortune $0
Seat 1: 572cd94 (button) folded before Flop (didn't bet)
Seat 2: Hero (small blind) folded before Flop
Seat 3: 27cfe22f (big blind) folded before Flop
Seat 4: ec06370 folded before Flop (didn't bet)
Seat 5: db8fa48b collected ($0.25)
Seat 6: 37629f45 folded before Flop (didn't bet)


Poker Hand #RC1316922745: Hold'em No Limit  ($0.05/$0.1) - 2023/02/02 13:50:14
Table 'RushAndCash5118005' 6-max Seat #1 is the button
Seat 1: e7a3c645 ($13.8 in chips)
Seat 2: 1e54b030 ($10.15 in chips)
Seat 3: Hero ($11.02 in chips)
Seat 4: f396c7c9 ($15.05 in chips)
Seat 5: 33c9d3a4 ($16.43 in chips)
Seat 6: 554fdc7 ($11.72 in chips)
1e54b030: posts small blind $0.05
Hero: posts big blind $0.1
*** HOLE CARDS ***
Dealt to e7a3c645 
Dealt to 1e54b030 
Dealt to Hero [Ts 2s]
Dealt to f396c7c9 
Dealt to 33c9d3a4 
Dealt to 554fdc7 
f396c7c9: folds
33c9d3a4: folds
554fdc7: folds
e7a3c645: folds
1e54b030: folds
Uncalled bet ($0.05) returned to Hero
*** SHOWDOWN ***
Hero collected $0.1 from pot
*** SUMMARY ***
Total pot $0.1 | Rake $0 | Jackpot $0 | Bingo $0 | Fortune $0
Seat 1: e7a3c645 (button) folded before Flop (didn't bet)
Seat 2: 1e54b030 (small blind) folded before Flop
Seat 3: Hero (big blind) collected ($0.1)
Seat 4: f396c7c9 folded before Flop (didn't bet)
Seat 5: 33c9d3a4 folded before Flop (didn't bet)
Seat 6: 554fdc7 folded before Flop (didn't bet)


Poker Hand #RC1316922662: Hold'em No Limit  ($0.05/$0.1) - 2023/02/02 13:50:00
Table 'RushAndCash5117922' 6-max Seat #1 is the button
Seat 1: 469e92e6 ($13.03 in chips)
Seat 2: 21467c52 ($10.05 in chips)
Seat 3: 66e09ffa ($14.1 in chips)
Seat 4: a33492a3 ($10.08 in chips)
Seat 5: Hero ($10.87 in chips)
Seat 6: 44cee332 ($10 in chips)
21467c52: posts small blind $0.05
66e09ffa: posts big blind $0.1
*** HOLE CARDS ***
Dealt to 469e92e6 
Dealt to 21467c52 
Dealt to 66e09ffa 
Dealt to a33492a3 
Dealt to Hero [Ks Kc]
Dealt to 44cee332 
a33492a3: folds
Hero: raises $0.15 to $0.25
44cee332: folds
469e92e6: folds
21467c52: folds
66e09ffa: folds
Uncalled bet ($0.15) returned to Hero
*** SHOWDOWN ***
Hero collected $0.25 from pot
*** SUMMARY ***
Total pot $0.25 | Rake $0 | Jackpot $0 | Bingo $0 | Fortune $0
Seat 1: 469e92e6 (button) folded before Flop (didn't bet)
Seat 2: 21467c52 (small blind) folded before Flop
Seat 3: 66e09ffa (big blind) folded before Flop
Seat 4: a33492a3 folded before Flop (didn't bet)
Seat 5: Hero collected ($0.25)
Seat 6: 44cee332 folded before Flop (didn't bet)


Poker Hand #RC1316922634: Hold'em No Limit  ($0.05/$0.1) - 2023/02/02 13:49:55
Table 'RushAndCash5117894' 6-max Seat #1 is the button
Seat 1: a8e25082 ($10.33 in chips)
Seat 2: b8f75f5 ($11.12 in chips)
Seat 3: 4b955da1 ($7.22 in chips)
Seat 4: Hero ($10.87 in chips)
Seat 5: c8fbcf60 ($6.14 in chips)
Seat 6: 589ac4f6 ($11.18 in chips)
b8f75f5: posts small blind $0.05
4b955da1: posts big blind $0.1
*** HOLE CARDS ***
Dealt to a8e25082 
Dealt to b8f75f5 
Dealt to 4b955da1 
Dealt to Hero [Kc 6h]
Dealt to c8fbcf60 
Dealt to 589ac4f6 
Hero: folds
c8fbcf60: folds
589ac4f6: folds
a8e25082: raises $0.15 to $0.25
b8f75f5: folds
4b955da1: raises $0.55 to $0.8
a8e25082: folds
Uncalled bet ($0.55) returned to 4b955da1
*** SHOWDOWN ***
4b955da1 collected $0.53 from pot
*** SUMMARY ***
Total pot $0.55 | Rake $0.02 | Jackpot $0 | Bingo $0 | Fortune $0
Seat 1: a8e25082 (button) folded before Flop
Seat 2: b8f75f5 (small blind) folded before Flop
Seat 3: 4b955da1 (big blind) collected ($0.53)
Seat 4: Hero folded before Flop (didn't bet)
Seat 5: c8fbcf60 folded before Flop (didn't bet)
Seat 6: 589ac4f6 folded before Flop (didn't bet)


Poker Hand #RC1316922603: Hold'em No Limit  ($0.05/$0.1) - 2023/02/02 13:49:50
Table 'RushAndCash5117863' 6-max Seat #1 is the button
Seat 1: Hero ($10.87 in chips)
Seat 2: 25ed30b3 ($10 in chips)
Seat 3: fd47d1d6 ($11.89 in chips)
Seat 4: 7ba7ddec ($17.86 in chips)
Seat 5: d5542cb9 ($10.03 in chips)
Seat 6: fa358bb6 ($5.74 in chips)
25ed30b3: posts small blind $0.05
fd47d1d6: posts big blind $0.1
*** HOLE CARDS ***
Dealt to Hero [7d Td]
Dealt to 25ed30b3 
Dealt to fd47d1d6 
Dealt to 7ba7ddec 
Dealt to d5542cb9 
Dealt to fa358bb6 
7ba7ddec: folds
d5542cb9: raises $0.15 to $0.25
fa358bb6: folds
Hero: folds
25ed30b3: folds
fd47d1d6: folds
Uncalled bet ($0.15) returned to d5542cb9
*** SHOWDOWN ***
d5542cb9 collected $0.25 from pot
*** SUMMARY ***
Total pot $0.25 | Rake $0 | Jackpot $0 | Bingo $0 | Fortune $0
Seat 1: Hero (button) folded before Flop (didn't bet)
Seat 2: 25ed30b3 (small blind) folded before Flop
Seat 3: fd47d1d6 (big blind) folded before Flop
Seat 4: 7ba7ddec folded before Flop (didn't bet)
Seat 5: d5542cb9 collected ($0.25)
Seat 6: fa358bb6 folded before Flop (didn't bet)


Poker Hand #RC1316922336: Hold'em No Limit  ($0.05/$0.1) - 2023/02/02 13:49:03
Table 'RushAndCash5117596' 6-max Seat #1 is the button
Seat 1: d5542cb9 ($10.28 in chips)
Seat 2: fd47d1d6 ($11.54 in chips)
Seat 3: Hero ($11.25 in chips)
Seat 4: d433a235 ($14.18 in chips)
Seat 5: abe55004 ($24.55 in chips)
Seat 6: 3720c3d3 ($10.22 in chips)
fd47d1d6: posts small blind $0.05
Hero: posts big blind $0.1
*** HOLE CARDS ***
Dealt to d5542cb9 
Dealt to fd47d1d6 
Dealt to Hero [5s Ad]
Dealt to d433a235 
Dealt to abe55004 
Dealt to 3720c3d3 
d433a235: folds
abe55004: folds
3720c3d3: folds
d5542cb9: folds
fd47d1d6: raises $0.13 to $0.23
Hero: calls $0.13
*** FLOP *** [Ks 2c 4h]
fd47d1d6: checks
Hero: bets $0.15
fd47d1d6: calls $0.15
*** TURN *** [Ks 2c 4h] [Qh]
fd47d1d6: checks
Hero: checks
*** RIVER *** [Ks 2c 4h Qh] [2s]
fd47d1d6: bets $0.51
Hero: folds
Uncalled bet ($0.51) returned to fd47d1d6
*** SHOWDOWN ***
fd47d1d6 collected $0.73 from pot
*** SUMMARY ***
Total pot $0.76 | Rake $0.03 | Jackpot $0 | Bingo $0 | Fortune $0
Board [Ks 2c 4h Qh 2s]
Seat 1: d5542cb9 (button) folded before Flop (didn't bet)
Seat 2: fd47d1d6 (small blind) won ($0.73)
Seat 3: Hero (big blind) folded on the River
Seat 4: d433a235 folded before Flop (didn't bet)
Seat 5: abe55004 folded before Flop (didn't bet)
Seat 6: 3720c3d3 folded before Flop (didn't bet)


Poker Hand #RC1316922312: Hold'em No Limit  ($0.05/$0.1) - 2023/02/02 13:49:00
Table 'RushAndCash5117572' 6-max Seat #1 is the button
Seat 1: 9286244f ($12.38 in chips)
Seat 2: e58114d9 ($12.02 in chips)
Seat 3: 8f1069bc ($10.65 in chips)
Seat 4: Hero ($11.25 in chips)
Seat 5: d20dbdb ($10.84 in chips)
Seat 6: d595a4c7 ($10 in chips)
e58114d9: posts small blind $0.05
8f1069bc: posts big blind $0.1
*** HOLE CARDS ***
Dealt to 9286244f 
Dealt to e58114d9 
Dealt to 8f1069bc 
Dealt to Hero [6c 5s]
Dealt to d20dbdb 
Dealt to d595a4c7 
Hero: folds
d20dbdb: folds
d595a4c7: folds
9286244f: raises $0.15 to $0.25
e58114d9: folds
8f1069bc: folds
Uncalled bet ($0.15) returned to 9286244f
*** SHOWDOWN ***
9286244f collected $0.25 from pot
*** SUMMARY ***
Total pot $0.25 | Rake $0 | Jackpot $0 | Bingo $0 | Fortune $0
Seat 1: 9286244f (button) collected ($0.25)
Seat 2: e58114d9 (small blind) folded before Flop
Seat 3: 8f1069bc (big blind) folded before Flop
Seat 4: Hero folded before Flop (didn't bet)
Seat 5: d20dbdb folded before Flop (didn't bet)
Seat 6: d595a4c7 folded before Flop (didn't bet)


Poker Hand #RC1316922287: Hold'em No Limit  ($0.05/$0.1) - 2023/02/02 13:48:55
Table 'RushAndCash5117547' 6-max Seat #1 is the button
Seat 1: c619e978 ($10.37 in chips)
Seat 2: Hero ($11.3 in chips)
Seat 3: 4b0a7a3 ($10.38 in chips)
Seat 4: f9b15fd8 ($18.11 in chips)
Seat 5: 887dada5 ($9.83 in chips)
Seat 6: 33efe3f7 ($8.28 in chips)
Hero: posts small blind $0.05
4b0a7a3: posts big blind $0.1
*** HOLE CARDS ***
Dealt to c619e978 
Dealt to Hero [8d 7h]
Dealt to 4b0a7a3 
Dealt to f9b15fd8 
Dealt to 887dada5 
Dealt to 33efe3f7 
f9b15fd8: folds
887dada5: calls $0.1
33efe3f7: folds
c619e978: folds
Hero: folds
4b0a7a3: checks
*** FLOP *** [4d Qd 2s]
4b0a7a3: checks
887dada5: bets $0.13
4b0a7a3: calls $0.13
*** TURN *** [4d Qd 2s] [Ts]
4b0a7a3: checks
887dada5: checks
*** RIVER *** [4d Qd 2s Ts] [Ks]
4b0a7a3: checks
887dada5: checks
4b0a7a3: shows [7d 9d] (King-High)
887dada5: shows [Ac 5d] (Ace-High)
*** SHOWDOWN ***
887dada5 collected $0.49 from pot
*** SUMMARY ***
Total pot $0.51 | Rake $0.02 | Jackpot $0 | Bingo $0 | Fortune $0
Board [4d Qd 2s Ts Ks]
Seat 1: c619e978 (button) folded before Flop (didn't bet)
Seat 2: Hero (small blind) folded before Flop
Seat 3: 4b0a7a3 (big blind) showed [7d 9d] and lost with King-High
Seat 4: f9b15fd8 folded before Flop (didn't bet)
Seat 5: 887dada5 showed [Ac 5d] and won ($0.49) with Ace-High
Seat 6: 33efe3f7 folded before Flop (didn't bet)


Poker Hand #RC1316922266: Hold'em No Limit  ($0.05/$0.1) - 2023/02/02 13:48:51
Table 'RushAndCash5117526' 6-max Seat #1 is the button
Seat 1: 2fbbc433 ($11.25 in chips)
Seat 2: 984f5587 ($10.58 in chips)
Seat 3: 4a156b00 ($10 in chips)
Seat 4: 89dbab57 ($14.9 in chips)
Seat 5: 33efe3f7 ($8.28 in chips)
Seat 6: Hero ($11.3 in chips)
984f5587: posts small blind $0.05
4a156b00: posts big blind $0.1
*** HOLE CARDS ***
Dealt to 2fbbc433 
Dealt to 984f5587 
Dealt to 4a156b00 
Dealt to 89dbab57 
Dealt to 33efe3f7 
Dealt to Hero [Ts 3s]
89dbab57: raises $0.15 to $0.25
33efe3f7: folds
Hero: folds
2fbbc433: folds
984f5587: raises $0.75 to $1
4a156b00: folds
89dbab57: calls $0.75
*** FLOP *** [Kh 5d 9c]
984f5587: bets $1.05
89dbab57: folds
Uncalled bet ($1.05) returned to 984f5587
*** SHOWDOWN ***
984f5587 collected $2 from pot
*** SUMMARY ***
Total pot $2.1 | Rake $0.1 | Jackpot $0 | Bingo $0 | Fortune $0
Board [Kh 5d 9c]
Seat 1: 2fbbc433 (button) folded before Flop (didn't bet)
Seat 2: 984f5587 (small blind) won ($2)
Seat 3: 4a156b00 (big blind) folded before Flop
Seat 4: 89dbab57 folded on the Flop
Seat 5: 33efe3f7 folded before Flop (didn't bet)
Seat 6: Hero folded before Flop (didn't bet)


Poker Hand #RC1316922246: Hold'em No Limit  ($0.05/$0.1) - 2023/02/02 13:48:48
Table 'RushAndCash5117506' 6-max Seat #1 is the button
Seat 1: 33efe3f7 ($8.28 in chips)
Seat 2: b8691dbb ($10.15 in chips)
Seat 3: afd8c859 ($24.21 in chips)
Seat 4: 4a156b00 ($10 in chips)
Seat 5: Hero ($11.3 in chips)
Seat 6: 90a4f6d3 ($11.96 in chips)
b8691dbb: posts small blind $0.05
afd8c859: posts big blind $0.1
*** HOLE CARDS ***
Dealt to 33efe3f7 
Dealt to b8691dbb 
Dealt to afd8c859 
Dealt to 4a156b00 
Dealt to Hero [Ts 3h]
Dealt to 90a4f6d3 
4a156b00: folds
Hero: folds
90a4f6d3: folds
33efe3f7: folds
b8691dbb: folds
Uncalled bet ($0.05) returned to afd8c859
*** SHOWDOWN ***
afd8c859 collected $0.1 from pot
*** SUMMARY ***
Total pot $0.1 | Rake $0 | Jackpot $0 | Bingo $0 | Fortune $0
Seat 1: 33efe3f7 (button) folded before Flop (didn't bet)
Seat 2: b8691dbb (small blind) folded before Flop
Seat 3: afd8c859 (big blind) collected ($0.1)
Seat 4: 4a156b00 folded before Flop (didn't bet)
Seat 5: Hero folded before Flop (didn't bet)
Seat 6: 90a4f6d3 folded before Flop (didn't bet)


Poker Hand #RC1316922203: Hold'em No Limit  ($0.05/$0.1) - 2023/02/02 13:48:40
Table 'RushAndCash5117463' 6-max Seat #1 is the button
Seat 1: 7d6c1f07 ($10.3 in chips)
Seat 2: 764134ab ($25.18 in chips)
Seat 3: f396c7c9 ($16.89 in chips)
Seat 4: ae3f5de4 ($29.86 in chips)
Seat 5: ad4afe2a ($10 in chips)
Seat 6: Hero ($11.3 in chips)
764134ab: posts small blind $0.05
f396c7c9: posts big blind $0.1
*** HOLE CARDS ***
Dealt to 7d6c1f07 
Dealt to 764134ab 
Dealt to f396c7c9 
Dealt to ae3f5de4 
Dealt to ad4afe2a 
Dealt to Hero [9c 2s]
ae3f5de4: raises $0.15 to $0.25
ad4afe2a: folds
Hero: folds
7d6c1f07: folds
764134ab: folds
f396c7c9: calls $0.15
*** FLOP *** [9h 6s Ks]
f396c7c9: checks
ae3f5de4: bets $0.19
f396c7c9: calls $0.19
*** TURN *** [9h 6s Ks] [2c]
f396c7c9: checks
ae3f5de4: checks
*** RIVER *** [9h 6s Ks 2c] [2d]
f396c7c9: bets $0.57
ae3f5de4: raises $0.93 to $1.5
f396c7c9: calls $0.93
ae3f5de4: shows [9s 9d] (Nines Full over Twos)
f396c7c9: shows [As Kh] (Pair of Kings and Pair of Twos)
*** SHOWDOWN ***
ae3f5de4 collected $3.6 from pot
*** SUMMARY ***
Total pot $3.93 | Rake $0.18 | Jackpot $0.15 | Bingo $0 | Fortune $0
Board [9h 6s Ks 2c 2d]
Seat 1: 7d6c1f07 (button) folded before Flop (didn't bet)
Seat 2: 764134ab (small blind) folded before Flop
Seat 3: f396c7c9 (big blind) showed [As Kh] and lost with Pair of Kings and Pair of Twos
Seat 4: ae3f5de4 showed [9s 9d] and won ($3.6) with Nines Full over Twos
Seat 5: ad4afe2a folded before Flop (didn't bet)
Seat 6: Hero folded before Flop (didn't bet)


Poker Hand #RC1316922071: Hold'em No Limit  ($0.05/$0.1) - 2023/02/02 13:48:21
Table 'RushAndCash5117331' 6-max Seat #1 is the button
Seat 1: Hero ($11.15 in chips)
Seat 2: 123789f2 ($76.22 in chips)
Seat 3: 83cf0341 ($11.06 in chips)
Seat 4: 694c1edf ($16.12 in chips)
Seat 5: d5542cb9 ($10.33 in chips)
Seat 6: 8f6b9b00 ($26.87 in chips)
123789f2: posts small blind $0.05
83cf0341: posts big blind $0.1
*** HOLE CARDS ***
Dealt to Hero [Kd Ad]
Dealt to 123789f2 
Dealt to 83cf0341 
Dealt to 694c1edf 
Dealt to d5542cb9 
Dealt to 8f6b9b00 
694c1edf: folds
d5542cb9: folds
8f6b9b00: folds
Hero: raises $0.15 to $0.25
123789f2: folds
83cf0341: folds
Uncalled bet ($0.15) returned to Hero
*** SHOWDOWN ***
Hero collected $0.25 from pot
*** SUMMARY ***
Total pot $0.25 | Rake $0 | Jackpot $0 | Bingo $0 | Fortune $0
Seat 1: Hero (button) collected ($0.25)
Seat 2: 123789f2 (small blind) folded before Flop
Seat 3: 83cf0341 (big blind) folded before Flop
Seat 4: 694c1edf folded before Flop (didn't bet)
Seat 5: d5542cb9 folded before Flop (didn't bet)
Seat 6: 8f6b9b00 folded before Flop (didn't bet)


Poker Hand #RC1316921661: Hold'em No Limit  ($0.05/$0.1) - 2023/02/02 13:47:13
Table 'RushAndCash5116921' 6-max Seat #1 is the button
Seat 1: 2956368b ($11.59 in chips)
Seat 2: b959cff5 ($10.73 in chips)
Seat 3: Hero ($10.92 in chips)
Seat 4: 694c1edf ($16.32 in chips)
Seat 5: e58114d9 ($13.17 in chips)
Seat 6: 90df046f ($10 in chips)
b959cff5: posts small blind $0.05
Hero: posts big blind $0.1
*** HOLE CARDS ***
Dealt to 2956368b 
Dealt to b959cff5 
Dealt to Hero [8s Ah]
Dealt to 694c1edf 
Dealt to e58114d9 
Dealt to 90df046f 
694c1edf: raises $0.1 to $0.2
e58114d9: folds
90df046f: folds
2956368b: folds
b959cff5: folds
Hero: calls $0.1
*** FLOP *** [Tc Th 5h]
Hero: checks
694c1edf: checks
*** TURN *** [Tc Th 5h] [Js]
Hero: checks
694c1edf: checks
*** RIVER *** [Tc Th 5h Js] [4h]
Hero: checks
694c1edf: checks
Hero: shows [8s Ah] (Pair of Tens)
694c1edf: shows [7s As] (Pair of Tens)
*** SHOWDOWN ***
Hero collected $0.43 from pot
*** SUMMARY ***
Total pot $0.45 | Rake $0.02 | Jackpot $0 | Bingo $0 | Fortune $0
Board [Tc Th 5h Js 4h]
Seat 1: 2956368b (button) folded before Flop (didn't bet)
Seat 2: b959cff5 (small blind) folded before Flop
Seat 3: Hero (big blind) showed [8s Ah] and won ($0.43) with Pair of Tens
Seat 4: 694c1edf showed [7s As] and lost with Pair of Tens
Seat 5: e58114d9 folded before Flop (didn't bet)
Seat 6: 90df046f folded before Flop (didn't bet)


Poker Hand #RC1316921539: Hold'em No Limit  ($0.05/$0.1) - 2023/02/02 13:46:50
Table 'RushAndCash5116799' 6-max Seat #1 is the button
Seat 1: d509ee56 ($11.5 in chips)
Seat 2: Hero ($10.97 in chips)
Seat 3: 27cfe22f ($9.35 in chips)
Seat 4: 37c77bfe ($13.58 in chips)
Seat 5: 41f356ff ($10.17 in chips)
Seat 6: 5291f299 ($24.65 in chips)
Hero: posts small blind $0.05
27cfe22f: posts big blind $0.1
*** HOLE CARDS ***
Dealt to d509ee56 
Dealt to Hero [Jd Ad]
Dealt to 27cfe22f 
Dealt to 37c77bfe 
Dealt to 41f356ff 
Dealt to 5291f299 
37c77bfe: folds
41f356ff: raises $0.14 to $0.24
5291f299: folds
d509ee56: folds
Hero: folds
27cfe22f: folds
Uncalled bet ($0.14) returned to 41f356ff
*** SHOWDOWN ***
41f356ff collected $0.25 from pot
*** SUMMARY ***
Total pot $0.25 | Rake $0 | Jackpot $0 | Bingo $0 | Fortune $0
Seat 1: d509ee56 (button) folded before Flop (didn't bet)
Seat 2: Hero (small blind) folded before Flop
Seat 3: 27cfe22f (big blind) folded before Flop
Seat 4: 37c77bfe folded before Flop (didn't bet)
Seat 5: 41f356ff collected ($0.25)
Seat 6: 5291f299 folded before Flop (didn't bet)


Poker Hand #RC1316921516: Hold'em No Limit  ($0.05/$0.1) - 2023/02/02 13:46:46
Table 'RushAndCash5116776' 6-max Seat #1 is the button
Seat 1: 7d4a2f54 ($13.06 in chips)
Seat 2: e2ecd0c0 ($3.98 in chips)
Seat 3: 5a69198f ($33.21 in chips)
Seat 4: Hero ($10.97 in chips)
Seat 5: 90df046f ($10 in chips)
Seat 6: cc1b8ee3 ($10.01 in chips)
e2ecd0c0: posts small blind $0.05
5a69198f: posts big blind $0.1
*** HOLE CARDS ***
Dealt to 7d4a2f54 
Dealt to e2ecd0c0 
Dealt to 5a69198f 
Dealt to Hero [5h Kc]
Dealt to 90df046f 
Dealt to cc1b8ee3 
Hero: folds
90df046f: folds
cc1b8ee3: raises $0.15 to $0.25
7d4a2f54: folds
e2ecd0c0: raises $0.55 to $0.8
5a69198f: folds
cc1b8ee3: folds
Uncalled bet ($0.55) returned to e2ecd0c0
*** SHOWDOWN ***
e2ecd0c0 collected $0.57 from pot
*** SUMMARY ***
Total pot $0.6 | Rake $0.03 | Jackpot $0 | Bingo $0 | Fortune $0
Seat 1: 7d4a2f54 (button) folded before Flop (didn't bet)
Seat 2: e2ecd0c0 (small blind) collected ($0.57)
Seat 3: 5a69198f (big blind) folded before Flop
Seat 4: Hero folded before Flop (didn't bet)
Seat 5: 90df046f folded before Flop (didn't bet)
Seat 6: cc1b8ee3 folded before Flop


Poker Hand #RC1316921486: Hold'em No Limit  ($0.05/$0.1) - 2023/02/02 13:46:41
Table 'RushAndCash5116746' 6-max Seat #1 is the button
Seat 1: 45eb3128 ($11.76 in chips)
Seat 2: 8504c1aa ($5.16 in chips)
Seat 3: e331248e ($19.33 in chips)
Seat 4: 43449f06 ($10 in chips)
Seat 5: Hero ($10.97 in chips)
Seat 6: 5eb6be30 ($11.11 in chips)
8504c1aa: posts small blind $0.05
e331248e: posts big blind $0.1
*** HOLE CARDS ***
Dealt to 45eb3128 
Dealt to 8504c1aa 
Dealt to e331248e 
Dealt to 43449f06 
Dealt to Hero [As 7d]
Dealt to 5eb6be30 
43449f06: folds
Hero: folds
5eb6be30: folds
45eb3128: folds
8504c1aa: folds
Uncalled bet ($0.05) returned to e331248e
*** SHOWDOWN ***
e331248e collected $0.1 from pot
*** SUMMARY ***
Total pot $0.1 | Rake $0 | Jackpot $0 | Bingo $0 | Fortune $0
Seat 1: 45eb3128 (button) folded before Flop (didn't bet)
Seat 2: 8504c1aa (small blind) folded before Flop
Seat 3: e331248e (big blind) collected ($0.1)
Seat 4: 43449f06 folded before Flop (didn't bet)
Seat 5: Hero folded before Flop (didn't bet)
Seat 6: 5eb6be30 folded before Flop (didn't bet)


Poker Hand #RC1316921441: Hold'em No Limit  ($0.05/$0.1) - 2023/02/02 13:46:34
Table 'RushAndCash5116701' 6-max Seat #1 is the button
Seat 1: Hero ($10.97 in chips)
Seat 2: d8f356b1 ($5.11 in chips)
Seat 3: e21bef76 ($13.19 in chips)
Seat 4: 425bcc6 ($15.39 in chips)
Seat 5: 516a151 ($13.63 in chips)
Seat 6: 7d6c1f07 ($10.43 in chips)
d8f356b1: posts small blind $0.05
e21bef76: posts big blind $0.1
*** HOLE CARDS ***
Dealt to Hero [9h Js]
Dealt to d8f356b1 
Dealt to e21bef76 
Dealt to 425bcc6 
Dealt to 516a151 
Dealt to 7d6c1f07 
425bcc6: raises $0.15 to $0.25
516a151: folds
7d6c1f07: folds
Hero: folds
d8f356b1: folds
e21bef76: calls $0.15
*** FLOP *** [9s Qd 8c]
e21bef76: checks
425bcc6: checks
*** TURN *** [9s Qd 8c] [Th]
e21bef76: bets $0.79
425bcc6: folds
Uncalled bet ($0.79) returned to e21bef76
*** SHOWDOWN ***
e21bef76 collected $0.53 from pot
*** SUMMARY ***
Total pot $0.55 | Rake $0.02 | Jackpot $0 | Bingo $0 | Fortune $0
Board [9s Qd 8c Th]
Seat 1: Hero (button) folded before Flop (didn't bet)
Seat 2: d8f356b1 (small blind) folded before Flop
Seat 3: e21bef76 (big blind) won ($0.53)
Seat 4: 425bcc6 folded on the Turn
Seat 5: 516a151 folded before Flop (didn't bet)
Seat 6: 7d6c1f07 folded before Flop (didn't bet)


Poker Hand #RC1316921410: Hold'em No Limit  ($0.05/$0.1) - 2023/02/02 13:46:29
Table 'RushAndCash5116670' 6-max Seat #1 is the button
Seat 1: b694a5da ($10 in chips)
Seat 2: 10cd6494 ($10.27 in chips)
Seat 3: f7288b7c ($10 in chips)
Seat 4: Hero ($10.97 in chips)
Seat 5: 43449f06 ($10 in chips)
Seat 6: 6a39bd11 ($10.85 in chips)
10cd6494: posts small blind $0.05
f7288b7c: posts big blind $0.1
*** HOLE CARDS ***
Dealt to b694a5da 
Dealt to 10cd6494 
Dealt to f7288b7c 
Dealt to Hero [4c Th]
Dealt to 43449f06 
Dealt to 6a39bd11 
Hero: folds
43449f06: folds
6a39bd11: folds
b694a5da: folds
10cd6494: folds
Uncalled bet ($0.05) returned to f7288b7c
*** SHOWDOWN ***
f7288b7c collected $0.1 from pot
*** SUMMARY ***
Total pot $0.1 | Rake $0 | Jackpot $0 | Bingo $0 | Fortune $0
Seat 1: b694a5da (button) folded before Flop (didn't bet)
Seat 2: 10cd6494 (small blind) folded before Flop
Seat 3: f7288b7c (big blind) collected ($0.1)
Seat 4: Hero folded before Flop (didn't bet)
Seat 5: 43449f06 folded before Flop (didn't bet)
Seat 6: 6a39bd11 folded before Flop (didn't bet)


Poker Hand #RC1316921355: Hold'em No Limit  ($0.05/$0.1) - 2023/02/02 13:46:20
Table 'RushAndCash5116615' 6-max Seat #1 is the button
Seat 1: 46ec31ae ($10.18 in chips)
Seat 2: Hero ($11.02 in chips)
Seat 3: 63234475 ($10 in chips)
Seat 4: a33492a3 ($10.05 in chips)
Seat 5: 84a2c758 ($10 in chips)
Seat 6: b219d968 ($11.99 in chips)
Hero: posts small blind $0.05
63234475: posts big blind $0.1
*** HOLE CARDS ***
Dealt to 46ec31ae 
Dealt to Hero [8d Qd]
Dealt to 63234475 
Dealt to a33492a3 
Dealt to 84a2c758 
Dealt to b219d968 
a33492a3: folds
84a2c758: folds
b219d968: folds
46ec31ae: raises $0.15 to $0.25
Hero: folds
63234475: folds
Uncalled bet ($0.15) returned to 46ec31ae
*** SHOWDOWN ***
46ec31ae collected $0.25 from pot
*** SUMMARY ***
Total pot $0.25 | Rake $0 | Jackpot $0 | Bingo $0 | Fortune $0
Seat 1: 46ec31ae (button) collected ($0.25)
Seat 2: Hero (small blind) folded before Flop
Seat 3: 63234475 (big blind) folded before Flop
Seat 4: a33492a3 folded before Flop (didn't bet)
Seat 5: 84a2c758 folded before Flop (didn't bet)
Seat 6: b219d968 folded before Flop (didn't bet)


Poker Hand #RC1316921323: Hold'em No Limit  ($0.05/$0.1) - 2023/02/02 13:46:14
Table 'RushAndCash5116583' 6-max Seat #1 is the button
Seat 1: fe2dec61 ($9.59 in chips)
Seat 2: df97c35c ($12.97 in chips)
Seat 3: Hero ($11.12 in chips)
Seat 4: abe55004 ($13.27 in chips)
Seat 5: 3cf601f2 ($7.8 in chips)
Seat 6: 9286244f ($11.83 in chips)
df97c35c: posts small blind $0.05
Hero: posts big blind $0.1
*** HOLE CARDS ***
Dealt to fe2dec61 
Dealt to df97c35c 
Dealt to Hero [3d 8d]
Dealt to abe55004 
Dealt to 3cf601f2 
Dealt to 9286244f 
abe55004: folds
3cf601f2: raises $0.12 to $0.22
9286244f: folds
fe2dec61: folds
df97c35c: folds
Hero: folds
Uncalled bet ($0.12) returned to 3cf601f2
*** SHOWDOWN ***
3cf601f2 collected $0.25 from pot
*** SUMMARY ***
Total pot $0.25 | Rake $0 | Jackpot $0 | Bingo $0 | Fortune $0
Seat 1: fe2dec61 (button) folded before Flop (didn't bet)
Seat 2: df97c35c (small blind) folded before Flop
Seat 3: Hero (big blind) folded before Flop
Seat 4: abe55004 folded before Flop (didn't bet)
Seat 5: 3cf601f2 collected ($0.25)
Seat 6: 9286244f folded before Flop (didn't bet)


Poker Hand #RC1316921241: Hold'em No Limit  ($0.05/$0.1) - 2023/02/02 13:46:01
Table 'RushAndCash5116501' 6-max Seat #1 is the button
Seat 1: 67b1a6be ($8.67 in chips)
Seat 2: f971222 ($9.08 in chips)
Seat 3: 80727905 ($12.26 in chips)
Seat 4: 6fe3b0f1 ($9.65 in chips)
Seat 5: Hero ($11.12 in chips)
Seat 6: ce09a3a1 ($10.78 in chips)
f971222: posts small blind $0.05
80727905: posts big blind $0.1
*** HOLE CARDS ***
Dealt to 67b1a6be 
Dealt to f971222 
Dealt to 80727905 
Dealt to 6fe3b0f1 
Dealt to Hero [8c 3h]
Dealt to ce09a3a1 
6fe3b0f1: calls $0.1
Hero: folds
ce09a3a1: folds
67b1a6be: folds
f971222: calls $0.05
80727905: raises $0.4 to $0.5
6fe3b0f1: calls $0.4
f971222: folds
*** FLOP *** [8d 9h Ts]
80727905: bets $0.55
6fe3b0f1: calls $0.55
*** TURN *** [8d 9h Ts] [Kc]
80727905: checks
6fe3b0f1: bets $0.73
80727905: raises $1.87 to $2.6
6fe3b0f1: calls $1.87
*** RIVER *** [8d 9h Ts Kc] [4d]
80727905: bets $6.5
6fe3b0f1: calls $6 and is all-in
Uncalled bet ($0.5) returned to 80727905
80727905: shows [Ks Kh] (Three Kings)
6fe3b0f1: shows [Jd Qh] (Kings-High Straight)
*** SHOWDOWN ***
6fe3b0f1 collected $18.95 from pot
*** SUMMARY ***
Total pot $19.4 | Rake $0.3 | Jackpot $0.15 | Bingo $0 | Fortune $0
Board [8d 9h Ts Kc 4d]
Seat 1: 67b1a6be (button) folded before Flop (didn't bet)
Seat 2: f971222 (small blind) folded before Flop
Seat 3: 80727905 (big blind) showed [Ks Kh] and lost with Three Kings
Seat 4: 6fe3b0f1 showed [Jd Qh] and won ($18.95) with Kings-High Straight
Seat 5: Hero folded before Flop (didn't bet)
Seat 6: ce09a3a1 folded before Flop (didn't bet)


Poker Hand #RC1316921190: Hold'em No Limit  ($0.05/$0.1) - 2023/02/02 13:45:52
Table 'RushAndCash5116450' 6-max Seat #1 is the button
Seat 1: 40313cc8 ($12.62 in chips)
Seat 2: 3c631a97 ($26.53 in chips)
Seat 3: 597e9e92 ($11.88 in chips)
Seat 4: Hero ($11.12 in chips)
Seat 5: 78230982 ($11.71 in chips)
Seat 6: b451cf6b ($13.35 in chips)
3c631a97: posts small blind $0.05
597e9e92: posts big blind $0.1
*** HOLE CARDS ***
Dealt to 40313cc8 
Dealt to 3c631a97 
Dealt to 597e9e92 
Dealt to Hero [6h 2h]
Dealt to 78230982 
Dealt to b451cf6b 
Hero: folds
78230982: folds
b451cf6b: raises $0.15 to $0.25
40313cc8: raises $0.65 to $0.9
3c631a97: folds
597e9e92: folds
b451cf6b: folds
Uncalled bet ($0.65) returned to 40313cc8
*** SHOWDOWN ***
40313cc8 collected $0.62 from pot
*** SUMMARY ***
Total pot $0.65 | Rake $0.03 | Jackpot $0 | Bingo $0 | Fortune $0
Seat 1: 40313cc8 (button) collected ($0.62)
Seat 2: 3c631a97 (small blind) folded before Flop
Seat 3: 597e9e92 (big blind) folded before Flop
Seat 4: Hero folded before Flop (didn't bet)
Seat 5: 78230982 folded before Flop (didn't bet)
Seat 6: b451cf6b folded before Flop


Poker Hand #RC1316921151: Hold'em No Limit  ($0.05/$0.1) - 2023/02/02 13:45:46
Table 'RushAndCash5116411' 6-max Seat #1 is the button
Seat 1: 9286244f ($11.98 in chips)
Seat 2: 764134ab ($23.77 in chips)
Seat 3: 44295b1f ($10.86 in chips)
Seat 4: Hero ($11.12 in chips)
Seat 5: c7059548 ($16.37 in chips)
Seat 6: 278dbeb9 ($19.1 in chips)
764134ab: posts small blind $0.05
44295b1f: posts big blind $0.1
*** HOLE CARDS ***
Dealt to 9286244f 
Dealt to 764134ab 
Dealt to 44295b1f 
Dealt to Hero [2h 2c]
Dealt to c7059548 
Dealt to 278dbeb9 
Hero: folds
c7059548: folds
278dbeb9: folds
9286244f: folds
764134ab: folds
Uncalled bet ($0.05) returned to 44295b1f
*** SHOWDOWN ***
44295b1f collected $0.1 from pot
*** SUMMARY ***
Total pot $0.1 | Rake $0 | Jackpot $0 | Bingo $0 | Fortune $0
Seat 1: 9286244f (button) folded before Flop (didn't bet)
Seat 2: 764134ab (small blind) folded before Flop
Seat 3: 44295b1f (big blind) collected ($0.1)
Seat 4: Hero folded before Flop (didn't bet)
Seat 5: c7059548 folded before Flop (didn't bet)
Seat 6: 278dbeb9 folded before Flop (didn't bet)


Poker Hand #RC1316921121: Hold'em No Limit  ($0.05/$0.1) - 2023/02/02 13:45:41
Table 'RushAndCash5116381' 6-max Seat #1 is the button
Seat 1: Hero ($11.12 in chips)
Seat 2: d35e662c ($10.39 in chips)
Seat 3: 554fdc7 ($14.16 in chips)
Seat 4: 7a387534 ($22.41 in chips)
Seat 5: dea4decb ($13.82 in chips)
Seat 6: 35dc0748 ($10.06 in chips)
d35e662c: posts small blind $0.05
554fdc7: posts big blind $0.1
*** HOLE CARDS ***
Dealt to Hero [9h 4s]
Dealt to d35e662c 
Dealt to 554fdc7 
Dealt to 7a387534 
Dealt to dea4decb 
Dealt to 35dc0748 
7a387534: folds
dea4decb: folds
35dc0748: raises $0.12 to $0.22
Hero: folds
d35e662c: folds
554fdc7: folds
Uncalled bet ($0.12) returned to 35dc0748
*** SHOWDOWN ***
35dc0748 collected $0.25 from pot
*** SUMMARY ***
Total pot $0.25 | Rake $0 | Jackpot $0 | Bingo $0 | Fortune $0
Seat 1: Hero (button) folded before Flop (didn't bet)
Seat 2: d35e662c (small blind) folded before Flop
Seat 3: 554fdc7 (big blind) folded before Flop
Seat 4: 7a387534 folded before Flop (didn't bet)
Seat 5: dea4decb folded before Flop (didn't bet)
Seat 6: 35dc0748 collected ($0.25)


Poker Hand #RC1316921065: Hold'em No Limit  ($0.05/$0.1) - 2023/02/02 13:45:33
Table 'RushAndCash5116325' 6-max Seat #1 is the button
Seat 1: 43e17bbd ($11.4 in chips)
Seat 2: 10cd6494 ($10 in chips)
Seat 3: Hero ($11.22 in chips)
Seat 4: 6d029a9 ($15.63 in chips)
Seat 5: 97c932ca ($10.35 in chips)
Seat 6: a5631ad9 ($11.34 in chips)
10cd6494: posts small blind $0.05
Hero: posts big blind $0.1
*** HOLE CARDS ***
Dealt to 43e17bbd 
Dealt to 10cd6494 
Dealt to Hero [6s 4d]
Dealt to 6d029a9 
Dealt to 97c932ca 
Dealt to a5631ad9 
6d029a9: folds
97c932ca: folds
a5631ad9: raises $0.12 to $0.22
43e17bbd: folds
10cd6494: folds
Hero: folds
Uncalled bet ($0.12) returned to a5631ad9
*** SHOWDOWN ***
a5631ad9 collected $0.25 from pot
*** SUMMARY ***
Total pot $0.25 | Rake $0 | Jackpot $0 | Bingo $0 | Fortune $0
Seat 1: 43e17bbd (button) folded before Flop (didn't bet)
Seat 2: 10cd6494 (small blind) folded before Flop
Seat 3: Hero (big blind) folded before Flop
Seat 4: 6d029a9 folded before Flop (didn't bet)
Seat 5: 97c932ca folded before Flop (didn't bet)
Seat 6: a5631ad9 collected ($0.25)


Poker Hand #RC1316921019: Hold'em No Limit  ($0.05/$0.1) - 2023/02/02 13:45:25
Table 'RushAndCash5116279' 6-max Seat #1 is the button
Seat 1: d509ee56 ($10.88 in chips)
Seat 2: Hero ($11.27 in chips)
Seat 3: e2f34eb9 ($11.4 in chips)
Seat 4: 67d5ca7b ($10.91 in chips)
Seat 5: 4065afd3 ($19.8 in chips)
Seat 6: 95a98df ($15.23 in chips)
Hero: posts small blind $0.05
e2f34eb9: posts big blind $0.1
*** HOLE CARDS ***
Dealt to d509ee56 
Dealt to Hero [7d 8s]
Dealt to e2f34eb9 
Dealt to 67d5ca7b 
Dealt to 4065afd3 
Dealt to 95a98df 
67d5ca7b: folds
4065afd3: folds
95a98df: folds
d509ee56: raises $0.15 to $0.25
Hero: folds
e2f34eb9: folds
Uncalled bet ($0.15) returned to d509ee56
*** SHOWDOWN ***
d509ee56 collected $0.25 from pot
*** SUMMARY ***
Total pot $0.25 | Rake $0 | Jackpot $0 | Bingo $0 | Fortune $0
Seat 1: d509ee56 (button) collected ($0.25)
Seat 2: Hero (small blind) folded before Flop
Seat 3: e2f34eb9 (big blind) folded before Flop
Seat 4: 67d5ca7b folded before Flop (didn't bet)
Seat 5: 4065afd3 folded before Flop (didn't bet)
Seat 6: 95a98df folded before Flop (didn't bet)


Poker Hand #RC1316920993: Hold'em No Limit  ($0.05/$0.1) - 2023/02/02 13:45:21
Table 'RushAndCash5116253' 6-max Seat #1 is the button
Seat 1: 984f5587 ($10.1 in chips)
Seat 2: 480e17b6 ($10 in chips)
Seat 3: 37629f45 ($12.17 in chips)
Seat 4: 580fdf93 ($25.1 in chips)
Seat 5: Hero ($11.27 in chips)
Seat 6: 6b0aa086 ($11.84 in chips)
480e17b6: posts small blind $0.05
37629f45: posts big blind $0.1
*** HOLE CARDS ***
Dealt to 984f5587 
Dealt to 480e17b6 
Dealt to 37629f45 
Dealt to 580fdf93 
Dealt to Hero [Qc 6s]
Dealt to 6b0aa086 
580fdf93: folds
Hero: folds
6b0aa086: folds
984f5587: folds
480e17b6: folds
Uncalled bet ($0.05) returned to 37629f45
*** SHOWDOWN ***
37629f45 collected $0.1 from pot
*** SUMMARY ***
Total pot $0.1 | Rake $0 | Jackpot $0 | Bingo $0 | Fortune $0
Seat 1: 984f5587 (button) folded before Flop (didn't bet)
Seat 2: 480e17b6 (small blind) folded before Flop
Seat 3: 37629f45 (big blind) collected ($0.1)
Seat 4: 580fdf93 folded before Flop (didn't bet)
Seat 5: Hero folded before Flop (didn't bet)
Seat 6: 6b0aa086 folded before Flop (didn't bet)


Poker Hand #RC1316920969: Hold'em No Limit  ($0.05/$0.1) - 2023/02/02 13:45:17
Table 'RushAndCash5116229' 6-max Seat #1 is the button
Seat 1: 5ee1e2f2 ($39.76 in chips)
Seat 2: d367c806 ($29.73 in chips)
Seat 3: cf6e2d2d ($13.05 in chips)
Seat 4: b9fc2b4e ($18.85 in chips)
Seat 5: Hero ($11.27 in chips)
Seat 6: c5ca61d4 ($11.88 in chips)
d367c806: posts small blind $0.05
cf6e2d2d: posts big blind $0.1
*** HOLE CARDS ***
Dealt to 5ee1e2f2 
Dealt to d367c806 
Dealt to cf6e2d2d 
Dealt to b9fc2b4e 
Dealt to Hero [3s 2s]
Dealt to c5ca61d4 
b9fc2b4e: raises $0.1 to $0.2
Hero: folds
c5ca61d4: folds
5ee1e2f2: folds
d367c806: folds
cf6e2d2d: folds
Uncalled bet ($0.1) returned to b9fc2b4e
*** SHOWDOWN ***
b9fc2b4e collected $0.25 from pot
*** SUMMARY ***
Total pot $0.25 | Rake $0 | Jackpot $0 | Bingo $0 | Fortune $0
Seat 1: 5ee1e2f2 (button) folded before Flop (didn't bet)
Seat 2: d367c806 (small blind) folded before Flop
Seat 3: cf6e2d2d (big blind) folded before Flop
Seat 4: b9fc2b4e collected ($0.25)
Seat 5: Hero folded before Flop (didn't bet)
Seat 6: c5ca61d4 folded before Flop (didn't bet)


Poker Hand #RC1316920947: Hold'em No Limit  ($0.05/$0.1) - 2023/02/02 13:45:13
Table 'RushAndCash5116207' 6-max Seat #1 is the button
Seat 1: 2f9df460 ($9.7 in chips)
Seat 2: 80727905 ($12.46 in chips)
Seat 3: f07ce14f ($11.84 in chips)
Seat 4: 7a387534 ($22.26 in chips)
Seat 5: 5b3820cb ($17.68 in chips)
Seat 6: Hero ($11.27 in chips)
80727905: posts small blind $0.05
f07ce14f: posts big blind $0.1
*** HOLE CARDS ***
Dealt to 2f9df460 
Dealt to 80727905 
Dealt to f07ce14f 
Dealt to 7a387534 
Dealt to 5b3820cb 
Dealt to Hero [9s 4d]
7a387534: raises $0.2 to $0.3
5b3820cb: folds
Hero: folds
2f9df460: folds
80727905: folds
f07ce14f: folds
Uncalled bet ($0.2) returned to 7a387534
*** SHOWDOWN ***
7a387534 collected $0.25 from pot
*** SUMMARY ***
Total pot $0.25 | Rake $0 | Jackpot $0 | Bingo $0 | Fortune $0
Seat 1: 2f9df460 (button) folded before Flop (didn't bet)
Seat 2: 80727905 (small blind) folded before Flop
Seat 3: f07ce14f (big blind) folded before Flop
Seat 4: 7a387534 collected ($0.25)
Seat 5: 5b3820cb folded before Flop (didn't bet)
Seat 6: Hero folded before Flop (didn't bet)


Poker Hand #RC1316920919: Hold'em No Limit  ($0.05/$0.1) - 2023/02/02 13:45:08
Table 'RushAndCash5116179' 6-max Seat #1 is the button
Seat 1: Hero ($11.27 in chips)
Seat 2: 5291f299 ($24.9 in chips)
Seat 3: c75857a7 ($12.05 in chips)
Seat 4: 2c9af4e6 ($10 in chips)
Seat 5: b90e9337 ($14.74 in chips)
Seat 6: 9ad43200 ($10.15 in chips)
5291f299: posts small blind $0.05
c75857a7: posts big blind $0.1
*** HOLE CARDS ***
Dealt to Hero [2s 8c]
Dealt to 5291f299 
Dealt to c75857a7 
Dealt to 2c9af4e6 
Dealt to b90e9337 
Dealt to 9ad43200 
2c9af4e6: folds
b90e9337: folds
9ad43200: raises $0.15 to $0.25
Hero: folds
5291f299: folds
c75857a7: calls $0.15
*** FLOP *** [Ac Td 3h]
c75857a7: checks
9ad43200: bets $0.19
c75857a7: calls $0.19
*** TURN *** [Ac Td 3h] [9s]
c75857a7: checks
9ad43200: checks
*** RIVER *** [Ac Td 3h 9s] [4s]
c75857a7: checks
9ad43200: checks
c75857a7: shows [Jd Kc] (Ace-High)
9ad43200: shows [8s 8d] (Pair of Eights)
*** SHOWDOWN ***
9ad43200 collected $0.89 from pot
*** SUMMARY ***
Total pot $0.93 | Rake $0.04 | Jackpot $0 | Bingo $0 | Fortune $0
Board [Ac Td 3h 9s 4s]
Seat 1: Hero (button) folded before Flop (didn't bet)
Seat 2: 5291f299 (small blind) folded before Flop
Seat 3: c75857a7 (big blind) showed [Jd Kc] and lost with Ace-High
Seat 4: 2c9af4e6 folded before Flop (didn't bet)
Seat 5: b90e9337 folded before Flop (didn't bet)
Seat 6: 9ad43200 showed [8s 8d] and won ($0.89) with Pair of Eights


Poker Hand #RC1316920897: Hold'em No Limit  ($0.05/$0.1) - 2023/02/02 13:45:05
Table 'RushAndCash5116157' 6-max Seat #1 is the button
Seat 1: a7dd82d4 ($10.58 in chips)
Seat 2: b90e9337 ($14.79 in chips)
Seat 3: 5ee1e2f2 ($39.86 in chips)
Seat 4: Hero ($11.27 in chips)
Seat 5: 5ab8166a ($10.23 in chips)
Seat 6: 1ac652fb ($11.42 in chips)
b90e9337: posts small blind $0.05
5ee1e2f2: posts big blind $0.1
*** HOLE CARDS ***
Dealt to a7dd82d4 
Dealt to b90e9337 
Dealt to 5ee1e2f2 
Dealt to Hero [7s Qs]
Dealt to 5ab8166a 
Dealt to 1ac652fb 
Hero: folds
5ab8166a: folds
1ac652fb: raises $0.1 to $0.2
a7dd82d4: raises $0.5 to $0.7
b90e9337: folds
5ee1e2f2: folds
1ac652fb: folds
Uncalled bet ($0.5) returned to a7dd82d4
*** SHOWDOWN ***
a7dd82d4 collected $0.53 from pot
*** SUMMARY ***
Total pot $0.55 | Rake $0.02 | Jackpot $0 | Bingo $0 | Fortune $0
Seat 1: a7dd82d4 (button) collected ($0.53)
Seat 2: b90e9337 (small blind) folded before Flop
Seat 3: 5ee1e2f2 (big blind) folded before Flop
Seat 4: Hero folded before Flop (didn't bet)
Seat 5: 5ab8166a folded before Flop (didn't bet)
Seat 6: 1ac652fb folded before Flop


Poker Hand #RC1316920866: Hold'em No Limit  ($0.05/$0.1) - 2023/02/02 13:45:00
Table 'RushAndCash5116126' 6-max Seat #1 is the button
Seat 1: 9c1ff0eb ($13.58 in chips)
Seat 2: ca45576d ($10 in chips)
Seat 3: Hero ($11.37 in chips)
Seat 4: 8ecd9df2 ($16.57 in chips)
Seat 5: 6a39bd11 ($10.9 in chips)
Seat 6: 60dc62a7 ($7.46 in chips)
ca45576d: posts small blind $0.05
Hero: posts big blind $0.1
*** HOLE CARDS ***
Dealt to 9c1ff0eb 
Dealt to ca45576d 
Dealt to Hero [4c 3d]
Dealt to 8ecd9df2 
Dealt to 6a39bd11 
Dealt to 60dc62a7 
8ecd9df2: folds
6a39bd11: folds
60dc62a7: folds
9c1ff0eb: raises $0.1 to $0.2
ca45576d: raises $0.75 to $0.95
Hero: folds
9c1ff0eb: folds
Uncalled bet ($0.75) returned to ca45576d
*** SHOWDOWN ***
ca45576d collected $0.48 from pot
*** SUMMARY ***
Total pot $0.5 | Rake $0.02 | Jackpot $0 | Bingo $0 | Fortune $0
Seat 1: 9c1ff0eb (button) folded before Flop
Seat 2: ca45576d (small blind) collected ($0.48)
Seat 3: Hero (big blind) folded before Flop
Seat 4: 8ecd9df2 folded before Flop (didn't bet)
Seat 5: 6a39bd11 folded before Flop (didn't bet)
Seat 6: 60dc62a7 folded before Flop (didn't bet)


Poker Hand #RC1316920838: Hold'em No Limit  ($0.05/$0.1) - 2023/02/02 13:44:55
Table 'RushAndCash5116098' 6-max Seat #1 is the button
Seat 1: ef486511 ($21.65 in chips)
Seat 2: b40b6aa4 ($12.98 in chips)
Seat 3: a0b046cd ($10.92 in chips)
Seat 4: 4bf13164 ($9.83 in chips)
Seat 5: Hero ($11.37 in chips)
Seat 6: ec28c68b ($12.23 in chips)
b40b6aa4: posts small blind $0.05
a0b046cd: posts big blind $0.1
*** HOLE CARDS ***
Dealt to ef486511 
Dealt to b40b6aa4 
Dealt to a0b046cd 
Dealt to 4bf13164 
Dealt to Hero [Js 4d]
Dealt to ec28c68b 
4bf13164: folds
Hero: folds
ec28c68b: folds
ef486511: raises $0.14 to $0.24
b40b6aa4: folds
a0b046cd: folds
Uncalled bet ($0.14) returned to ef486511
*** SHOWDOWN ***
ef486511 collected $0.25 from pot
*** SUMMARY ***
Total pot $0.25 | Rake $0 | Jackpot $0 | Bingo $0 | Fortune $0
Seat 1: ef486511 (button) collected ($0.25)
Seat 2: b40b6aa4 (small blind) folded before Flop
Seat 3: a0b046cd (big blind) folded before Flop
Seat 4: 4bf13164 folded before Flop (didn't bet)
Seat 5: Hero folded before Flop (didn't bet)
Seat 6: ec28c68b folded before Flop (didn't bet)


Poker Hand #RC1316920815: Hold'em No Limit  ($0.05/$0.1) - 2023/02/02 13:44:51
Table 'RushAndCash5116075' 6-max Seat #1 is the button
Seat 1: f4ac5f12 ($11.05 in chips)
Seat 2: Hero ($11.42 in chips)
Seat 3: c7cb04d4 ($26.16 in chips)
Seat 4: 2280f4aa ($10.15 in chips)
Seat 5: eabec68f ($10 in chips)
Seat 6: 1dab96e2 ($10.32 in chips)
Hero: posts small blind $0.05
c7cb04d4: posts big blind $0.1
*** HOLE CARDS ***
Dealt to f4ac5f12 
Dealt to Hero [3d 5c]
Dealt to c7cb04d4 
Dealt to 2280f4aa 
Dealt to eabec68f 
Dealt to 1dab96e2 
2280f4aa: raises $0.15 to $0.25
eabec68f: folds
1dab96e2: folds
f4ac5f12: folds
Hero: folds
c7cb04d4: folds
Uncalled bet ($0.15) returned to 2280f4aa
*** SHOWDOWN ***
2280f4aa collected $0.25 from pot
*** SUMMARY ***
Total pot $0.25 | Rake $0 | Jackpot $0 | Bingo $0 | Fortune $0
Seat 1: f4ac5f12 (button) folded before Flop (didn't bet)
Seat 2: Hero (small blind) folded before Flop
Seat 3: c7cb04d4 (big blind) folded before Flop
Seat 4: 2280f4aa collected ($0.25)
Seat 5: eabec68f folded before Flop (didn't bet)
Seat 6: 1dab96e2 folded before Flop (didn't bet)


Poker Hand #RC1316920783: Hold'em No Limit  ($0.05/$0.1) - 2023/02/02 13:44:46
Table 'RushAndCash5116043' 6-max Seat #1 is the button
Seat 1: 4102215f ($10 in chips)
Seat 2: ce1f6c2c ($15.18 in chips)
Seat 3: 1c0d9010 ($11.13 in chips)
Seat 4: 24096ad7 ($9.85 in chips)
Seat 5: Hero ($11.42 in chips)
Seat 6: de55a96b ($25.41 in chips)
ce1f6c2c: posts small blind $0.05
1c0d9010: posts big blind $0.1
*** HOLE CARDS ***
Dealt to 4102215f 
Dealt to ce1f6c2c 
Dealt to 1c0d9010 
Dealt to 24096ad7 
Dealt to Hero [3h 3s]
Dealt to de55a96b 
24096ad7: raises $0.1 to $0.2
Hero: folds
de55a96b: raises $0.42 to $0.62
4102215f: folds
ce1f6c2c: folds
1c0d9010: folds
24096ad7: calls $0.42
*** FLOP *** [Tc 5c Kc]
24096ad7: checks
de55a96b: checks
*** TURN *** [Tc 5c Kc] [9h]
24096ad7: bets $1.05
de55a96b: calls $1.05
*** RIVER *** [Tc 5c Kc 9h] [Ad]
24096ad7: bets $2.62
de55a96b: folds
Uncalled bet ($2.62) returned to 24096ad7
*** SHOWDOWN ***
24096ad7 collected $3.18 from pot
*** SUMMARY ***
Total pot $3.49 | Rake $0.16 | Jackpot $0.15 | Bingo $0 | Fortune $0
Board [Tc 5c Kc 9h Ad]
Seat 1: 4102215f (button) folded before Flop (didn't bet)
Seat 2: ce1f6c2c (small blind) folded before Flop
Seat 3: 1c0d9010 (big blind) folded before Flop
Seat 4: 24096ad7 won ($3.18)
Seat 5: Hero folded before Flop (didn't bet)
Seat 6: de55a96b folded on the River


Poker Hand #RC1316920720: Hold'em No Limit  ($0.05/$0.1) - 2023/02/02 13:44:36
Table 'RushAndCash5115980' 6-max Seat #1 is the button
Seat 1: b451cf6b ($13.75 in chips)
Seat 2: Hero ($11.47 in chips)
Seat 3: 48451ad4 ($10.73 in chips)
Seat 4: 554fdc7 ($14.21 in chips)
Seat 5: 244b3641 ($15.08 in chips)
Seat 6: 57a516a0 ($10.19 in chips)
Hero: posts small blind $0.05
48451ad4: posts big blind $0.1
*** HOLE CARDS ***
Dealt to b451cf6b 
Dealt to Hero [Qs 7c]
Dealt to 48451ad4 
Dealt to 554fdc7 
Dealt to 244b3641 
Dealt to 57a516a0 
554fdc7: folds
244b3641: folds
57a516a0: folds
b451cf6b: raises $0.15 to $0.25
Hero: folds
48451ad4: calls $0.15
*** FLOP *** [Kd 8c 8d]
48451ad4: checks
b451cf6b: checks
*** TURN *** [Kd 8c 8d] [9d]
48451ad4: bets $0.2
b451cf6b: folds
Uncalled bet ($0.2) returned to 48451ad4
*** SHOWDOWN ***
48451ad4 collected $0.53 from pot
*** SUMMARY ***
Total pot $0.55 | Rake $0.02 | Jackpot $0 | Bingo $0 | Fortune $0
Board [Kd 8c 8d 9d]
Seat 1: b451cf6b (button) folded on the Turn
Seat 2: Hero (small blind) folded before Flop
Seat 3: 48451ad4 (big blind) won ($0.53)
Seat 4: 554fdc7 folded before Flop (didn't bet)
Seat 5: 244b3641 folded before Flop (didn't bet)
Seat 6: 57a516a0 folded before Flop (didn't bet)


Poker Hand #RC1316920692: Hold'em No Limit  ($0.05/$0.1) - 2023/02/02 13:44:32
Table 'RushAndCash5115952' 6-max Seat #1 is the button
Seat 1: Hero ($11.47 in chips)
Seat 2: 10b69628 ($11.03 in chips)
Seat 3: f8840a59 ($16.14 in chips)
Seat 4: ec06370 ($10.52 in chips)
Seat 5: 6b48fc10 ($5.91 in chips)
Seat 6: 67b1a6be ($4.66 in chips)
10b69628: posts small blind $0.05
f8840a59: posts big blind $0.1
*** HOLE CARDS ***
Dealt to Hero [5s 2s]
Dealt to 10b69628 
Dealt to f8840a59 
Dealt to ec06370 
Dealt to 6b48fc10 
Dealt to 67b1a6be 
ec06370: folds
6b48fc10: folds
67b1a6be: folds
Hero: folds
10b69628: folds
Uncalled bet ($0.05) returned to f8840a59
*** SHOWDOWN ***
f8840a59 collected $0.1 from pot
*** SUMMARY ***
Total pot $0.1 | Rake $0 | Jackpot $0 | Bingo $0 | Fortune $0
Seat 1: Hero (button) folded before Flop (didn't bet)
Seat 2: 10b69628 (small blind) folded before Flop
Seat 3: f8840a59 (big blind) collected ($0.1)
Seat 4: ec06370 folded before Flop (didn't bet)
Seat 5: 6b48fc10 folded before Flop (didn't bet)
Seat 6: 67b1a6be folded before Flop (didn't bet)


Poker Hand #RC1316920665: Hold'em No Limit  ($0.05/$0.1) - 2023/02/02 13:44:28
Table 'RushAndCash5115925' 6-max Seat #1 is the button
Seat 1: b219d968 ($11.62 in chips)
Seat 2: 244b3641 ($15.13 in chips)
Seat 3: Hero ($11.57 in chips)
Seat 4: f9d5331d ($9.7 in chips)
Seat 5: e79a686f ($11.97 in chips)
Seat 6: b8f75f5 ($10 in chips)
244b3641: posts small blind $0.05
Hero: posts big blind $0.1
*** HOLE CARDS ***
Dealt to b219d968 
Dealt to 244b3641 
Dealt to Hero [Js 6c]
Dealt to f9d5331d 
Dealt to e79a686f 
Dealt to b8f75f5 
f9d5331d: raises $0.12 to $0.22
e79a686f: folds
b8f75f5: raises $0.59 to $0.81
b219d968: folds
244b3641: folds
Hero: folds
f9d5331d: raises $1.29 to $2.1
b8f75f5: calls $1.29
*** FLOP *** [Td 8h 6s]
f9d5331d: bets $1.44
b8f75f5: folds
Uncalled bet ($1.44) returned to f9d5331d
*** SHOWDOWN ***
f9d5331d collected $3.99 from pot
*** SUMMARY ***
Total pot $4.35 | Rake $0.21 | Jackpot $0.15 | Bingo $0 | Fortune $0
Board [Td 8h 6s]
Seat 1: b219d968 (button) folded before Flop (didn't bet)
Seat 2: 244b3641 (small blind) folded before Flop
Seat 3: Hero (big blind) folded before Flop
Seat 4: f9d5331d won ($3.99)
Seat 5: e79a686f folded before Flop (didn't bet)
Seat 6: b8f75f5 folded on the Flop


Poker Hand #RC1316920645: Hold'em No Limit  ($0.05/$0.1) - 2023/02/02 13:44:24
Table 'RushAndCash5115905' 6-max Seat #1 is the button
Seat 1: cb98a323 ($17.96 in chips)
Seat 2: a5ff5048 ($10 in chips)
Seat 3: b19d0d06 ($13.34 in chips)
Seat 4: 84c6ab9d ($9.37 in chips)
Seat 5: Hero ($11.57 in chips)
Seat 6: 89bfc792 ($10.15 in chips)
a5ff5048: posts small blind $0.05
b19d0d06: posts big blind $0.1
*** HOLE CARDS ***
Dealt to cb98a323 
Dealt to a5ff5048 
Dealt to b19d0d06 
Dealt to 84c6ab9d 
Dealt to Hero [2d 6d]
Dealt to 89bfc792 
84c6ab9d: folds
Hero: folds
89bfc792: folds
cb98a323: raises $0.15 to $0.25
a5ff5048: folds
b19d0d06: calls $0.15
*** FLOP *** [Kh 7h 4h]
b19d0d06: checks
cb98a323: checks
*** TURN *** [Kh 7h 4h] [8h]
b19d0d06: bets $0.31
cb98a323: folds
Uncalled bet ($0.31) returned to b19d0d06
*** SHOWDOWN ***
b19d0d06 collected $0.53 from pot
*** SUMMARY ***
Total pot $0.55 | Rake $0.02 | Jackpot $0 | Bingo $0 | Fortune $0
Board [Kh 7h 4h 8h]
Seat 1: cb98a323 (button) folded on the Turn
Seat 2: a5ff5048 (small blind) folded before Flop
Seat 3: b19d0d06 (big blind) won ($0.53)
Seat 4: 84c6ab9d folded before Flop (didn't bet)
Seat 5: Hero folded before Flop (didn't bet)
Seat 6: 89bfc792 folded before Flop (didn't bet)


Poker Hand #RC1316920616: Hold'em No Limit  ($0.05/$0.1) - 2023/02/02 13:44:19
Table 'RushAndCash5115876' 6-max Seat #1 is the button
Seat 1: 425bcc6 ($15.04 in chips)
Seat 2: b8691dbb ($10.15 in chips)
Seat 3: 3e4899ff ($34.11 in chips)
Seat 4: a9a3ee5d ($10.34 in chips)
Seat 5: Hero ($11.57 in chips)
Seat 6: 3f16b959 ($10.15 in chips)
b8691dbb: posts small blind $0.05
3e4899ff: posts big blind $0.1
*** HOLE CARDS ***
Dealt to 425bcc6 
Dealt to b8691dbb 
Dealt to 3e4899ff 
Dealt to a9a3ee5d 
Dealt to Hero [Qd 2s]
Dealt to 3f16b959 
a9a3ee5d: folds
Hero: folds
3f16b959: folds
425bcc6: folds
b8691dbb: folds
Uncalled bet ($0.05) returned to 3e4899ff
*** SHOWDOWN ***
3e4899ff collected $0.1 from pot
*** SUMMARY ***
Total pot $0.1 | Rake $0 | Jackpot $0 | Bingo $0 | Fortune $0
Seat 1: 425bcc6 (button) folded before Flop (didn't bet)
Seat 2: b8691dbb (small blind) folded before Flop
Seat 3: 3e4899ff (big blind) collected ($0.1)
Seat 4: a9a3ee5d folded before Flop (didn't bet)
Seat 5: Hero folded before Flop (didn't bet)
Seat 6: 3f16b959 folded before Flop (didn't bet)


Poker Hand #RC1316920508: Hold'em No Limit  ($0.05/$0.1) - 2023/02/02 13:43:59
Table 'RushAndCash5115768' 6-max Seat #1 is the button
Seat 1: 4065afd3 ($10 in chips)
Seat 2: d8fa0745 ($10.09 in chips)
Seat 3: 6aaca674 ($4 in chips)
Seat 4: 37d1b473 ($11.22 in chips)
Seat 5: 11e7af6c ($15.67 in chips)
Seat 6: Hero ($11.42 in chips)
d8fa0745: posts small blind $0.05
6aaca674: posts big blind $0.1
*** HOLE CARDS ***
Dealt to 4065afd3 
Dealt to d8fa0745 
Dealt to 6aaca674 
Dealt to 37d1b473 
Dealt to 11e7af6c 
Dealt to Hero [Kh Qd]
37d1b473: folds
11e7af6c: folds
Hero: raises $0.15 to $0.25
4065afd3: folds
d8fa0745: folds
6aaca674: folds
Uncalled bet ($0.15) returned to Hero
*** SHOWDOWN ***
Hero collected $0.25 from pot
*** SUMMARY ***
Total pot $0.25 | Rake $0 | Jackpot $0 | Bingo $0 | Fortune $0
Seat 1: 4065afd3 (button) folded before Flop (didn't bet)
Seat 2: d8fa0745 (small blind) folded before Flop
Seat 3: 6aaca674 (big blind) folded before Flop
Seat 4: 37d1b473 folded before Flop (didn't bet)
Seat 5: 11e7af6c folded before Flop (didn't bet)
Seat 6: Hero collected ($0.25)


Poker Hand #RC1316920117: Hold'em No Limit  ($0.05/$0.1) - 2023/02/02 13:42:54
Table 'RushAndCash5115377' 6-max Seat #1 is the button
Seat 1: Hero ($11.06 in chips)
Seat 2: 90df046f ($10.27 in chips)
Seat 3: 174e4954 ($19.59 in chips)
Seat 4: d8fa0745 ($10.33 in chips)
Seat 5: 4d3af38f ($10 in chips)
Seat 6: 594730b8 ($4.39 in chips)
90df046f: posts small blind $0.05
174e4954: posts big blind $0.1
*** HOLE CARDS ***
Dealt to Hero [Jd Ac]
Dealt to 90df046f 
Dealt to 174e4954 
Dealt to d8fa0745 
Dealt to 4d3af38f 
Dealt to 594730b8 
d8fa0745: raises $0.14 to $0.24
4d3af38f: folds
594730b8: folds
Hero: calls $0.24
90df046f: folds
174e4954: folds
*** FLOP *** [2d Ks Qd]
d8fa0745: checks
Hero: checks
*** TURN *** [2d Ks Qd] [6h]
d8fa0745: checks
Hero: bets $0.32
d8fa0745: folds
Uncalled bet ($0.32) returned to Hero
*** SHOWDOWN ***
Hero collected $0.6 from pot
*** SUMMARY ***
Total pot $0.63 | Rake $0.03 | Jackpot $0 | Bingo $0 | Fortune $0
Board [2d Ks Qd 6h]
Seat 1: Hero (button) won ($0.6)
Seat 2: 90df046f (small blind) folded before Flop
Seat 3: 174e4954 (big blind) folded before Flop
Seat 4: d8fa0745 folded on the Turn
Seat 5: 4d3af38f folded before Flop (didn't bet)
Seat 6: 594730b8 folded before Flop (didn't bet)


Poker Hand #RC1316919953: Hold'em No Limit  ($0.05/$0.1) - 2023/02/02 13:42:27
Table 'RushAndCash5115213' 6-max Seat #1 is the button
Seat 1: 79c753e6 ($10 in chips)
Seat 2: Hero ($11.36 in chips)
Seat 3: 5421c2ce ($11.57 in chips)
Seat 4: 92fdd6f3 ($12.54 in chips)
Seat 5: 672ba439 ($30.72 in chips)
Seat 6: e7a3c645 ($10 in chips)
Hero: posts small blind $0.05
5421c2ce: posts big blind $0.1
*** HOLE CARDS ***
Dealt to 79c753e6 
Dealt to Hero [Ts Kc]
Dealt to 5421c2ce 
Dealt to 92fdd6f3 
Dealt to 672ba439 
Dealt to e7a3c645 
92fdd6f3: folds
672ba439: folds
e7a3c645: folds
79c753e6: folds
Hero: raises $0.2 to $0.3
5421c2ce: raises $0.6 to $0.9
Hero: folds
Uncalled bet ($0.6) returned to 5421c2ce
*** SHOWDOWN ***
5421c2ce collected $0.57 from pot
*** SUMMARY ***
Total pot $0.6 | Rake $0.03 | Jackpot $0 | Bingo $0 | Fortune $0
Seat 1: 79c753e6 (button) folded before Flop (didn't bet)
Seat 2: Hero (small blind) folded before Flop
Seat 3: 5421c2ce (big blind) collected ($0.57)
Seat 4: 92fdd6f3 folded before Flop (didn't bet)
Seat 5: 672ba439 folded before Flop (didn't bet)
Seat 6: e7a3c645 folded before Flop (didn't bet)


Poker Hand #RC1316919905: Hold'em No Limit  ($0.05/$0.1) - 2023/02/02 13:42:19
Table 'RushAndCash5115165' 6-max Seat #1 is the button
Seat 1: d8fa0745 ($10.48 in chips)
Seat 2: f9d5331d ($9.9 in chips)
Seat 3: Hero ($11.31 in chips)
Seat 4: 332e6b89 ($10 in chips)
Seat 5: 6b0aa086 ($13.24 in chips)
Seat 6: f07ce14f ($10.6 in chips)
f9d5331d: posts small blind $0.05
Hero: posts big blind $0.1
*** HOLE CARDS ***
Dealt to d8fa0745 
Dealt to f9d5331d 
Dealt to Hero [Tc 9c]
Dealt to 332e6b89 
Dealt to 6b0aa086 
Dealt to f07ce14f 
332e6b89: folds
6b0aa086: folds
f07ce14f: folds
d8fa0745: folds
f9d5331d: folds
Uncalled bet ($0.05) returned to Hero
*** SHOWDOWN ***
Hero collected $0.1 from pot
*** SUMMARY ***
Total pot $0.1 | Rake $0 | Jackpot $0 | Bingo $0 | Fortune $0
Seat 1: d8fa0745 (button) folded before Flop (didn't bet)
Seat 2: f9d5331d (small blind) folded before Flop
Seat 3: Hero (big blind) collected ($0.1)
Seat 4: 332e6b89 folded before Flop (didn't bet)
Seat 5: 6b0aa086 folded before Flop (didn't bet)
Seat 6: f07ce14f folded before Flop (didn't bet)


Poker Hand #RC1316919867: Hold'em No Limit  ($0.05/$0.1) - 2023/02/02 13:42:13
Table 'RushAndCash5115127' 6-max Seat #1 is the button
Seat 1: 57f24a62 ($23.71 in chips)
Seat 2: e7c7aa80 ($11.04 in chips)
Seat 3: 98f6e09c ($6.59 in chips)
Seat 4: 3ed4d36e ($10.56 in chips)
Seat 5: 3d2bf5bc ($12.85 in chips)
Seat 6: Hero ($11.31 in chips)
e7c7aa80: posts small blind $0.05
98f6e09c: posts big blind $0.1
*** HOLE CARDS ***
Dealt to 57f24a62 
Dealt to e7c7aa80 
Dealt to 98f6e09c 
Dealt to 3ed4d36e 
Dealt to 3d2bf5bc 
Dealt to Hero [4d Qh]
3ed4d36e: folds
3d2bf5bc: folds
Hero: folds
57f24a62: folds
e7c7aa80: raises $0.2 to $0.3
98f6e09c: folds
Uncalled bet ($0.2) returned to e7c7aa80
*** SHOWDOWN ***
e7c7aa80 collected $0.2 from pot
*** SUMMARY ***
Total pot $0.2 | Rake $0 | Jackpot $0 | Bingo $0 | Fortune $0
Seat 1: 57f24a62 (button) folded before Flop (didn't bet)
Seat 2: e7c7aa80 (small blind) collected ($0.2)
Seat 3: 98f6e09c (big blind) folded before Flop
Seat 4: 3ed4d36e folded before Flop (didn't bet)
Seat 5: 3d2bf5bc folded before Flop (didn't bet)
Seat 6: Hero folded before Flop (didn't bet)


Poker Hand #RC1316919842: Hold'em No Limit  ($0.05/$0.1) - 2023/02/02 13:42:09
Table 'RushAndCash5115102' 6-max Seat #1 is the button
Seat 1: 278dbeb9 ($23.07 in chips)
Seat 2: a0486099 ($18.21 in chips)
Seat 3: 11e7af6c ($15.92 in chips)
Seat 4: 53b7ef5a ($22.4 in chips)
Seat 5: Hero ($11.31 in chips)
Seat 6: e58114d9 ($12.34 in chips)
a0486099: posts small blind $0.05
11e7af6c: posts big blind $0.1
*** HOLE CARDS ***
Dealt to 278dbeb9 
Dealt to a0486099 
Dealt to 11e7af6c 
Dealt to 53b7ef5a 
Dealt to Hero [4s Qs]
Dealt to e58114d9 
53b7ef5a: folds
Hero: folds
e58114d9: folds
278dbeb9: folds
a0486099: folds
Uncalled bet ($0.05) returned to 11e7af6c
*** SHOWDOWN ***
11e7af6c collected $0.1 from pot
*** SUMMARY ***
Total pot $0.1 | Rake $0 | Jackpot $0 | Bingo $0 | Fortune $0
Seat 1: 278dbeb9 (button) folded before Flop (didn't bet)
Seat 2: a0486099 (small blind) folded before Flop
Seat 3: 11e7af6c (big blind) collected ($0.1)
Seat 4: 53b7ef5a folded before Flop (didn't bet)
Seat 5: Hero folded before Flop (didn't bet)
Seat 6: e58114d9 folded before Flop (didn't bet)


Poker Hand #RC1316919817: Hold'em No Limit  ($0.05/$0.1) - 2023/02/02 13:42:04
Table 'RushAndCash5115077' 6-max Seat #1 is the button
Seat 1: Hero ($11.31 in chips)
Seat 2: 5eb6be30 ($10.23 in chips)
Seat 3: 17fd6262 ($8.49 in chips)
Seat 4: 40c04b68 ($26.29 in chips)
Seat 5: eff1d00a ($10.66 in chips)
Seat 6: 9ce8cf5d ($17.01 in chips)
5eb6be30: posts small blind $0.05
17fd6262: posts big blind $0.1
*** HOLE CARDS ***
Dealt to Hero [Tc 8d]
Dealt to 5eb6be30 
Dealt to 17fd6262 
Dealt to 40c04b68 
Dealt to eff1d00a 
Dealt to 9ce8cf5d 
40c04b68: folds
eff1d00a: folds
9ce8cf5d: raises $0.1 to $0.2
Hero: folds
5eb6be30: folds
17fd6262: calls $0.1
*** FLOP *** [Kh 4d 7s]
17fd6262: checks
9ce8cf5d: checks
*** TURN *** [Kh 4d 7s] [7c]
17fd6262: checks
9ce8cf5d: checks
*** RIVER *** [Kh 4d 7s 7c] [Kc]
17fd6262: checks
9ce8cf5d: bets $0.45
17fd6262: folds
Uncalled bet ($0.45) returned to 9ce8cf5d
*** SHOWDOWN ***
9ce8cf5d collected $0.43 from pot
*** SUMMARY ***
Total pot $0.45 | Rake $0.02 | Jackpot $0 | Bingo $0 | Fortune $0
Board [Kh 4d 7s 7c Kc]
Seat 1: Hero (button) folded before Flop (didn't bet)
Seat 2: 5eb6be30 (small blind) folded before Flop
Seat 3: 17fd6262 (big blind) folded on the River
Seat 4: 40c04b68 folded before Flop (didn't bet)
Seat 5: eff1d00a folded before Flop (didn't bet)
Seat 6: 9ce8cf5d won ($0.43)


Poker Hand #RC1316919782: Hold'em No Limit  ($0.05/$0.1) - 2023/02/02 13:41:58
Table 'RushAndCash5115042' 6-max Seat #1 is the button
Seat 1: dcb6f389 ($12.26 in chips)
Seat 2: Hero ($11.36 in chips)
Seat 3: 4991bf6e ($11.51 in chips)
Seat 4: b451cf6b ($10.15 in chips)
Seat 5: ef42fb3c ($10 in chips)
Seat 6: 40c04b68 ($26.29 in chips)
Hero: posts small blind $0.05
4991bf6e: posts big blind $0.1
*** HOLE CARDS ***
Dealt to dcb6f389 
Dealt to Hero [Kc 3c]
Dealt to 4991bf6e 
Dealt to b451cf6b 
Dealt to ef42fb3c 
Dealt to 40c04b68 
b451cf6b: raises $0.15 to $0.25
ef42fb3c: folds
40c04b68: folds
dcb6f389: folds
Hero: folds
4991bf6e: calls $0.15
*** FLOP *** [Jc 5c Ts]
4991bf6e: checks
b451cf6b: bets $0.28
4991bf6e: calls $0.28
*** TURN *** [Jc 5c Ts] [Qd]
4991bf6e: checks
b451cf6b: bets $0.56
4991bf6e: raises $1.12 to $1.68
b451cf6b: calls $1.12
*** RIVER *** [Jc 5c Ts Qd] [6s]
4991bf6e: bets $2.24
b451cf6b: calls $2.24
4991bf6e: shows [Jd Qh] (Pair of Queens and Pair of Jacks)
b451cf6b: shows [Td Th] (Three Tens)
*** SHOWDOWN ***
b451cf6b collected $8.5 from pot
*** SUMMARY ***
Total pot $8.95 | Rake $0.3 | Jackpot $0.15 | Bingo $0 | Fortune $0
Board [Jc 5c Ts Qd 6s]
Seat 1: dcb6f389 (button) folded before Flop (didn't bet)
Seat 2: Hero (small blind) folded before Flop
Seat 3: 4991bf6e (big blind) showed [Jd Qh] and lost with Pair of Queens and Pair of Jacks
Seat 4: b451cf6b showed [Td Th] and won ($8.5) with Three Tens
Seat 5: ef42fb3c folded before Flop (didn't bet)
Seat 6: 40c04b68 folded before Flop (didn't bet)


Poker Hand #RC1316919758: Hold'em No Limit  ($0.05/$0.1) - 2023/02/02 13:41:54
Table 'RushAndCash5115018' 6-max Seat #1 is the button
Seat 1: 2dbf26fc ($10.05 in chips)
Seat 2: 6fe3b0f1 ($10.49 in chips)
Seat 3: a0b046cd ($10 in chips)
Seat 4: afd25674 ($14.53 in chips)
Seat 5: ee65323 ($10.26 in chips)
Seat 6: Hero ($11.36 in chips)
6fe3b0f1: posts small blind $0.05
a0b046cd: posts big blind $0.1
*** HOLE CARDS ***
Dealt to 2dbf26fc 
Dealt to 6fe3b0f1 
Dealt to a0b046cd 
Dealt to afd25674 
Dealt to ee65323 
Dealt to Hero [2c Jh]
afd25674: folds
ee65323: folds
Hero: folds
2dbf26fc: folds
6fe3b0f1: raises $0.2 to $0.3
a0b046cd: raises $0.57 to $0.87
6fe3b0f1: calls $0.57
*** FLOP *** [9h Ac 6s]
6fe3b0f1: bets $0.58
a0b046cd: folds
Uncalled bet ($0.58) returned to 6fe3b0f1
*** SHOWDOWN ***
6fe3b0f1 collected $1.66 from pot
*** SUMMARY ***
Total pot $1.74 | Rake $0.08 | Jackpot $0 | Bingo $0 | Fortune $0
Board [9h Ac 6s]
Seat 1: 2dbf26fc (button) folded before Flop (didn't bet)
Seat 2: 6fe3b0f1 (small blind) won ($1.66)
Seat 3: a0b046cd (big blind) folded on the Flop
Seat 4: afd25674 folded before Flop (didn't bet)
Seat 5: ee65323 folded before Flop (didn't bet)
Seat 6: Hero folded before Flop (didn't bet)


Poker Hand #RC1316919714: Hold'em No Limit  ($0.05/$0.1) - 2023/02/02 13:41:46
Table 'RushAndCash5114974' 6-max Seat #1 is the button
Seat 1: 8e4718ee ($11.31 in chips)
Seat 2: de55a96b ($26.23 in chips)
Seat 3: Hero ($11.31 in chips)
Seat 4: 2dbf26fc ($10.15 in chips)
Seat 5: ce2b1ec ($10.3 in chips)
Seat 6: 592a0d89 ($9.26 in chips)
de55a96b: posts small blind $0.05
Hero: posts big blind $0.1
*** HOLE CARDS ***
Dealt to 8e4718ee 
Dealt to de55a96b 
Dealt to Hero [6h 9d]
Dealt to 2dbf26fc 
Dealt to ce2b1ec 
Dealt to 592a0d89 
2dbf26fc: folds
ce2b1ec: folds
592a0d89: folds
8e4718ee: folds
de55a96b: folds
Uncalled bet ($0.05) returned to Hero
*** SHOWDOWN ***
Hero collected $0.1 from pot
*** SUMMARY ***
Total pot $0.1 | Rake $0 | Jackpot $0 | Bingo $0 | Fortune $0
Seat 1: 8e4718ee (button) folded before Flop (didn't bet)
Seat 2: de55a96b (small blind) folded before Flop
Seat 3: Hero (big blind) collected ($0.1)
Seat 4: 2dbf26fc folded before Flop (didn't bet)
Seat 5: ce2b1ec folded before Flop (didn't bet)
Seat 6: 592a0d89 folded before Flop (didn't bet)


Poker Hand #RC1316919687: Hold'em No Limit  ($0.05/$0.1) - 2023/02/02 13:41:42
Table 'RushAndCash5114947' 6-max Seat #1 is the button
Seat 1: 9053c965 ($25.6 in chips)
Seat 2: d3f45a2 ($12.72 in chips)
Seat 3: b834df54 ($23.12 in chips)
Seat 4: 29b18ea6 ($8.52 in chips)
Seat 5: Hero ($11.31 in chips)
Seat 6: 129444b4 ($14.37 in chips)
d3f45a2: posts small blind $0.05
b834df54: posts big blind $0.1
*** HOLE CARDS ***
Dealt to 9053c965 
Dealt to d3f45a2 
Dealt to b834df54 
Dealt to 29b18ea6 
Dealt to Hero [Ac 2h]
Dealt to 129444b4 
29b18ea6: raises $0.1 to $0.2
Hero: folds
129444b4: folds
9053c965: folds
d3f45a2: raises $0.7 to $0.9
b834df54: folds
29b18ea6: calls $0.7
*** FLOP *** [4d 5d 8s]
d3f45a2: checks
29b18ea6: checks
*** TURN *** [4d 5d 8s] [Qs]
d3f45a2: bets $1.45
29b18ea6: folds
Uncalled bet ($1.45) returned to d3f45a2
*** SHOWDOWN ***
d3f45a2 collected $1.81 from pot
*** SUMMARY ***
Total pot $1.9 | Rake $0.09 | Jackpot $0 | Bingo $0 | Fortune $0
Board [4d 5d 8s Qs]
Seat 1: 9053c965 (button) folded before Flop (didn't bet)
Seat 2: d3f45a2 (small blind) won ($1.81)
Seat 3: b834df54 (big blind) folded before Flop
Seat 4: 29b18ea6 folded on the Turn
Seat 5: Hero folded before Flop (didn't bet)
Seat 6: 129444b4 folded before Flop (didn't bet)


Poker Hand #RC1316919665: Hold'em No Limit  ($0.05/$0.1) - 2023/02/02 13:41:38
Table 'RushAndCash5114925' 6-max Seat #1 is the button
Seat 1: bc717a6c ($7.37 in chips)
Seat 2: ee80910b ($5.55 in chips)
Seat 3: cd8d77cf ($10 in chips)
Seat 4: Hero ($11.31 in chips)
Seat 5: 9b7234f2 ($10.41 in chips)
Seat 6: 20f57af4 ($11.78 in chips)
ee80910b: posts small blind $0.05
cd8d77cf: posts big blind $0.1
*** HOLE CARDS ***
Dealt to bc717a6c 
Dealt to ee80910b 
Dealt to cd8d77cf 
Dealt to Hero [4d 2d]
Dealt to 9b7234f2 
Dealt to 20f57af4 
Hero: folds
9b7234f2: folds
20f57af4: raises $0.1 to $0.2
bc717a6c: folds
ee80910b: calls $0.15
cd8d77cf: raises $1.1 to $1.3
20f57af4: folds
ee80910b: folds
Uncalled bet ($1.1) returned to cd8d77cf
*** SHOWDOWN ***
cd8d77cf collected $0.57 from pot
*** SUMMARY ***
Total pot $0.6 | Rake $0.03 | Jackpot $0 | Bingo $0 | Fortune $0
Seat 1: bc717a6c (button) folded before Flop (didn't bet)
Seat 2: ee80910b (small blind) folded before Flop
Seat 3: cd8d77cf (big blind) collected ($0.57)
Seat 4: Hero folded before Flop (didn't bet)
Seat 5: 9b7234f2 folded before Flop (didn't bet)
Seat 6: 20f57af4 folded before Flop


Poker Hand #RC1316919642: Hold'em No Limit  ($0.05/$0.1) - 2023/02/02 13:41:34
Table 'RushAndCash5114902' 6-max Seat #1 is the button
Seat 1: ec28c68b ($10 in chips)
Seat 2: 530e5a41 ($10.37 in chips)
Seat 3: a4a170ee ($10.79 in chips)
Seat 4: 67ca5402 ($10.1 in chips)
Seat 5: Hero ($11.31 in chips)
Seat 6: f396c7c9 ($17.09 in chips)
530e5a41: posts small blind $0.05
a4a170ee: posts big blind $0.1
*** HOLE CARDS ***
Dealt to ec28c68b 
Dealt to 530e5a41 
Dealt to a4a170ee 
Dealt to 67ca5402 
Dealt to Hero [4s Th]
Dealt to f396c7c9 
67ca5402: folds
Hero: folds
f396c7c9: folds
ec28c68b: folds
530e5a41: folds
Uncalled bet ($0.05) returned to a4a170ee
*** SHOWDOWN ***
a4a170ee collected $0.1 from pot
*** SUMMARY ***
Total pot $0.1 | Rake $0 | Jackpot $0 | Bingo $0 | Fortune $0
Seat 1: ec28c68b (button) folded before Flop (didn't bet)
Seat 2: 530e5a41 (small blind) folded before Flop
Seat 3: a4a170ee (big blind) collected ($0.1)
Seat 4: 67ca5402 folded before Flop (didn't bet)
Seat 5: Hero folded before Flop (didn't bet)
Seat 6: f396c7c9 folded before Flop (didn't bet)


Poker Hand #RC1316919617: Hold'em No Limit  ($0.05/$0.1) - 2023/02/02 13:41:29
Table 'RushAndCash5114877' 6-max Seat #1 is the button
Seat 1: Hero ($11.31 in chips)
Seat 2: 39b91777 ($10 in chips)
Seat 3: 419e6bce ($10.15 in chips)
Seat 4: 47bb40fc ($5.84 in chips)
Seat 5: 58bcf4a5 ($10.08 in chips)
Seat 6: ceac471a ($10 in chips)
39b91777: posts small blind $0.05
419e6bce: posts big blind $0.1
*** HOLE CARDS ***
Dealt to Hero [5d 4c]
Dealt to 39b91777 
Dealt to 419e6bce 
Dealt to 47bb40fc 
Dealt to 58bcf4a5 
Dealt to ceac471a 
47bb40fc: folds
58bcf4a5: folds
ceac471a: folds
Hero: folds
39b91777: folds
Uncalled bet ($0.05) returned to 419e6bce
*** SHOWDOWN ***
419e6bce collected $0.1 from pot
*** SUMMARY ***
Total pot $0.1 | Rake $0 | Jackpot $0 | Bingo $0 | Fortune $0
Seat 1: Hero (button) folded before Flop (didn't bet)
Seat 2: 39b91777 (small blind) folded before Flop
Seat 3: 419e6bce (big blind) collected ($0.1)
Seat 4: 47bb40fc folded before Flop (didn't bet)
Seat 5: 58bcf4a5 folded before Flop (didn't bet)
Seat 6: ceac471a folded before Flop (didn't bet)


Poker Hand #RC1316919498: Hold'em No Limit  ($0.05/$0.1) - 2023/02/02 13:41:09
Table 'RushAndCash5114758' 6-max Seat #1 is the button
Seat 1: 63234475 ($10.9 in chips)
Seat 2: Hero ($11.21 in chips)
Seat 3: 508a8e2f ($10 in chips)
Seat 4: ec28c68b ($10 in chips)
Seat 5: b219d968 ($10.07 in chips)
Seat 6: a2ef2efb ($15.72 in chips)
Hero: posts small blind $0.05
508a8e2f: posts big blind $0.1
*** HOLE CARDS ***
Dealt to 63234475 
Dealt to Hero [Jd Kc]
Dealt to 508a8e2f 
Dealt to ec28c68b 
Dealt to b219d968 
Dealt to a2ef2efb 
ec28c68b: folds
b219d968: folds
a2ef2efb: folds
63234475: folds
Hero: raises $0.2 to $0.3
508a8e2f: folds
Uncalled bet ($0.2) returned to Hero
*** SHOWDOWN ***
Hero collected $0.2 from pot
*** SUMMARY ***
Total pot $0.2 | Rake $0 | Jackpot $0 | Bingo $0 | Fortune $0
Seat 1: 63234475 (button) folded before Flop (didn't bet)
Seat 2: Hero (small blind) collected ($0.2)
Seat 3: 508a8e2f (big blind) folded before Flop
Seat 4: ec28c68b folded before Flop (didn't bet)
Seat 5: b219d968 folded before Flop (didn't bet)
Seat 6: a2ef2efb folded before Flop (didn't bet)


Poker Hand #RC1316919347: Hold'em No Limit  ($0.05/$0.1) - 2023/02/02 13:40:41
Table 'RushAndCash5114607' 6-max Seat #1 is the button
Seat 1: 43e17bbd ($11.78 in chips)
Seat 2: ca45576d ($10.15 in chips)
Seat 3: Hero ($11.46 in chips)
Seat 4: 10cd6494 ($11.25 in chips)
Seat 5: b219d968 ($10.02 in chips)
Seat 6: a2ef2efb ($15.44 in chips)
ca45576d: posts small blind $0.05
Hero: posts big blind $0.1
*** HOLE CARDS ***
Dealt to 43e17bbd 
Dealt to ca45576d 
Dealt to Hero [9s Js]
Dealt to 10cd6494 
Dealt to b219d968 
Dealt to a2ef2efb 
10cd6494: folds
b219d968: folds
a2ef2efb: raises $0.15 to $0.25
43e17bbd: folds
ca45576d: folds
Hero: calls $0.15
*** FLOP *** [6d Qc Ad]
Hero: checks
a2ef2efb: bets $0.4
Hero: folds
Uncalled bet ($0.4) returned to a2ef2efb
*** SHOWDOWN ***
a2ef2efb collected $0.53 from pot
*** SUMMARY ***
Total pot $0.55 | Rake $0.02 | Jackpot $0 | Bingo $0 | Fortune $0
Board [6d Qc Ad]
Seat 1: 43e17bbd (button) folded before Flop (didn't bet)
Seat 2: ca45576d (small blind) folded before Flop
Seat 3: Hero (big blind) folded on the Flop
Seat 4: 10cd6494 folded before Flop (didn't bet)
Seat 5: b219d968 folded before Flop (didn't bet)
Seat 6: a2ef2efb won ($0.53)


Poker Hand #RC1316919325: Hold'em No Limit  ($0.05/$0.1) - 2023/02/02 13:40:37
Table 'RushAndCash5114585' 6-max Seat #1 is the button
Seat 1: 9053c965 ($25.7 in chips)
Seat 2: 47ad8f71 ($10.05 in chips)
Seat 3: b9fc2b4e ($18.35 in chips)
Seat 4: Hero ($11.46 in chips)
Seat 5: 2e40002e ($14.89 in chips)
Seat 6: 70157308 ($10.15 in chips)
47ad8f71: posts small blind $0.05
b9fc2b4e: posts big blind $0.1
*** HOLE CARDS ***
Dealt to 9053c965 
Dealt to 47ad8f71 
Dealt to b9fc2b4e 
Dealt to Hero [Qh 2s]
Dealt to 2e40002e 
Dealt to 70157308 
Hero: folds
2e40002e: folds
70157308: folds
9053c965: folds
47ad8f71: folds
Uncalled bet ($0.05) returned to b9fc2b4e
*** SHOWDOWN ***
b9fc2b4e collected $0.1 from pot
*** SUMMARY ***
Total pot $0.1 | Rake $0 | Jackpot $0 | Bingo $0 | Fortune $0
Seat 1: 9053c965 (button) folded before Flop (didn't bet)
Seat 2: 47ad8f71 (small blind) folded before Flop
Seat 3: b9fc2b4e (big blind) collected ($0.1)
Seat 4: Hero folded before Flop (didn't bet)
Seat 5: 2e40002e folded before Flop (didn't bet)
Seat 6: 70157308 folded before Flop (didn't bet)


Poker Hand #RC1316918916: Hold'em No Limit  ($0.05/$0.1) - 2023/02/02 13:39:26
Table 'RushAndCash5114176' 6-max Seat #1 is the button
Seat 1: 25cb00e0 ($10.67 in chips)
Seat 2: 2e79ae04 ($10 in chips)
Seat 3: 9aed9c2a ($22.99 in chips)
Seat 4: 39b91777 ($10 in chips)
Seat 5: Hero ($11.18 in chips)
Seat 6: 37c77bfe ($12.93 in chips)
2e79ae04: posts small blind $0.05
9aed9c2a: posts big blind $0.1
*** HOLE CARDS ***
Dealt to 25cb00e0 
Dealt to 2e79ae04 
Dealt to 9aed9c2a 
Dealt to 39b91777 
Dealt to Hero [Qh Jh]
Dealt to 37c77bfe 
39b91777: folds
Hero: raises $0.15 to $0.25
37c77bfe: folds
25cb00e0: folds
2e79ae04: folds
9aed9c2a: calls $0.15
*** FLOP *** [6d 6h 4c]
9aed9c2a: checks
Hero: checks
*** TURN *** [6d 6h 4c] [9h]
9aed9c2a: checks
Hero: bets $0.3
9aed9c2a: folds
Uncalled bet ($0.3) returned to Hero
*** SHOWDOWN ***
Hero collected $0.53 from pot
*** SUMMARY ***
Total pot $0.55 | Rake $0.02 | Jackpot $0 | Bingo $0 | Fortune $0
Board [6d 6h 4c 9h]
Seat 1: 25cb00e0 (button) folded before Flop (didn't bet)
Seat 2: 2e79ae04 (small blind) folded before Flop
Seat 3: 9aed9c2a (big blind) folded on the Turn
Seat 4: 39b91777 folded before Flop (didn't bet)
Seat 5: Hero won ($0.53)
Seat 6: 37c77bfe folded before Flop (didn't bet)


Poker Hand #RC1316918890: Hold'em No Limit  ($0.05/$0.1) - 2023/02/02 13:39:21
Table 'RushAndCash5114150' 6-max Seat #1 is the button
Seat 1: 6329da58 ($38.85 in chips)
Seat 2: 18e48067 ($10 in chips)
Seat 3: 6ad84d2a ($19.98 in chips)
Seat 4: Hero ($11.18 in chips)
Seat 5: c1068e29 ($10.13 in chips)
Seat 6: 5eb6be30 ($10.38 in chips)
18e48067: posts small blind $0.05
6ad84d2a: posts big blind $0.1
*** HOLE CARDS ***
Dealt to 6329da58 
Dealt to 18e48067 
Dealt to 6ad84d2a 
Dealt to Hero [3d Tc]
Dealt to c1068e29 
Dealt to 5eb6be30 
Hero: folds
c1068e29: folds
5eb6be30: folds
6329da58: folds
18e48067: raises $0.15 to $0.25
6ad84d2a: folds
Uncalled bet ($0.15) returned to 18e48067
*** SHOWDOWN ***
18e48067 collected $0.2 from pot
*** SUMMARY ***
Total pot $0.2 | Rake $0 | Jackpot $0 | Bingo $0 | Fortune $0
Seat 1: 6329da58 (button) folded before Flop (didn't bet)
Seat 2: 18e48067 (small blind) collected ($0.2)
Seat 3: 6ad84d2a (big blind) folded before Flop
Seat 4: Hero folded before Flop (didn't bet)
Seat 5: c1068e29 folded before Flop (didn't bet)
Seat 6: 5eb6be30 folded before Flop (didn't bet)


Poker Hand #RC1316918863: Hold'em No Limit  ($0.05/$0.1) - 2023/02/02 13:39:17
Table 'RushAndCash5114123' 6-max Seat #1 is the button
Seat 1: a33492a3 ($10.51 in chips)
Seat 2: 84c6ab9d ($10.71 in chips)
Seat 3: 38008ffc ($28.63 in chips)
Seat 4: 8cf0d117 ($10 in chips)
Seat 5: Hero ($11.18 in chips)
Seat 6: cc12df17 ($4.24 in chips)
84c6ab9d: posts small blind $0.05
38008ffc: posts big blind $0.1
*** HOLE CARDS ***
Dealt to a33492a3 
Dealt to 84c6ab9d 
Dealt to 38008ffc 
Dealt to 8cf0d117 
Dealt to Hero [9s 2c]
Dealt to cc12df17 
8cf0d117: folds
Hero: folds
cc12df17: folds
a33492a3: folds
84c6ab9d: folds
Uncalled bet ($0.05) returned to 38008ffc
*** SHOWDOWN ***
38008ffc collected $0.1 from pot
*** SUMMARY ***
Total pot $0.1 | Rake $0 | Jackpot $0 | Bingo $0 | Fortune $0
Seat 1: a33492a3 (button) folded before Flop (didn't bet)
Seat 2: 84c6ab9d (small blind) folded before Flop
Seat 3: 38008ffc (big blind) collected ($0.1)
Seat 4: 8cf0d117 folded before Flop (didn't bet)
Seat 5: Hero folded before Flop (didn't bet)
Seat 6: cc12df17 folded before Flop (didn't bet)


Poker Hand #RC1316918603: Hold'em No Limit  ($0.05/$0.1) - 2023/02/02 13:38:29
Table 'RushAndCash5113863' 6-max Seat #1 is the button
Seat 1: Hero ($9.85 in chips)
Seat 2: fa2a15cf ($11.94 in chips)
Seat 3: c1e13604 ($11.11 in chips)
Seat 4: c7059548 ($16.24 in chips)
Seat 5: 80727905 ($11.26 in chips)
Seat 6: 38008ffc ($29.68 in chips)
fa2a15cf: posts small blind $0.05
c1e13604: posts big blind $0.1
*** HOLE CARDS ***
Dealt to Hero [8d Kd]
Dealt to fa2a15cf 
Dealt to c1e13604 
Dealt to c7059548 
Dealt to 80727905 
Dealt to 38008ffc 
c7059548: raises $0.15 to $0.25
80727905: folds
38008ffc: calls $0.25
Hero: raises $0.8 to $1.05
fa2a15cf: folds
c1e13604: folds
c7059548: folds
38008ffc: calls $0.8
*** FLOP *** [Qh 2s 7h]
38008ffc: checks
Hero: bets $0.87
38008ffc: folds
Uncalled bet ($0.87) returned to Hero
*** SHOWDOWN ***
Hero collected $2.38 from pot
*** SUMMARY ***
Total pot $2.5 | Rake $0.12 | Jackpot $0 | Bingo $0 | Fortune $0
Board [Qh 2s 7h]
Seat 1: Hero (button) won ($2.38)
Seat 2: fa2a15cf (small blind) folded before Flop
Seat 3: c1e13604 (big blind) folded before Flop
Seat 4: c7059548 folded before Flop
Seat 5: 80727905 folded before Flop (didn't bet)
Seat 6: 38008ffc folded on the Flop


Poker Hand #RC1316918564: Hold'em No Limit  ($0.05/$0.1) - 2023/02/02 13:38:22
Table 'RushAndCash5113824' 6-max Seat #1 is the button
Seat 1: 31bc5dfa ($19.83 in chips)
Seat 2: Hero ($9.9 in chips)
Seat 3: 7a387534 ($16.11 in chips)
Seat 4: b834df54 ($23 in chips)
Seat 5: a33492a3 ($10.66 in chips)
Seat 6: abe55004 ($10 in chips)
Hero: posts small blind $0.05
7a387534: posts big blind $0.1
*** HOLE CARDS ***
Dealt to 31bc5dfa 
Dealt to Hero [3h Js]
Dealt to 7a387534 
Dealt to b834df54 
Dealt to a33492a3 
Dealt to abe55004 
b834df54: folds
a33492a3: raises $0.15 to $0.25
abe55004: folds
31bc5dfa: folds
Hero: folds
7a387534: folds
Uncalled bet ($0.15) returned to a33492a3
*** SHOWDOWN ***
a33492a3 collected $0.25 from pot
*** SUMMARY ***
Total pot $0.25 | Rake $0 | Jackpot $0 | Bingo $0 | Fortune $0
Seat 1: 31bc5dfa (button) folded before Flop (didn't bet)
Seat 2: Hero (small blind) folded before Flop
Seat 3: 7a387534 (big blind) folded before Flop
Seat 4: b834df54 folded before Flop (didn't bet)
Seat 5: a33492a3 collected ($0.25)
Seat 6: abe55004 folded before Flop (didn't bet)


Poker Hand #RC1316918527: Hold'em No Limit  ($0.05/$0.1) - 2023/02/02 13:38:15
Table 'RushAndCash5113787' 6-max Seat #1 is the button
Seat 1: 45eb3128 ($10 in chips)
Seat 2: fa358bb6 ($9.8 in chips)
Seat 3: Hero ($10 in chips)
Seat 4: 94298a61 ($5.44 in chips)
Seat 5: ba36758d ($15.69 in chips)
Seat 6: 8ecd9df2 ($12.66 in chips)
fa358bb6: posts small blind $0.05
Hero: posts big blind $0.1
*** HOLE CARDS ***
Dealt to 45eb3128 
Dealt to fa358bb6 
Dealt to Hero [7c 5h]
Dealt to 94298a61 
Dealt to ba36758d 
Dealt to 8ecd9df2 
94298a61: folds
ba36758d: folds
8ecd9df2: folds
45eb3128: raises $0.15 to $0.25
fa358bb6: folds
Hero: folds
Uncalled bet ($0.15) returned to 45eb3128
*** SHOWDOWN ***
45eb3128 collected $0.25 from pot
*** SUMMARY ***
Total pot $0.25 | Rake $0 | Jackpot $0 | Bingo $0 | Fortune $0
Seat 1: 45eb3128 (button) collected ($0.25)
Seat 2: fa358bb6 (small blind) folded before Flop
Seat 3: Hero (big blind) folded before Flop
Seat 4: 94298a61 folded before Flop (didn't bet)
Seat 5: ba36758d folded before Flop (didn't bet)
Seat 6: 8ecd9df2 folded before Flop (didn't bet)


